MittausID;Pvm;Vuosi;Kuukausi;Tunti;Viikonpäivä;PP_1;PP_2;PP_YHT;JK_1;JK_2;JK_YHT
89;03.01.2011;2011;01;00;Maanantai;0;0;0;2;0;2
89;03.01.2011;2011;01;01;Maanantai;1;3;4;2;0;2
89;03.01.2011;2011;01;02;Maanantai;0;1;1;0;0;0
89;03.01.2011;2011;01;03;Maanantai;1;3;4;1;1;2
89;03.01.2011;2011;01;04;Maanantai;1;10;11;0;3;3
89;03.01.2011;2011;01;05;Maanantai;5;29;34;2;6;8
89;03.01.2011;2011;01;06;Maanantai;17;61;78;7;27;34
89;03.01.2011;2011;01;07;Maanantai;26;106;132;10;33;43
89;03.01.2011;2011;01;08;Maanantai;13;68;81;10;41;51
89;03.01.2011;2011;01;09;Maanantai;25;58;83;16;32;48
89;03.01.2011;2011;01;10;Maanantai;28;40;68;14;34;48
89;03.01.2011;2011;01;11;Maanantai;36;53;89;23;36;59
89;03.01.2011;2011;01;12;Maanantai;31;59;90;31;39;70
89;03.01.2011;2011;01;13;Maanantai;48;49;97;28;24;52
89;03.01.2011;2011;01;14;Maanantai;71;43;114;31;32;63
89;03.01.2011;2011;01;15;Maanantai;110;40;150;40;23;63
89;03.01.2011;2011;01;16;Maanantai;59;41;100;31;25;56
89;03.01.2011;2011;01;17;Maanantai;44;23;67;36;16;52
89;03.01.2011;2011;01;18;Maanantai;31;20;51;35;24;59
89;03.01.2011;2011;01;19;Maanantai;25;23;48;0;0;0
89;03.01.2011;2011;01;20;Maanantai;16;14;30;0;0;0
89;03.01.2011;2011;01;21;Maanantai;15;15;30;0;0;0
89;03.01.2011;2011;01;22;Maanantai;6;4;10;0;0;0
89;03.01.2011;2011;01;23;Maanantai;4;1;5;0;0;0
89;04.01.2011;2011;01;00;Tiistai;1;0;1;0;0;0
89;04.01.2011;2011;01;01;Tiistai;3;1;4;0;0;0
89;04.01.2011;2011;01;02;Tiistai;1;1;2;0;0;0
89;04.01.2011;2011;01;03;Tiistai;4;3;7;0;0;0
89;04.01.2011;2011;01;04;Tiistai;6;5;11;0;0;0
89;04.01.2011;2011;01;05;Tiistai;13;19;32;4;1;5
89;04.01.2011;2011;01;06;Tiistai;29;46;75;6;11;17
89;04.01.2011;2011;01;07;Tiistai;50;69;119;11;23;34
89;04.01.2011;2011;01;08;Tiistai;25;53;78;9;13;22
89;04.01.2011;2011;01;09;Tiistai;14;27;41;8;26;34
89;04.01.2011;2011;01;10;Tiistai;13;42;55;9;28;37
89;04.01.2011;2011;01;11;Tiistai;11;40;51;21;46;67
89;04.01.2011;2011;01;12;Tiistai;17;52;69;14;29;43
89;04.01.2011;2011;01;13;Tiistai;25;47;72;9;36;45
89;04.01.2011;2011;01;14;Tiistai;40;67;107;21;26;47
89;04.01.2011;2011;01;15;Tiistai;35;97;132;28;15;43
89;04.01.2011;2011;01;16;Tiistai;35;69;104;24;21;45
89;04.01.2011;2011;01;17;Tiistai;24;39;63;19;24;43
89;04.01.2011;2011;01;18;Tiistai;21;30;51;16;19;35
89;04.01.2011;2011;01;19;Tiistai;19;25;44;10;18;28
89;04.01.2011;2011;01;20;Tiistai;18;23;41;12;10;22
89;04.01.2011;2011;01;21;Tiistai;9;8;17;7;4;11
89;04.01.2011;2011;01;22;Tiistai;4;2;6;5;2;7
89;04.01.2011;2011;01;23;Tiistai;0;4;4;1;1;2
89;05.01.2011;2011;01;00;Keskiviikko;1;0;1;1;2;3
89;05.01.2011;2011;01;01;Keskiviikko;0;0;0;1;1;2
89;05.01.2011;2011;01;02;Keskiviikko;0;0;0;0;0;0
89;05.01.2011;2011;01;03;Keskiviikko;0;8;8;0;0;0
89;05.01.2011;2011;01;04;Keskiviikko;2;4;6;0;3;3
89;05.01.2011;2011;01;05;Keskiviikko;11;19;30;3;2;5
89;05.01.2011;2011;01;06;Keskiviikko;16;54;70;2;17;19
89;05.01.2011;2011;01;07;Keskiviikko;12;90;102;8;28;36
89;05.01.2011;2011;01;08;Keskiviikko;12;71;83;5;25;30
89;05.01.2011;2011;01;09;Keskiviikko;10;29;39;9;24;33
89;05.01.2011;2011;01;10;Keskiviikko;13;35;48;14;31;45
89;05.01.2011;2011;01;11;Keskiviikko;25;28;53;16;28;44
89;05.01.2011;2011;01;12;Keskiviikko;23;44;67;21;19;40
89;05.01.2011;2011;01;13;Keskiviikko;38;34;72;20;22;42
89;05.01.2011;2011;01;14;Keskiviikko;67;41;108;15;23;38
89;05.01.2011;2011;01;15;Keskiviikko;66;51;117;26;17;43
89;05.01.2011;2011;01;16;Keskiviikko;58;42;100;21;19;40
89;05.01.2011;2011;01;17;Keskiviikko;32;31;63;14;8;22
89;05.01.2011;2011;01;18;Keskiviikko;22;21;43;12;12;24
89;05.01.2011;2011;01;19;Keskiviikko;15;24;39;5;9;14
89;05.01.2011;2011;01;20;Keskiviikko;17;10;27;6;12;18
89;05.01.2011;2011;01;21;Keskiviikko;8;16;24;5;2;7
89;05.01.2011;2011;01;22;Keskiviikko;8;1;9;2;5;7
89;05.01.2011;2011;01;23;Keskiviikko;8;4;12;0;1;1
89;06.01.2011;2011;01;00;Torstai;2;3;5;2;1;3
89;06.01.2011;2011;01;01;Torstai;2;2;4;3;2;5
89;06.01.2011;2011;01;02;Torstai;9;3;12;3;0;3
89;06.01.2011;2011;01;03;Torstai;10;2;12;11;0;11
89;06.01.2011;2011;01;04;Torstai;6;0;6;5;0;5
89;06.01.2011;2011;01;05;Torstai;1;0;1;0;0;0
89;06.01.2011;2011;01;06;Torstai;2;2;4;2;0;2
89;06.01.2011;2011;01;07;Torstai;2;3;5;2;6;8
89;06.01.2011;2011;01;08;Torstai;1;3;4;1;3;4
89;06.01.2011;2011;01;09;Torstai;6;8;14;2;6;8
89;06.01.2011;2011;01;10;Torstai;6;6;12;12;19;31
89;06.01.2011;2011;01;11;Torstai;10;12;22;18;26;44
89;06.01.2011;2011;01;12;Torstai;10;12;22;25;38;63
89;06.01.2011;2011;01;13;Torstai;17;13;30;26;55;81
89;06.01.2011;2011;01;14;Torstai;11;14;25;24;44;68
89;06.01.2011;2011;01;15;Torstai;14;10;24;19;29;48
89;06.01.2011;2011;01;16;Torstai;22;17;39;9;27;36
89;06.01.2011;2011;01;17;Torstai;12;17;29;21;23;44
89;06.01.2011;2011;01;18;Torstai;19;16;35;17;27;44
89;06.01.2011;2011;01;19;Torstai;11;8;19;16;27;43
89;06.01.2011;2011;01;20;Torstai;13;10;23;11;13;24
89;06.01.2011;2011;01;21;Torstai;22;19;41;3;8;11
89;06.01.2011;2011;01;22;Torstai;7;7;14;7;6;13
89;06.01.2011;2011;01;23;Torstai;0;1;1;2;1;3
89;07.01.2011;2011;01;00;Perjantai;4;7;11;1;1;2
89;07.01.2011;2011;01;01;Perjantai;2;0;2;3;0;3
89;07.01.2011;2011;01;02;Perjantai;3;1;4;2;0;2
89;07.01.2011;2011;01;03;Perjantai;3;3;6;1;0;1
89;07.01.2011;2011;01;04;Perjantai;2;3;5;0;1;1
89;07.01.2011;2011;01;05;Perjantai;6;6;12;1;0;1
89;07.01.2011;2011;01;06;Perjantai;12;12;24;1;2;3
89;07.01.2011;2011;01;07;Perjantai;26;27;53;4;15;19
89;07.01.2011;2011;01;08;Perjantai;42;40;82;10;20;30
89;07.01.2011;2011;01;09;Perjantai;43;25;68;10;12;22
89;07.01.2011;2011;01;10;Perjantai;32;34;66;18;33;51
89;07.01.2011;2011;01;11;Perjantai;49;31;80;36;30;66
89;07.01.2011;2011;01;12;Perjantai;33;35;68;27;36;63
89;07.01.2011;2011;01;13;Perjantai;42;37;79;37;26;63
89;07.01.2011;2011;01;14;Perjantai;46;43;89;31;36;67
89;07.01.2011;2011;01;15;Perjantai;61;38;99;38;32;70
89;07.01.2011;2011;01;16;Perjantai;86;46;132;44;23;67
89;07.01.2011;2011;01;17;Perjantai;37;45;82;38;20;58
89;07.01.2011;2011;01;18;Perjantai;56;26;82;22;18;40
89;07.01.2011;2011;01;19;Perjantai;44;20;64;19;12;31
89;07.01.2011;2011;01;20;Perjantai;28;20;48;19;14;33
89;07.01.2011;2011;01;21;Perjantai;27;12;39;16;6;22
89;07.01.2011;2011;01;22;Perjantai;12;11;23;5;5;10
89;07.01.2011;2011;01;23;Perjantai;14;6;20;4;1;5
89;08.01.2011;2011;01;00;Lauantai;14;6;20;1;2;3
89;08.01.2011;2011;01;01;Lauantai;6;7;13;3;1;4
89;08.01.2011;2011;01;02;Lauantai;7;4;11;4;1;5
89;08.01.2011;2011;01;03;Lauantai;11;1;12;4;0;4
89;08.01.2011;2011;01;04;Lauantai;7;3;10;7;0;7
89;08.01.2011;2011;01;05;Lauantai;2;0;2;9;2;11
89;08.01.2011;2011;01;06;Lauantai;7;7;14;2;1;3
89;08.01.2011;2011;01;07;Lauantai;11;6;17;6;2;8
89;08.01.2011;2011;01;08;Lauantai;10;2;12;10;4;14
89;08.01.2011;2011;01;09;Lauantai;22;16;38;20;11;31
89;08.01.2011;2011;01;10;Lauantai;23;16;39;22;17;39
89;08.01.2011;2011;01;11;Lauantai;30;17;47;47;13;60
89;08.01.2011;2011;01;12;Lauantai;38;30;68;38;24;62
89;08.01.2011;2011;01;13;Lauantai;38;37;75;41;30;71
89;08.01.2011;2011;01;14;Lauantai;41;33;74;33;31;64
89;08.01.2011;2011;01;15;Lauantai;55;25;80;48;26;74
89;08.01.2011;2011;01;16;Lauantai;42;7;49;35;19;54
89;08.01.2011;2011;01;17;Lauantai;29;18;47;27;14;41
89;08.01.2011;2011;01;18;Lauantai;30;8;38;24;26;50
89;08.01.2011;2011;01;19;Lauantai;21;10;31;17;21;38
89;08.01.2011;2011;01;20;Lauantai;23;8;31;13;14;27
89;08.01.2011;2011;01;21;Lauantai;21;8;29;9;7;16
89;08.01.2011;2011;01;22;Lauantai;5;8;13;1;8;9
89;08.01.2011;2011;01;23;Lauantai;10;16;26;0;11;11
89;09.01.2011;2011;01;00;Sunnuntai;5;15;20;0;9;9
89;09.01.2011;2011;01;01;Sunnuntai;10;1;11;3;4;7
89;09.01.2011;2011;01;02;Sunnuntai;9;5;14;4;2;6
89;09.01.2011;2011;01;03;Sunnuntai;4;5;9;4;1;5
89;09.01.2011;2011;01;04;Sunnuntai;9;0;9;9;3;12
89;09.01.2011;2011;01;05;Sunnuntai;6;1;7;3;0;3
89;09.01.2011;2011;01;06;Sunnuntai;8;3;11;0;0;0
89;09.01.2011;2011;01;07;Sunnuntai;4;1;5;0;0;0
89;09.01.2011;2011;01;08;Sunnuntai;2;1;3;5;0;5
89;09.01.2011;2011;01;09;Sunnuntai;9;5;14;1;0;1
89;09.01.2011;2011;01;10;Sunnuntai;14;9;23;8;0;8
89;09.01.2011;2011;01;11;Sunnuntai;25;16;41;17;0;17
89;09.01.2011;2011;01;12;Sunnuntai;38;19;57;27;1;28
89;09.01.2011;2011;01;13;Sunnuntai;24;10;34;39;1;40
89;09.01.2011;2011;01;14;Sunnuntai;19;16;35;2;0;2
89;09.01.2011;2011;01;15;Sunnuntai;26;24;50;0;0;0
89;09.01.2011;2011;01;16;Sunnuntai;19;19;38;0;0;0
89;09.01.2011;2011;01;17;Sunnuntai;28;26;54;0;0;0
89;09.01.2011;2011;01;18;Sunnuntai;19;15;34;0;0;0
89;09.01.2011;2011;01;19;Sunnuntai;17;14;31;1;0;1
89;09.01.2011;2011;01;20;Sunnuntai;14;12;26;2;0;2
89;09.01.2011;2011;01;21;Sunnuntai;11;7;18;1;2;3
89;09.01.2011;2011;01;22;Sunnuntai;14;4;18;1;3;4
89;09.01.2011;2011;01;23;Sunnuntai;3;1;4;3;1;4
89;10.01.2011;2011;01;00;Maanantai;4;1;5;3;3;6
89;10.01.2011;2011;01;01;Maanantai;1;0;1;0;0;0
89;10.01.2011;2011;01;02;Maanantai;0;1;1;2;0;2
89;10.01.2011;2011;01;03;Maanantai;1;1;2;2;1;3
89;10.01.2011;2011;01;04;Maanantai;2;6;8;0;3;3
89;10.01.2011;2011;01;05;Maanantai;3;6;9;1;2;3
89;10.01.2011;2011;01;06;Maanantai;17;23;40;3;15;18
89;10.01.2011;2011;01;07;Maanantai;41;69;110;6;27;33
89;10.01.2011;2011;01;08;Maanantai;65;154;219;9;49;58
89;10.01.2011;2011;01;09;Maanantai;44;95;139;16;46;62
89;10.01.2011;2011;01;10;Maanantai;30;67;97;16;32;48
89;10.01.2011;2011;01;11;Maanantai;38;54;92;30;33;63
89;10.01.2011;2011;01;12;Maanantai;54;54;108;34;41;75
89;10.01.2011;2011;01;13;Maanantai;50;56;106;26;40;66
89;10.01.2011;2011;01;14;Maanantai;65;45;110;31;27;58
89;10.01.2011;2011;01;15;Maanantai;96;63;159;22;12;34
89;10.01.2011;2011;01;16;Maanantai;119;99;218;3;1;4
89;10.01.2011;2011;01;17;Maanantai;71;67;138;2;2;4
89;10.01.2011;2011;01;18;Maanantai;51;44;95;0;2;2
89;10.01.2011;2011;01;19;Maanantai;35;35;70;0;9;9
89;10.01.2011;2011;01;20;Maanantai;35;28;63;2;8;10
89;10.01.2011;2011;01;21;Maanantai;24;18;42;1;2;3
89;10.01.2011;2011;01;22;Maanantai;7;3;10;0;0;0
89;10.01.2011;2011;01;23;Maanantai;3;2;5;0;0;0
89;11.01.2011;2011;01;00;Tiistai;2;1;3;0;0;0
89;11.01.2011;2011;01;01;Tiistai;1;0;1;0;0;0
89;11.01.2011;2011;01;02;Tiistai;1;0;1;0;0;0
89;11.01.2011;2011;01;03;Tiistai;3;2;5;0;1;1
89;11.01.2011;2011;01;04;Tiistai;3;5;8;1;0;1
89;11.01.2011;2011;01;05;Tiistai;5;4;9;0;0;0
89;11.01.2011;2011;01;06;Tiistai;26;22;48;0;1;1
89;11.01.2011;2011;01;07;Tiistai;38;52;90;2;8;10
89;11.01.2011;2011;01;08;Tiistai;90;142;232;1;19;20
89;11.01.2011;2011;01;09;Tiistai;27;65;92;8;24;32
89;11.01.2011;2011;01;10;Tiistai;32;63;95;11;34;45
89;11.01.2011;2011;01;11;Tiistai;39;45;84;16;42;58
89;11.01.2011;2011;01;12;Tiistai;21;64;85;27;37;64
89;11.01.2011;2011;01;13;Tiistai;39;59;98;34;32;66
89;11.01.2011;2011;01;14;Tiistai;59;54;113;34;33;67
89;11.01.2011;2011;01;15;Tiistai;94;63;157;43;23;66
89;11.01.2011;2011;01;16;Tiistai;142;63;205;53;36;89
89;11.01.2011;2011;01;17;Tiistai;85;66;151;48;33;81
89;11.01.2011;2011;01;18;Tiistai;50;51;101;48;30;78
89;11.01.2011;2011;01;19;Tiistai;55;34;89;53;28;81
89;11.01.2011;2011;01;20;Tiistai;40;21;61;36;28;64
89;11.01.2011;2011;01;21;Tiistai;44;14;58;16;12;28
89;11.01.2011;2011;01;22;Tiistai;17;6;23;9;12;21
89;11.01.2011;2011;01;23;Tiistai;6;5;11;3;1;4
89;12.01.2011;2011;01;00;Keskiviikko;3;2;5;0;0;0
89;12.01.2011;2011;01;01;Keskiviikko;0;0;0;0;1;1
89;12.01.2011;2011;01;02;Keskiviikko;2;1;3;1;0;1
89;12.01.2011;2011;01;03;Keskiviikko;0;0;0;0;0;0
89;12.01.2011;2011;01;04;Keskiviikko;0;1;1;2;1;3
89;12.01.2011;2011;01;05;Keskiviikko;4;9;13;0;2;2
89;12.01.2011;2011;01;06;Keskiviikko;5;35;40;5;7;12
89;12.01.2011;2011;01;07;Keskiviikko;22;93;115;7;31;38
89;12.01.2011;2011;01;08;Keskiviikko;48;183;231;12;57;69
89;12.01.2011;2011;01;09;Keskiviikko;26;89;115;14;48;62
89;12.01.2011;2011;01;10;Keskiviikko;23;59;82;20;26;46
89;12.01.2011;2011;01;11;Keskiviikko;25;43;68;16;38;54
89;12.01.2011;2011;01;12;Keskiviikko;36;57;93;33;26;59
89;12.01.2011;2011;01;13;Keskiviikko;51;64;115;33;31;64
89;12.01.2011;2011;01;14;Keskiviikko;62;56;118;26;28;54
89;12.01.2011;2011;01;15;Keskiviikko;108;62;170;38;28;66
89;12.01.2011;2011;01;16;Keskiviikko;137;82;219;60;21;81
89;12.01.2011;2011;01;17;Keskiviikko;74;78;152;46;30;76
89;12.01.2011;2011;01;18;Keskiviikko;54;47;101;38;33;71
89;12.01.2011;2011;01;19;Keskiviikko;42;31;73;33;31;64
89;12.01.2011;2011;01;20;Keskiviikko;37;28;65;24;24;48
89;12.01.2011;2011;01;21;Keskiviikko;35;13;48;17;13;30
89;12.01.2011;2011;01;22;Keskiviikko;11;6;17;5;9;14
89;12.01.2011;2011;01;23;Keskiviikko;5;4;9;2;3;5
89;13.01.2011;2011;01;00;Torstai;11;1;12;1;2;3
89;13.01.2011;2011;01;01;Torstai;1;2;3;1;1;2
89;13.01.2011;2011;01;02;Torstai;0;2;2;0;0;0
89;13.01.2011;2011;01;03;Torstai;0;0;0;0;0;0
89;13.01.2011;2011;01;04;Torstai;1;3;4;0;3;3
89;13.01.2011;2011;01;05;Torstai;4;10;14;3;2;5
89;13.01.2011;2011;01;06;Torstai;6;39;45;2;17;19
89;13.01.2011;2011;01;07;Torstai;19;95;114;8;28;36
89;13.01.2011;2011;01;08;Torstai;42;189;231;5;25;30
89;13.01.2011;2011;01;09;Torstai;23;80;103;9;24;33
89;13.01.2011;2011;01;10;Torstai;30;59;89;14;31;45
89;13.01.2011;2011;01;11;Torstai;38;48;86;16;28;44
89;13.01.2011;2011;01;12;Torstai;39;49;88;21;19;40
89;13.01.2011;2011;01;13;Torstai;48;47;95;20;22;42
89;13.01.2011;2011;01;14;Torstai;64;62;126;15;23;38
89;13.01.2011;2011;01;15;Torstai;83;80;163;26;17;43
89;13.01.2011;2011;01;16;Torstai;95;92;187;21;19;40
89;13.01.2011;2011;01;17;Torstai;62;62;124;14;8;22
89;13.01.2011;2011;01;18;Torstai;48;44;92;12;12;24
89;13.01.2011;2011;01;19;Torstai;33;31;64;5;9;14
89;13.01.2011;2011;01;20;Torstai;35;34;69;6;12;18
89;13.01.2011;2011;01;21;Torstai;25;21;46;5;2;7
89;13.01.2011;2011;01;22;Torstai;12;12;24;2;5;7
89;13.01.2011;2011;01;23;Torstai;5;3;8;0;1;1
89;14.01.2011;2011;01;00;Perjantai;4;2;6;1;1;2
89;14.01.2011;2011;01;01;Perjantai;5;1;6;3;0;3
89;14.01.2011;2011;01;02;Perjantai;3;1;4;2;0;2
89;14.01.2011;2011;01;03;Perjantai;2;0;2;1;0;1
89;14.01.2011;2011;01;04;Perjantai;3;2;5;0;1;1
89;14.01.2011;2011;01;05;Perjantai;5;3;8;1;0;1
89;14.01.2011;2011;01;06;Perjantai;24;21;45;1;2;3
89;14.01.2011;2011;01;07;Perjantai;49;47;96;4;15;19
89;14.01.2011;2011;01;08;Perjantai;94;93;187;10;20;30
89;14.01.2011;2011;01;09;Perjantai;53;52;105;10;12;22
89;14.01.2011;2011;01;10;Perjantai;48;45;93;18;33;51
89;14.01.2011;2011;01;11;Perjantai;35;35;70;36;30;66
89;14.01.2011;2011;01;12;Perjantai;45;42;87;27;36;63
89;14.01.2011;2011;01;13;Perjantai;65;64;129;37;26;63
89;14.01.2011;2011;01;14;Perjantai;60;59;119;31;36;67
89;14.01.2011;2011;01;15;Perjantai;103;58;161;38;32;70
89;14.01.2011;2011;01;16;Perjantai;104;55;159;44;23;67
89;14.01.2011;2011;01;17;Perjantai;67;47;114;38;20;58
89;14.01.2011;2011;01;18;Perjantai;52;27;79;22;18;40
89;14.01.2011;2011;01;19;Perjantai;53;24;77;19;12;31
89;14.01.2011;2011;01;20;Perjantai;28;30;58;19;14;33
89;14.01.2011;2011;01;21;Perjantai;21;15;36;16;6;22
89;14.01.2011;2011;01;22;Perjantai;24;14;38;5;5;10
89;14.01.2011;2011;01;23;Perjantai;12;13;25;4;1;5
89;15.01.2011;2011;01;00;Lauantai;9;4;13;1;2;3
89;15.01.2011;2011;01;01;Lauantai;9;6;15;2;3;5
89;15.01.2011;2011;01;02;Lauantai;8;3;11;10;1;11
89;15.01.2011;2011;01;03;Lauantai;8;2;10;4;0;4
89;15.01.2011;2011;01;04;Lauantai;4;4;8;7;0;7
89;15.01.2011;2011;01;05;Lauantai;2;4;6;0;1;1
89;15.01.2011;2011;01;06;Lauantai;1;6;7;3;1;4
89;15.01.2011;2011;01;07;Lauantai;2;7;9;3;3;6
89;15.01.2011;2011;01;08;Lauantai;3;15;18;1;5;6
89;15.01.2011;2011;01;09;Lauantai;3;17;20;13;13;26
89;15.01.2011;2011;01;10;Lauantai;9;19;28;7;16;23
89;15.01.2011;2011;01;11;Lauantai;10;24;34;14;39;53
89;15.01.2011;2011;01;12;Lauantai;18;31;49;25;37;62
89;15.01.2011;2011;01;13;Lauantai;16;33;49;19;40;59
89;15.01.2011;2011;01;14;Lauantai;24;23;47;25;20;45
89;15.01.2011;2011;01;15;Lauantai;34;25;59;18;22;40
89;15.01.2011;2011;01;16;Lauantai;19;18;37;15;10;25
89;15.01.2011;2011;01;17;Lauantai;20;19;39;18;17;35
89;15.01.2011;2011;01;18;Lauantai;20;18;38;12;12;24
89;15.01.2011;2011;01;19;Lauantai;9;6;15;9;8;17
89;15.01.2011;2011;01;20;Lauantai;8;12;20;6;2;8
89;15.01.2011;2011;01;21;Lauantai;12;7;19;6;4;10
89;15.01.2011;2011;01;22;Lauantai;13;12;25;5;2;7
89;15.01.2011;2011;01;23;Lauantai;6;7;13;1;4;5
89;16.01.2011;2011;01;00;Sunnuntai;4;5;9;1;3;4
89;16.01.2011;2011;01;01;Sunnuntai;10;7;17;2;4;6
89;16.01.2011;2011;01;02;Sunnuntai;7;1;8;5;1;6
89;16.01.2011;2011;01;03;Sunnuntai;6;0;6;5;0;5
89;16.01.2011;2011;01;04;Sunnuntai;11;5;16;3;0;3
89;16.01.2011;2011;01;05;Sunnuntai;0;1;1;0;1;1
89;16.01.2011;2011;01;06;Sunnuntai;5;6;11;2;6;8
89;16.01.2011;2011;01;07;Sunnuntai;1;2;3;1;1;2
89;16.01.2011;2011;01;08;Sunnuntai;1;0;1;3;4;7
89;16.01.2011;2011;01;09;Sunnuntai;5;8;13;11;10;21
89;16.01.2011;2011;01;10;Sunnuntai;11;22;33;9;16;25
89;16.01.2011;2011;01;11;Sunnuntai;8;21;29;22;27;49
89;16.01.2011;2011;01;12;Sunnuntai;13;29;42;31;36;67
89;16.01.2011;2011;01;13;Sunnuntai;17;40;57;27;45;72
89;16.01.2011;2011;01;14;Sunnuntai;24;21;45;36;32;68
89;16.01.2011;2011;01;15;Sunnuntai;23;22;45;31;24;55
89;16.01.2011;2011;01;16;Sunnuntai;16;29;45;17;31;48
89;16.01.2011;2011;01;17;Sunnuntai;21;16;37;17;18;35
89;16.01.2011;2011;01;18;Sunnuntai;27;22;49;16;13;29
89;16.01.2011;2011;01;19;Sunnuntai;18;18;36;24;17;41
89;16.01.2011;2011;01;20;Sunnuntai;18;10;28;25;15;40
89;16.01.2011;2011;01;21;Sunnuntai;10;6;16;9;6;15
89;16.01.2011;2011;01;22;Sunnuntai;15;6;21;0;4;4
89;16.01.2011;2011;01;23;Sunnuntai;2;3;5;2;0;2
89;17.01.2011;2011;01;00;Maanantai;1;0;1;3;3;6
89;17.01.2011;2011;01;01;Maanantai;1;0;1;0;0;0
89;17.01.2011;2011;01;02;Maanantai;2;1;3;2;0;2
89;17.01.2011;2011;01;03;Maanantai;2;1;3;2;1;3
89;17.01.2011;2011;01;04;Maanantai;3;3;6;0;3;3
89;17.01.2011;2011;01;05;Maanantai;2;1;3;1;2;3
89;17.01.2011;2011;01;06;Maanantai;18;15;33;3;15;18
89;17.01.2011;2011;01;07;Maanantai;42;40;82;6;27;33
89;17.01.2011;2011;01;08;Maanantai;109;107;216;9;49;58
89;17.01.2011;2011;01;09;Maanantai;53;52;105;16;46;62
89;17.01.2011;2011;01;10;Maanantai;36;36;72;16;32;48
89;17.01.2011;2011;01;11;Maanantai;31;30;61;30;33;63
89;17.01.2011;2011;01;12;Maanantai;38;37;75;34;41;75
89;17.01.2011;2011;01;13;Maanantai;45;43;88;26;40;66
89;17.01.2011;2011;01;14;Maanantai;56;53;109;31;27;58
89;17.01.2011;2011;01;15;Maanantai;70;68;138;22;12;34
89;17.01.2011;2011;01;16;Maanantai;109;101;210;3;1;4
89;17.01.2011;2011;01;17;Maanantai;103;22;125;2;2;4
89;17.01.2011;2011;01;18;Maanantai;92;17;109;0;2;2
89;17.01.2011;2011;01;19;Maanantai;61;11;72;0;9;9
89;17.01.2011;2011;01;20;Maanantai;61;10;71;2;8;10
89;17.01.2011;2011;01;21;Maanantai;34;4;38;1;2;3
89;17.01.2011;2011;01;22;Maanantai;15;1;16;0;0;0
89;17.01.2011;2011;01;23;Maanantai;9;1;10;0;0;0
89;18.01.2011;2011;01;00;Tiistai;7;0;7;3;0;3
89;18.01.2011;2011;01;01;Tiistai;3;0;3;3;0;3
89;18.01.2011;2011;01;02;Tiistai;5;0;5;1;0;1
89;18.01.2011;2011;01;03;Tiistai;3;0;3;0;0;0
89;18.01.2011;2011;01;04;Tiistai;10;1;11;0;0;0
89;18.01.2011;2011;01;05;Tiistai;6;3;9;1;0;1
89;18.01.2011;2011;01;06;Tiistai;32;15;47;8;1;9
89;18.01.2011;2011;01;07;Tiistai;81;32;113;40;0;40
89;18.01.2011;2011;01;08;Tiistai;192;41;233;53;0;53
89;18.01.2011;2011;01;09;Tiistai;110;18;128;52;0;52
89;18.01.2011;2011;01;10;Tiistai;73;14;87;64;0;64
89;18.01.2011;2011;01;11;Tiistai;60;13;73;59;0;59
89;18.01.2011;2011;01;12;Tiistai;72;14;86;55;0;55
89;18.01.2011;2011;01;13;Tiistai;83;15;98;44;0;44
89;18.01.2011;2011;01;14;Tiistai;111;16;127;50;0;50
89;18.01.2011;2011;01;15;Tiistai;133;22;155;72;0;72
89;18.01.2011;2011;01;16;Tiistai;189;29;218;72;0;72
89;18.01.2011;2011;01;17;Tiistai;120;19;139;62;0;62
89;18.01.2011;2011;01;18;Tiistai;88;11;99;57;0;57
89;18.01.2011;2011;01;19;Tiistai;76;12;88;52;0;52
89;18.01.2011;2011;01;20;Tiistai;66;9;75;58;0;58
89;18.01.2011;2011;01;21;Tiistai;44;5;49;35;0;35
89;18.01.2011;2011;01;22;Tiistai;26;3;29;12;0;12
89;18.01.2011;2011;01;23;Tiistai;19;0;19;3;0;3
89;19.01.2011;2011;01;00;Keskiviikko;3;0;3;2;0;2
89;19.01.2011;2011;01;01;Keskiviikko;5;0;5;3;0;3
89;19.01.2011;2011;01;02;Keskiviikko;7;0;7;2;0;2
89;19.01.2011;2011;01;03;Keskiviikko;2;0;2;1;0;1
89;19.01.2011;2011;01;04;Keskiviikko;6;1;7;1;0;1
89;19.01.2011;2011;01;05;Keskiviikko;3;0;3;3;0;3
89;19.01.2011;2011;01;06;Keskiviikko;33;9;42;9;0;9
89;19.01.2011;2011;01;07;Keskiviikko;98;20;118;30;0;30
89;19.01.2011;2011;01;08;Keskiviikko;214;28;242;63;0;63
89;19.01.2011;2011;01;09;Keskiviikko;103;15;118;51;0;51
89;19.01.2011;2011;01;10;Keskiviikko;86;13;99;47;0;47
89;19.01.2011;2011;01;11;Keskiviikko;77;9;86;56;0;56
89;19.01.2011;2011;01;12;Keskiviikko;93;11;104;49;0;49
89;19.01.2011;2011;01;13;Keskiviikko;95;12;107;53;0;53
89;19.01.2011;2011;01;14;Keskiviikko;103;11;114;70;0;70
89;19.01.2011;2011;01;15;Keskiviikko;148;12;160;57;0;57
89;19.01.2011;2011;01;16;Keskiviikko;211;20;231;80;0;80
89;19.01.2011;2011;01;17;Keskiviikko;128;19;147;59;0;59
89;19.01.2011;2011;01;18;Keskiviikko;124;6;130;64;0;64
89;19.01.2011;2011;01;19;Keskiviikko;70;7;77;52;0;52
89;19.01.2011;2011;01;20;Keskiviikko;75;10;85;46;0;46
89;19.01.2011;2011;01;21;Keskiviikko;66;7;73;24;0;24
89;19.01.2011;2011;01;22;Keskiviikko;22;1;23;12;0;12
89;19.01.2011;2011;01;23;Keskiviikko;11;0;11;2;0;2
89;20.01.2011;2011;01;00;Torstai;9;0;9;3;0;3
89;20.01.2011;2011;01;01;Torstai;8;0;8;4;0;4
89;20.01.2011;2011;01;02;Torstai;3;0;3;1;0;1
89;20.01.2011;2011;01;03;Torstai;6;0;6;3;0;3
89;20.01.2011;2011;01;04;Torstai;5;0;5;1;0;1
89;20.01.2011;2011;01;05;Torstai;11;1;12;1;0;1
89;20.01.2011;2011;01;06;Torstai;34;6;40;4;0;4
89;20.01.2011;2011;01;07;Torstai;104;21;125;34;0;34
89;20.01.2011;2011;01;08;Torstai;206;23;229;74;0;74
89;20.01.2011;2011;01;09;Torstai;100;8;108;58;0;58
89;20.01.2011;2011;01;10;Torstai;90;6;96;50;0;50
89;20.01.2011;2011;01;11;Torstai;95;5;100;54;0;54
89;20.01.2011;2011;01;12;Torstai;85;8;93;49;0;49
89;20.01.2011;2011;01;13;Torstai;110;7;117;48;0;48
89;20.01.2011;2011;01;14;Torstai;132;3;135;55;0;55
89;20.01.2011;2011;01;15;Torstai;163;12;175;75;0;75
89;20.01.2011;2011;01;16;Torstai;221;14;235;80;0;80
89;20.01.2011;2011;01;17;Torstai;145;6;151;63;0;63
89;20.01.2011;2011;01;18;Torstai;94;6;100;49;0;49
89;20.01.2011;2011;01;19;Torstai;90;2;92;59;0;59
89;20.01.2011;2011;01;20;Torstai;63;1;64;50;0;50
89;20.01.2011;2011;01;21;Torstai;58;0;58;30;0;30
89;20.01.2011;2011;01;22;Torstai;30;0;30;20;0;20
89;20.01.2011;2011;01;23;Torstai;12;0;12;13;0;13
89;21.01.2011;2011;01;00;Perjantai;7;0;7;8;0;8
89;21.01.2011;2011;01;01;Perjantai;3;0;3;3;0;3
89;21.01.2011;2011;01;02;Perjantai;6;0;6;3;0;3
89;21.01.2011;2011;01;03;Perjantai;2;0;2;1;0;1
89;21.01.2011;2011;01;04;Perjantai;7;1;8;0;0;0
89;21.01.2011;2011;01;05;Perjantai;10;0;10;2;0;2
89;21.01.2011;2011;01;06;Perjantai;35;4;39;9;0;9
89;21.01.2011;2011;01;07;Perjantai;100;9;109;32;0;32
89;21.01.2011;2011;01;08;Perjantai;192;5;197;71;0;71
89;21.01.2011;2011;01;09;Perjantai;87;1;88;48;0;48
89;21.01.2011;2011;01;10;Perjantai;101;0;101;48;0;48
89;21.01.2011;2011;01;11;Perjantai;76;0;76;45;0;45
89;21.01.2011;2011;01;12;Perjantai;108;0;108;60;0;60
89;21.01.2011;2011;01;13;Perjantai;119;0;119;68;0;68
89;21.01.2011;2011;01;14;Perjantai;125;4;129;72;0;72
89;21.01.2011;2011;01;15;Perjantai;172;4;176;69;0;69
89;21.01.2011;2011;01;16;Perjantai;138;4;142;48;0;48
89;21.01.2011;2011;01;17;Perjantai;109;3;112;58;0;58
89;21.01.2011;2011;01;18;Perjantai;78;1;79;40;0;40
89;21.01.2011;2011;01;19;Perjantai;59;1;60;33;0;33
89;21.01.2011;2011;01;20;Perjantai;62;3;65;35;0;35
89;21.01.2011;2011;01;21;Perjantai;43;0;43;27;0;27
89;21.01.2011;2011;01;22;Perjantai;21;0;21;14;0;14
89;21.01.2011;2011;01;23;Perjantai;13;0;13;8;0;8
89;22.01.2011;2011;01;00;Lauantai;18;0;18;5;0;5
89;22.01.2011;2011;01;01;Lauantai;17;0;17;4;0;4
89;22.01.2011;2011;01;02;Lauantai;10;0;10;9;0;9
89;22.01.2011;2011;01;03;Lauantai;5;0;5;5;0;5
89;22.01.2011;2011;01;04;Lauantai;9;0;9;5;0;5
89;22.01.2011;2011;01;05;Lauantai;7;0;7;13;0;13
89;22.01.2011;2011;01;06;Lauantai;8;1;9;6;0;6
89;22.01.2011;2011;01;07;Lauantai;11;2;13;3;0;3
89;22.01.2011;2011;01;08;Lauantai;24;2;26;19;0;19
89;22.01.2011;2011;01;09;Lauantai;30;0;30;28;0;28
89;22.01.2011;2011;01;10;Lauantai;38;0;38;48;0;48
89;22.01.2011;2011;01;11;Lauantai;54;3;57;56;0;56
89;22.01.2011;2011;01;12;Lauantai;71;2;73;74;0;74
89;22.01.2011;2011;01;13;Lauantai;71;2;73;67;0;67
89;22.01.2011;2011;01;14;Lauantai;75;1;76;61;0;61
89;22.01.2011;2011;01;15;Lauantai;70;0;70;54;0;54
89;22.01.2011;2011;01;16;Lauantai;65;0;65;57;0;57
89;22.01.2011;2011;01;17;Lauantai;51;0;51;40;0;40
89;22.01.2011;2011;01;18;Lauantai;48;0;48;45;0;45
89;22.01.2011;2011;01;19;Lauantai;41;0;41;30;0;30
89;22.01.2011;2011;01;20;Lauantai;33;0;33;20;0;20
89;22.01.2011;2011;01;21;Lauantai;28;0;28;12;0;12
89;22.01.2011;2011;01;22;Lauantai;32;1;33;16;0;16
89;22.01.2011;2011;01;23;Lauantai;25;0;25;11;0;11
89;23.01.2011;2011;01;00;Sunnuntai;33;0;33;7;0;7
89;23.01.2011;2011;01;01;Sunnuntai;10;0;10;10;0;10
89;23.01.2011;2011;01;02;Sunnuntai;5;0;5;4;0;4
89;23.01.2011;2011;01;03;Sunnuntai;17;0;17;8;0;8
89;23.01.2011;2011;01;04;Sunnuntai;14;0;14;5;0;5
89;23.01.2011;2011;01;05;Sunnuntai;3;0;3;2;0;2
89;23.01.2011;2011;01;06;Sunnuntai;12;0;12;4;0;4
89;23.01.2011;2011;01;07;Sunnuntai;6;0;6;6;0;6
89;23.01.2011;2011;01;08;Sunnuntai;11;0;11;13;0;13
89;23.01.2011;2011;01;09;Sunnuntai;10;0;10;26;0;26
89;23.01.2011;2011;01;10;Sunnuntai;26;0;26;61;0;61
89;23.01.2011;2011;01;11;Sunnuntai;34;0;34;67;0;67
89;23.01.2011;2011;01;12;Sunnuntai;65;0;65;84;0;84
89;23.01.2011;2011;01;13;Sunnuntai;58;0;58;113;0;113
89;23.01.2011;2011;01;14;Sunnuntai;50;0;50;101;0;101
89;23.01.2011;2011;01;15;Sunnuntai;54;0;54;89;0;89
89;23.01.2011;2011;01;16;Sunnuntai;60;0;60;66;0;66
89;23.01.2011;2011;01;17;Sunnuntai;55;0;55;57;0;57
89;23.01.2011;2011;01;18;Sunnuntai;36;0;36;52;0;52
89;23.01.2011;2011;01;19;Sunnuntai;52;0;52;45;0;45
89;23.01.2011;2011;01;20;Sunnuntai;38;0;38;27;0;27
89;23.01.2011;2011;01;21;Sunnuntai;20;0;20;23;0;23
89;23.01.2011;2011;01;22;Sunnuntai;11;0;11;8;0;8
89;23.01.2011;2011;01;23;Sunnuntai;2;0;2;10;0;10
89;24.01.2011;2011;01;00;Maanantai;2;0;2;2;0;2
89;24.01.2011;2011;01;01;Maanantai;1;0;1;1;0;1
89;24.01.2011;2011;01;02;Maanantai;2;0;2;3;0;3
89;24.01.2011;2011;01;03;Maanantai;1;0;1;0;0;0
89;24.01.2011;2011;01;04;Maanantai;3;0;3;4;0;4
89;24.01.2011;2011;01;05;Maanantai;8;0;8;5;0;5
89;24.01.2011;2011;01;06;Maanantai;41;0;41;10;0;10
89;24.01.2011;2011;01;07;Maanantai;102;0;102;32;0;32
89;24.01.2011;2011;01;08;Maanantai;213;3;216;66;0;66
89;24.01.2011;2011;01;09;Maanantai;116;2;118;51;0;51
89;24.01.2011;2011;01;10;Maanantai;82;0;82;50;0;50
89;24.01.2011;2011;01;11;Maanantai;72;0;72;58;0;58
89;24.01.2011;2011;01;12;Maanantai;79;2;81;70;0;70
89;24.01.2011;2011;01;13;Maanantai;96;1;97;62;34;96
89;24.01.2011;2011;01;14;Maanantai;69;52;121;44;29;73
89;24.01.2011;2011;01;15;Maanantai;84;49;133;41;32;73
89;24.01.2011;2011;01;16;Maanantai;147;58;205;52;38;90
89;24.01.2011;2011;01;17;Maanantai;86;58;144;43;21;64
89;24.01.2011;2011;01;18;Maanantai;74;38;112;44;26;70
89;24.01.2011;2011;01;19;Maanantai;35;43;78;32;29;61
89;24.01.2011;2011;01;20;Maanantai;44;22;66;20;17;37
89;24.01.2011;2011;01;21;Maanantai;42;17;59;22;14;36
89;24.01.2011;2011;01;22;Maanantai;14;8;22;3;2;5
89;24.01.2011;2011;01;23;Maanantai;5;1;6;3;1;4
89;25.01.2011;2011;01;00;Tiistai;4;0;4;2;4;6
89;25.01.2011;2011;01;01;Tiistai;0;2;2;1;2;3
89;25.01.2011;2011;01;02;Tiistai;0;0;0;1;0;1
89;25.01.2011;2011;01;03;Tiistai;1;1;2;0;0;0
89;25.01.2011;2011;01;04;Tiistai;2;5;7;1;0;1
89;25.01.2011;2011;01;05;Tiistai;2;4;6;1;2;3
89;25.01.2011;2011;01;06;Tiistai;5;33;38;6;6;12
89;25.01.2011;2011;01;07;Tiistai;14;76;90;10;38;48
89;25.01.2011;2011;01;08;Tiistai;36;172;208;11;59;70
89;25.01.2011;2011;01;09;Tiistai;33;83;116;11;40;51
89;25.01.2011;2011;01;10;Tiistai;29;55;84;15;29;44
89;25.01.2011;2011;01;11;Tiistai;27;32;59;29;25;54
89;25.01.2011;2011;01;12;Tiistai;25;46;71;25;35;60
89;25.01.2011;2011;01;13;Tiistai;42;47;89;34;38;72
89;25.01.2011;2011;01;14;Tiistai;70;50;120;23;25;48
89;25.01.2011;2011;01;15;Tiistai;99;41;140;35;31;66
89;25.01.2011;2011;01;16;Tiistai;145;59;204;44;28;72
89;25.01.2011;2011;01;17;Tiistai;59;38;97;38;20;58
89;25.01.2011;2011;01;18;Tiistai;53;34;87;27;16;43
89;25.01.2011;2011;01;19;Tiistai;37;23;60;16;14;30
89;25.01.2011;2011;01;20;Tiistai;41;23;64;12;6;18
89;25.01.2011;2011;01;21;Tiistai;23;15;38;10;9;19
89;25.01.2011;2011;01;22;Tiistai;24;11;35;1;1;2
89;25.01.2011;2011;01;23;Tiistai;9;2;11;1;1;2
89;26.01.2011;2011;01;00;Keskiviikko;2;4;6;1;0;1
89;26.01.2011;2011;01;01;Keskiviikko;1;0;1;1;0;1
89;26.01.2011;2011;01;02;Keskiviikko;0;0;0;1;0;1
89;26.01.2011;2011;01;03;Keskiviikko;0;0;0;0;0;0
89;26.01.2011;2011;01;04;Keskiviikko;0;4;4;0;0;0
89;26.01.2011;2011;01;05;Keskiviikko;1;7;8;0;0;0
89;26.01.2011;2011;01;06;Keskiviikko;5;28;33;4;20;24
89;26.01.2011;2011;01;07;Keskiviikko;16;78;94;3;29;32
89;26.01.2011;2011;01;08;Keskiviikko;24;159;183;10;66;76
89;26.01.2011;2011;01;09;Keskiviikko;24;67;91;16;29;45
89;26.01.2011;2011;01;10;Keskiviikko;16;34;50;13;28;41
89;26.01.2011;2011;01;11;Keskiviikko;20;28;48;12;26;38
89;26.01.2011;2011;01;12;Keskiviikko;20;32;52;23;31;54
89;26.01.2011;2011;01;13;Keskiviikko;25;36;61;35;26;61
89;26.01.2011;2011;01;14;Keskiviikko;55;22;77;34;31;65
89;26.01.2011;2011;01;15;Keskiviikko;81;43;124;31;24;55
89;26.01.2011;2011;01;16;Keskiviikko;119;41;160;47;30;77
89;26.01.2011;2011;01;17;Keskiviikko;63;45;108;37;16;53
89;26.01.2011;2011;01;18;Keskiviikko;52;34;86;22;14;36
89;26.01.2011;2011;01;19;Keskiviikko;52;31;83;27;18;45
89;26.01.2011;2011;01;20;Keskiviikko;41;20;61;14;15;29
89;26.01.2011;2011;01;21;Keskiviikko;25;14;39;9;8;17
89;26.01.2011;2011;01;22;Keskiviikko;16;4;20;3;6;9
89;26.01.2011;2011;01;23;Keskiviikko;7;9;16;1;2;3
89;27.01.2011;2011;01;00;Torstai;3;3;6;1;6;7
89;27.01.2011;2011;01;01;Torstai;4;0;4;1;2;3
89;27.01.2011;2011;01;02;Torstai;1;1;2;4;0;4
89;27.01.2011;2011;01;03;Torstai;0;0;0;1;0;1
89;27.01.2011;2011;01;04;Torstai;1;8;9;0;0;0
89;27.01.2011;2011;01;05;Torstai;3;3;6;1;1;2
89;27.01.2011;2011;01;06;Torstai;7;36;43;5;8;13
89;27.01.2011;2011;01;07;Torstai;28;124;152;6;57;63
89;27.01.2011;2011;01;08;Torstai;29;121;150;14;49;63
89;27.01.2011;2011;01;09;Torstai;25;79;104;13;30;43
89;27.01.2011;2011;01;10;Torstai;26;45;71;17;28;45
89;27.01.2011;2011;01;11;Torstai;26;47;73;31;36;67
89;27.01.2011;2011;01;12;Torstai;35;47;82;26;28;54
89;27.01.2011;2011;01;13;Torstai;55;48;103;27;32;59
89;27.01.2011;2011;01;14;Torstai;52;59;111;47;35;82
89;27.01.2011;2011;01;15;Torstai;106;56;162;36;33;69
89;27.01.2011;2011;01;16;Torstai;116;54;170;58;34;92
89;27.01.2011;2011;01;17;Torstai;69;39;108;28;22;50
89;27.01.2011;2011;01;18;Torstai;53;42;95;33;20;53
89;27.01.2011;2011;01;19;Torstai;42;31;73;27;28;55
89;27.01.2011;2011;01;20;Torstai;43;20;63;20;18;38
89;27.01.2011;2011;01;21;Torstai;35;14;49;12;14;26
89;27.01.2011;2011;01;22;Torstai;10;12;22;5;6;11
89;27.01.2011;2011;01;23;Torstai;10;12;22;4;7;11
89;28.01.2011;2011;01;00;Perjantai;1;5;6;1;1;2
89;28.01.2011;2011;01;01;Perjantai;5;1;6;4;2;6
89;28.01.2011;2011;01;02;Perjantai;1;1;2;2;1;3
89;28.01.2011;2011;01;03;Perjantai;2;1;3;0;0;0
89;28.01.2011;2011;01;04;Perjantai;1;5;6;7;1;8
89;28.01.2011;2011;01;05;Perjantai;4;8;12;0;1;1
89;28.01.2011;2011;01;06;Perjantai;9;36;45;9;10;19
89;28.01.2011;2011;01;07;Perjantai;28;140;168;9;46;55
89;28.01.2011;2011;01;08;Perjantai;21;130;151;15;51;66
89;28.01.2011;2011;01;09;Perjantai;40;70;110;18;30;48
89;28.01.2011;2011;01;10;Perjantai;25;57;82;21;31;52
89;28.01.2011;2011;01;11;Perjantai;34;45;79;25;43;68
89;28.01.2011;2011;01;12;Perjantai;58;62;120;33;44;77
89;28.01.2011;2011;01;13;Perjantai;73;60;133;34;40;74
89;28.01.2011;2011;01;14;Perjantai;101;50;151;41;31;72
89;28.01.2011;2011;01;15;Perjantai;109;55;164;69;34;103
89;28.01.2011;2011;01;16;Perjantai;117;63;180;61;36;97
89;28.01.2011;2011;01;17;Perjantai;56;54;110;29;14;43
89;28.01.2011;2011;01;18;Perjantai;50;44;94;19;22;41
89;28.01.2011;2011;01;19;Perjantai;35;27;62;29;20;49
89;28.01.2011;2011;01;20;Perjantai;33;26;59;18;12;30
89;28.01.2011;2011;01;21;Perjantai;25;18;43;6;5;11
89;28.01.2011;2011;01;22;Perjantai;13;16;29;9;11;20
89;28.01.2011;2011;01;23;Perjantai;10;17;27;6;9;15
89;29.01.2011;2011;01;00;Lauantai;7;5;12;6;3;9
89;29.01.2011;2011;01;01;Lauantai;15;6;21;3;3;6
89;29.01.2011;2011;01;02;Lauantai;15;3;18;13;1;14
89;29.01.2011;2011;01;03;Lauantai;15;3;18;3;0;3
89;29.01.2011;2011;01;04;Lauantai;6;2;8;4;0;4
89;29.01.2011;2011;01;05;Lauantai;5;5;10;0;1;1
89;29.01.2011;2011;01;06;Lauantai;6;12;18;6;17;23
89;29.01.2011;2011;01;07;Lauantai;3;16;19;7;10;17
89;29.01.2011;2011;01;08;Lauantai;6;18;24;11;10;21
89;29.01.2011;2011;01;09;Lauantai;8;39;47;12;23;35
89;29.01.2011;2011;01;10;Lauantai;11;39;50;22;38;60
89;29.01.2011;2011;01;11;Lauantai;22;48;70;27;41;68
89;29.01.2011;2011;01;12;Lauantai;19;56;75;29;47;76
89;29.01.2011;2011;01;13;Lauantai;45;26;71;45;42;87
89;29.01.2011;2011;01;14;Lauantai;36;29;65;29;26;55
89;29.01.2011;2011;01;15;Lauantai;29;20;49;33;28;61
89;29.01.2011;2011;01;16;Lauantai;41;34;75;35;24;59
89;29.01.2011;2011;01;17;Lauantai;33;20;53;16;27;43
89;29.01.2011;2011;01;18;Lauantai;20;19;39;36;27;63
89;29.01.2011;2011;01;19;Lauantai;22;21;43;17;14;31
89;29.01.2011;2011;01;20;Lauantai;11;7;18;9;10;19
89;29.01.2011;2011;01;21;Lauantai;8;17;25;9;3;12
89;29.01.2011;2011;01;22;Lauantai;7;17;24;4;8;12
89;29.01.2011;2011;01;23;Lauantai;2;12;14;6;4;10
89;30.01.2011;2011;01;00;Sunnuntai;4;7;11;2;4;6
89;30.01.2011;2011;01;01;Sunnuntai;4;2;6;2;0;2
89;30.01.2011;2011;01;02;Sunnuntai;10;1;11;3;2;5
89;30.01.2011;2011;01;03;Sunnuntai;24;6;30;10;2;12
89;30.01.2011;2011;01;04;Sunnuntai;7;0;7;8;2;10
89;30.01.2011;2011;01;05;Sunnuntai;4;4;8;3;0;3
89;30.01.2011;2011;01;06;Sunnuntai;4;4;8;1;4;5
89;30.01.2011;2011;01;07;Sunnuntai;2;6;8;4;1;5
89;30.01.2011;2011;01;08;Sunnuntai;6;7;13;7;7;14
89;30.01.2011;2011;01;09;Sunnuntai;5;4;9;14;22;36
89;30.01.2011;2011;01;10;Sunnuntai;11;16;27;28;38;66
89;30.01.2011;2011;01;11;Sunnuntai;11;22;33;53;69;122
89;30.01.2011;2011;01;12;Sunnuntai;15;32;47;65;76;141
89;30.01.2011;2011;01;13;Sunnuntai;31;34;65;68;89;157
89;30.01.2011;2011;01;14;Sunnuntai;35;20;55;54;49;103
89;30.01.2011;2011;01;15;Sunnuntai;26;34;60;54;41;95
89;30.01.2011;2011;01;16;Sunnuntai;27;33;60;30;19;49
89;30.01.2011;2011;01;17;Sunnuntai;36;26;62;19;19;38
89;30.01.2011;2011;01;18;Sunnuntai;21;13;34;33;24;57
89;30.01.2011;2011;01;19;Sunnuntai;21;8;29;12;15;27
89;30.01.2011;2011;01;20;Sunnuntai;11;13;24;13;10;23
89;30.01.2011;2011;01;21;Sunnuntai;10;5;15;10;8;18
89;30.01.2011;2011;01;22;Sunnuntai;5;2;7;6;4;10
89;30.01.2011;2011;01;23;Sunnuntai;4;2;6;1;3;4
89;31.01.2011;2011;01;00;Maanantai;4;2;6;1;0;1
89;31.01.2011;2011;01;01;Maanantai;2;0;2;0;0;0
89;31.01.2011;2011;01;02;Maanantai;0;1;1;0;0;0
89;31.01.2011;2011;01;03;Maanantai;1;1;2;2;0;2
89;31.01.2011;2011;01;04;Maanantai;1;8;9;1;2;3
89;31.01.2011;2011;01;05;Maanantai;3;7;10;0;0;0
89;31.01.2011;2011;01;06;Maanantai;6;40;46;12;38;50
89;31.01.2011;2011;01;07;Maanantai;29;125;154;4;41;45
89;31.01.2011;2011;01;08;Maanantai;37;166;203;12;50;62
89;31.01.2011;2011;01;09;Maanantai;42;88;130;19;43;62
89;31.01.2011;2011;01;10;Maanantai;26;41;67;29;33;62
89;31.01.2011;2011;01;11;Maanantai;45;39;84;33;28;61
89;31.01.2011;2011;01;12;Maanantai;28;53;81;32;48;80
89;31.01.2011;2011;01;13;Maanantai;49;55;104;37;28;65
89;31.01.2011;2011;01;14;Maanantai;76;55;131;43;33;76
89;31.01.2011;2011;01;15;Maanantai;116;69;185;67;34;101
89;31.01.2011;2011;01;16;Maanantai;133;72;205;62;32;94
89;31.01.2011;2011;01;17;Maanantai;76;53;129;49;31;80
89;31.01.2011;2011;01;18;Maanantai;68;38;106;42;24;66
89;31.01.2011;2011;01;19;Maanantai;42;37;79;38;25;63
89;31.01.2011;2011;01;20;Maanantai;53;19;72;37;25;62
89;31.01.2011;2011;01;21;Maanantai;29;14;43;14;12;26
89;31.01.2011;2011;01;22;Maanantai;7;2;9;3;3;6
89;31.01.2011;2011;01;23;Maanantai;3;3;6;4;3;7
89;01.02.2011;2011;02;00;Tiistai;1;3;4;0;1;1
89;01.02.2011;2011;02;01;Tiistai;1;1;2;0;0;0
89;01.02.2011;2011;02;02;Tiistai;2;1;3;1;0;1
89;01.02.2011;2011;02;03;Tiistai;1;0;1;0;0;0
89;01.02.2011;2011;02;04;Tiistai;2;7;9;1;1;2
89;01.02.2011;2011;02;05;Tiistai;6;10;16;1;1;2
89;01.02.2011;2011;02;06;Tiistai;9;54;63;5;14;19
89;01.02.2011;2011;02;07;Tiistai;23;160;183;12;49;61
89;01.02.2011;2011;02;08;Tiistai;35;157;192;17;51;68
89;01.02.2011;2011;02;09;Tiistai;30;92;122;22;51;73
89;01.02.2011;2011;02;10;Tiistai;54;45;99;31;38;69
89;01.02.2011;2011;02;11;Tiistai;31;73;104;48;49;97
89;01.02.2011;2011;02;12;Tiistai;48;57;105;50;50;100
89;01.02.2011;2011;02;13;Tiistai;55;54;109;37;29;66
89;01.02.2011;2011;02;14;Tiistai;86;50;136;49;36;85
89;01.02.2011;2011;02;15;Tiistai;128;70;198;41;35;76
89;01.02.2011;2011;02;16;Tiistai;144;73;217;69;33;102
89;01.02.2011;2011;02;17;Tiistai;73;41;114;44;29;73
89;01.02.2011;2011;02;18;Tiistai;59;31;90;46;31;77
89;01.02.2011;2011;02;19;Tiistai;50;30;80;37;34;71
89;01.02.2011;2011;02;20;Tiistai;34;20;54;33;18;51
89;01.02.2011;2011;02;21;Tiistai;39;10;49;15;8;23
89;01.02.2011;2011;02;22;Tiistai;11;7;18;6;4;10
89;01.02.2011;2011;02;23;Tiistai;5;2;7;2;0;2
89;02.02.2011;2011;02;00;Keskiviikko;3;1;4;1;1;2
89;02.02.2011;2011;02;01;Keskiviikko;2;1;3;1;1;2
89;02.02.2011;2011;02;02;Keskiviikko;1;2;3;0;0;0
89;02.02.2011;2011;02;03;Keskiviikko;0;0;0;0;1;1
89;02.02.2011;2011;02;04;Keskiviikko;2;6;8;1;3;4
89;02.02.2011;2011;02;05;Keskiviikko;5;8;13;2;0;2
89;02.02.2011;2011;02;06;Keskiviikko;11;38;49;5;15;20
89;02.02.2011;2011;02;07;Keskiviikko;24;127;151;7;43;50
89;02.02.2011;2011;02;08;Keskiviikko;48;186;234;16;53;69
89;02.02.2011;2011;02;09;Keskiviikko;31;60;91;11;37;48
89;02.02.2011;2011;02;10;Keskiviikko;46;42;88;37;40;77
89;02.02.2011;2011;02;11;Keskiviikko;37;38;75;25;43;68
89;02.02.2011;2011;02;12;Keskiviikko;36;58;94;32;48;80
89;02.02.2011;2011;02;13;Keskiviikko;53;50;103;34;32;66
89;02.02.2011;2011;02;14;Keskiviikko;82;48;130;35;30;65
89;02.02.2011;2011;02;15;Keskiviikko;111;64;175;36;22;58
89;02.02.2011;2011;02;16;Keskiviikko;110;77;187;48;34;82
89;02.02.2011;2011;02;17;Keskiviikko;84;49;133;43;27;70
89;02.02.2011;2011;02;18;Keskiviikko;58;36;94;33;33;66
89;02.02.2011;2011;02;19;Keskiviikko;51;35;86;30;31;61
89;02.02.2011;2011;02;20;Keskiviikko;53;30;83;27;12;39
89;02.02.2011;2011;02;21;Keskiviikko;30;25;55;17;11;28
89;02.02.2011;2011;02;22;Keskiviikko;12;9;21;10;1;11
89;02.02.2011;2011;02;23;Keskiviikko;8;6;14;4;8;12
89;03.02.2011;2011;02;00;Torstai;2;2;4;1;0;1
89;03.02.2011;2011;02;01;Torstai;5;2;7;1;1;2
89;03.02.2011;2011;02;02;Torstai;4;0;4;2;0;2
89;03.02.2011;2011;02;03;Torstai;4;3;7;0;0;0
89;03.02.2011;2011;02;04;Torstai;0;7;7;0;0;0
89;03.02.2011;2011;02;05;Torstai;6;5;11;1;0;1
89;03.02.2011;2011;02;06;Torstai;9;52;61;9;24;33
89;03.02.2011;2011;02;07;Torstai;27;143;170;5;52;57
89;03.02.2011;2011;02;08;Torstai;33;140;173;14;65;79
89;03.02.2011;2011;02;09;Torstai;23;93;116;24;34;58
89;03.02.2011;2011;02;10;Torstai;27;61;88;31;30;61
89;03.02.2011;2011;02;11;Torstai;43;59;102;32;41;73
89;03.02.2011;2011;02;12;Torstai;31;53;84;20;33;53
89;03.02.2011;2011;02;13;Torstai;51;41;92;42;39;81
89;03.02.2011;2011;02;14;Torstai;86;57;143;36;29;65
89;03.02.2011;2011;02;15;Torstai;100;58;158;46;32;78
89;03.02.2011;2011;02;16;Torstai;125;56;181;50;29;79
89;03.02.2011;2011;02;17;Torstai;72;53;125;39;27;66
89;03.02.2011;2011;02;18;Torstai;58;23;81;22;34;56
89;03.02.2011;2011;02;19;Torstai;54;16;70;22;8;30
89;03.02.2011;2011;02;20;Torstai;28;27;55;20;0;20
89;03.02.2011;2011;02;21;Torstai;17;15;32;15;0;15
89;03.02.2011;2011;02;22;Torstai;8;5;13;10;0;10
89;03.02.2011;2011;02;23;Torstai;3;3;6;5;0;5
89;04.02.2011;2011;02;00;Perjantai;4;2;6;1;1;2
89;04.02.2011;2011;02;01;Perjantai;3;2;5;4;2;6
89;04.02.2011;2011;02;02;Perjantai;2;0;2;2;1;3
89;04.02.2011;2011;02;03;Perjantai;4;3;7;0;0;0
89;04.02.2011;2011;02;04;Perjantai;4;1;5;7;1;8
89;04.02.2011;2011;02;05;Perjantai;9;7;16;0;1;1
89;04.02.2011;2011;02;06;Perjantai;18;18;36;9;10;19
89;04.02.2011;2011;02;07;Perjantai;71;68;139;9;46;55
89;04.02.2011;2011;02;08;Perjantai;73;71;144;15;51;66
89;04.02.2011;2011;02;09;Perjantai;45;43;88;18;30;48
89;04.02.2011;2011;02;10;Perjantai;34;33;67;21;31;52
89;04.02.2011;2011;02;11;Perjantai;48;44;92;25;43;68
89;04.02.2011;2011;02;12;Perjantai;52;49;101;33;44;77
89;04.02.2011;2011;02;13;Perjantai;67;65;132;34;40;74
89;04.02.2011;2011;02;14;Perjantai;57;56;113;41;31;72
89;04.02.2011;2011;02;15;Perjantai;91;72;163;69;34;103
89;04.02.2011;2011;02;16;Perjantai;79;62;141;61;36;97
89;04.02.2011;2011;02;17;Perjantai;63;50;113;29;14;43
89;04.02.2011;2011;02;18;Perjantai;34;42;76;19;22;41
89;04.02.2011;2011;02;19;Perjantai;41;24;65;29;20;49
89;04.02.2011;2011;02;20;Perjantai;34;22;56;18;12;30
89;04.02.2011;2011;02;21;Perjantai;20;20;40;6;5;11
89;04.02.2011;2011;02;22;Perjantai;13;15;28;9;11;20
89;04.02.2011;2011;02;23;Perjantai;14;10;24;6;9;15
89;05.02.2011;2011;02;00;Lauantai;13;14;27;6;3;9
89;05.02.2011;2011;02;01;Lauantai;9;6;15;3;3;6
89;05.02.2011;2011;02;02;Lauantai;13;4;17;13;1;14
89;05.02.2011;2011;02;03;Lauantai;7;1;8;3;0;3
89;05.02.2011;2011;02;04;Lauantai;7;3;10;4;0;4
89;05.02.2011;2011;02;05;Lauantai;5;4;9;0;1;1
89;05.02.2011;2011;02;06;Lauantai;2;10;12;6;17;23
89;05.02.2011;2011;02;07;Lauantai;4;8;12;7;10;17
89;05.02.2011;2011;02;08;Lauantai;8;17;25;11;10;21
89;05.02.2011;2011;02;09;Lauantai;5;30;35;12;23;35
89;05.02.2011;2011;02;10;Lauantai;12;24;36;22;38;60
89;05.02.2011;2011;02;11;Lauantai;25;21;46;27;41;68
89;05.02.2011;2011;02;12;Lauantai;19;16;35;29;47;76
89;05.02.2011;2011;02;13;Lauantai;25;23;48;45;42;87
89;05.02.2011;2011;02;14;Lauantai;24;22;46;29;26;55
89;05.02.2011;2011;02;15;Lauantai;28;26;54;33;28;61
89;05.02.2011;2011;02;16;Lauantai;26;25;51;35;24;59
89;05.02.2011;2011;02;17;Lauantai;21;19;40;16;27;43
89;05.02.2011;2011;02;18;Lauantai;19;18;37;36;27;63
89;05.02.2011;2011;02;19;Lauantai;18;16;34;17;14;31
89;05.02.2011;2011;02;20;Lauantai;11;10;21;9;10;19
89;05.02.2011;2011;02;21;Lauantai;16;13;29;9;3;12
89;05.02.2011;2011;02;22;Lauantai;14;11;25;4;8;12
89;05.02.2011;2011;02;23;Lauantai;10;7;17;6;4;10
89;06.02.2011;2011;02;00;Sunnuntai;8;7;15;2;4;6
89;06.02.2011;2011;02;01;Sunnuntai;11;10;21;2;0;2
89;06.02.2011;2011;02;02;Sunnuntai;6;4;10;3;2;5
89;06.02.2011;2011;02;03;Sunnuntai;8;7;15;10;2;12
89;06.02.2011;2011;02;04;Sunnuntai;7;4;11;8;2;10
89;06.02.2011;2011;02;05;Sunnuntai;3;1;4;3;0;3
89;06.02.2011;2011;02;06;Sunnuntai;5;3;8;1;4;5
89;06.02.2011;2011;02;07;Sunnuntai;10;9;19;4;1;5
89;06.02.2011;2011;02;08;Sunnuntai;4;2;6;7;7;14
89;06.02.2011;2011;02;09;Sunnuntai;7;6;13;14;22;36
89;06.02.2011;2011;02;10;Sunnuntai;9;7;16;28;38;66
89;06.02.2011;2011;02;11;Sunnuntai;15;14;29;53;69;122
89;06.02.2011;2011;02;12;Sunnuntai;16;13;29;65;76;141
89;06.02.2011;2011;02;13;Sunnuntai;22;20;42;68;89;157
89;06.02.2011;2011;02;14;Sunnuntai;21;19;40;54;49;103
89;06.02.2011;2011;02;15;Sunnuntai;24;23;47;54;41;95
89;06.02.2011;2011;02;16;Sunnuntai;24;22;46;30;19;49
89;06.02.2011;2011;02;17;Sunnuntai;24;22;46;19;19;38
89;06.02.2011;2011;02;18;Sunnuntai;19;18;37;33;24;57
89;06.02.2011;2011;02;19;Sunnuntai;16;16;32;12;15;27
89;06.02.2011;2011;02;20;Sunnuntai;17;15;32;13;10;23
89;06.02.2011;2011;02;21;Sunnuntai;10;9;19;10;8;18
89;06.02.2011;2011;02;22;Sunnuntai;8;4;12;6;4;10
89;06.02.2011;2011;02;23;Sunnuntai;5;3;8;1;3;4
89;07.02.2011;2011;02;00;Maanantai;1;1;2;0;0;0
89;07.02.2011;2011;02;01;Maanantai;1;0;1;0;0;0
89;07.02.2011;2011;02;02;Maanantai;1;0;1;0;0;0
89;07.02.2011;2011;02;03;Maanantai;3;1;4;0;0;0
89;07.02.2011;2011;02;04;Maanantai;4;1;5;0;0;0
89;07.02.2011;2011;02;05;Maanantai;5;4;9;0;0;0
89;07.02.2011;2011;02;06;Maanantai;23;20;43;0;1;1
89;07.02.2011;2011;02;07;Maanantai;61;60;121;5;6;11
89;07.02.2011;2011;02;08;Maanantai;28;119;147;14;61;75
89;07.02.2011;2011;02;09;Maanantai;26;62;88;5;27;32
89;07.02.2011;2011;02;10;Maanantai;13;37;50;16;22;38
89;07.02.2011;2011;02;11;Maanantai;17;28;45;24;31;55
89;07.02.2011;2011;02;12;Maanantai;23;37;60;34;24;58
89;07.02.2011;2011;02;13;Maanantai;42;36;78;27;28;55
89;07.02.2011;2011;02;14;Maanantai;52;36;88;42;27;69
89;07.02.2011;2011;02;15;Maanantai;86;49;135;54;30;84
89;07.02.2011;2011;02;16;Maanantai;84;63;147;52;21;73
89;07.02.2011;2011;02;17;Maanantai;55;46;101;30;19;49
89;07.02.2011;2011;02;18;Maanantai;56;35;91;34;18;52
89;07.02.2011;2011;02;19;Maanantai;47;32;79;30;19;49
89;07.02.2011;2011;02;20;Maanantai;44;19;63;11;18;29
89;07.02.2011;2011;02;21;Maanantai;24;7;31;6;5;11
89;07.02.2011;2011;02;22;Maanantai;15;2;17;4;2;6
89;07.02.2011;2011;02;23;Maanantai;3;3;6;3;0;3
89;08.02.2011;2011;02;00;Tiistai;0;1;1;1;0;1
89;08.02.2011;2011;02;01;Tiistai;1;0;1;0;1;1
89;08.02.2011;2011;02;02;Tiistai;1;1;2;1;0;1
89;08.02.2011;2011;02;03;Tiistai;2;3;5;0;0;0
89;08.02.2011;2011;02;04;Tiistai;0;5;5;2;1;3
89;08.02.2011;2011;02;05;Tiistai;2;11;13;3;0;3
89;08.02.2011;2011;02;06;Tiistai;10;34;44;8;12;20
89;08.02.2011;2011;02;07;Tiistai;30;131;161;13;53;66
89;08.02.2011;2011;02;08;Tiistai;39;150;189;16;61;77
89;08.02.2011;2011;02;09;Tiistai;28;73;101;29;36;65
89;08.02.2011;2011;02;10;Tiistai;39;50;89;32;41;73
89;08.02.2011;2011;02;11;Tiistai;39;51;90;27;44;71
89;08.02.2011;2011;02;12;Tiistai;39;67;106;41;37;78
89;08.02.2011;2011;02;13;Tiistai;45;57;102;30;34;64
89;08.02.2011;2011;02;14;Tiistai;74;40;114;53;39;92
89;08.02.2011;2011;02;15;Tiistai;110;69;179;51;45;96
89;08.02.2011;2011;02;16;Tiistai;102;79;181;74;38;112
89;08.02.2011;2011;02;17;Tiistai;78;52;130;51;31;82
89;08.02.2011;2011;02;18;Tiistai;51;45;96;47;29;76
89;08.02.2011;2011;02;19;Tiistai;26;27;53;40;41;81
89;08.02.2011;2011;02;20;Tiistai;52;24;76;22;19;41
89;08.02.2011;2011;02;21;Tiistai;28;14;42;19;13;32
89;08.02.2011;2011;02;22;Tiistai;14;6;20;2;4;6
89;08.02.2011;2011;02;23;Tiistai;6;3;9;2;1;3
89;09.02.2011;2011;02;00;Keskiviikko;1;1;2;2;3;5
89;09.02.2011;2011;02;01;Keskiviikko;1;1;2;0;0;0
89;09.02.2011;2011;02;02;Keskiviikko;4;0;4;0;0;0
89;09.02.2011;2011;02;03;Keskiviikko;0;1;1;0;1;1
89;09.02.2011;2011;02;04;Keskiviikko;1;5;6;0;0;0
89;09.02.2011;2011;02;05;Keskiviikko;4;7;11;2;4;6
89;09.02.2011;2011;02;06;Keskiviikko;8;31;39;5;11;16
89;09.02.2011;2011;02;07;Keskiviikko;16;140;156;8;45;53
89;09.02.2011;2011;02;08;Keskiviikko;32;152;184;11;60;71
89;09.02.2011;2011;02;09;Keskiviikko;36;70;106;11;17;28
89;09.02.2011;2011;02;10;Keskiviikko;33;47;80;22;30;52
89;09.02.2011;2011;02;11;Keskiviikko;23;40;63;25;37;62
89;09.02.2011;2011;02;12;Keskiviikko;31;46;77;34;35;69
89;09.02.2011;2011;02;13;Keskiviikko;50;50;100;40;36;76
89;09.02.2011;2011;02;14;Keskiviikko;71;45;116;56;35;91
89;09.02.2011;2011;02;15;Keskiviikko;97;54;151;51;40;91
89;09.02.2011;2011;02;16;Keskiviikko;128;52;180;62;20;82
89;09.02.2011;2011;02;17;Keskiviikko;66;52;118;45;21;66
89;09.02.2011;2011;02;18;Keskiviikko;56;35;91;25;22;47
89;09.02.2011;2011;02;19;Keskiviikko;51;25;76;17;13;30
89;09.02.2011;2011;02;20;Keskiviikko;40;27;67;15;12;27
89;09.02.2011;2011;02;21;Keskiviikko;33;24;57;9;9;18
89;09.02.2011;2011;02;22;Keskiviikko;9;0;9;3;2;5
89;09.02.2011;2011;02;23;Keskiviikko;9;5;14;2;1;3
89;10.02.2011;2011;02;00;Torstai;1;1;2;1;1;2
89;10.02.2011;2011;02;01;Torstai;4;1;5;2;0;2
89;10.02.2011;2011;02;02;Torstai;1;0;1;0;0;0
89;10.02.2011;2011;02;03;Torstai;0;3;3;0;0;0
89;10.02.2011;2011;02;04;Torstai;0;5;5;0;1;1
89;10.02.2011;2011;02;05;Torstai;3;7;10;0;2;2
89;10.02.2011;2011;02;06;Torstai;6;34;40;9;16;25
89;10.02.2011;2011;02;07;Torstai;23;103;126;9;46;55
89;10.02.2011;2011;02;08;Torstai;15;109;124;17;49;66
89;10.02.2011;2011;02;09;Torstai;16;34;50;7;35;42
89;10.02.2011;2011;02;10;Torstai;14;33;47;11;25;36
89;10.02.2011;2011;02;11;Torstai;20;32;52;19;24;43
89;10.02.2011;2011;02;12;Torstai;24;24;48;29;26;55
89;10.02.2011;2011;02;13;Torstai;27;19;46;22;32;54
89;10.02.2011;2011;02;14;Torstai;48;33;81;37;24;61
89;10.02.2011;2011;02;15;Torstai;70;37;107;45;23;68
89;10.02.2011;2011;02;16;Torstai;103;34;137;56;21;77
89;10.02.2011;2011;02;17;Torstai;48;44;92;29;13;42
89;10.02.2011;2011;02;18;Torstai;38;25;63;15;11;26
89;10.02.2011;2011;02;19;Torstai;12;18;30;15;14;29
89;10.02.2011;2011;02;20;Torstai;30;16;46;9;7;16
89;10.02.2011;2011;02;21;Torstai;19;9;28;9;5;14
89;10.02.2011;2011;02;22;Torstai;6;7;13;5;4;9
89;10.02.2011;2011;02;23;Torstai;4;3;7;3;4;7
89;11.02.2011;2011;02;00;Perjantai;1;0;1;3;0;3
89;11.02.2011;2011;02;01;Perjantai;3;0;3;3;0;3
89;11.02.2011;2011;02;02;Perjantai;4;0;4;3;1;4
89;11.02.2011;2011;02;03;Perjantai;1;1;2;3;0;3
89;11.02.2011;2011;02;04;Perjantai;1;4;5;0;1;1
89;11.02.2011;2011;02;05;Perjantai;3;8;11;1;2;3
89;11.02.2011;2011;02;06;Perjantai;5;26;31;4;6;10
89;11.02.2011;2011;02;07;Perjantai;14;74;88;7;46;53
89;11.02.2011;2011;02;08;Perjantai;14;87;101;5;42;47
89;11.02.2011;2011;02;09;Perjantai;18;41;59;7;22;29
89;11.02.2011;2011;02;10;Perjantai;9;27;36;10;23;33
89;11.02.2011;2011;02;11;Perjantai;21;21;42;14;26;40
89;11.02.2011;2011;02;12;Perjantai;39;36;75;24;29;53
89;11.02.2011;2011;02;13;Perjantai;30;45;75;28;30;58
89;11.02.2011;2011;02;14;Perjantai;40;32;72;44;24;68
89;11.02.2011;2011;02;15;Perjantai;60;37;97;43;27;70
89;11.02.2011;2011;02;16;Perjantai;69;48;117;43;30;73
89;11.02.2011;2011;02;17;Perjantai;31;38;69;27;17;44
89;11.02.2011;2011;02;18;Perjantai;27;32;59;15;27;42
89;11.02.2011;2011;02;19;Perjantai;22;14;36;18;9;27
89;11.02.2011;2011;02;20;Perjantai;19;13;32;10;5;15
89;11.02.2011;2011;02;21;Perjantai;20;17;37;3;5;8
89;11.02.2011;2011;02;22;Perjantai;11;10;21;6;5;11
89;11.02.2011;2011;02;23;Perjantai;7;5;12;3;5;8
89;12.02.2011;2011;02;00;Lauantai;5;5;10;1;1;2
89;12.02.2011;2011;02;01;Lauantai;10;4;14;0;3;3
89;12.02.2011;2011;02;02;Lauantai;6;5;11;0;3;3
89;12.02.2011;2011;02;03;Lauantai;9;0;9;2;0;2
89;12.02.2011;2011;02;04;Lauantai;7;3;10;4;1;5
89;12.02.2011;2011;02;05;Lauantai;3;4;7;0;1;1
89;12.02.2011;2011;02;06;Lauantai;3;7;10;6;34;40
89;12.02.2011;2011;02;07;Lauantai;6;10;16;2;3;5
89;12.02.2011;2011;02;08;Lauantai;5;15;20;7;14;21
89;12.02.2011;2011;02;09;Lauantai;2;19;21;3;9;12
89;12.02.2011;2011;02;10;Lauantai;9;32;41;15;24;39
89;12.02.2011;2011;02;11;Lauantai;13;22;35;24;43;67
89;12.02.2011;2011;02;12;Lauantai;22;45;67;35;58;93
89;12.02.2011;2011;02;13;Lauantai;20;32;52;39;63;102
89;12.02.2011;2011;02;14;Lauantai;37;28;65;50;50;100
89;12.02.2011;2011;02;15;Lauantai;25;26;51;48;38;86
89;12.02.2011;2011;02;16;Lauantai;34;19;53;31;21;52
89;12.02.2011;2011;02;17;Lauantai;24;18;42;18;19;37
89;12.02.2011;2011;02;18;Lauantai;21;16;37;16;19;35
89;12.02.2011;2011;02;19;Lauantai;14;11;25;10;8;18
89;12.02.2011;2011;02;20;Lauantai;13;16;29;4;7;11
89;12.02.2011;2011;02;21;Lauantai;6;8;14;10;8;18
89;12.02.2011;2011;02;22;Lauantai;7;11;18;0;2;2
89;12.02.2011;2011;02;23;Lauantai;8;7;15;2;4;6
89;13.02.2011;2011;02;00;Sunnuntai;14;4;18;6;1;7
89;13.02.2011;2011;02;01;Sunnuntai;6;1;7;3;1;4
89;13.02.2011;2011;02;02;Sunnuntai;6;2;8;4;0;4
89;13.02.2011;2011;02;03;Sunnuntai;8;5;13;5;0;5
89;13.02.2011;2011;02;04;Sunnuntai;3;2;5;8;1;9
89;13.02.2011;2011;02;05;Sunnuntai;3;2;5;1;0;1
89;13.02.2011;2011;02;06;Sunnuntai;3;4;7;5;13;18
89;13.02.2011;2011;02;07;Sunnuntai;2;4;6;1;2;3
89;13.02.2011;2011;02;08;Sunnuntai;1;2;3;8;4;12
89;13.02.2011;2011;02;09;Sunnuntai;4;7;11;9;10;19
89;13.02.2011;2011;02;10;Sunnuntai;3;11;14;15;18;33
89;13.02.2011;2011;02;11;Sunnuntai;5;14;19;21;30;51
89;13.02.2011;2011;02;12;Sunnuntai;10;23;33;31;44;75
89;13.02.2011;2011;02;13;Sunnuntai;12;23;35;41;59;100
89;13.02.2011;2011;02;14;Sunnuntai;15;17;32;46;56;102
89;13.02.2011;2011;02;15;Sunnuntai;24;15;39;38;32;70
89;13.02.2011;2011;02;16;Sunnuntai;19;9;28;28;20;48
89;13.02.2011;2011;02;17;Sunnuntai;25;27;52;17;20;37
89;13.02.2011;2011;02;18;Sunnuntai;13;16;29;15;12;27
89;13.02.2011;2011;02;19;Sunnuntai;15;10;25;10;11;21
89;13.02.2011;2011;02;20;Sunnuntai;20;5;25;8;6;14
89;13.02.2011;2011;02;21;Sunnuntai;15;7;22;3;3;6
89;13.02.2011;2011;02;22;Sunnuntai;11;1;12;2;0;2
89;13.02.2011;2011;02;23;Sunnuntai;3;0;3;2;1;3
89;14.02.2011;2011;02;00;Maanantai;1;0;1;2;0;2
89;14.02.2011;2011;02;01;Maanantai;2;0;2;0;0;0
89;14.02.2011;2011;02;02;Maanantai;1;1;2;0;0;0
89;14.02.2011;2011;02;03;Maanantai;0;2;2;0;0;0
89;14.02.2011;2011;02;04;Maanantai;1;5;6;1;1;2
89;14.02.2011;2011;02;05;Maanantai;3;6;9;1;2;3
89;14.02.2011;2011;02;06;Maanantai;6;26;32;4;17;21
89;14.02.2011;2011;02;07;Maanantai;12;70;82;4;39;43
89;14.02.2011;2011;02;08;Maanantai;14;74;88;7;45;52
89;14.02.2011;2011;02;09;Maanantai;16;60;76;6;23;29
89;14.02.2011;2011;02;10;Maanantai;18;37;55;15;28;43
89;14.02.2011;2011;02;11;Maanantai;16;27;43;17;32;49
89;14.02.2011;2011;02;12;Maanantai;14;34;48;22;40;62
89;14.02.2011;2011;02;13;Maanantai;25;37;62;23;35;58
89;14.02.2011;2011;02;14;Maanantai;44;20;64;35;29;64
89;14.02.2011;2011;02;15;Maanantai;60;30;90;50;17;67
89;14.02.2011;2011;02;16;Maanantai;86;34;120;42;20;62
89;14.02.2011;2011;02;17;Maanantai;33;27;60;22;18;40
89;14.02.2011;2011;02;18;Maanantai;23;25;48;21;8;29
89;14.02.2011;2011;02;19;Maanantai;27;15;42;18;6;24
89;14.02.2011;2011;02;20;Maanantai;26;20;46;12;7;19
89;14.02.2011;2011;02;21;Maanantai;20;2;22;5;6;11
89;14.02.2011;2011;02;22;Maanantai;16;1;17;4;0;4
89;14.02.2011;2011;02;23;Maanantai;5;2;7;1;1;2
89;15.02.2011;2011;02;00;Tiistai;1;1;2;0;0;0
89;15.02.2011;2011;02;01;Tiistai;0;0;0;2;1;3
89;15.02.2011;2011;02;02;Tiistai;0;0;0;0;0;0
89;15.02.2011;2011;02;03;Tiistai;0;1;1;1;0;1
89;15.02.2011;2011;02;04;Tiistai;0;5;5;0;1;1
89;15.02.2011;2011;02;05;Tiistai;3;6;9;0;3;3
89;15.02.2011;2011;02;06;Tiistai;6;22;28;4;19;23
89;15.02.2011;2011;02;07;Tiistai;13;78;91;7;48;55
89;15.02.2011;2011;02;08;Tiistai;14;78;92;5;36;41
89;15.02.2011;2011;02;09;Tiistai;22;42;64;13;27;40
89;15.02.2011;2011;02;10;Tiistai;10;25;35;12;19;31
89;15.02.2011;2011;02;11;Tiistai;21;20;41;16;28;44
89;15.02.2011;2011;02;12;Tiistai;16;25;41;19;35;54
89;15.02.2011;2011;02;13;Tiistai;24;22;46;28;18;46
89;15.02.2011;2011;02;14;Tiistai;33;31;64;24;17;41
89;15.02.2011;2011;02;15;Tiistai;60;30;90;37;20;57
89;15.02.2011;2011;02;16;Tiistai;80;38;118;48;21;69
89;15.02.2011;2011;02;17;Tiistai;35;31;66;31;12;43
89;15.02.2011;2011;02;18;Tiistai;27;15;42;14;12;26
89;15.02.2011;2011;02;19;Tiistai;31;14;45;18;15;33
89;15.02.2011;2011;02;20;Tiistai;32;11;43;9;12;21
89;15.02.2011;2011;02;21;Tiistai;20;11;31;1;2;3
89;15.02.2011;2011;02;22;Tiistai;4;2;6;3;2;5
89;15.02.2011;2011;02;23;Tiistai;4;0;4;1;2;3
89;16.02.2011;2011;02;00;Keskiviikko;4;0;4;0;0;0
89;16.02.2011;2011;02;01;Keskiviikko;1;0;1;1;0;1
89;16.02.2011;2011;02;02;Keskiviikko;0;0;0;1;0;1
89;16.02.2011;2011;02;03;Keskiviikko;0;1;1;0;0;0
89;16.02.2011;2011;02;04;Keskiviikko;0;6;6;0;1;1
89;16.02.2011;2011;02;05;Keskiviikko;4;1;5;0;3;3
89;16.02.2011;2011;02;06;Keskiviikko;5;19;24;4;15;19
89;16.02.2011;2011;02;07;Keskiviikko;14;69;83;4;45;49
89;16.02.2011;2011;02;08;Keskiviikko;13;74;87;7;46;53
89;16.02.2011;2011;02;09;Keskiviikko;13;41;54;4;31;35
89;16.02.2011;2011;02;10;Keskiviikko;12;18;30;8;22;30
89;16.02.2011;2011;02;11;Keskiviikko;11;18;29;14;31;45
89;16.02.2011;2011;02;12;Keskiviikko;12;19;31;23;33;56
89;16.02.2011;2011;02;13;Keskiviikko;31;30;61;30;24;54
89;16.02.2011;2011;02;14;Keskiviikko;39;22;61;38;22;60
89;16.02.2011;2011;02;15;Keskiviikko;56;21;77;37;30;67
89;16.02.2011;2011;02;16;Keskiviikko;61;36;97;54;19;73
89;16.02.2011;2011;02;17;Keskiviikko;36;25;61;20;16;36
89;16.02.2011;2011;02;18;Keskiviikko;21;18;39;19;20;39
89;16.02.2011;2011;02;19;Keskiviikko;19;18;37;18;18;36
89;16.02.2011;2011;02;20;Keskiviikko;21;16;37;17;6;23
89;16.02.2011;2011;02;21;Keskiviikko;23;9;32;2;4;6
89;16.02.2011;2011;02;22;Keskiviikko;4;2;6;7;8;15
89;16.02.2011;2011;02;23;Keskiviikko;7;4;11;1;2;3
89;17.02.2011;2011;02;00;Torstai;2;0;2;2;1;3
89;17.02.2011;2011;02;01;Torstai;1;1;2;3;1;4
89;17.02.2011;2011;02;02;Torstai;2;0;2;0;0;0
89;17.02.2011;2011;02;03;Torstai;1;0;1;2;0;2
89;17.02.2011;2011;02;04;Torstai;1;9;10;3;1;4
89;17.02.2011;2011;02;05;Torstai;4;9;13;1;5;6
89;17.02.2011;2011;02;06;Torstai;5;20;25;3;15;18
89;17.02.2011;2011;02;07;Torstai;16;65;81;8;51;59
89;17.02.2011;2011;02;08;Torstai;13;70;83;12;28;40
89;17.02.2011;2011;02;09;Torstai;19;36;55;12;21;33
89;17.02.2011;2011;02;10;Torstai;11;28;39;8;25;33
89;17.02.2011;2011;02;11;Torstai;24;24;48;13;25;38
89;17.02.2011;2011;02;12;Torstai;16;29;45;20;36;56
89;17.02.2011;2011;02;13;Torstai;26;28;54;22;25;47
89;17.02.2011;2011;02;14;Torstai;40;32;72;31;28;59
89;17.02.2011;2011;02;15;Torstai;59;36;95;59;28;87
89;17.02.2011;2011;02;16;Torstai;59;28;87;49;20;69
89;17.02.2011;2011;02;17;Torstai;39;34;73;31;23;54
89;17.02.2011;2011;02;18;Torstai;22;19;41;19;17;36
89;17.02.2011;2011;02;19;Torstai;19;14;33;20;14;34
89;17.02.2011;2011;02;20;Torstai;31;10;41;13;8;21
89;17.02.2011;2011;02;21;Torstai;14;11;25;7;7;14
89;17.02.2011;2011;02;22;Torstai;10;5;15;5;3;8
89;17.02.2011;2011;02;23;Torstai;7;2;9;0;2;2
89;18.02.2011;2011;02;00;Perjantai;2;0;2;1;0;1
89;18.02.2011;2011;02;01;Perjantai;6;0;6;0;0;0
89;18.02.2011;2011;02;02;Perjantai;2;0;2;2;0;2
89;18.02.2011;2011;02;03;Perjantai;1;0;1;1;0;1
89;18.02.2011;2011;02;04;Perjantai;1;5;6;0;2;2
89;18.02.2011;2011;02;05;Perjantai;3;7;10;0;4;4
89;18.02.2011;2011;02;06;Perjantai;5;13;18;3;13;16
89;18.02.2011;2011;02;07;Perjantai;14;54;68;9;35;44
89;18.02.2011;2011;02;08;Perjantai;8;57;65;8;31;39
89;18.02.2011;2011;02;09;Perjantai;7;38;45;5;19;24
89;18.02.2011;2011;02;10;Perjantai;14;24;38;7;25;32
89;18.02.2011;2011;02;11;Perjantai;7;29;36;15;28;43
89;18.02.2011;2011;02;12;Perjantai;22;29;51;20;31;51
89;18.02.2011;2011;02;13;Perjantai;28;31;59;24;21;45
89;18.02.2011;2011;02;14;Perjantai;44;24;68;29;28;57
89;18.02.2011;2011;02;15;Perjantai;61;27;88;37;25;62
89;18.02.2011;2011;02;16;Perjantai;49;21;70;38;19;57
89;18.02.2011;2011;02;17;Perjantai;24;20;44;27;19;46
89;18.02.2011;2011;02;18;Perjantai;22;27;49;12;14;26
89;18.02.2011;2011;02;19;Perjantai;13;16;29;15;11;26
89;18.02.2011;2011;02;20;Perjantai;22;7;29;10;7;17
89;18.02.2011;2011;02;21;Perjantai;12;9;21;4;8;12
89;18.02.2011;2011;02;22;Perjantai;9;7;16;6;2;8
89;18.02.2011;2011;02;23;Perjantai;7;8;15;2;6;8
89;19.02.2011;2011;02;00;Lauantai;6;11;17;4;2;6
89;19.02.2011;2011;02;01;Lauantai;3;1;4;4;0;4
89;19.02.2011;2011;02;02;Lauantai;5;1;6;3;0;3
89;19.02.2011;2011;02;03;Lauantai;3;1;4;4;1;5
89;19.02.2011;2011;02;04;Lauantai;6;3;9;3;3;6
89;19.02.2011;2011;02;05;Lauantai;3;4;7;0;3;3
89;19.02.2011;2011;02;06;Lauantai;3;7;10;0;7;7
89;19.02.2011;2011;02;07;Lauantai;4;4;8;4;3;7
89;19.02.2011;2011;02;08;Lauantai;4;11;15;5;7;12
89;19.02.2011;2011;02;09;Lauantai;5;31;36;4;18;22
89;19.02.2011;2011;02;10;Lauantai;3;18;21;14;29;43
89;19.02.2011;2011;02;11;Lauantai;13;27;40;17;41;58
89;19.02.2011;2011;02;12;Lauantai;17;28;45;32;60;92
89;19.02.2011;2011;02;13;Lauantai;24;19;43;32;38;70
89;19.02.2011;2011;02;14;Lauantai;25;18;43;35;34;69
89;19.02.2011;2011;02;15;Lauantai;27;34;61;43;43;86
89;19.02.2011;2011;02;16;Lauantai;23;23;46;32;20;52
89;19.02.2011;2011;02;17;Lauantai;19;23;42;25;18;43
89;19.02.2011;2011;02;18;Lauantai;20;17;37;17;8;25
89;19.02.2011;2011;02;19;Lauantai;7;6;13;10;14;24
89;19.02.2011;2011;02;20;Lauantai;16;11;27;4;6;10
89;19.02.2011;2011;02;21;Lauantai;10;9;19;8;6;14
89;19.02.2011;2011;02;22;Lauantai;9;7;16;1;8;9
89;19.02.2011;2011;02;23;Lauantai;6;2;8;3;7;10
89;20.02.2011;2011;02;00;Sunnuntai;5;3;8;5;1;6
89;20.02.2011;2011;02;01;Sunnuntai;5;3;8;2;2;4
89;20.02.2011;2011;02;02;Sunnuntai;6;2;8;1;0;1
89;20.02.2011;2011;02;03;Sunnuntai;7;1;8;5;2;7
89;20.02.2011;2011;02;04;Sunnuntai;12;2;14;4;0;4
89;20.02.2011;2011;02;05;Sunnuntai;0;0;0;0;0;0
89;20.02.2011;2011;02;06;Sunnuntai;1;4;5;0;9;9
89;20.02.2011;2011;02;07;Sunnuntai;3;3;6;3;0;3
89;20.02.2011;2011;02;08;Sunnuntai;1;5;6;6;6;12
89;20.02.2011;2011;02;09;Sunnuntai;3;8;11;10;23;33
89;20.02.2011;2011;02;10;Sunnuntai;9;14;23;21;20;41
89;20.02.2011;2011;02;11;Sunnuntai;7;18;25;37;42;79
89;20.02.2011;2011;02;12;Sunnuntai;8;25;33;34;58;92
89;20.02.2011;2011;02;13;Sunnuntai;22;29;51;64;81;145
89;20.02.2011;2011;02;14;Sunnuntai;26;22;48;47;54;101
89;20.02.2011;2011;02;15;Sunnuntai;19;25;44;50;31;81
89;20.02.2011;2011;02;16;Sunnuntai;33;11;44;45;35;80
89;20.02.2011;2011;02;17;Sunnuntai;20;21;41;24;21;45
89;20.02.2011;2011;02;18;Sunnuntai;21;13;34;25;25;50
89;20.02.2011;2011;02;19;Sunnuntai;21;10;31;13;9;22
89;20.02.2011;2011;02;20;Sunnuntai;13;8;21;9;4;13
89;20.02.2011;2011;02;21;Sunnuntai;11;4;15;1;5;6
89;20.02.2011;2011;02;22;Sunnuntai;4;2;6;7;4;11
89;20.02.2011;2011;02;23;Sunnuntai;3;5;8;5;0;5
89;21.02.2011;2011;02;00;Maanantai;0;1;1;1;1;2
89;21.02.2011;2011;02;01;Maanantai;1;3;4;0;0;0
89;21.02.2011;2011;02;02;Maanantai;0;1;1;2;1;3
89;21.02.2011;2011;02;03;Maanantai;0;0;0;0;0;0
89;21.02.2011;2011;02;04;Maanantai;1;5;6;1;0;1
89;21.02.2011;2011;02;05;Maanantai;3;5;8;1;2;3
89;21.02.2011;2011;02;06;Maanantai;7;29;36;5;12;17
89;21.02.2011;2011;02;07;Maanantai;22;102;124;10;42;52
89;21.02.2011;2011;02;08;Maanantai;23;95;118;10;48;58
89;21.02.2011;2011;02;09;Maanantai;19;58;77;10;44;54
89;21.02.2011;2011;02;10;Maanantai;18;37;55;14;20;34
89;21.02.2011;2011;02;11;Maanantai;14;29;43;28;37;65
89;21.02.2011;2011;02;12;Maanantai;22;33;55;28;45;73
89;21.02.2011;2011;02;13;Maanantai;35;34;69;34;35;69
89;21.02.2011;2011;02;14;Maanantai;44;47;91;56;34;90
89;21.02.2011;2011;02;15;Maanantai;90;51;141;52;27;79
89;21.02.2011;2011;02;16;Maanantai;80;41;121;61;33;94
89;21.02.2011;2011;02;17;Maanantai;44;39;83;27;27;54
89;21.02.2011;2011;02;18;Maanantai;46;36;82;21;26;47
89;21.02.2011;2011;02;19;Maanantai;32;26;58;20;16;36
89;21.02.2011;2011;02;20;Maanantai;50;20;70;12;14;26
89;21.02.2011;2011;02;21;Maanantai;23;8;31;11;7;18
89;21.02.2011;2011;02;22;Maanantai;8;0;8;5;6;11
89;21.02.2011;2011;02;23;Maanantai;5;3;8;1;0;1
89;22.02.2011;2011;02;00;Tiistai;1;2;3;3;1;4
89;22.02.2011;2011;02;01;Tiistai;2;1;3;0;1;1
89;22.02.2011;2011;02;02;Tiistai;1;1;2;0;1;1
89;22.02.2011;2011;02;03;Tiistai;1;1;2;0;0;0
89;22.02.2011;2011;02;04;Tiistai;3;2;5;1;1;2
89;22.02.2011;2011;02;05;Tiistai;3;14;17;1;1;2
89;22.02.2011;2011;02;06;Tiistai;13;30;43;5;15;20
89;22.02.2011;2011;02;07;Tiistai;30;125;155;2;52;54
89;22.02.2011;2011;02;08;Tiistai;33;129;162;8;43;51
89;22.02.2011;2011;02;09;Tiistai;21;75;96;14;26;40
89;22.02.2011;2011;02;10;Tiistai;19;44;63;16;31;47
89;22.02.2011;2011;02;11;Tiistai;26;39;65;23;34;57
89;22.02.2011;2011;02;12;Tiistai;30;42;72;32;41;73
89;22.02.2011;2011;02;13;Tiistai;41;35;76;28;31;59
89;22.02.2011;2011;02;14;Tiistai;66;39;105;53;25;78
89;22.02.2011;2011;02;15;Tiistai;85;64;149;44;37;81
89;22.02.2011;2011;02;16;Tiistai;100;82;182;49;36;85
89;22.02.2011;2011;02;17;Tiistai;62;49;111;36;34;70
89;22.02.2011;2011;02;18;Tiistai;51;50;101;38;20;58
89;22.02.2011;2011;02;19;Tiistai;51;28;79;21;18;39
89;22.02.2011;2011;02;20;Tiistai;32;29;61;17;13;30
89;22.02.2011;2011;02;21;Tiistai;31;15;46;8;6;14
89;22.02.2011;2011;02;22;Tiistai;10;4;14;3;1;4
89;22.02.2011;2011;02;23;Tiistai;6;3;9;1;0;1
89;23.02.2011;2011;02;00;Keskiviikko;3;1;4;0;0;0
89;23.02.2011;2011;02;01;Keskiviikko;3;0;3;1;0;1
89;23.02.2011;2011;02;02;Keskiviikko;1;3;4;0;1;1
89;23.02.2011;2011;02;03;Keskiviikko;0;1;1;0;0;0
89;23.02.2011;2011;02;04;Keskiviikko;2;4;6;0;0;0
89;23.02.2011;2011;02;05;Keskiviikko;2;7;9;1;2;3
89;23.02.2011;2011;02;06;Keskiviikko;11;31;42;5;21;26
89;23.02.2011;2011;02;07;Keskiviikko;31;97;128;8;40;48
89;23.02.2011;2011;02;08;Keskiviikko;29;110;139;9;45;54
89;23.02.2011;2011;02;09;Keskiviikko;20;59;79;9;33;42
89;23.02.2011;2011;02;10;Keskiviikko;13;44;57;20;29;49
89;23.02.2011;2011;02;11;Keskiviikko;26;28;54;23;23;46
89;23.02.2011;2011;02;12;Keskiviikko;21;32;53;29;39;68
89;23.02.2011;2011;02;13;Keskiviikko;47;38;85;37;30;67
89;23.02.2011;2011;02;14;Keskiviikko;58;41;99;33;33;66
89;23.02.2011;2011;02;15;Keskiviikko;78;43;121;33;28;61
89;23.02.2011;2011;02;16;Keskiviikko;99;57;156;42;19;61
89;23.02.2011;2011;02;17;Keskiviikko;55;54;109;30;23;53
89;23.02.2011;2011;02;18;Keskiviikko;42;30;72;21;13;34
89;23.02.2011;2011;02;19;Keskiviikko;39;23;62;17;18;35
89;23.02.2011;2011;02;20;Keskiviikko;32;18;50;11;7;18
89;23.02.2011;2011;02;21;Keskiviikko;29;19;48;9;6;15
89;23.02.2011;2011;02;22;Keskiviikko;11;6;17;1;5;6
89;23.02.2011;2011;02;23;Keskiviikko;3;4;7;3;5;8
89;24.02.2011;2011;02;00;Torstai;1;1;2;1;1;2
89;24.02.2011;2011;02;01;Torstai;2;1;3;1;0;1
89;24.02.2011;2011;02;02;Torstai;0;1;1;2;0;2
89;24.02.2011;2011;02;03;Torstai;0;5;5;0;0;0
89;24.02.2011;2011;02;04;Torstai;4;2;6;0;0;0
89;24.02.2011;2011;02;05;Torstai;4;6;10;2;2;4
89;24.02.2011;2011;02;06;Torstai;7;30;37;3;16;19
89;24.02.2011;2011;02;07;Torstai;25;106;131;4;46;50
89;24.02.2011;2011;02;08;Torstai;26;96;122;10;36;46
89;24.02.2011;2011;02;09;Torstai;24;46;70;9;43;52
89;24.02.2011;2011;02;10;Torstai;19;30;49;9;19;28
89;24.02.2011;2011;02;11;Torstai;19;37;56;17;30;47
89;24.02.2011;2011;02;12;Torstai;24;32;56;24;23;47
89;24.02.2011;2011;02;13;Torstai;40;35;75;24;41;65
89;24.02.2011;2011;02;14;Torstai;56;30;86;32;23;55
89;24.02.2011;2011;02;15;Torstai;69;55;124;41;29;70
89;24.02.2011;2011;02;16;Torstai;79;49;128;53;24;77
89;24.02.2011;2011;02;17;Torstai;57;48;105;21;18;39
89;24.02.2011;2011;02;18;Torstai;48;25;73;10;10;20
89;24.02.2011;2011;02;19;Torstai;34;20;54;17;16;33
89;24.02.2011;2011;02;20;Torstai;28;14;42;13;9;22
89;24.02.2011;2011;02;21;Torstai;18;11;29;13;6;19
89;24.02.2011;2011;02;22;Torstai;7;4;11;3;5;8
89;24.02.2011;2011;02;23;Torstai;8;2;10;3;1;4
89;25.02.2011;2011;02;00;Perjantai;3;4;7;1;1;2
89;25.02.2011;2011;02;01;Perjantai;1;0;1;1;0;1
89;25.02.2011;2011;02;02;Perjantai;3;0;3;1;0;1
89;25.02.2011;2011;02;03;Perjantai;1;1;2;1;0;1
89;25.02.2011;2011;02;04;Perjantai;2;5;7;1;1;2
89;25.02.2011;2011;02;05;Perjantai;3;4;7;0;1;1
89;25.02.2011;2011;02;06;Perjantai;15;29;44;3;9;12
89;25.02.2011;2011;02;07;Perjantai;36;73;109;5;38;43
89;25.02.2011;2011;02;08;Perjantai;47;92;139;7;32;39
89;25.02.2011;2011;02;09;Perjantai;23;58;81;14;30;44
89;25.02.2011;2011;02;10;Perjantai;21;33;54;9;32;41
89;25.02.2011;2011;02;11;Perjantai;27;34;61;19;35;54
89;25.02.2011;2011;02;12;Perjantai;40;41;81;23;30;53
89;25.02.2011;2011;02;13;Perjantai;62;40;102;26;20;46
89;25.02.2011;2011;02;14;Perjantai;60;21;81;38;28;66
89;25.02.2011;2011;02;15;Perjantai;76;33;109;39;16;55
89;25.02.2011;2011;02;16;Perjantai;87;46;133;33;13;46
89;25.02.2011;2011;02;17;Perjantai;45;30;75;15;20;35
89;25.02.2011;2011;02;18;Perjantai;36;25;61;13;19;32
89;25.02.2011;2011;02;19;Perjantai;25;17;42;11;10;21
89;25.02.2011;2011;02;20;Perjantai;23;21;44;12;6;18
89;25.02.2011;2011;02;21;Perjantai;15;18;33;1;8;9
89;25.02.2011;2011;02;22;Perjantai;8;21;29;3;6;9
89;25.02.2011;2011;02;23;Perjantai;14;11;25;3;6;9
89;26.02.2011;2011;02;00;Lauantai;12;4;16;3;2;5
89;26.02.2011;2011;02;01;Lauantai;6;2;8;4;0;4
89;26.02.2011;2011;02;02;Lauantai;11;3;14;4;1;5
89;26.02.2011;2011;02;03;Lauantai;7;2;9;6;0;6
89;26.02.2011;2011;02;04;Lauantai;4;3;7;6;0;6
89;26.02.2011;2011;02;05;Lauantai;2;1;3;0;0;0
89;26.02.2011;2011;02;06;Lauantai;6;7;13;3;10;13
89;26.02.2011;2011;02;07;Lauantai;8;10;18;6;6;12
89;26.02.2011;2011;02;08;Lauantai;13;11;24;6;10;16
89;26.02.2011;2011;02;09;Lauantai;10;32;42;11;27;38
89;26.02.2011;2011;02;10;Lauantai;20;35;55;17;28;45
89;26.02.2011;2011;02;11;Lauantai;24;37;61;24;39;63
89;26.02.2011;2011;02;12;Lauantai;36;50;86;28;45;73
89;26.02.2011;2011;02;13;Lauantai;30;46;76;42;42;84
89;26.02.2011;2011;02;14;Lauantai;41;44;85;34;51;85
89;26.02.2011;2011;02;15;Lauantai;37;30;67;27;37;64
89;26.02.2011;2011;02;16;Lauantai;28;27;55;43;35;78
89;26.02.2011;2011;02;17;Lauantai;28;26;54;38;26;64
89;26.02.2011;2011;02;18;Lauantai;25;30;55;29;23;52
89;26.02.2011;2011;02;19;Lauantai;18;16;34;19;10;29
89;26.02.2011;2011;02;20;Lauantai;13;14;27;15;11;26
89;26.02.2011;2011;02;21;Lauantai;21;16;37;3;3;6
89;26.02.2011;2011;02;22;Lauantai;9;12;21;7;4;11
89;26.02.2011;2011;02;23;Lauantai;10;14;24;5;14;19
89;27.02.2011;2011;02;00;Sunnuntai;10;7;17;5;5;10
89;27.02.2011;2011;02;01;Sunnuntai;10;5;15;7;1;8
89;27.02.2011;2011;02;02;Sunnuntai;15;0;15;8;2;10
89;27.02.2011;2011;02;03;Sunnuntai;12;2;14;8;1;9
89;27.02.2011;2011;02;04;Sunnuntai;10;4;14;10;2;12
89;27.02.2011;2011;02;05;Sunnuntai;4;0;4;1;0;1
89;27.02.2011;2011;02;06;Sunnuntai;4;7;11;4;19;23
89;27.02.2011;2011;02;07;Sunnuntai;6;4;10;6;3;9
89;27.02.2011;2011;02;08;Sunnuntai;3;8;11;9;12;21
89;27.02.2011;2011;02;09;Sunnuntai;5;14;19;19;18;37
89;27.02.2011;2011;02;10;Sunnuntai;3;25;28;34;49;83
89;27.02.2011;2011;02;11;Sunnuntai;22;40;62;50;68;118
89;27.02.2011;2011;02;12;Sunnuntai;30;27;57;52;81;133
89;27.02.2011;2011;02;13;Sunnuntai;25;37;62;40;62;102
89;27.02.2011;2011;02;14;Sunnuntai;43;30;73;51;49;100
89;27.02.2011;2011;02;15;Sunnuntai;28;25;53;48;29;77
89;27.02.2011;2011;02;16;Sunnuntai;26;39;65;35;33;68
89;27.02.2011;2011;02;17;Sunnuntai;28;19;47;35;30;65
89;27.02.2011;2011;02;18;Sunnuntai;29;30;59;39;28;67
89;27.02.2011;2011;02;19;Sunnuntai;32;14;46;31;23;54
89;27.02.2011;2011;02;20;Sunnuntai;23;11;34;17;14;31
89;27.02.2011;2011;02;21;Sunnuntai;14;3;17;11;8;19
89;27.02.2011;2011;02;22;Sunnuntai;4;7;11;3;1;4
89;27.02.2011;2011;02;23;Sunnuntai;3;1;4;3;7;10
89;28.02.2011;2011;02;00;Maanantai;3;3;6;0;0;0
89;28.02.2011;2011;02;01;Maanantai;3;0;3;1;0;1
89;28.02.2011;2011;02;02;Maanantai;0;1;1;0;0;0
89;28.02.2011;2011;02;03;Maanantai;1;1;2;0;1;1
89;28.02.2011;2011;02;04;Maanantai;0;6;6;1;0;1
89;28.02.2011;2011;02;05;Maanantai;5;7;12;0;0;0
89;28.02.2011;2011;02;06;Maanantai;11;37;48;14;31;45
89;28.02.2011;2011;02;07;Maanantai;28;139;167;7;47;54
89;28.02.2011;2011;02;08;Maanantai;36;151;187;29;50;79
89;28.02.2011;2011;02;09;Maanantai;31;65;96;12;35;47
89;28.02.2011;2011;02;10;Maanantai;31;46;77;34;40;74
89;28.02.2011;2011;02;11;Maanantai;30;66;96;45;54;99
89;28.02.2011;2011;02;12;Maanantai;32;52;84;34;58;92
89;28.02.2011;2011;02;13;Maanantai;63;47;110;27;38;65
89;28.02.2011;2011;02;14;Maanantai;89;45;134;54;34;88
89;28.02.2011;2011;02;15;Maanantai;104;57;161;72;43;115
89;28.02.2011;2011;02;16;Maanantai;141;80;221;73;37;110
89;28.02.2011;2011;02;17;Maanantai;78;58;136;42;37;79
89;28.02.2011;2011;02;18;Maanantai;62;45;107;47;26;73
89;28.02.2011;2011;02;19;Maanantai;38;35;73;32;16;48
89;28.02.2011;2011;02;20;Maanantai;44;19;63;27;19;46
89;28.02.2011;2011;02;21;Maanantai;36;11;47;23;13;36
89;28.02.2011;2011;02;22;Maanantai;7;5;12;8;11;19
89;28.02.2011;2011;02;23;Maanantai;6;2;8;1;1;2
89;01.03.2011;2011;03;00;Tiistai;0;1;1;2;1;3
89;01.03.2011;2011;03;01;Tiistai;1;1;2;2;1;3
89;01.03.2011;2011;03;02;Tiistai;0;0;0;0;0;0
89;01.03.2011;2011;03;03;Tiistai;1;1;2;0;0;0
89;01.03.2011;2011;03;04;Tiistai;0;8;8;1;0;1
89;01.03.2011;2011;03;05;Tiistai;2;15;17;2;1;3
89;01.03.2011;2011;03;06;Tiistai;6;40;46;8;23;31
89;01.03.2011;2011;03;07;Tiistai;29;136;165;7;50;57
89;01.03.2011;2011;03;08;Tiistai;29;150;179;10;34;44
89;01.03.2011;2011;03;09;Tiistai;33;76;109;21;35;56
89;01.03.2011;2011;03;10;Tiistai;26;42;68;28;34;62
89;01.03.2011;2011;03;11;Tiistai;34;44;78;30;38;68
89;01.03.2011;2011;03;12;Tiistai;27;51;78;21;52;73
89;01.03.2011;2011;03;13;Tiistai;49;44;93;26;34;60
89;01.03.2011;2011;03;14;Tiistai;71;35;106;43;31;74
89;01.03.2011;2011;03;15;Tiistai;101;62;163;52;27;79
89;01.03.2011;2011;03;16;Tiistai;131;78;209;65;33;98
89;01.03.2011;2011;03;17;Tiistai;74;62;136;59;44;103
89;01.03.2011;2011;03;18;Tiistai;61;43;104;40;23;63
89;01.03.2011;2011;03;19;Tiistai;48;25;73;34;27;61
89;01.03.2011;2011;03;20;Tiistai;38;17;55;32;18;50
89;01.03.2011;2011;03;21;Tiistai;20;14;34;12;10;22
89;01.03.2011;2011;03;22;Tiistai;13;5;18;6;2;8
89;01.03.2011;2011;03;23;Tiistai;4;4;8;3;2;5
89;02.03.2011;2011;03;00;Keskiviikko;1;1;2;4;2;6
89;02.03.2011;2011;03;01;Keskiviikko;3;0;3;0;1;1
89;02.03.2011;2011;03;02;Keskiviikko;2;0;2;1;0;1
89;02.03.2011;2011;03;03;Keskiviikko;0;0;0;1;0;1
89;02.03.2011;2011;03;04;Keskiviikko;1;6;7;3;0;3
89;02.03.2011;2011;03;05;Keskiviikko;6;12;18;2;0;2
89;02.03.2011;2011;03;06;Keskiviikko;11;38;49;7;26;33
89;02.03.2011;2011;03;07;Keskiviikko;20;151;171;9;43;52
89;02.03.2011;2011;03;08;Keskiviikko;40;140;180;20;36;56
89;02.03.2011;2011;03;09;Keskiviikko;35;77;112;21;51;72
89;02.03.2011;2011;03;10;Keskiviikko;34;45;79;33;43;76
89;02.03.2011;2011;03;11;Keskiviikko;37;54;91;39;52;91
89;02.03.2011;2011;03;12;Keskiviikko;30;60;90;23;44;67
89;02.03.2011;2011;03;13;Keskiviikko;57;55;112;43;29;72
89;02.03.2011;2011;03;14;Keskiviikko;87;51;138;49;21;70
89;02.03.2011;2011;03;15;Keskiviikko;109;64;173;43;27;70
89;02.03.2011;2011;03;16;Keskiviikko;135;78;213;59;37;96
89;02.03.2011;2011;03;17;Keskiviikko;102;64;166;64;34;98
89;02.03.2011;2011;03;18;Keskiviikko;70;33;103;45;36;81
89;02.03.2011;2011;03;19;Keskiviikko;56;32;88;31;17;48
89;02.03.2011;2011;03;20;Keskiviikko;45;24;69;31;19;50
89;02.03.2011;2011;03;21;Keskiviikko;41;34;75;16;9;25
89;02.03.2011;2011;03;22;Keskiviikko;7;9;16;2;11;13
89;02.03.2011;2011;03;23;Keskiviikko;6;6;12;4;3;7
89;03.03.2011;2011;03;00;Torstai;3;3;6;2;2;4
89;03.03.2011;2011;03;01;Torstai;5;1;6;5;4;9
89;03.03.2011;2011;03;02;Torstai;2;2;4;7;0;7
89;03.03.2011;2011;03;03;Torstai;4;1;5;3;0;3
89;03.03.2011;2011;03;04;Torstai;1;6;7;1;0;1
89;03.03.2011;2011;03;05;Torstai;4;9;13;0;0;0
89;03.03.2011;2011;03;06;Torstai;9;30;39;11;24;35
89;03.03.2011;2011;03;07;Torstai;18;128;146;4;44;48
89;03.03.2011;2011;03;08;Torstai;30;139;169;14;40;54
89;03.03.2011;2011;03;09;Torstai;24;58;82;16;29;45
89;03.03.2011;2011;03;10;Torstai;32;49;81;16;36;52
89;03.03.2011;2011;03;11;Torstai;27;52;79;20;29;49
89;03.03.2011;2011;03;12;Torstai;40;53;93;33;36;69
89;03.03.2011;2011;03;13;Torstai;45;48;93;41;39;80
89;03.03.2011;2011;03;14;Torstai;63;39;102;49;27;76
89;03.03.2011;2011;03;15;Torstai;94;60;154;58;27;85
89;03.03.2011;2011;03;16;Torstai;127;76;203;48;30;78
89;03.03.2011;2011;03;17;Torstai;82;42;124;47;40;87
89;03.03.2011;2011;03;18;Torstai;44;36;80;35;22;57
89;03.03.2011;2011;03;19;Torstai;39;25;64;23;20;43
89;03.03.2011;2011;03;20;Torstai;30;29;59;14;14;28
89;03.03.2011;2011;03;21;Torstai;21;14;35;15;15;30
89;03.03.2011;2011;03;22;Torstai;16;8;24;2;8;10
89;03.03.2011;2011;03;23;Torstai;9;5;14;8;6;14
89;04.03.2011;2011;03;00;Perjantai;3;1;4;5;1;6
89;04.03.2011;2011;03;01;Perjantai;3;1;4;0;0;0
89;04.03.2011;2011;03;02;Perjantai;8;1;9;7;1;8
89;04.03.2011;2011;03;03;Perjantai;5;3;8;0;0;0
89;04.03.2011;2011;03;04;Perjantai;3;7;10;1;1;2
89;04.03.2011;2011;03;05;Perjantai;1;6;7;0;0;0
89;04.03.2011;2011;03;06;Perjantai;11;31;42;5;23;28
89;04.03.2011;2011;03;07;Perjantai;24;150;174;9;46;55
89;04.03.2011;2011;03;08;Perjantai;29;116;145;9;47;56
89;04.03.2011;2011;03;09;Perjantai;27;74;101;21;38;59
89;04.03.2011;2011;03;10;Perjantai;18;43;61;31;40;71
89;04.03.2011;2011;03;11;Perjantai;40;41;81;23;30;53
89;04.03.2011;2011;03;12;Perjantai;32;65;97;30;54;84
89;04.03.2011;2011;03;13;Perjantai;77;53;130;41;30;71
89;04.03.2011;2011;03;14;Perjantai;81;49;130;41;27;68
89;04.03.2011;2011;03;15;Perjantai;88;45;133;38;23;61
89;04.03.2011;2011;03;16;Perjantai;91;38;129;48;37;85
89;04.03.2011;2011;03;17;Perjantai;68;34;102;33;32;65
89;04.03.2011;2011;03;18;Perjantai;42;24;66;24;14;38
89;04.03.2011;2011;03;19;Perjantai;30;15;45;26;14;40
89;04.03.2011;2011;03;20;Perjantai;25;17;42;12;10;22
89;04.03.2011;2011;03;21;Perjantai;17;21;38;9;10;19
89;04.03.2011;2011;03;22;Perjantai;10;21;31;7;2;9
89;04.03.2011;2011;03;23;Perjantai;9;12;21;1;11;12
89;05.03.2011;2011;03;00;Lauantai;7;10;17;9;6;15
89;05.03.2011;2011;03;01;Lauantai;6;6;12;4;0;4
89;05.03.2011;2011;03;02;Lauantai;9;2;11;7;4;11
89;05.03.2011;2011;03;03;Lauantai;11;1;12;8;0;8
89;05.03.2011;2011;03;04;Lauantai;19;0;19;7;1;8
89;05.03.2011;2011;03;05;Lauantai;5;2;7;5;0;5
89;05.03.2011;2011;03;06;Lauantai;3;12;15;10;13;23
89;05.03.2011;2011;03;07;Lauantai;4;18;22;5;12;17
89;05.03.2011;2011;03;08;Lauantai;5;17;22;11;11;22
89;05.03.2011;2011;03;09;Lauantai;6;35;41;15;30;45
89;05.03.2011;2011;03;10;Lauantai;13;35;48;14;44;58
89;05.03.2011;2011;03;11;Lauantai;19;36;55;40;35;75
89;05.03.2011;2011;03;12;Lauantai;25;38;63;28;33;61
89;05.03.2011;2011;03;13;Lauantai;35;35;70;33;33;66
89;05.03.2011;2011;03;14;Lauantai;37;35;72;39;35;74
89;05.03.2011;2011;03;15;Lauantai;50;38;88;41;25;66
89;05.03.2011;2011;03;16;Lauantai;38;33;71;49;32;81
89;05.03.2011;2011;03;17;Lauantai;32;13;45;38;24;62
89;05.03.2011;2011;03;18;Lauantai;23;26;49;29;17;46
89;05.03.2011;2011;03;19;Lauantai;17;15;32;19;19;38
89;05.03.2011;2011;03;20;Lauantai;9;15;24;12;10;22
89;05.03.2011;2011;03;21;Lauantai;16;11;27;7;9;16
89;05.03.2011;2011;03;22;Lauantai;11;16;27;5;9;14
89;05.03.2011;2011;03;23;Lauantai;4;9;13;7;9;16
89;06.03.2011;2011;03;00;Sunnuntai;6;5;11;1;12;13
89;06.03.2011;2011;03;01;Sunnuntai;8;1;9;2;1;3
89;06.03.2011;2011;03;02;Sunnuntai;13;2;15;6;0;6
89;06.03.2011;2011;03;03;Sunnuntai;9;2;11;5;2;7
89;06.03.2011;2011;03;04;Sunnuntai;12;1;13;4;0;4
89;06.03.2011;2011;03;05;Sunnuntai;2;2;4;2;0;2
89;06.03.2011;2011;03;06;Sunnuntai;1;8;9;7;9;16
89;06.03.2011;2011;03;07;Sunnuntai;2;8;10;4;7;11
89;06.03.2011;2011;03;08;Sunnuntai;4;5;9;11;9;20
89;06.03.2011;2011;03;09;Sunnuntai;3;14;17;26;12;38
89;06.03.2011;2011;03;10;Sunnuntai;4;19;23;44;46;90
89;06.03.2011;2011;03;11;Sunnuntai;15;28;43;62;55;117
89;06.03.2011;2011;03;12;Sunnuntai;25;40;65;64;83;147
89;06.03.2011;2011;03;13;Sunnuntai;32;38;70;72;81;153
89;06.03.2011;2011;03;14;Sunnuntai;29;30;59;56;70;126
89;06.03.2011;2011;03;15;Sunnuntai;23;23;46;42;38;80
89;06.03.2011;2011;03;16;Sunnuntai;37;31;68;44;35;79
89;06.03.2011;2011;03;17;Sunnuntai;29;26;55;34;32;66
89;06.03.2011;2011;03;18;Sunnuntai;21;19;40;25;29;54
89;06.03.2011;2011;03;19;Sunnuntai;26;19;45;21;15;36
89;06.03.2011;2011;03;20;Sunnuntai;15;11;26;8;7;15
89;06.03.2011;2011;03;21;Sunnuntai;8;8;16;7;7;14
89;06.03.2011;2011;03;22;Sunnuntai;9;4;13;2;2;4
89;06.03.2011;2011;03;23;Sunnuntai;8;1;9;1;2;3
89;07.03.2011;2011;03;00;Maanantai;3;3;6;1;1;2
89;07.03.2011;2011;03;01;Maanantai;3;3;6;0;1;1
89;07.03.2011;2011;03;02;Maanantai;2;4;6;2;0;2
89;07.03.2011;2011;03;03;Maanantai;0;2;2;0;1;1
89;07.03.2011;2011;03;04;Maanantai;1;5;6;1;0;1
89;07.03.2011;2011;03;05;Maanantai;1;10;11;5;2;7
89;07.03.2011;2011;03;06;Maanantai;7;26;33;7;15;22
89;07.03.2011;2011;03;07;Maanantai;9;87;96;4;38;42
89;07.03.2011;2011;03;08;Maanantai;23;88;111;13;40;53
89;07.03.2011;2011;03;09;Maanantai;28;51;79;19;40;59
89;07.03.2011;2011;03;10;Maanantai;17;22;39;19;35;54
89;07.03.2011;2011;03;11;Maanantai;16;39;55;32;43;75
89;07.03.2011;2011;03;12;Maanantai;29;48;77;20;36;56
89;07.03.2011;2011;03;13;Maanantai;41;42;83;25;45;70
89;07.03.2011;2011;03;14;Maanantai;42;37;79;37;38;75
89;07.03.2011;2011;03;15;Maanantai;71;58;129;52;34;86
89;07.03.2011;2011;03;16;Maanantai;100;60;160;62;23;85
89;07.03.2011;2011;03;17;Maanantai;54;38;92;42;26;68
89;07.03.2011;2011;03;18;Maanantai;45;30;75;36;11;47
89;07.03.2011;2011;03;19;Maanantai;37;13;50;31;16;47
89;07.03.2011;2011;03;20;Maanantai;36;15;51;22;14;36
89;07.03.2011;2011;03;21;Maanantai;20;13;33;9;7;16
89;07.03.2011;2011;03;22;Maanantai;6;3;9;3;4;7
89;07.03.2011;2011;03;23;Maanantai;3;2;5;4;0;4
89;08.03.2011;2011;03;00;Tiistai;4;4;8;2;2;4
89;08.03.2011;2011;03;01;Tiistai;1;3;4;1;1;2
89;08.03.2011;2011;03;02;Tiistai;0;2;2;1;0;1
89;08.03.2011;2011;03;03;Tiistai;0;3;3;2;0;2
89;08.03.2011;2011;03;04;Tiistai;4;2;6;2;1;3
89;08.03.2011;2011;03;05;Tiistai;2;8;10;0;1;1
89;08.03.2011;2011;03;06;Tiistai;10;35;45;10;5;15
89;08.03.2011;2011;03;07;Tiistai;17;78;95;8;37;45
89;08.03.2011;2011;03;08;Tiistai;16;75;91;27;46;73
89;08.03.2011;2011;03;09;Tiistai;26;44;70;21;40;61
89;08.03.2011;2011;03;10;Tiistai;28;43;71;18;42;60
89;08.03.2011;2011;03;11;Tiistai;30;40;70;33;45;78
89;08.03.2011;2011;03;12;Tiistai;29;56;85;40;64;104
89;08.03.2011;2011;03;13;Tiistai;37;75;112;45;57;102
89;08.03.2011;2011;03;14;Tiistai;43;62;105;45;32;77
89;08.03.2011;2011;03;15;Tiistai;79;57;136;34;27;61
89;08.03.2011;2011;03;16;Tiistai;101;48;149;70;30;100
89;08.03.2011;2011;03;17;Tiistai;63;37;100;38;32;70
89;08.03.2011;2011;03;18;Tiistai;43;29;72;31;30;61
89;08.03.2011;2011;03;19;Tiistai;28;16;44;32;16;48
89;08.03.2011;2011;03;20;Tiistai;26;15;41;16;15;31
89;08.03.2011;2011;03;21;Tiistai;22;12;34;17;7;24
89;08.03.2011;2011;03;22;Tiistai;11;5;16;7;2;9
89;08.03.2011;2011;03;23;Tiistai;1;2;3;2;1;3
89;09.03.2011;2011;03;00;Keskiviikko;11;3;14;6;2;8
89;09.03.2011;2011;03;01;Keskiviikko;3;1;4;3;0;3
89;09.03.2011;2011;03;02;Keskiviikko;7;2;9;4;0;4
89;09.03.2011;2011;03;03;Keskiviikko;6;2;8;11;6;17
89;09.03.2011;2011;03;04;Keskiviikko;3;6;9;3;1;4
89;09.03.2011;2011;03;05;Keskiviikko;2;4;6;0;1;1
89;09.03.2011;2011;03;06;Keskiviikko;9;35;44;7;11;18
89;09.03.2011;2011;03;07;Keskiviikko;19;71;90;7;34;41
89;09.03.2011;2011;03;08;Keskiviikko;19;59;78;15;31;46
89;09.03.2011;2011;03;09;Keskiviikko;20;48;68;14;39;53
89;09.03.2011;2011;03;10;Keskiviikko;30;39;69;17;40;57
89;09.03.2011;2011;03;11;Keskiviikko;23;40;63;29;41;70
89;09.03.2011;2011;03;12;Keskiviikko;27;34;61;35;52;87
89;09.03.2011;2011;03;13;Keskiviikko;37;38;75;37;37;74
89;09.03.2011;2011;03;14;Keskiviikko;36;39;75;37;28;65
89;09.03.2011;2011;03;15;Keskiviikko;62;57;119;40;28;68
89;09.03.2011;2011;03;16;Keskiviikko;79;53;132;46;20;66
89;09.03.2011;2011;03;17;Keskiviikko;56;40;96;38;28;66
89;09.03.2011;2011;03;18;Keskiviikko;43;22;65;29;25;54
89;09.03.2011;2011;03;19;Keskiviikko;31;18;49;28;19;47
89;09.03.2011;2011;03;20;Keskiviikko;32;14;46;16;13;29
89;09.03.2011;2011;03;21;Keskiviikko;18;12;30;11;13;24
89;09.03.2011;2011;03;22;Keskiviikko;6;5;11;3;0;3
89;09.03.2011;2011;03;23;Keskiviikko;4;1;5;4;2;6
89;10.03.2011;2011;03;00;Torstai;6;3;9;4;0;4
89;10.03.2011;2011;03;01;Torstai;0;1;1;2;0;2
89;10.03.2011;2011;03;02;Torstai;2;1;3;1;0;1
89;10.03.2011;2011;03;03;Torstai;1;1;2;1;0;1
89;10.03.2011;2011;03;04;Torstai;0;6;6;1;0;1
89;10.03.2011;2011;03;05;Torstai;1;11;12;2;0;2
89;10.03.2011;2011;03;06;Torstai;8;29;37;9;13;22
89;10.03.2011;2011;03;07;Torstai;17;59;76;7;22;29
89;10.03.2011;2011;03;08;Torstai;8;65;73;10;31;41
89;10.03.2011;2011;03;09;Torstai;22;41;63;6;22;28
89;10.03.2011;2011;03;10;Torstai;15;24;39;15;28;43
89;10.03.2011;2011;03;11;Torstai;31;43;74;38;51;89
89;10.03.2011;2011;03;12;Torstai;26;20;46;26;32;58
89;10.03.2011;2011;03;13;Torstai;28;44;72;25;30;55
89;10.03.2011;2011;03;14;Torstai;37;50;87;34;25;59
89;10.03.2011;2011;03;15;Torstai;77;45;122;27;32;59
89;10.03.2011;2011;03;16;Torstai;79;46;125;39;28;67
89;10.03.2011;2011;03;17;Torstai;50;44;94;47;32;79
89;10.03.2011;2011;03;18;Torstai;37;26;63;25;20;45
89;10.03.2011;2011;03;19;Torstai;30;15;45;20;18;38
89;10.03.2011;2011;03;20;Torstai;29;19;48;12;7;19
89;10.03.2011;2011;03;21;Torstai;28;13;41;10;7;17
89;10.03.2011;2011;03;22;Torstai;6;14;20;2;5;7
89;10.03.2011;2011;03;23;Torstai;4;7;11;4;12;16
89;11.03.2011;2011;03;00;Perjantai;4;1;5;5;1;6
89;11.03.2011;2011;03;01;Perjantai;4;0;4;0;0;0
89;11.03.2011;2011;03;02;Perjantai;16;4;20;7;1;8
89;11.03.2011;2011;03;03;Perjantai;4;1;5;0;0;0
89;11.03.2011;2011;03;04;Perjantai;6;4;10;1;1;2
89;11.03.2011;2011;03;05;Perjantai;5;1;6;0;0;0
89;11.03.2011;2011;03;06;Perjantai;18;17;35;5;23;28
89;11.03.2011;2011;03;07;Perjantai;36;34;70;9;46;55
89;11.03.2011;2011;03;08;Perjantai;36;34;70;9;47;56
89;11.03.2011;2011;03;09;Perjantai;19;16;35;21;38;59
89;11.03.2011;2011;03;10;Perjantai;14;10;24;31;40;71
89;11.03.2011;2011;03;11;Perjantai;21;18;39;23;30;53
89;11.03.2011;2011;03;12;Perjantai;25;22;47;30;54;84
89;11.03.2011;2011;03;13;Perjantai;36;35;71;41;30;71
89;11.03.2011;2011;03;14;Perjantai;31;33;64;41;27;68
89;11.03.2011;2011;03;15;Perjantai;53;25;78;38;23;61
89;11.03.2011;2011;03;16;Perjantai;58;32;90;48;37;85
89;11.03.2011;2011;03;17;Perjantai;32;22;54;33;32;65
89;11.03.2011;2011;03;18;Perjantai;19;17;36;24;14;38
89;11.03.2011;2011;03;19;Perjantai;24;11;35;26;14;40
89;11.03.2011;2011;03;20;Perjantai;17;16;33;12;10;22
89;11.03.2011;2011;03;21;Perjantai;20;7;27;9;10;19
89;11.03.2011;2011;03;22;Perjantai;7;13;20;7;2;9
89;11.03.2011;2011;03;23;Perjantai;5;11;16;1;11;12
89;12.03.2011;2011;03;00;Lauantai;6;3;9;10;0;10
89;12.03.2011;2011;03;01;Lauantai;5;3;8;5;1;6
89;12.03.2011;2011;03;02;Lauantai;6;2;8;3;1;4
89;12.03.2011;2011;03;03;Lauantai;5;3;8;4;1;5
89;12.03.2011;2011;03;04;Lauantai;3;2;5;8;4;12
89;12.03.2011;2011;03;05;Lauantai;8;2;10;1;1;2
89;12.03.2011;2011;03;06;Lauantai;2;5;7;2;4;6
89;12.03.2011;2011;03;07;Lauantai;6;5;11;4;10;14
89;12.03.2011;2011;03;08;Lauantai;6;10;16;6;10;16
89;12.03.2011;2011;03;09;Lauantai;21;33;54;4;16;20
89;12.03.2011;2011;03;10;Lauantai;18;37;55;29;36;65
89;12.03.2011;2011;03;11;Lauantai;21;35;56;40;47;87
89;12.03.2011;2011;03;12;Lauantai;20;58;78;49;59;108
89;12.03.2011;2011;03;13;Lauantai;47;44;91;59;65;124
89;12.03.2011;2011;03;14;Lauantai;39;41;80;62;59;121
89;12.03.2011;2011;03;15;Lauantai;40;40;80;41;41;82
89;12.03.2011;2011;03;16;Lauantai;41;26;67;45;33;78
89;12.03.2011;2011;03;17;Lauantai;27;34;61;36;22;58
89;12.03.2011;2011;03;18;Lauantai;30;17;47;23;19;42
89;12.03.2011;2011;03;19;Lauantai;15;17;32;18;17;35
89;12.03.2011;2011;03;20;Lauantai;14;15;29;14;9;23
89;12.03.2011;2011;03;21;Lauantai;17;14;31;10;7;17
89;12.03.2011;2011;03;22;Lauantai;11;21;32;7;10;17
89;12.03.2011;2011;03;23;Lauantai;11;5;16;1;2;3
89;13.03.2011;2011;03;00;Sunnuntai;4;5;9;3;4;7
89;13.03.2011;2011;03;01;Sunnuntai;5;4;9;5;1;6
89;13.03.2011;2011;03;02;Sunnuntai;9;1;10;3;1;4
89;13.03.2011;2011;03;03;Sunnuntai;14;0;14;2;1;3
89;13.03.2011;2011;03;04;Sunnuntai;8;3;11;4;0;4
89;13.03.2011;2011;03;05;Sunnuntai;5;0;5;1;0;1
89;13.03.2011;2011;03;06;Sunnuntai;2;3;5;3;2;5
89;13.03.2011;2011;03;07;Sunnuntai;6;3;9;5;6;11
89;13.03.2011;2011;03;08;Sunnuntai;8;8;16;17;13;30
89;13.03.2011;2011;03;09;Sunnuntai;4;10;14;17;23;40
89;13.03.2011;2011;03;10;Sunnuntai;16;27;43;30;32;62
89;13.03.2011;2011;03;11;Sunnuntai;21;26;47;47;39;86
89;13.03.2011;2011;03;12;Sunnuntai;18;34;52;43;56;99
89;13.03.2011;2011;03;13;Sunnuntai;30;32;62;50;56;106
89;13.03.2011;2011;03;14;Sunnuntai;27;25;52;42;55;97
89;13.03.2011;2011;03;15;Sunnuntai;37;41;78;43;47;90
89;13.03.2011;2011;03;16;Sunnuntai;23;41;64;34;41;75
89;13.03.2011;2011;03;17;Sunnuntai;30;34;64;29;31;60
89;13.03.2011;2011;03;18;Sunnuntai;43;18;61;20;25;45
89;13.03.2011;2011;03;19;Sunnuntai;25;19;44;16;15;31
89;13.03.2011;2011;03;20;Sunnuntai;17;11;28;12;11;23
89;13.03.2011;2011;03;21;Sunnuntai;31;10;41;7;9;16
89;13.03.2011;2011;03;22;Sunnuntai;7;1;8;6;7;13
89;13.03.2011;2011;03;23;Sunnuntai;8;3;11;3;4;7
89;14.03.2011;2011;03;00;Maanantai;5;1;6;1;0;1
89;14.03.2011;2011;03;01;Maanantai;2;2;4;1;0;1
89;14.03.2011;2011;03;02;Maanantai;0;1;1;0;0;0
89;14.03.2011;2011;03;03;Maanantai;0;0;0;1;0;1
89;14.03.2011;2011;03;04;Maanantai;3;6;9;1;0;1
89;14.03.2011;2011;03;05;Maanantai;4;8;12;0;3;3
89;14.03.2011;2011;03;06;Maanantai;9;48;57;10;8;18
89;14.03.2011;2011;03;07;Maanantai;18;145;163;8;37;45
89;14.03.2011;2011;03;08;Maanantai;40;133;173;7;53;60
89;14.03.2011;2011;03;09;Maanantai;28;75;103;17;34;51
89;14.03.2011;2011;03;10;Maanantai;27;47;74;31;31;62
89;14.03.2011;2011;03;11;Maanantai;37;35;72;38;45;83
89;14.03.2011;2011;03;12;Maanantai;25;41;66;32;41;73
89;14.03.2011;2011;03;13;Maanantai;41;30;71;27;46;73
89;14.03.2011;2011;03;14;Maanantai;59;36;95;37;18;55
89;14.03.2011;2011;03;15;Maanantai;96;47;143;55;33;88
89;14.03.2011;2011;03;16;Maanantai;107;73;180;53;24;77
89;14.03.2011;2011;03;17;Maanantai;67;41;108;38;28;66
89;14.03.2011;2011;03;18;Maanantai;39;41;80;38;26;64
89;14.03.2011;2011;03;19;Maanantai;38;37;75;26;19;45
89;14.03.2011;2011;03;20;Maanantai;60;20;80;25;15;40
89;14.03.2011;2011;03;21;Maanantai;22;6;28;13;13;26
89;14.03.2011;2011;03;22;Maanantai;9;2;11;2;2;4
89;14.03.2011;2011;03;23;Maanantai;1;3;4;4;3;7
89;15.03.2011;2011;03;00;Tiistai;0;0;0;1;1;2
89;15.03.2011;2011;03;01;Tiistai;1;1;2;1;0;1
89;15.03.2011;2011;03;02;Tiistai;0;0;0;0;0;0
89;15.03.2011;2011;03;03;Tiistai;0;2;2;0;0;0
89;15.03.2011;2011;03;04;Tiistai;3;5;8;0;0;0
89;15.03.2011;2011;03;05;Tiistai;5;10;15;0;1;1
89;15.03.2011;2011;03;06;Tiistai;11;55;66;6;10;16
89;15.03.2011;2011;03;07;Tiistai;43;114;157;7;35;42
89;15.03.2011;2011;03;08;Tiistai;97;96;193;0;0;0
89;15.03.2011;2011;03;09;Tiistai;51;48;99;0;0;0
89;15.03.2011;2011;03;10;Tiistai;66;7;73;43;3;46
89;15.03.2011;2011;03;11;Tiistai;75;6;81;53;6;59
89;15.03.2011;2011;03;12;Tiistai;87;6;93;66;20;86
89;15.03.2011;2011;03;13;Tiistai;53;46;99;45;32;77
89;15.03.2011;2011;03;14;Tiistai;91;70;161;39;30;69
89;15.03.2011;2011;03;15;Tiistai;107;77;184;45;42;87
89;15.03.2011;2011;03;16;Tiistai;144;72;216;61;30;91
89;15.03.2011;2011;03;17;Tiistai;62;59;121;42;34;76
89;15.03.2011;2011;03;18;Tiistai;82;34;116;36;31;67
89;15.03.2011;2011;03;19;Tiistai;42;23;65;24;16;40
89;15.03.2011;2011;03;20;Tiistai;46;26;72;23;12;35
89;15.03.2011;2011;03;21;Tiistai;46;12;58;14;10;24
89;15.03.2011;2011;03;22;Tiistai;17;4;21;5;3;8
89;15.03.2011;2011;03;23;Tiistai;6;1;7;3;1;4
89;16.03.2011;2011;03;00;Keskiviikko;2;2;4;0;1;1
89;16.03.2011;2011;03;01;Keskiviikko;1;0;1;1;0;1
89;16.03.2011;2011;03;02;Keskiviikko;2;1;3;1;0;1
89;16.03.2011;2011;03;03;Keskiviikko;0;2;2;0;0;0
89;16.03.2011;2011;03;04;Keskiviikko;2;4;6;1;1;2
89;16.03.2011;2011;03;05;Keskiviikko;3;6;9;0;3;3
89;16.03.2011;2011;03;06;Keskiviikko;8;44;52;15;28;43
89;16.03.2011;2011;03;07;Keskiviikko;33;150;183;6;50;56
89;16.03.2011;2011;03;08;Keskiviikko;37;172;209;17;46;63
89;16.03.2011;2011;03;09;Keskiviikko;28;77;105;8;39;47
89;16.03.2011;2011;03;10;Keskiviikko;34;50;84;33;49;82
89;16.03.2011;2011;03;11;Keskiviikko;47;53;100;37;45;82
89;16.03.2011;2011;03;12;Keskiviikko;31;59;90;34;40;74
89;16.03.2011;2011;03;13;Keskiviikko;60;53;113;53;44;97
89;16.03.2011;2011;03;14;Keskiviikko;77;58;135;64;45;109
89;16.03.2011;2011;03;15;Keskiviikko;115;59;174;65;54;119
89;16.03.2011;2011;03;16;Keskiviikko;147;82;229;63;48;111
89;16.03.2011;2011;03;17;Keskiviikko;77;71;148;53;33;86
89;16.03.2011;2011;03;18;Keskiviikko;81;35;116;39;30;69
89;16.03.2011;2011;03;19;Keskiviikko;60;28;88;35;16;51
89;16.03.2011;2011;03;20;Keskiviikko;56;23;79;22;20;42
89;16.03.2011;2011;03;21;Keskiviikko;32;13;45;10;9;19
89;16.03.2011;2011;03;22;Keskiviikko;13;8;21;5;4;9
89;16.03.2011;2011;03;23;Keskiviikko;8;4;12;3;3;6
89;17.03.2011;2011;03;00;Torstai;8;4;12;0;1;1
89;17.03.2011;2011;03;01;Torstai;4;0;4;1;1;2
89;17.03.2011;2011;03;02;Torstai;0;0;0;0;0;0
89;17.03.2011;2011;03;03;Torstai;3;3;6;2;1;3
89;17.03.2011;2011;03;04;Torstai;2;7;9;2;2;4
89;17.03.2011;2011;03;05;Torstai;6;10;16;1;2;3
89;17.03.2011;2011;03;06;Torstai;12;50;62;10;8;18
89;17.03.2011;2011;03;07;Torstai;27;138;165;10;46;56
89;17.03.2011;2011;03;08;Torstai;43;125;168;23;43;66
89;17.03.2011;2011;03;09;Torstai;41;81;122;23;49;72
89;17.03.2011;2011;03;10;Torstai;29;59;88;20;46;66
89;17.03.2011;2011;03;11;Torstai;40;58;98;36;43;79
89;17.03.2011;2011;03;12;Torstai;51;63;114;52;42;94
89;17.03.2011;2011;03;13;Torstai;57;58;115;44;37;81
89;17.03.2011;2011;03;14;Torstai;74;61;135;38;27;65
89;17.03.2011;2011;03;15;Torstai;143;59;202;48;32;80
89;17.03.2011;2011;03;16;Torstai;145;69;214;57;43;100
89;17.03.2011;2011;03;17;Torstai;92;75;167;42;32;74
89;17.03.2011;2011;03;18;Torstai;61;50;111;30;32;62
89;17.03.2011;2011;03;19;Torstai;51;17;68;29;22;51
89;17.03.2011;2011;03;20;Torstai;55;25;80;23;13;36
89;17.03.2011;2011;03;21;Torstai;28;25;53;13;8;21
89;17.03.2011;2011;03;22;Torstai;14;17;31;3;6;9
89;17.03.2011;2011;03;23;Torstai;12;4;16;3;3;6
89;18.03.2011;2011;03;00;Perjantai;5;3;8;2;4;6
89;18.03.2011;2011;03;01;Perjantai;5;1;6;1;0;1
89;18.03.2011;2011;03;02;Perjantai;8;4;12;2;0;2
89;18.03.2011;2011;03;03;Perjantai;7;0;7;2;0;2
89;18.03.2011;2011;03;04;Perjantai;2;5;7;4;2;6
89;18.03.2011;2011;03;05;Perjantai;4;5;9;1;2;3
89;18.03.2011;2011;03;06;Perjantai;8;46;54;9;8;17
89;18.03.2011;2011;03;07;Perjantai;35;143;178;18;61;79
89;18.03.2011;2011;03;08;Perjantai;55;122;177;19;47;66
89;18.03.2011;2011;03;09;Perjantai;36;96;132;20;29;49
89;18.03.2011;2011;03;10;Perjantai;40;49;89;26;58;84
89;18.03.2011;2011;03;11;Perjantai;35;53;88;41;40;81
89;18.03.2011;2011;03;12;Perjantai;44;65;109;49;59;108
89;18.03.2011;2011;03;13;Perjantai;90;72;162;48;30;78
89;18.03.2011;2011;03;14;Perjantai;91;67;158;45;33;78
89;18.03.2011;2011;03;15;Perjantai;116;54;170;33;18;51
89;18.03.2011;2011;03;16;Perjantai;101;62;163;45;26;71
89;18.03.2011;2011;03;17;Perjantai;70;61;131;31;25;56
89;18.03.2011;2011;03;18;Perjantai;43;49;92;25;25;50
89;18.03.2011;2011;03;19;Perjantai;51;21;72;18;26;44
89;18.03.2011;2011;03;20;Perjantai;33;24;57;17;14;31
89;18.03.2011;2011;03;21;Perjantai;30;24;54;6;9;15
89;18.03.2011;2011;03;22;Perjantai;18;22;40;5;3;8
89;18.03.2011;2011;03;23;Perjantai;18;13;31;0;3;3
89;19.03.2011;2011;03;00;Lauantai;14;6;20;5;0;5
89;19.03.2011;2011;03;01;Lauantai;14;5;19;2;1;3
89;19.03.2011;2011;03;02;Lauantai;12;2;14;2;2;4
89;19.03.2011;2011;03;03;Lauantai;14;3;17;4;2;6
89;19.03.2011;2011;03;04;Lauantai;9;3;12;4;0;4
89;19.03.2011;2011;03;05;Lauantai;4;4;8;3;2;5
89;19.03.2011;2011;03;06;Lauantai;3;10;13;3;3;6
89;19.03.2011;2011;03;07;Lauantai;5;17;22;7;5;12
89;19.03.2011;2011;03;08;Lauantai;14;33;47;13;17;30
89;19.03.2011;2011;03;09;Lauantai;15;52;67;28;22;50
89;19.03.2011;2011;03;10;Lauantai;20;55;75;14;34;48
89;19.03.2011;2011;03;11;Lauantai;39;38;77;31;39;70
89;19.03.2011;2011;03;12;Lauantai;23;54;77;20;31;51
89;19.03.2011;2011;03;13;Lauantai;31;42;73;25;27;52
89;19.03.2011;2011;03;14;Lauantai;42;28;70;26;22;48
89;19.03.2011;2011;03;15;Lauantai;41;17;58;34;22;56
89;19.03.2011;2011;03;16;Lauantai;35;28;63;20;22;42
89;19.03.2011;2011;03;17;Lauantai;29;20;49;22;22;44
89;19.03.2011;2011;03;18;Lauantai;36;26;62;31;20;51
89;19.03.2011;2011;03;19;Lauantai;14;12;26;15;21;36
89;19.03.2011;2011;03;20;Lauantai;15;14;29;6;6;12
89;19.03.2011;2011;03;21;Lauantai;12;20;32;5;7;12
89;19.03.2011;2011;03;22;Lauantai;15;20;35;7;4;11
89;19.03.2011;2011;03;23;Lauantai;8;11;19;6;8;14
89;20.03.2011;2011;03;00;Sunnuntai;21;7;28;6;0;6
89;20.03.2011;2011;03;01;Sunnuntai;19;3;22;7;1;8
89;20.03.2011;2011;03;02;Sunnuntai;14;2;16;9;0;9
89;20.03.2011;2011;03;03;Sunnuntai;16;1;17;7;2;9
89;20.03.2011;2011;03;04;Sunnuntai;12;5;17;4;4;8
89;20.03.2011;2011;03;05;Sunnuntai;1;2;3;1;1;2
89;20.03.2011;2011;03;06;Sunnuntai;7;10;17;2;1;3
89;20.03.2011;2011;03;07;Sunnuntai;4;1;5;2;5;7
89;20.03.2011;2011;03;08;Sunnuntai;9;12;21;11;9;20
89;20.03.2011;2011;03;09;Sunnuntai;7;18;25;30;27;57
89;20.03.2011;2011;03;10;Sunnuntai;7;21;28;34;40;74
89;20.03.2011;2011;03;11;Sunnuntai;16;37;53;52;73;125
89;20.03.2011;2011;03;12;Sunnuntai;22;45;67;65;84;149
89;20.03.2011;2011;03;13;Sunnuntai;40;53;93;76;97;173
89;20.03.2011;2011;03;14;Sunnuntai;65;46;111;75;87;162
89;20.03.2011;2011;03;15;Sunnuntai;37;41;78;73;53;126
89;20.03.2011;2011;03;16;Sunnuntai;64;33;97;58;55;113
89;20.03.2011;2011;03;17;Sunnuntai;44;32;76;47;45;92
89;20.03.2011;2011;03;18;Sunnuntai;39;17;56;40;37;77
89;20.03.2011;2011;03;19;Sunnuntai;28;22;50;21;20;41
89;20.03.2011;2011;03;20;Sunnuntai;21;30;51;11;12;23
89;20.03.2011;2011;03;21;Sunnuntai;19;5;24;10;7;17
89;20.03.2011;2011;03;22;Sunnuntai;19;5;24;3;2;5
89;20.03.2011;2011;03;23;Sunnuntai;4;0;4;2;2;4
89;21.03.2011;2011;03;00;Maanantai;2;2;4;1;1;2
89;21.03.2011;2011;03;01;Maanantai;2;0;2;0;0;0
89;21.03.2011;2011;03;02;Maanantai;1;1;2;0;0;0
89;21.03.2011;2011;03;03;Maanantai;0;0;0;2;0;2
89;21.03.2011;2011;03;04;Maanantai;1;6;7;0;1;1
89;21.03.2011;2011;03;05;Maanantai;5;11;16;1;2;3
89;21.03.2011;2011;03;06;Maanantai;15;39;54;8;8;16
89;21.03.2011;2011;03;07;Maanantai;24;152;176;5;32;37
89;21.03.2011;2011;03;08;Maanantai;43;128;171;11;65;76
89;21.03.2011;2011;03;09;Maanantai;31;78;109;10;50;60
89;21.03.2011;2011;03;10;Maanantai;29;63;92;24;30;54
89;21.03.2011;2011;03;11;Maanantai;48;48;96;26;43;69
89;21.03.2011;2011;03;12;Maanantai;37;56;93;39;58;97
89;21.03.2011;2011;03;13;Maanantai;65;60;125;42;43;85
89;21.03.2011;2011;03;14;Maanantai;111;73;184;56;46;102
89;21.03.2011;2011;03;15;Maanantai;131;59;190;77;37;114
89;21.03.2011;2011;03;16;Maanantai;142;63;205;61;42;103
89;21.03.2011;2011;03;17;Maanantai;85;49;134;38;38;76
89;21.03.2011;2011;03;18;Maanantai;76;41;117;41;33;74
89;21.03.2011;2011;03;19;Maanantai;54;35;89;25;13;38
89;21.03.2011;2011;03;20;Maanantai;48;15;63;19;16;35
89;21.03.2011;2011;03;21;Maanantai;20;7;27;6;9;15
89;21.03.2011;2011;03;22;Maanantai;12;3;15;2;2;4
89;21.03.2011;2011;03;23;Maanantai;10;8;18;0;2;2
89;22.03.2011;2011;03;00;Tiistai;1;1;2;0;0;0
89;22.03.2011;2011;03;01;Tiistai;1;1;2;0;0;0
89;22.03.2011;2011;03;02;Tiistai;0;3;3;2;1;3
89;22.03.2011;2011;03;03;Tiistai;1;2;3;1;0;1
89;22.03.2011;2011;03;04;Tiistai;4;8;12;1;2;3
89;22.03.2011;2011;03;05;Tiistai;10;7;17;2;4;6
89;22.03.2011;2011;03;06;Tiistai;15;48;63;16;24;40
89;22.03.2011;2011;03;07;Tiistai;29;152;181;15;48;63
89;22.03.2011;2011;03;08;Tiistai;39;163;202;23;55;78
89;22.03.2011;2011;03;09;Tiistai;45;85;130;17;59;76
89;22.03.2011;2011;03;10;Tiistai;30;53;83;21;26;47
89;22.03.2011;2011;03;11;Tiistai;42;44;86;27;51;78
89;22.03.2011;2011;03;12;Tiistai;47;34;81;45;29;74
89;22.03.2011;2011;03;13;Tiistai;47;39;86;35;40;75
89;22.03.2011;2011;03;14;Tiistai;79;60;139;41;26;67
89;22.03.2011;2011;03;15;Tiistai;119;65;184;83;65;148
89;22.03.2011;2011;03;16;Tiistai;128;58;186;43;22;65
89;22.03.2011;2011;03;17;Tiistai;78;54;132;42;38;80
89;22.03.2011;2011;03;18;Tiistai;70;40;110;52;29;81
89;22.03.2011;2011;03;19;Tiistai;57;33;90;27;21;48
89;22.03.2011;2011;03;20;Tiistai;36;17;53;20;20;40
89;22.03.2011;2011;03;21;Tiistai;25;18;43;10;12;22
89;22.03.2011;2011;03;22;Tiistai;15;9;24;7;3;10
89;22.03.2011;2011;03;23;Tiistai;5;1;6;0;1;1
89;23.03.2011;2011;03;00;Keskiviikko;3;0;3;0;3;3
89;23.03.2011;2011;03;01;Keskiviikko;4;2;6;3;1;4
89;23.03.2011;2011;03;02;Keskiviikko;1;1;2;2;0;2
89;23.03.2011;2011;03;03;Keskiviikko;1;4;5;0;0;0
89;23.03.2011;2011;03;04;Keskiviikko;6;7;13;1;1;2
89;23.03.2011;2011;03;05;Keskiviikko;24;18;42;0;2;2
89;23.03.2011;2011;03;06;Keskiviikko;18;43;61;5;21;26
89;23.03.2011;2011;03;07;Keskiviikko;22;130;152;7;40;47
89;23.03.2011;2011;03;08;Keskiviikko;45;130;175;22;59;81
89;23.03.2011;2011;03;09;Keskiviikko;34;62;96;12;29;41
89;23.03.2011;2011;03;10;Keskiviikko;37;54;91;25;35;60
89;23.03.2011;2011;03;11;Keskiviikko;35;50;85;35;53;88
89;23.03.2011;2011;03;12;Keskiviikko;66;62;128;41;49;90
89;23.03.2011;2011;03;13;Keskiviikko;52;59;111;33;32;65
89;23.03.2011;2011;03;14;Keskiviikko;60;59;119;54;27;81
89;23.03.2011;2011;03;15;Keskiviikko;115;67;182;32;30;62
89;23.03.2011;2011;03;16;Keskiviikko;132;61;193;43;26;69
89;23.03.2011;2011;03;17;Keskiviikko;75;44;119;39;32;71
89;23.03.2011;2011;03;18;Keskiviikko;73;37;110;34;40;74
89;23.03.2011;2011;03;19;Keskiviikko;55;21;76;26;20;46
89;23.03.2011;2011;03;20;Keskiviikko;50;34;84;16;19;35
89;23.03.2011;2011;03;21;Keskiviikko;23;27;50;10;8;18
89;23.03.2011;2011;03;22;Keskiviikko;11;5;16;8;4;12
89;23.03.2011;2011;03;23;Keskiviikko;5;5;10;1;1;2
89;24.03.2011;2011;03;00;Torstai;9;0;9;3;0;3
89;24.03.2011;2011;03;01;Torstai;3;0;3;4;0;4
89;24.03.2011;2011;03;02;Torstai;1;0;1;3;1;4
89;24.03.2011;2011;03;03;Torstai;1;1;2;1;0;1
89;24.03.2011;2011;03;04;Torstai;4;4;8;1;4;5
89;24.03.2011;2011;03;05;Torstai;1;4;5;0;1;1
89;24.03.2011;2011;03;06;Torstai;17;42;59;8;8;16
89;24.03.2011;2011;03;07;Torstai;23;116;139;8;46;54
89;24.03.2011;2011;03;08;Torstai;39;131;170;17;53;70
89;24.03.2011;2011;03;09;Torstai;34;78;112;14;54;68
89;24.03.2011;2011;03;10;Torstai;28;41;69;17;40;57
89;24.03.2011;2011;03;11;Torstai;39;47;86;41;30;71
89;24.03.2011;2011;03;12;Torstai;42;54;96;27;34;61
89;24.03.2011;2011;03;13;Torstai;47;59;106;27;30;57
89;24.03.2011;2011;03;14;Torstai;84;63;147;29;29;58
89;24.03.2011;2011;03;15;Torstai;106;45;151;57;28;85
89;24.03.2011;2011;03;16;Torstai;135;51;186;55;30;85
89;24.03.2011;2011;03;17;Torstai;79;58;137;28;36;64
89;24.03.2011;2011;03;18;Torstai;51;44;95;27;28;55
89;24.03.2011;2011;03;19;Torstai;45;23;68;34;22;56
89;24.03.2011;2011;03;20;Torstai;46;25;71;15;16;31
89;24.03.2011;2011;03;21;Torstai;14;19;33;10;9;19
89;24.03.2011;2011;03;22;Torstai;17;3;20;6;6;12
89;24.03.2011;2011;03;23;Torstai;10;2;12;12;10;22
89;25.03.2011;2011;03;00;Perjantai;3;2;5;2;0;2
89;25.03.2011;2011;03;01;Perjantai;6;1;7;1;0;1
89;25.03.2011;2011;03;02;Perjantai;3;0;3;3;1;4
89;25.03.2011;2011;03;03;Perjantai;6;2;8;1;0;1
89;25.03.2011;2011;03;04;Perjantai;1;3;4;0;1;1
89;25.03.2011;2011;03;05;Perjantai;5;3;8;2;1;3
89;25.03.2011;2011;03;06;Perjantai;18;47;65;6;10;16
89;25.03.2011;2011;03;07;Perjantai;25;138;163;7;38;45
89;25.03.2011;2011;03;08;Perjantai;41;119;160;13;46;59
89;25.03.2011;2011;03;09;Perjantai;29;82;111;17;71;88
89;25.03.2011;2011;03;10;Perjantai;28;51;79;36;36;72
89;25.03.2011;2011;03;11;Perjantai;43;46;89;36;63;99
89;25.03.2011;2011;03;12;Perjantai;43;46;89;52;38;90
89;25.03.2011;2011;03;13;Perjantai;65;65;130;47;34;81
89;25.03.2011;2011;03;14;Perjantai;78;47;125;36;27;63
89;25.03.2011;2011;03;15;Perjantai;129;53;182;46;27;73
89;25.03.2011;2011;03;16;Perjantai;92;53;145;49;30;79
89;25.03.2011;2011;03;17;Perjantai;59;34;93;36;30;66
89;25.03.2011;2011;03;18;Perjantai;46;41;87;27;29;56
89;25.03.2011;2011;03;19;Perjantai;33;18;51;20;16;36
89;25.03.2011;2011;03;20;Perjantai;32;22;54;19;12;31
89;25.03.2011;2011;03;21;Perjantai;25;14;39;2;9;11
89;25.03.2011;2011;03;22;Perjantai;14;20;34;4;9;13
89;25.03.2011;2011;03;23;Perjantai;11;11;22;4;6;10
89;26.03.2011;2011;03;00;Lauantai;5;4;9;5;9;14
89;26.03.2011;2011;03;01;Lauantai;12;7;19;3;1;4
89;26.03.2011;2011;03;02;Lauantai;16;3;19;8;0;8
89;26.03.2011;2011;03;03;Lauantai;11;3;14;8;3;11
89;26.03.2011;2011;03;04;Lauantai;6;2;8;7;1;8
89;26.03.2011;2011;03;05;Lauantai;3;3;6;1;3;4
89;26.03.2011;2011;03;06;Lauantai;1;9;10;2;7;9
89;26.03.2011;2011;03;07;Lauantai;5;12;17;5;9;14
89;26.03.2011;2011;03;08;Lauantai;8;18;26;11;24;35
89;26.03.2011;2011;03;09;Lauantai;12;38;50;14;39;53
89;26.03.2011;2011;03;10;Lauantai;12;52;64;18;34;52
89;26.03.2011;2011;03;11;Lauantai;36;42;78;26;38;64
89;26.03.2011;2011;03;12;Lauantai;39;46;85;47;65;112
89;26.03.2011;2011;03;13;Lauantai;37;40;77;50;68;118
89;26.03.2011;2011;03;14;Lauantai;50;36;86;58;53;111
89;26.03.2011;2011;03;15;Lauantai;44;36;80;57;37;94
89;26.03.2011;2011;03;16;Lauantai;36;35;71;48;35;83
89;26.03.2011;2011;03;17;Lauantai;51;30;81;29;25;54
89;26.03.2011;2011;03;18;Lauantai;34;18;52;25;28;53
89;26.03.2011;2011;03;19;Lauantai;20;23;43;17;16;33
89;26.03.2011;2011;03;20;Lauantai;22;13;35;7;8;15
89;26.03.2011;2011;03;21;Lauantai;9;14;23;5;10;15
89;26.03.2011;2011;03;22;Lauantai;6;14;20;3;8;11
89;26.03.2011;2011;03;23;Lauantai;10;8;18;5;6;11
89;27.03.2011;2011;03;00;Sunnuntai;3;5;8;2;7;9
89;27.03.2011;2011;03;01;Sunnuntai;13;4;17;7;5;12
89;27.03.2011;2011;03;02;Sunnuntai;0;0;0;0;0;0
89;27.03.2011;2011;03;03;Sunnuntai;17;11;28;12;0;12
89;27.03.2011;2011;03;04;Sunnuntai;4;6;10;1;0;1
89;27.03.2011;2011;03;05;Sunnuntai;6;8;14;1;1;2
89;27.03.2011;2011;03;06;Sunnuntai;2;6;8;2;1;3
89;27.03.2011;2011;03;07;Sunnuntai;2;6;8;2;1;3
89;27.03.2011;2011;03;08;Sunnuntai;4;6;10;11;9;20
89;27.03.2011;2011;03;09;Sunnuntai;7;14;21;17;20;37
89;27.03.2011;2011;03;10;Sunnuntai;18;40;58;17;19;36
89;27.03.2011;2011;03;11;Sunnuntai;17;30;47;32;43;75
89;27.03.2011;2011;03;12;Sunnuntai;19;23;42;52;59;111
89;27.03.2011;2011;03;13;Sunnuntai;35;34;69;60;60;120
89;27.03.2011;2011;03;14;Sunnuntai;26;30;56;59;51;110
89;27.03.2011;2011;03;15;Sunnuntai;42;27;69;43;49;92
89;27.03.2011;2011;03;16;Sunnuntai;33;40;73;41;69;110
89;27.03.2011;2011;03;17;Sunnuntai;36;37;73;39;30;69
89;27.03.2011;2011;03;18;Sunnuntai;37;18;55;37;31;68
89;27.03.2011;2011;03;19;Sunnuntai;28;17;45;20;31;51
89;27.03.2011;2011;03;20;Sunnuntai;26;18;44;21;13;34
89;27.03.2011;2011;03;21;Sunnuntai;16;12;28;11;12;23
89;27.03.2011;2011;03;22;Sunnuntai;16;9;25;6;8;14
89;27.03.2011;2011;03;23;Sunnuntai;4;2;6;3;1;4
89;28.03.2011;2011;03;00;Maanantai;3;1;4;2;1;3
89;28.03.2011;2011;03;01;Maanantai;2;1;3;3;2;5
89;28.03.2011;2011;03;02;Maanantai;2;1;3;1;1;2
89;28.03.2011;2011;03;03;Maanantai;0;0;0;4;1;5
89;28.03.2011;2011;03;04;Maanantai;2;4;6;0;2;2
89;28.03.2011;2011;03;05;Maanantai;1;5;6;3;4;7
89;28.03.2011;2011;03;06;Maanantai;10;40;50;4;8;12
89;28.03.2011;2011;03;07;Maanantai;28;147;175;5;65;70
89;28.03.2011;2011;03;08;Maanantai;40;136;176;15;44;59
89;28.03.2011;2011;03;09;Maanantai;36;74;110;10;36;46
89;28.03.2011;2011;03;10;Maanantai;30;46;76;24;38;62
89;28.03.2011;2011;03;11;Maanantai;49;36;85;39;44;83
89;28.03.2011;2011;03;12;Maanantai;37;61;98;31;47;78
89;28.03.2011;2011;03;13;Maanantai;57;72;129;33;33;66
89;28.03.2011;2011;03;14;Maanantai;90;53;143;50;38;88
89;28.03.2011;2011;03;15;Maanantai;136;81;217;45;33;78
89;28.03.2011;2011;03;16;Maanantai;152;78;230;57;42;99
89;28.03.2011;2011;03;17;Maanantai;66;56;122;45;44;89
89;28.03.2011;2011;03;18;Maanantai;81;58;139;37;35;72
89;28.03.2011;2011;03;19;Maanantai;47;34;81;47;28;75
89;28.03.2011;2011;03;20;Maanantai;44;29;73;33;22;55
89;28.03.2011;2011;03;21;Maanantai;26;15;41;16;12;28
89;28.03.2011;2011;03;22;Maanantai;7;1;8;2;2;4
89;28.03.2011;2011;03;23;Maanantai;3;1;4;3;5;8
89;29.03.2011;2011;03;00;Tiistai;11;10;21;0;0;0
89;29.03.2011;2011;03;01;Tiistai;7;5;12;1;1;2
89;29.03.2011;2011;03;02;Tiistai;0;0;0;0;0;0
89;29.03.2011;2011;03;03;Tiistai;1;0;1;1;1;2
89;29.03.2011;2011;03;04;Tiistai;1;6;7;0;2;2
89;29.03.2011;2011;03;05;Tiistai;3;9;12;1;1;2
89;29.03.2011;2011;03;06;Tiistai;12;41;53;6;11;17
89;29.03.2011;2011;03;07;Tiistai;27;139;166;6;45;51
89;29.03.2011;2011;03;08;Tiistai;40;131;171;11;42;53
89;29.03.2011;2011;03;09;Tiistai;39;55;94;24;37;61
89;29.03.2011;2011;03;10;Tiistai;22;42;64;18;32;50
89;29.03.2011;2011;03;11;Tiistai;34;64;98;27;52;79
89;29.03.2011;2011;03;12;Tiistai;38;58;96;48;62;110
89;29.03.2011;2011;03;13;Tiistai;55;58;113;46;38;84
89;29.03.2011;2011;03;14;Tiistai;85;60;145;45;23;68
89;29.03.2011;2011;03;15;Tiistai;119;77;196;63;33;96
89;29.03.2011;2011;03;16;Tiistai;159;62;221;60;29;89
89;29.03.2011;2011;03;17;Tiistai;82;65;147;40;32;72
89;29.03.2011;2011;03;18;Tiistai;54;56;110;48;43;91
89;29.03.2011;2011;03;19;Tiistai;75;33;108;48;48;96
89;29.03.2011;2011;03;20;Tiistai;34;24;58;31;28;59
89;29.03.2011;2011;03;21;Tiistai;34;14;48;6;11;17
89;29.03.2011;2011;03;22;Tiistai;19;15;34;6;6;12
89;29.03.2011;2011;03;23;Tiistai;12;6;18;3;1;4
89;30.03.2011;2011;03;00;Keskiviikko;5;1;6;2;1;3
89;30.03.2011;2011;03;01;Keskiviikko;3;1;4;0;2;2
89;30.03.2011;2011;03;02;Keskiviikko;2;1;3;0;0;0
89;30.03.2011;2011;03;03;Keskiviikko;1;1;2;0;0;0
89;30.03.2011;2011;03;04;Keskiviikko;2;5;7;0;1;1
89;30.03.2011;2011;03;05;Keskiviikko;5;8;13;0;1;1
89;30.03.2011;2011;03;06;Keskiviikko;17;42;59;3;12;15
89;30.03.2011;2011;03;07;Keskiviikko;31;128;159;3;42;45
89;30.03.2011;2011;03;08;Keskiviikko;42;127;169;18;60;78
89;30.03.2011;2011;03;09;Keskiviikko;28;54;82;12;35;47
89;30.03.2011;2011;03;10;Keskiviikko;20;51;71;19;31;50
89;30.03.2011;2011;03;11;Keskiviikko;37;46;83;48;36;84
89;30.03.2011;2011;03;12;Keskiviikko;38;64;102;31;44;75
89;30.03.2011;2011;03;13;Keskiviikko;55;63;118;37;54;91
89;30.03.2011;2011;03;14;Keskiviikko;96;66;162;46;27;73
89;30.03.2011;2011;03;15;Keskiviikko;117;73;190;40;33;73
89;30.03.2011;2011;03;16;Keskiviikko;148;96;244;49;25;74
89;30.03.2011;2011;03;17;Keskiviikko;78;71;149;46;33;79
89;30.03.2011;2011;03;18;Keskiviikko;76;40;116;39;27;66
89;30.03.2011;2011;03;19;Keskiviikko;53;30;83;43;32;75
89;30.03.2011;2011;03;20;Keskiviikko;51;23;74;26;25;51
89;30.03.2011;2011;03;21;Keskiviikko;65;26;91;11;6;17
89;30.03.2011;2011;03;22;Keskiviikko;19;8;27;0;5;5
89;30.03.2011;2011;03;23;Keskiviikko;8;3;11;1;1;2
89;31.03.2011;2011;03;00;Torstai;4;1;5;3;5;8
89;31.03.2011;2011;03;01;Torstai;4;2;6;2;0;2
89;31.03.2011;2011;03;02;Torstai;4;0;4;2;4;6
89;31.03.2011;2011;03;03;Torstai;4;1;5;0;0;0
89;31.03.2011;2011;03;04;Torstai;3;6;9;3;1;4
89;31.03.2011;2011;03;05;Torstai;5;10;15;0;2;2
89;31.03.2011;2011;03;06;Torstai;15;45;60;5;11;16
89;31.03.2011;2011;03;07;Torstai;19;118;137;3;45;48
89;31.03.2011;2011;03;08;Torstai;47;146;193;15;58;73
89;31.03.2011;2011;03;09;Torstai;49;72;121;11;28;39
89;31.03.2011;2011;03;10;Torstai;34;39;73;23;23;46
89;31.03.2011;2011;03;11;Torstai;36;62;98;31;40;71
89;31.03.2011;2011;03;12;Torstai;42;48;90;33;47;80
89;31.03.2011;2011;03;13;Torstai;85;48;133;45;38;83
89;31.03.2011;2011;03;14;Torstai;92;52;144;44;36;80
89;31.03.2011;2011;03;15;Torstai;108;61;169;46;32;78
89;31.03.2011;2011;03;16;Torstai;130;67;197;53;35;88
89;31.03.2011;2011;03;17;Torstai;91;75;166;44;38;82
89;31.03.2011;2011;03;18;Torstai;51;35;86;57;38;95
89;31.03.2011;2011;03;19;Torstai;57;37;94;27;31;58
89;31.03.2011;2011;03;20;Torstai;41;27;68;28;18;46
89;31.03.2011;2011;03;21;Torstai;31;15;46;13;7;20
89;31.03.2011;2011;03;22;Torstai;34;22;56;1;4;5
89;31.03.2011;2011;03;23;Torstai;8;5;13;2;1;3
89;01.04.2011;2011;04;00;Perjantai;3;2;5;0;1;1
89;01.04.2011;2011;04;01;Perjantai;5;0;5;3;2;5
89;01.04.2011;2011;04;02;Perjantai;2;2;4;4;0;4
89;01.04.2011;2011;04;03;Perjantai;2;1;3;2;0;2
89;01.04.2011;2011;04;04;Perjantai;4;5;9;1;3;4
89;01.04.2011;2011;04;05;Perjantai;4;6;10;0;4;4
89;01.04.2011;2011;04;06;Perjantai;16;49;65;4;7;11
89;01.04.2011;2011;04;07;Perjantai;21;113;134;6;56;62
89;01.04.2011;2011;04;08;Perjantai;43;127;170;13;44;57
89;01.04.2011;2011;04;09;Perjantai;33;69;102;18;34;52
89;01.04.2011;2011;04;10;Perjantai;44;70;114;25;60;85
89;01.04.2011;2011;04;11;Perjantai;43;58;101;15;37;52
89;01.04.2011;2011;04;12;Perjantai;56;53;109;42;29;71
89;01.04.2011;2011;04;13;Perjantai;75;53;128;43;40;83
89;01.04.2011;2011;04;14;Perjantai;98;63;161;48;24;72
89;01.04.2011;2011;04;15;Perjantai;118;57;175;46;20;66
89;01.04.2011;2011;04;16;Perjantai;106;67;173;36;32;68
89;01.04.2011;2011;04;17;Perjantai;70;48;118;25;25;50
89;01.04.2011;2011;04;18;Perjantai;43;43;86;29;28;57
89;01.04.2011;2011;04;19;Perjantai;43;29;72;21;16;37
89;01.04.2011;2011;04;20;Perjantai;41;31;72;23;17;40
89;01.04.2011;2011;04;21;Perjantai;27;6;33;8;9;17
89;01.04.2011;2011;04;22;Perjantai;18;22;40;5;4;9
89;01.04.2011;2011;04;23;Perjantai;12;23;35;3;4;7
89;02.04.2011;2011;04;00;Lauantai;18;4;22;4;7;11
89;02.04.2011;2011;04;01;Lauantai;9;3;12;6;2;8
89;02.04.2011;2011;04;02;Lauantai;10;2;12;6;0;6
89;02.04.2011;2011;04;03;Lauantai;12;3;15;6;0;6
89;02.04.2011;2011;04;04;Lauantai;9;3;12;7;2;9
89;02.04.2011;2011;04;05;Lauantai;4;3;7;0;1;1
89;02.04.2011;2011;04;06;Lauantai;0;13;13;3;2;5
89;02.04.2011;2011;04;07;Lauantai;7;10;17;4;7;11
89;02.04.2011;2011;04;08;Lauantai;9;14;23;14;16;30
89;02.04.2011;2011;04;09;Lauantai;12;34;46;29;18;47
89;02.04.2011;2011;04;10;Lauantai;14;50;64;23;28;51
89;02.04.2011;2011;04;11;Lauantai;25;61;86;18;48;66
89;02.04.2011;2011;04;12;Lauantai;38;48;86;27;40;67
89;02.04.2011;2011;04;13;Lauantai;35;48;83;39;53;92
89;02.04.2011;2011;04;14;Lauantai;56;54;110;25;33;58
89;02.04.2011;2011;04;15;Lauantai;67;24;91;31;28;59
89;02.04.2011;2011;04;16;Lauantai;51;11;62;20;11;31
89;02.04.2011;2011;04;17;Lauantai;28;22;50;21;15;36
89;02.04.2011;2011;04;18;Lauantai;31;32;63;21;24;45
89;02.04.2011;2011;04;19;Lauantai;17;20;37;13;27;40
89;02.04.2011;2011;04;20;Lauantai;22;17;39;14;11;25
89;02.04.2011;2011;04;21;Lauantai;9;21;30;5;6;11
89;02.04.2011;2011;04;22;Lauantai;14;15;29;7;7;14
89;02.04.2011;2011;04;23;Lauantai;10;15;25;2;8;10
89;03.04.2011;2011;04;00;Sunnuntai;11;13;24;5;2;7
89;03.04.2011;2011;04;01;Sunnuntai;11;7;18;3;2;5
89;03.04.2011;2011;04;02;Sunnuntai;10;4;14;5;2;7
89;03.04.2011;2011;04;03;Sunnuntai;15;3;18;11;1;12
89;03.04.2011;2011;04;04;Sunnuntai;16;2;18;7;1;8
89;03.04.2011;2011;04;05;Sunnuntai;2;3;5;2;1;3
89;03.04.2011;2011;04;06;Sunnuntai;1;4;5;1;3;4
89;03.04.2011;2011;04;07;Sunnuntai;3;7;10;3;5;8
89;03.04.2011;2011;04;08;Sunnuntai;6;4;10;5;8;13
89;03.04.2011;2011;04;09;Sunnuntai;7;9;16;8;13;21
89;03.04.2011;2011;04;10;Sunnuntai;9;17;26;19;27;46
89;03.04.2011;2011;04;11;Sunnuntai;19;42;61;43;41;84
89;03.04.2011;2011;04;12;Sunnuntai;33;44;77;39;59;98
89;03.04.2011;2011;04;13;Sunnuntai;28;48;76;35;70;105
89;03.04.2011;2011;04;14;Sunnuntai;50;47;97;42;42;84
89;03.04.2011;2011;04;15;Sunnuntai;49;38;87;49;33;82
89;03.04.2011;2011;04;16;Sunnuntai;57;50;107;35;36;71
89;03.04.2011;2011;04;17;Sunnuntai;65;36;101;45;40;85
89;03.04.2011;2011;04;18;Sunnuntai;42;24;66;37;22;59
89;03.04.2011;2011;04;19;Sunnuntai;43;37;80;29;23;52
89;03.04.2011;2011;04;20;Sunnuntai;23;16;39;18;25;43
89;03.04.2011;2011;04;21;Sunnuntai;14;9;23;15;10;25
89;03.04.2011;2011;04;22;Sunnuntai;8;2;10;2;4;6
89;03.04.2011;2011;04;23;Sunnuntai;3;1;4;5;3;8
89;04.04.2011;2011;04;00;Maanantai;5;3;8;1;1;2
89;04.04.2011;2011;04;01;Maanantai;0;1;1;0;0;0
89;04.04.2011;2011;04;02;Maanantai;0;2;2;0;2;2
89;04.04.2011;2011;04;03;Maanantai;1;2;3;1;0;1
89;04.04.2011;2011;04;04;Maanantai;1;7;8;0;1;1
89;04.04.2011;2011;04;05;Maanantai;4;8;12;0;1;1
89;04.04.2011;2011;04;06;Maanantai;19;41;60;4;11;15
89;04.04.2011;2011;04;07;Maanantai;32;159;191;4;39;43
89;04.04.2011;2011;04;08;Maanantai;56;141;197;18;67;85
89;04.04.2011;2011;04;09;Maanantai;38;110;148;22;32;54
89;04.04.2011;2011;04;10;Maanantai;34;73;107;13;27;40
89;04.04.2011;2011;04;11;Maanantai;46;57;103;28;32;60
89;04.04.2011;2011;04;12;Maanantai;56;86;142;26;34;60
89;04.04.2011;2011;04;13;Maanantai;78;72;150;31;36;67
89;04.04.2011;2011;04;14;Maanantai;100;70;170;43;22;65
89;04.04.2011;2011;04;15;Maanantai;120;77;197;37;45;82
89;04.04.2011;2011;04;16;Maanantai;170;64;234;46;19;65
89;04.04.2011;2011;04;17;Maanantai;96;61;157;35;20;55
89;04.04.2011;2011;04;18;Maanantai;54;45;99;33;33;66
89;04.04.2011;2011;04;19;Maanantai;49;26;75;31;28;59
89;04.04.2011;2011;04;20;Maanantai;51;23;74;23;16;39
89;04.04.2011;2011;04;21;Maanantai;30;13;43;9;19;28
89;04.04.2011;2011;04;22;Maanantai;12;2;14;4;3;7
89;04.04.2011;2011;04;23;Maanantai;3;0;3;1;1;2
89;05.04.2011;2011;04;00;Tiistai;2;0;2;0;0;0
89;05.04.2011;2011;04;01;Tiistai;0;0;0;0;0;0
89;05.04.2011;2011;04;02;Tiistai;0;1;1;0;1;1
89;05.04.2011;2011;04;03;Tiistai;0;0;0;0;0;0
89;05.04.2011;2011;04;04;Tiistai;0;7;7;0;1;1
89;05.04.2011;2011;04;05;Tiistai;3;8;11;1;1;2
89;05.04.2011;2011;04;06;Tiistai;12;50;62;8;4;12
89;05.04.2011;2011;04;07;Tiistai;32;161;193;6;54;60
89;05.04.2011;2011;04;08;Tiistai;45;159;204;21;53;74
89;05.04.2011;2011;04;09;Tiistai;50;94;144;18;56;74
89;05.04.2011;2011;04;10;Tiistai;30;81;111;33;34;67
89;05.04.2011;2011;04;11;Tiistai;56;70;126;36;45;81
89;05.04.2011;2011;04;12;Tiistai;55;64;119;40;45;85
89;05.04.2011;2011;04;13;Tiistai;82;69;151;27;33;60
89;05.04.2011;2011;04;14;Tiistai;130;85;215;53;39;92
89;05.04.2011;2011;04;15;Tiistai;150;93;243;54;35;89
89;05.04.2011;2011;04;16;Tiistai;175;101;276;52;39;91
89;05.04.2011;2011;04;17;Tiistai;83;79;162;69;41;110
89;05.04.2011;2011;04;18;Tiistai;84;68;152;65;45;110
89;05.04.2011;2011;04;19;Tiistai;82;46;128;70;64;134
89;05.04.2011;2011;04;20;Tiistai;72;32;104;31;30;61
89;05.04.2011;2011;04;21;Tiistai;46;16;62;14;15;29
89;05.04.2011;2011;04;22;Tiistai;16;4;20;6;7;13
89;05.04.2011;2011;04;23;Tiistai;8;1;9;2;3;5
89;06.04.2011;2011;04;00;Keskiviikko;5;4;9;2;2;4
89;06.04.2011;2011;04;01;Keskiviikko;2;1;3;0;0;0
89;06.04.2011;2011;04;02;Keskiviikko;2;3;5;0;0;0
89;06.04.2011;2011;04;03;Keskiviikko;0;2;2;1;0;1
89;06.04.2011;2011;04;04;Keskiviikko;1;6;7;1;1;2
89;06.04.2011;2011;04;05;Keskiviikko;8;9;17;0;2;2
89;06.04.2011;2011;04;06;Keskiviikko;21;52;73;4;12;16
89;06.04.2011;2011;04;07;Keskiviikko;31;179;210;9;33;42
89;06.04.2011;2011;04;08;Keskiviikko;48;135;183;6;39;45
89;06.04.2011;2011;04;09;Keskiviikko;27;55;82;7;18;25
89;06.04.2011;2011;04;10;Keskiviikko;24;71;95;8;34;42
89;06.04.2011;2011;04;11;Keskiviikko;44;60;104;13;23;36
89;06.04.2011;2011;04;12;Keskiviikko;32;66;98;17;19;36
89;06.04.2011;2011;04;13;Keskiviikko;64;55;119;17;19;36
89;06.04.2011;2011;04;14;Keskiviikko;92;85;177;21;11;32
89;06.04.2011;2011;04;15;Keskiviikko;110;62;172;33;19;52
89;06.04.2011;2011;04;16;Keskiviikko;150;76;226;33;13;46
89;06.04.2011;2011;04;17;Keskiviikko;89;41;130;30;12;42
89;06.04.2011;2011;04;18;Keskiviikko;66;49;115;23;18;41
89;06.04.2011;2011;04;19;Keskiviikko;65;26;91;25;17;42
89;06.04.2011;2011;04;20;Keskiviikko;53;37;90;17;12;29
89;06.04.2011;2011;04;21;Keskiviikko;36;12;48;5;10;15
89;06.04.2011;2011;04;22;Keskiviikko;12;14;26;1;2;3
89;06.04.2011;2011;04;23;Keskiviikko;2;6;8;1;2;3
89;07.04.2011;2011;04;00;Torstai;3;5;8;0;1;1
89;07.04.2011;2011;04;01;Torstai;4;0;4;0;0;0
89;07.04.2011;2011;04;02;Torstai;5;1;6;2;1;3
89;07.04.2011;2011;04;03;Torstai;1;1;2;2;0;2
89;07.04.2011;2011;04;04;Torstai;2;5;7;1;1;2
89;07.04.2011;2011;04;05;Torstai;3;10;13;0;0;0
89;07.04.2011;2011;04;06;Torstai;18;61;79;2;3;5
89;07.04.2011;2011;04;07;Torstai;34;179;213;5;37;42
89;07.04.2011;2011;04;08;Torstai;41;147;188;17;41;58
89;07.04.2011;2011;04;09;Torstai;49;87;136;19;34;53
89;07.04.2011;2011;04;10;Torstai;33;76;109;19;29;48
89;07.04.2011;2011;04;11;Torstai;60;68;128;26;42;68
89;07.04.2011;2011;04;12;Torstai;62;59;121;20;26;46
89;07.04.2011;2011;04;13;Torstai;81;83;164;27;32;59
89;07.04.2011;2011;04;14;Torstai;91;80;171;32;34;66
89;07.04.2011;2011;04;15;Torstai;125;68;193;43;25;68
89;07.04.2011;2011;04;16;Torstai;158;87;245;46;35;81
89;07.04.2011;2011;04;17;Torstai;108;84;192;42;39;81
89;07.04.2011;2011;04;18;Torstai;97;68;165;51;54;105
89;07.04.2011;2011;04;19;Torstai;83;52;135;43;34;77
89;07.04.2011;2011;04;20;Torstai;82;41;123;35;29;64
89;07.04.2011;2011;04;21;Torstai;46;26;72;19;16;35
89;07.04.2011;2011;04;22;Torstai;10;12;22;7;12;19
89;07.04.2011;2011;04;23;Torstai;4;4;8;7;2;9
89;08.04.2011;2011;04;00;Perjantai;8;2;10;0;1;1
89;08.04.2011;2011;04;01;Perjantai;1;1;2;2;0;2
89;08.04.2011;2011;04;02;Perjantai;3;0;3;6;0;6
89;08.04.2011;2011;04;03;Perjantai;6;2;8;0;0;0
89;08.04.2011;2011;04;04;Perjantai;1;4;5;0;2;2
89;08.04.2011;2011;04;05;Perjantai;1;11;12;3;2;5
89;08.04.2011;2011;04;06;Perjantai;18;58;76;6;10;16
89;08.04.2011;2011;04;07;Perjantai;33;148;181;8;45;53
89;08.04.2011;2011;04;08;Perjantai;50;166;216;29;48;77
89;08.04.2011;2011;04;09;Perjantai;39;86;125;10;28;38
89;08.04.2011;2011;04;10;Perjantai;46;90;136;17;32;49
89;08.04.2011;2011;04;11;Perjantai;62;70;132;23;40;63
89;08.04.2011;2011;04;12;Perjantai;69;81;150;41;36;77
89;08.04.2011;2011;04;13;Perjantai;87;111;198;21;46;67
89;08.04.2011;2011;04;14;Perjantai;102;98;200;40;16;56
89;08.04.2011;2011;04;15;Perjantai;140;85;225;29;16;45
89;08.04.2011;2011;04;16;Perjantai;125;77;202;26;32;58
89;08.04.2011;2011;04;17;Perjantai;90;57;147;36;31;67
89;08.04.2011;2011;04;18;Perjantai;54;51;105;37;30;67
89;08.04.2011;2011;04;19;Perjantai;75;43;118;44;29;73
89;08.04.2011;2011;04;20;Perjantai;54;38;92;18;22;40
89;08.04.2011;2011;04;21;Perjantai;38;24;62;12;8;20
89;08.04.2011;2011;04;22;Perjantai;19;21;40;9;6;15
89;08.04.2011;2011;04;23;Perjantai;14;14;28;3;9;12
89;09.04.2011;2011;04;00;Lauantai;13;17;30;5;7;12
89;09.04.2011;2011;04;01;Lauantai;16;6;22;6;2;8
89;09.04.2011;2011;04;02;Lauantai;15;2;17;4;2;6
89;09.04.2011;2011;04;03;Lauantai;15;2;17;3;1;4
89;09.04.2011;2011;04;04;Lauantai;10;1;11;3;0;3
89;09.04.2011;2011;04;05;Lauantai;5;5;10;2;1;3
89;09.04.2011;2011;04;06;Lauantai;2;13;15;2;0;2
89;09.04.2011;2011;04;07;Lauantai;6;15;21;3;11;14
89;09.04.2011;2011;04;08;Lauantai;10;41;51;9;14;23
89;09.04.2011;2011;04;09;Lauantai;19;65;84;15;28;43
89;09.04.2011;2011;04;10;Lauantai;27;82;109;27;43;70
89;09.04.2011;2011;04;11;Lauantai;38;101;139;34;69;103
89;09.04.2011;2011;04;12;Lauantai;59;108;167;49;76;125
89;09.04.2011;2011;04;13;Lauantai;87;88;175;57;60;117
89;09.04.2011;2011;04;14;Lauantai;130;89;219;60;68;128
89;09.04.2011;2011;04;15;Lauantai;112;61;173;60;41;101
89;09.04.2011;2011;04;16;Lauantai;79;60;139;48;43;91
89;09.04.2011;2011;04;17;Lauantai;79;55;134;39;29;68
89;09.04.2011;2011;04;18;Lauantai;75;34;109;45;26;71
89;09.04.2011;2011;04;19;Lauantai;45;38;83;20;21;41
89;09.04.2011;2011;04;20;Lauantai;40;48;88;13;19;32
89;09.04.2011;2011;04;21;Lauantai;11;30;41;11;14;25
89;09.04.2011;2011;04;22;Lauantai;21;24;45;3;7;10
89;09.04.2011;2011;04;23;Lauantai;19;42;61;2;4;6
89;10.04.2011;2011;04;00;Sunnuntai;14;12;26;2;7;9
89;10.04.2011;2011;04;01;Sunnuntai;23;16;39;7;4;11
89;10.04.2011;2011;04;02;Sunnuntai;14;2;16;10;5;15
89;10.04.2011;2011;04;03;Sunnuntai;21;3;24;7;0;7
89;10.04.2011;2011;04;04;Sunnuntai;11;3;14;7;1;8
89;10.04.2011;2011;04;05;Sunnuntai;3;5;8;0;3;3
89;10.04.2011;2011;04;06;Sunnuntai;2;6;8;1;3;4
89;10.04.2011;2011;04;07;Sunnuntai;6;13;19;5;8;13
89;10.04.2011;2011;04;08;Sunnuntai;8;8;16;14;12;26
89;10.04.2011;2011;04;09;Sunnuntai;16;27;43;31;28;59
89;10.04.2011;2011;04;10;Sunnuntai;39;69;108;56;58;114
89;10.04.2011;2011;04;11;Sunnuntai;41;98;139;53;73;126
89;10.04.2011;2011;04;12;Sunnuntai;76;121;197;63;91;154
89;10.04.2011;2011;04;13;Sunnuntai;98;122;220;70;97;167
89;10.04.2011;2011;04;14;Sunnuntai;117;86;203;62;65;127
89;10.04.2011;2011;04;15;Sunnuntai;117;79;196;70;58;128
89;10.04.2011;2011;04;16;Sunnuntai;82;88;170;46;44;90
89;10.04.2011;2011;04;17;Sunnuntai;72;58;130;59;43;102
89;10.04.2011;2011;04;18;Sunnuntai;78;45;123;68;52;120
89;10.04.2011;2011;04;19;Sunnuntai;57;37;94;31;35;66
89;10.04.2011;2011;04;20;Sunnuntai;45;21;66;23;26;49
89;10.04.2011;2011;04;21;Sunnuntai;23;15;38;10;10;20
89;10.04.2011;2011;04;22;Sunnuntai;14;9;23;6;1;7
89;10.04.2011;2011;04;23;Sunnuntai;3;4;7;4;4;8
89;11.04.2011;2011;04;00;Maanantai;5;3;8;4;0;4
89;11.04.2011;2011;04;01;Maanantai;2;0;2;0;0;0
89;11.04.2011;2011;04;02;Maanantai;4;2;6;0;2;2
89;11.04.2011;2011;04;03;Maanantai;1;3;4;0;0;0
89;11.04.2011;2011;04;04;Maanantai;0;5;5;0;1;1
89;11.04.2011;2011;04;05;Maanantai;6;13;19;1;2;3
89;11.04.2011;2011;04;06;Maanantai;17;55;72;2;7;9
89;11.04.2011;2011;04;07;Maanantai;39;185;224;6;29;35
89;11.04.2011;2011;04;08;Maanantai;55;162;217;13;41;54
89;11.04.2011;2011;04;09;Maanantai;46;108;154;12;23;35
89;11.04.2011;2011;04;10;Maanantai;50;61;111;17;37;54
89;11.04.2011;2011;04;11;Maanantai;53;77;130;32;37;69
89;11.04.2011;2011;04;12;Maanantai;64;73;137;38;33;71
89;11.04.2011;2011;04;13;Maanantai;88;75;163;46;26;72
89;11.04.2011;2011;04;14;Maanantai;118;78;196;25;19;44
89;11.04.2011;2011;04;15;Maanantai;176;103;279;46;22;68
89;11.04.2011;2011;04;16;Maanantai;166;103;269;42;31;73
89;11.04.2011;2011;04;17;Maanantai;112;48;160;24;36;60
89;11.04.2011;2011;04;18;Maanantai;65;70;135;46;36;82
89;11.04.2011;2011;04;19;Maanantai;64;45;109;30;42;72
89;11.04.2011;2011;04;20;Maanantai;56;36;92;35;31;66
89;11.04.2011;2011;04;21;Maanantai;50;16;66;12;10;22
89;11.04.2011;2011;04;22;Maanantai;10;8;18;6;9;15
89;11.04.2011;2011;04;23;Maanantai;7;6;13;2;3;5
89;12.04.2011;2011;04;00;Tiistai;3;3;6;1;2;3
89;12.04.2011;2011;04;01;Tiistai;2;0;2;0;0;0
89;12.04.2011;2011;04;02;Tiistai;2;0;2;0;1;1
89;12.04.2011;2011;04;03;Tiistai;1;1;2;0;0;0
89;12.04.2011;2011;04;04;Tiistai;1;11;12;1;0;1
89;12.04.2011;2011;04;05;Tiistai;3;12;15;0;1;1
89;12.04.2011;2011;04;06;Tiistai;20;60;80;4;5;9
89;12.04.2011;2011;04;07;Tiistai;42;197;239;8;42;50
89;12.04.2011;2011;04;08;Tiistai;60;178;238;17;35;52
89;12.04.2011;2011;04;09;Tiistai;45;91;136;21;58;79
89;12.04.2011;2011;04;10;Tiistai;48;67;115;32;23;55
89;12.04.2011;2011;04;11;Tiistai;62;84;146;29;36;65
89;12.04.2011;2011;04;12;Tiistai;64;66;130;23;28;51
89;12.04.2011;2011;04;13;Tiistai;90;75;165;27;30;57
89;12.04.2011;2011;04;14;Tiistai;117;74;191;46;30;76
89;12.04.2011;2011;04;15;Tiistai;164;94;258;42;23;65
89;12.04.2011;2011;04;16;Tiistai;189;101;290;31;26;57
89;12.04.2011;2011;04;17;Tiistai;96;85;181;39;33;72
89;12.04.2011;2011;04;18;Tiistai;94;68;162;39;39;78
89;12.04.2011;2011;04;19;Tiistai;74;48;122;47;38;85
89;12.04.2011;2011;04;20;Tiistai;82;32;114;32;39;71
89;12.04.2011;2011;04;21;Tiistai;41;21;62;18;19;37
89;12.04.2011;2011;04;22;Tiistai;24;6;30;6;7;13
89;12.04.2011;2011;04;23;Tiistai;4;4;8;7;0;7
89;13.04.2011;2011;04;00;Keskiviikko;3;7;10;0;0;0
89;13.04.2011;2011;04;01;Keskiviikko;4;1;5;1;0;1
89;13.04.2011;2011;04;02;Keskiviikko;2;1;3;0;0;0
89;13.04.2011;2011;04;03;Keskiviikko;2;0;2;2;2;4
89;13.04.2011;2011;04;04;Keskiviikko;2;5;7;1;3;4
89;13.04.2011;2011;04;05;Keskiviikko;7;9;16;0;2;2
89;13.04.2011;2011;04;06;Keskiviikko;23;61;84;3;10;13
89;13.04.2011;2011;04;07;Keskiviikko;41;189;230;3;41;44
89;13.04.2011;2011;04;08;Keskiviikko;47;184;231;14;43;57
89;13.04.2011;2011;04;09;Keskiviikko;49;98;147;16;26;42
89;13.04.2011;2011;04;10;Keskiviikko;40;61;101;18;26;44
89;13.04.2011;2011;04;11;Keskiviikko;56;90;146;22;28;50
89;13.04.2011;2011;04;12;Keskiviikko;71;82;153;26;22;48
89;13.04.2011;2011;04;13;Keskiviikko;78;71;149;23;17;40
89;13.04.2011;2011;04;14;Keskiviikko;114;67;181;32;24;56
89;13.04.2011;2011;04;15;Keskiviikko;146;81;227;36;17;53
89;13.04.2011;2011;04;16;Keskiviikko;158;85;243;28;18;46
89;13.04.2011;2011;04;17;Keskiviikko;92;46;138;29;18;47
89;13.04.2011;2011;04;18;Keskiviikko;84;57;141;43;28;71
89;13.04.2011;2011;04;19;Keskiviikko;61;41;102;45;38;83
89;13.04.2011;2011;04;20;Keskiviikko;63;35;98;28;21;49
89;13.04.2011;2011;04;21;Keskiviikko;38;30;68;9;15;24
89;13.04.2011;2011;04;22;Keskiviikko;18;15;33;6;8;14
89;13.04.2011;2011;04;23;Keskiviikko;5;10;15;3;2;5
89;14.04.2011;2011;04;00;Torstai;7;1;8;0;1;1
89;14.04.2011;2011;04;01;Torstai;1;0;1;4;0;4
89;14.04.2011;2011;04;02;Torstai;3;1;4;0;1;1
89;14.04.2011;2011;04;03;Torstai;2;1;3;2;0;2
89;14.04.2011;2011;04;04;Torstai;7;7;14;1;0;1
89;14.04.2011;2011;04;05;Torstai;4;6;10;2;3;5
89;14.04.2011;2011;04;06;Torstai;19;61;80;5;15;20
89;14.04.2011;2011;04;07;Torstai;37;191;228;6;48;54
89;14.04.2011;2011;04;08;Torstai;54;164;218;11;39;50
89;14.04.2011;2011;04;09;Torstai;47;105;152;17;34;51
89;14.04.2011;2011;04;10;Torstai;36;67;103;27;23;50
89;14.04.2011;2011;04;11;Torstai;63;87;150;30;35;65
89;14.04.2011;2011;04;12;Torstai;68;68;136;29;48;77
89;14.04.2011;2011;04;13;Torstai;96;62;158;22;33;55
89;14.04.2011;2011;04;14;Torstai;120;95;215;38;24;62
89;14.04.2011;2011;04;15;Torstai;163;78;241;38;29;67
89;14.04.2011;2011;04;16;Torstai;174;102;276;28;23;51
89;14.04.2011;2011;04;17;Torstai;117;104;221;41;29;70
89;14.04.2011;2011;04;18;Torstai;89;70;159;51;38;89
89;14.04.2011;2011;04;19;Torstai;95;60;155;35;40;75
89;14.04.2011;2011;04;20;Torstai;74;33;107;37;38;75
89;14.04.2011;2011;04;21;Torstai;45;26;71;15;8;23
89;14.04.2011;2011;04;22;Torstai;18;19;37;7;5;12
89;14.04.2011;2011;04;23;Torstai;9;7;16;2;6;8
89;15.04.2011;2011;04;00;Perjantai;6;3;9;3;0;3
89;15.04.2011;2011;04;01;Perjantai;3;2;5;1;1;2
89;15.04.2011;2011;04;02;Perjantai;3;2;5;0;0;0
89;15.04.2011;2011;04;03;Perjantai;6;0;6;1;0;1
89;15.04.2011;2011;04;04;Perjantai;3;8;11;1;1;2
89;15.04.2011;2011;04;05;Perjantai;4;6;10;2;3;5
89;15.04.2011;2011;04;06;Perjantai;18;62;80;5;7;12
89;15.04.2011;2011;04;07;Perjantai;45;194;239;7;31;38
89;15.04.2011;2011;04;08;Perjantai;52;141;193;17;32;49
89;15.04.2011;2011;04;09;Perjantai;33;134;167;12;39;51
89;15.04.2011;2011;04;10;Perjantai;62;78;140;22;32;54
89;15.04.2011;2011;04;11;Perjantai;60;74;134;27;53;80
89;15.04.2011;2011;04;12;Perjantai;84;93;177;28;51;79
89;15.04.2011;2011;04;13;Perjantai;123;121;244;42;40;82
89;15.04.2011;2011;04;14;Perjantai;166;105;271;48;30;78
89;15.04.2011;2011;04;15;Perjantai;176;89;265;46;32;78
89;15.04.2011;2011;04;16;Perjantai;175;111;286;58;33;91
89;15.04.2011;2011;04;17;Perjantai;103;97;200;36;35;71
89;15.04.2011;2011;04;18;Perjantai;93;46;139;37;22;59
89;15.04.2011;2011;04;19;Perjantai;72;52;124;28;24;52
89;15.04.2011;2011;04;20;Perjantai;41;50;91;23;15;38
89;15.04.2011;2011;04;21;Perjantai;52;34;86;12;16;28
89;15.04.2011;2011;04;22;Perjantai;25;25;50;8;9;17
89;15.04.2011;2011;04;23;Perjantai;18;28;46;9;7;16
89;16.04.2011;2011;04;00;Lauantai;20;7;27;1;2;3
89;16.04.2011;2011;04;01;Lauantai;35;13;48;7;3;10
89;16.04.2011;2011;04;02;Lauantai;18;6;24;10;2;12
89;16.04.2011;2011;04;03;Lauantai;13;0;13;8;0;8
89;16.04.2011;2011;04;04;Lauantai;9;4;13;4;1;5
89;16.04.2011;2011;04;05;Lauantai;1;6;7;5;1;6
89;16.04.2011;2011;04;06;Lauantai;8;14;22;1;4;5
89;16.04.2011;2011;04;07;Lauantai;10;19;29;8;7;15
89;16.04.2011;2011;04;08;Lauantai;12;23;35;10;16;26
89;16.04.2011;2011;04;09;Lauantai;23;87;110;18;39;57
89;16.04.2011;2011;04;10;Lauantai;40;117;157;21;37;58
89;16.04.2011;2011;04;11;Lauantai;63;88;151;48;50;98
89;16.04.2011;2011;04;12;Lauantai;89;119;208;28;44;72
89;16.04.2011;2011;04;13;Lauantai;95;131;226;40;41;81
89;16.04.2011;2011;04;14;Lauantai;106;97;203;53;42;95
89;16.04.2011;2011;04;15;Lauantai;123;80;203;39;49;88
89;16.04.2011;2011;04;16;Lauantai;102;75;177;45;64;109
89;16.04.2011;2011;04;17;Lauantai;85;69;154;42;40;82
89;16.04.2011;2011;04;18;Lauantai;83;68;151;35;21;56
89;16.04.2011;2011;04;19;Lauantai;51;52;103;30;28;58
89;16.04.2011;2011;04;20;Lauantai;50;54;104;21;13;34
89;16.04.2011;2011;04;21;Lauantai;36;26;62;5;11;16
89;16.04.2011;2011;04;22;Lauantai;19;28;47;5;7;12
89;16.04.2011;2011;04;23;Lauantai;24;38;62;2;7;9
89;17.04.2011;2011;04;00;Sunnuntai;23;20;43;2;5;7
89;17.04.2011;2011;04;01;Sunnuntai;29;12;41;6;0;6
89;17.04.2011;2011;04;02;Sunnuntai;29;7;36;3;1;4
89;17.04.2011;2011;04;03;Sunnuntai;22;6;28;9;1;10
89;17.04.2011;2011;04;04;Sunnuntai;18;0;18;6;1;7
89;17.04.2011;2011;04;05;Sunnuntai;3;5;8;2;2;4
89;17.04.2011;2011;04;06;Sunnuntai;3;6;9;5;1;6
89;17.04.2011;2011;04;07;Sunnuntai;4;8;12;10;7;17
89;17.04.2011;2011;04;08;Sunnuntai;12;12;24;11;13;24
89;17.04.2011;2011;04;09;Sunnuntai;18;28;46;19;20;39
89;17.04.2011;2011;04;10;Sunnuntai;27;31;58;50;56;106
89;17.04.2011;2011;04;11;Sunnuntai;43;74;117;38;51;89
89;17.04.2011;2011;04;12;Sunnuntai;54;81;135;45;48;93
89;17.04.2011;2011;04;13;Sunnuntai;74;71;145;27;43;70
89;17.04.2011;2011;04;14;Sunnuntai;75;54;129;47;43;90
89;17.04.2011;2011;04;15;Sunnuntai;59;56;115;40;32;72
89;17.04.2011;2011;04;16;Sunnuntai;57;49;106;20;28;48
89;17.04.2011;2011;04;17;Sunnuntai;71;68;139;38;42;80
89;17.04.2011;2011;04;18;Sunnuntai;57;47;104;36;25;61
89;17.04.2011;2011;04;19;Sunnuntai;36;23;59;37;35;72
89;17.04.2011;2011;04;20;Sunnuntai;41;26;67;17;20;37
89;17.04.2011;2011;04;21;Sunnuntai;29;16;45;6;10;16
89;17.04.2011;2011;04;22;Sunnuntai;11;9;20;4;3;7
89;17.04.2011;2011;04;23;Sunnuntai;8;6;14;3;1;4
89;18.04.2011;2011;04;00;Maanantai;4;4;8;4;4;8
89;18.04.2011;2011;04;01;Maanantai;4;4;8;2;0;2
89;18.04.2011;2011;04;02;Maanantai;3;3;6;21;5;26
89;18.04.2011;2011;04;03;Maanantai;3;0;3;4;0;4
89;18.04.2011;2011;04;04;Maanantai;8;0;8;0;0;0
89;18.04.2011;2011;04;05;Maanantai;12;0;12;3;0;3
89;18.04.2011;2011;04;06;Maanantai;82;0;82;15;0;15
89;18.04.2011;2011;04;07;Maanantai;228;6;234;32;7;39
89;18.04.2011;2011;04;08;Maanantai;225;7;232;55;6;61
89;18.04.2011;2011;04;09;Maanantai;146;21;167;42;9;51
89;18.04.2011;2011;04;10;Maanantai;112;15;127;58;6;64
89;18.04.2011;2011;04;11;Maanantai;116;39;155;50;8;58
89;18.04.2011;2011;04;12;Maanantai;146;36;182;41;21;62
89;18.04.2011;2011;04;13;Maanantai;103;67;170;48;24;72
89;18.04.2011;2011;04;14;Maanantai;180;79;259;46;20;66
89;18.04.2011;2011;04;15;Maanantai;193;101;294;54;29;83
89;18.04.2011;2011;04;16;Maanantai;214;102;316;58;29;87
89;18.04.2011;2011;04;17;Maanantai;128;71;199;38;29;67
89;18.04.2011;2011;04;18;Maanantai;117;58;175;62;33;95
89;18.04.2011;2011;04;19;Maanantai;100;38;138;66;34;100
89;18.04.2011;2011;04;20;Maanantai;96;16;112;42;25;67
89;18.04.2011;2011;04;21;Maanantai;42;13;55;22;10;32
89;18.04.2011;2011;04;22;Maanantai;20;3;23;4;2;6
89;18.04.2011;2011;04;23;Maanantai;3;3;6;2;3;5
89;19.04.2011;2011;04;00;Tiistai;5;4;9;2;0;2
89;19.04.2011;2011;04;01;Tiistai;0;0;0;2;0;2
89;19.04.2011;2011;04;02;Tiistai;1;1;2;0;0;0
89;19.04.2011;2011;04;03;Tiistai;2;1;3;0;0;0
89;19.04.2011;2011;04;04;Tiistai;4;2;6;0;1;1
89;19.04.2011;2011;04;05;Tiistai;14;5;19;0;0;0
89;19.04.2011;2011;04;06;Tiistai;55;32;87;6;7;13
89;19.04.2011;2011;04;07;Tiistai;148;112;260;8;25;33
89;19.04.2011;2011;04;08;Tiistai;129;145;274;19;30;49
89;19.04.2011;2011;04;09;Tiistai;86;111;197;24;37;61
89;19.04.2011;2011;04;10;Tiistai;71;73;144;30;38;68
89;19.04.2011;2011;04;11;Tiistai;85;67;152;31;22;53
89;19.04.2011;2011;04;12;Tiistai;95;97;192;28;34;62
89;19.04.2011;2011;04;13;Tiistai;102;90;192;23;27;50
89;19.04.2011;2011;04;14;Tiistai;159;95;254;40;45;85
89;19.04.2011;2011;04;15;Tiistai;196;129;325;39;29;68
89;19.04.2011;2011;04;16;Tiistai;212;100;312;36;38;74
89;19.04.2011;2011;04;17;Tiistai;145;85;230;45;27;72
89;19.04.2011;2011;04;18;Tiistai;125;66;191;41;45;86
89;19.04.2011;2011;04;19;Tiistai;104;36;140;55;28;83
89;19.04.2011;2011;04;20;Tiistai;80;38;118;39;33;72
89;19.04.2011;2011;04;21;Tiistai;53;14;67;15;19;34
89;19.04.2011;2011;04;22;Tiistai;22;6;28;5;3;8
89;19.04.2011;2011;04;23;Tiistai;5;5;10;4;2;6
89;20.04.2011;2011;04;00;Keskiviikko;4;1;5;1;0;1
89;20.04.2011;2011;04;01;Keskiviikko;3;0;3;0;0;0
89;20.04.2011;2011;04;02;Keskiviikko;5;0;5;1;0;1
89;20.04.2011;2011;04;03;Keskiviikko;1;4;5;0;0;0
89;20.04.2011;2011;04;04;Keskiviikko;5;3;8;0;1;1
89;20.04.2011;2011;04;05;Keskiviikko;8;5;13;0;1;1
89;20.04.2011;2011;04;06;Keskiviikko;42;28;70;3;11;14
89;20.04.2011;2011;04;07;Keskiviikko;115;128;243;8;28;36
89;20.04.2011;2011;04;08;Keskiviikko;94;120;214;12;27;39
89;20.04.2011;2011;04;09;Keskiviikko;70;59;129;13;20;33
89;20.04.2011;2011;04;10;Keskiviikko;43;37;80;8;19;27
89;20.04.2011;2011;04;11;Keskiviikko;54;41;95;15;25;40
89;20.04.2011;2011;04;12;Keskiviikko;73;63;136;19;22;41
89;20.04.2011;2011;04;13;Keskiviikko;109;31;140;13;27;40
89;20.04.2011;2011;04;14;Keskiviikko;127;61;188;29;20;49
89;20.04.2011;2011;04;15;Keskiviikko;149;83;232;31;24;55
89;20.04.2011;2011;04;16;Keskiviikko;179;59;238;29;24;53
89;20.04.2011;2011;04;17;Keskiviikko;111;66;177;35;26;61
89;20.04.2011;2011;04;18;Keskiviikko;95;38;133;26;26;52
89;20.04.2011;2011;04;19;Keskiviikko;82;38;120;32;17;49
89;20.04.2011;2011;04;20;Keskiviikko;70;30;100;27;25;52
89;20.04.2011;2011;04;21;Keskiviikko;58;14;72;15;17;32
89;20.04.2011;2011;04;22;Keskiviikko;21;10;31;0;8;8
89;20.04.2011;2011;04;23;Keskiviikko;5;7;12;2;2;4
89;21.04.2011;2011;04;00;Torstai;4;9;13;2;0;2
89;21.04.2011;2011;04;01;Torstai;7;2;9;2;3;5
89;21.04.2011;2011;04;02;Torstai;0;2;2;0;0;0
89;21.04.2011;2011;04;03;Torstai;0;0;0;0;1;1
89;21.04.2011;2011;04;04;Torstai;6;4;10;0;0;0
89;21.04.2011;2011;04;05;Torstai;10;6;16;1;1;2
89;21.04.2011;2011;04;06;Torstai;40;32;72;5;4;9
89;21.04.2011;2011;04;07;Torstai;90;121;211;5;26;31
89;21.04.2011;2011;04;08;Torstai;87;99;186;13;32;45
89;21.04.2011;2011;04;09;Torstai;64;76;140;25;30;55
89;21.04.2011;2011;04;10;Torstai;71;94;165;19;45;64
89;21.04.2011;2011;04;11;Torstai;82;85;167;19;38;57
89;21.04.2011;2011;04;12;Torstai;96;94;190;43;64;107
89;21.04.2011;2011;04;13;Torstai;124;90;214;29;35;64
89;21.04.2011;2011;04;14;Torstai;121;91;212;34;21;55
89;21.04.2011;2011;04;15;Torstai;154;80;234;38;26;64
89;21.04.2011;2011;04;16;Torstai;141;82;223;21;23;44
89;21.04.2011;2011;04;17;Torstai;74;61;135;27;17;44
89;21.04.2011;2011;04;18;Torstai;57;40;97;30;26;56
89;21.04.2011;2011;04;19;Torstai;64;31;95;13;18;31
89;21.04.2011;2011;04;20;Torstai;65;24;89;11;14;25
89;21.04.2011;2011;04;21;Torstai;26;22;48;16;15;31
89;21.04.2011;2011;04;22;Torstai;18;12;30;6;10;16
89;21.04.2011;2011;04;23;Torstai;12;15;27;3;6;9
89;22.04.2011;2011;04;00;Perjantai;6;4;10;4;2;6
89;22.04.2011;2011;04;01;Perjantai;18;9;27;4;1;5
89;22.04.2011;2011;04;02;Perjantai;11;8;19;2;1;3
89;22.04.2011;2011;04;03;Perjantai;21;1;22;3;0;3
89;22.04.2011;2011;04;04;Perjantai;7;1;8;3;0;3
89;22.04.2011;2011;04;05;Perjantai;4;1;5;0;0;0
89;22.04.2011;2011;04;06;Perjantai;10;9;19;4;4;8
89;22.04.2011;2011;04;07;Perjantai;10;9;19;10;5;15
89;22.04.2011;2011;04;08;Perjantai;14;5;19;14;16;30
89;22.04.2011;2011;04;09;Perjantai;29;21;50;24;30;54
89;22.04.2011;2011;04;10;Perjantai;52;40;92;38;27;65
89;22.04.2011;2011;04;11;Perjantai;64;52;116;74;59;133
89;22.04.2011;2011;04;12;Perjantai;134;31;165;111;30;141
89;22.04.2011;2011;04;13;Perjantai;175;0;175;118;0;118
89;22.04.2011;2011;04;14;Perjantai;208;0;208;161;0;161
89;22.04.2011;2011;04;15;Perjantai;180;0;180;117;0;117
89;22.04.2011;2011;04;16;Perjantai;136;13;149;98;11;109
89;22.04.2011;2011;04;17;Perjantai;76;55;131;40;35;75
89;22.04.2011;2011;04;18;Perjantai;67;22;89;29;31;60
89;22.04.2011;2011;04;19;Perjantai;49;42;91;32;32;64
89;22.04.2011;2011;04;20;Perjantai;45;19;64;15;23;38
89;22.04.2011;2011;04;21;Perjantai;37;23;60;7;7;14
89;22.04.2011;2011;04;22;Perjantai;23;6;29;7;5;12
89;22.04.2011;2011;04;23;Perjantai;11;17;28;3;8;11
89;23.04.2011;2011;04;00;Lauantai;17;4;21;3;3;6
89;23.04.2011;2011;04;01;Lauantai;13;7;20;1;3;4
89;23.04.2011;2011;04;02;Lauantai;18;6;24;5;3;8
89;23.04.2011;2011;04;03;Lauantai;11;1;12;8;0;8
89;23.04.2011;2011;04;04;Lauantai;10;1;11;5;0;5
89;23.04.2011;2011;04;05;Lauantai;4;1;5;1;1;2
89;23.04.2011;2011;04;06;Lauantai;11;9;20;1;2;3
89;23.04.2011;2011;04;07;Lauantai;24;7;31;5;8;13
89;23.04.2011;2011;04;08;Lauantai;21;11;32;10;16;26
89;23.04.2011;2011;04;09;Lauantai;32;30;62;19;12;31
89;23.04.2011;2011;04;10;Lauantai;70;77;147;22;40;62
89;23.04.2011;2011;04;11;Lauantai;87;75;162;29;39;68
89;23.04.2011;2011;04;12;Lauantai;133;90;223;28;43;71
89;23.04.2011;2011;04;13;Lauantai;113;101;214;29;41;70
89;23.04.2011;2011;04;14;Lauantai;111;84;195;56;43;99
89;23.04.2011;2011;04;15;Lauantai;108;56;164;33;47;80
89;23.04.2011;2011;04;16;Lauantai;95;39;134;39;24;63
89;23.04.2011;2011;04;17;Lauantai;113;94;207;41;30;71
89;23.04.2011;2011;04;18;Lauantai;77;42;119;29;37;66
89;23.04.2011;2011;04;19;Lauantai;75;42;117;29;18;47
89;23.04.2011;2011;04;20;Lauantai;51;21;72;18;6;24
89;23.04.2011;2011;04;21;Lauantai;27;28;55;7;11;18
89;23.04.2011;2011;04;22;Lauantai;28;46;74;2;6;8
89;23.04.2011;2011;04;23;Lauantai;16;15;31;4;6;10
89;24.04.2011;2011;04;00;Sunnuntai;19;10;29;1;3;4
89;24.04.2011;2011;04;01;Sunnuntai;16;8;24;1;0;1
89;24.04.2011;2011;04;02;Sunnuntai;21;4;25;6;1;7
89;24.04.2011;2011;04;03;Sunnuntai;24;0;24;6;0;6
89;24.04.2011;2011;04;04;Sunnuntai;11;1;12;7;1;8
89;24.04.2011;2011;04;05;Sunnuntai;11;4;15;2;0;2
89;24.04.2011;2011;04;06;Sunnuntai;8;0;8;2;1;3
89;24.04.2011;2011;04;07;Sunnuntai;12;5;17;3;10;13
89;24.04.2011;2011;04;08;Sunnuntai;14;3;17;12;15;27
89;24.04.2011;2011;04;09;Sunnuntai;29;3;32;20;31;51
89;24.04.2011;2011;04;10;Sunnuntai;47;28;75;42;21;63
89;24.04.2011;2011;04;11;Sunnuntai;79;56;135;55;67;122
89;24.04.2011;2011;04;12;Sunnuntai;103;79;182;46;61;107
89;24.04.2011;2011;04;13;Sunnuntai;130;105;235;55;68;123
89;24.04.2011;2011;04;14;Sunnuntai;123;106;229;54;67;121
89;24.04.2011;2011;04;15;Sunnuntai;159;97;256;55;47;102
89;24.04.2011;2011;04;16;Sunnuntai;124;100;224;47;46;93
89;24.04.2011;2011;04;17;Sunnuntai;98;94;192;40;43;83
89;24.04.2011;2011;04;18;Sunnuntai;107;53;160;52;39;91
89;24.04.2011;2011;04;19;Sunnuntai;78;38;116;25;21;46
89;24.04.2011;2011;04;20;Sunnuntai;66;29;95;35;25;60
89;24.04.2011;2011;04;21;Sunnuntai;31;28;59;11;11;22
89;24.04.2011;2011;04;22;Sunnuntai;17;16;33;5;6;11
89;24.04.2011;2011;04;23;Sunnuntai;5;6;11;2;5;7
89;25.04.2011;2011;04;00;Maanantai;9;5;14;4;2;6
89;25.04.2011;2011;04;01;Maanantai;19;3;22;0;2;2
89;25.04.2011;2011;04;02;Maanantai;9;1;10;2;0;2
89;25.04.2011;2011;04;03;Maanantai;11;2;13;1;0;1
89;25.04.2011;2011;04;04;Maanantai;7;2;9;1;0;1
89;25.04.2011;2011;04;05;Maanantai;1;2;3;1;1;2
89;25.04.2011;2011;04;06;Maanantai;7;10;17;1;2;3
89;25.04.2011;2011;04;07;Maanantai;6;8;14;8;8;16
89;25.04.2011;2011;04;08;Maanantai;6;17;23;12;8;20
89;25.04.2011;2011;04;09;Maanantai;13;49;62;17;38;55
89;25.04.2011;2011;04;10;Maanantai;41;75;116;42;41;83
89;25.04.2011;2011;04;11;Maanantai;84;105;189;47;65;112
89;25.04.2011;2011;04;12;Maanantai;94;180;274;74;79;153
89;25.04.2011;2011;04;13;Maanantai;174;182;356;66;79;145
89;25.04.2011;2011;04;14;Maanantai;149;128;277;60;62;122
89;25.04.2011;2011;04;15;Maanantai;136;124;260;52;69;121
89;25.04.2011;2011;04;16;Maanantai;118;137;255;50;59;109
89;25.04.2011;2011;04;17;Maanantai;131;97;228;36;44;80
89;25.04.2011;2011;04;18;Maanantai;123;61;184;54;48;102
89;25.04.2011;2011;04;19;Maanantai;90;59;149;33;27;60
89;25.04.2011;2011;04;20;Maanantai;55;43;98;35;27;62
89;25.04.2011;2011;04;21;Maanantai;41;22;63;18;10;28
89;25.04.2011;2011;04;22;Maanantai;26;14;40;4;5;9
89;25.04.2011;2011;04;23;Maanantai;5;10;15;2;2;4
89;26.04.2011;2011;04;00;Tiistai;2;7;9;2;4;6
89;26.04.2011;2011;04;01;Tiistai;6;1;7;3;6;9
89;26.04.2011;2011;04;02;Tiistai;2;3;5;0;1;1
89;26.04.2011;2011;04;03;Tiistai;0;1;1;2;1;3
89;26.04.2011;2011;04;04;Tiistai;3;6;9;1;0;1
89;26.04.2011;2011;04;05;Tiistai;5;12;17;1;0;1
89;26.04.2011;2011;04;06;Tiistai;26;66;92;6;4;10
89;26.04.2011;2011;04;07;Tiistai;79;223;302;7;31;38
89;26.04.2011;2011;04;08;Tiistai;75;209;284;11;26;37
89;26.04.2011;2011;04;09;Tiistai;57;134;191;13;43;56
89;26.04.2011;2011;04;10;Tiistai;53;93;146;17;18;35
89;26.04.2011;2011;04;11;Tiistai;114;76;190;20;25;45
89;26.04.2011;2011;04;12;Tiistai;127;115;242;43;35;78
89;26.04.2011;2011;04;13;Tiistai;115;127;242;28;41;69
89;26.04.2011;2011;04;14;Tiistai;180;170;350;32;29;61
89;26.04.2011;2011;04;15;Tiistai;208;235;443;32;54;86
89;26.04.2011;2011;04;16;Tiistai;251;175;426;41;32;73
89;26.04.2011;2011;04;17;Tiistai;159;120;279;33;37;70
89;26.04.2011;2011;04;18;Tiistai;127;97;224;36;33;69
89;26.04.2011;2011;04;19;Tiistai;119;45;164;32;32;64
89;26.04.2011;2011;04;20;Tiistai;82;59;141;29;34;63
89;26.04.2011;2011;04;21;Tiistai;35;28;63;16;13;29
89;26.04.2011;2011;04;22;Tiistai;34;15;49;11;7;18
89;26.04.2011;2011;04;23;Tiistai;10;12;22;1;5;6
89;27.04.2011;2011;04;00;Keskiviikko;9;5;14;5;0;5
89;27.04.2011;2011;04;01;Keskiviikko;10;4;14;2;1;3
89;27.04.2011;2011;04;02;Keskiviikko;5;1;6;0;0;0
89;27.04.2011;2011;04;03;Keskiviikko;18;4;22;0;0;0
89;27.04.2011;2011;04;04;Keskiviikko;3;4;7;2;0;2
89;27.04.2011;2011;04;05;Keskiviikko;6;14;20;1;1;2
89;27.04.2011;2011;04;06;Keskiviikko;23;68;91;5;18;23
89;27.04.2011;2011;04;07;Keskiviikko;64;235;299;6;37;43
89;27.04.2011;2011;04;08;Keskiviikko;95;221;316;9;28;37
89;27.04.2011;2011;04;09;Keskiviikko;55;149;204;13;37;50
89;27.04.2011;2011;04;10;Keskiviikko;55;119;174;24;26;50
89;27.04.2011;2011;04;11;Keskiviikko;88;112;200;19;38;57
89;27.04.2011;2011;04;12;Keskiviikko;123;136;259;22;47;69
89;27.04.2011;2011;04;13;Keskiviikko;136;112;248;34;31;65
89;27.04.2011;2011;04;14;Keskiviikko;177;157;334;30;29;59
89;27.04.2011;2011;04;15;Keskiviikko;199;136;335;27;22;49
89;27.04.2011;2011;04;16;Keskiviikko;279;136;415;42;27;69
89;27.04.2011;2011;04;17;Keskiviikko;175;142;317;40;41;81
89;27.04.2011;2011;04;18;Keskiviikko;124;110;234;39;39;78
89;27.04.2011;2011;04;19;Keskiviikko;100;62;162;32;23;55
89;27.04.2011;2011;04;20;Keskiviikko;96;46;142;48;32;80
89;27.04.2011;2011;04;21;Keskiviikko;68;30;98;15;16;31
89;27.04.2011;2011;04;22;Keskiviikko;24;26;50;3;3;6
89;27.04.2011;2011;04;23;Keskiviikko;23;30;53;2;4;6
89;28.04.2011;2011;04;00;Torstai;12;6;18;1;6;7
89;28.04.2011;2011;04;01;Torstai;14;5;19;2;2;4
89;28.04.2011;2011;04;02;Torstai;13;5;18;1;1;2
89;28.04.2011;2011;04;03;Torstai;11;2;13;1;0;1
89;28.04.2011;2011;04;04;Torstai;6;6;12;1;0;1
89;28.04.2011;2011;04;05;Torstai;5;13;18;2;1;3
89;28.04.2011;2011;04;06;Torstai;19;73;92;6;10;16
89;28.04.2011;2011;04;07;Torstai;63;234;297;4;33;37
89;28.04.2011;2011;04;08;Torstai;75;208;283;10;35;45
89;28.04.2011;2011;04;09;Torstai;56;132;188;10;19;29
89;28.04.2011;2011;04;10;Torstai;49;89;138;12;20;32
89;28.04.2011;2011;04;11;Torstai;76;98;174;14;32;46
89;28.04.2011;2011;04;12;Torstai;81;130;211;25;40;65
89;28.04.2011;2011;04;13;Torstai;108;114;222;24;23;47
89;28.04.2011;2011;04;14;Torstai;151;127;278;28;25;53
89;28.04.2011;2011;04;15;Torstai;196;167;363;31;21;52
89;28.04.2011;2011;04;16;Torstai;260;145;405;32;34;66
89;28.04.2011;2011;04;17;Torstai;166;109;275;34;28;62
89;28.04.2011;2011;04;18;Torstai;140;67;207;23;20;43
89;28.04.2011;2011;04;19;Torstai;110;54;164;32;28;60
89;28.04.2011;2011;04;20;Torstai;93;49;142;32;22;54
89;28.04.2011;2011;04;21;Torstai;69;23;92;16;19;35
89;28.04.2011;2011;04;22;Torstai;19;14;33;7;3;10
89;28.04.2011;2011;04;23;Torstai;19;8;27;5;2;7
89;29.04.2011;2011;04;00;Perjantai;9;4;13;1;3;4
89;29.04.2011;2011;04;01;Perjantai;6;16;22;1;0;1
89;29.04.2011;2011;04;02;Perjantai;4;5;9;0;0;0
89;29.04.2011;2011;04;03;Perjantai;5;3;8;1;2;3
89;29.04.2011;2011;04;04;Perjantai;7;10;17;0;2;2
89;29.04.2011;2011;04;05;Perjantai;5;17;22;2;2;4
89;29.04.2011;2011;04;06;Perjantai;23;56;79;1;9;10
89;29.04.2011;2011;04;07;Perjantai;48;214;262;6;24;30
89;29.04.2011;2011;04;08;Perjantai;70;197;267;6;31;37
89;29.04.2011;2011;04;09;Perjantai;47;147;194;21;37;58
89;29.04.2011;2011;04;10;Perjantai;51;112;163;10;27;37
89;29.04.2011;2011;04;11;Perjantai;84;98;182;19;18;37
89;29.04.2011;2011;04;12;Perjantai;95;102;197;21;20;41
89;29.04.2011;2011;04;13;Perjantai;114;119;233;16;33;49
89;29.04.2011;2011;04;14;Perjantai;157;144;301;30;30;60
89;29.04.2011;2011;04;15;Perjantai;182;136;318;14;29;43
89;29.04.2011;2011;04;16;Perjantai;188;126;314;32;41;73
89;29.04.2011;2011;04;17;Perjantai;135;115;250;21;46;67
89;29.04.2011;2011;04;18;Perjantai;115;116;231;29;22;51
89;29.04.2011;2011;04;19;Perjantai;95;71;166;26;33;59
89;29.04.2011;2011;04;20;Perjantai;75;88;163;6;18;24
89;29.04.2011;2011;04;21;Perjantai;47;65;112;14;14;28
89;29.04.2011;2011;04;22;Perjantai;58;33;91;7;22;29
89;29.04.2011;2011;04;23;Perjantai;43;44;87;11;7;18
89;30.04.2011;2011;04;00;Lauantai;34;16;50;6;7;13
89;30.04.2011;2011;04;01;Lauantai;33;4;37;12;1;13
89;30.04.2011;2011;04;02;Lauantai;45;2;47;11;1;12
89;30.04.2011;2011;04;03;Lauantai;34;3;37;2;2;4
89;30.04.2011;2011;04;04;Lauantai;16;10;26;2;1;3
89;30.04.2011;2011;04;05;Lauantai;4;7;11;1;1;2
89;30.04.2011;2011;04;06;Lauantai;9;23;32;2;1;3
89;30.04.2011;2011;04;07;Lauantai;12;14;26;7;8;15
89;30.04.2011;2011;04;08;Lauantai;12;33;45;15;24;39
89;30.04.2011;2011;04;09;Lauantai;23;62;85;17;29;46
89;30.04.2011;2011;04;10;Lauantai;38;108;146;16;26;42
89;30.04.2011;2011;04;11;Lauantai;49;186;235;15;58;73
89;30.04.2011;2011;04;12;Lauantai;102;168;270;30;38;68
89;30.04.2011;2011;04;13;Lauantai;121;377;498;21;53;74
89;30.04.2011;2011;04;14;Lauantai;142;360;502;33;87;120
89;30.04.2011;2011;04;15;Lauantai;195;183;378;38;54;92
89;30.04.2011;2011;04;16;Lauantai;230;164;394;47;41;88
89;30.04.2011;2011;04;17;Lauantai;135;131;266;32;30;62
89;30.04.2011;2011;04;18;Lauantai;101;106;207;24;34;58
89;30.04.2011;2011;04;19;Lauantai;78;125;203;25;36;61
89;30.04.2011;2011;04;20;Lauantai;69;121;190;15;44;59
89;30.04.2011;2011;04;21;Lauantai;45;106;151;14;48;62
89;30.04.2011;2011;04;22;Lauantai;59;75;134;23;38;61
89;30.04.2011;2011;04;23;Lauantai;68;95;163;32;23;55
89;01.05.2011;2011;05;00;Sunnuntai;94;33;127;19;9;28
89;01.05.2011;2011;05;01;Sunnuntai;69;32;101;18;10;28
89;01.05.2011;2011;05;02;Sunnuntai;59;26;85;21;2;23
89;01.05.2011;2011;05;03;Sunnuntai;61;13;74;21;3;24
89;01.05.2011;2011;05;04;Sunnuntai;45;7;52;6;2;8
89;01.05.2011;2011;05;05;Sunnuntai;54;5;59;5;3;8
89;01.05.2011;2011;05;06;Sunnuntai;14;18;32;2;2;4
89;01.05.2011;2011;05;07;Sunnuntai;15;5;20;7;3;10
89;01.05.2011;2011;05;08;Sunnuntai;16;27;43;8;12;20
89;01.05.2011;2011;05;09;Sunnuntai;20;60;80;18;35;53
89;01.05.2011;2011;05;10;Sunnuntai;54;160;214;27;58;85
89;01.05.2011;2011;05;11;Sunnuntai;72;147;219;31;63;94
89;01.05.2011;2011;05;12;Sunnuntai;88;156;244;36;50;86
89;01.05.2011;2011;05;13;Sunnuntai;162;155;317;61;56;117
89;01.05.2011;2011;05;14;Sunnuntai;182;103;285;43;37;80
89;01.05.2011;2011;05;15;Sunnuntai;106;58;164;35;23;58
89;01.05.2011;2011;05;16;Sunnuntai;115;83;198;15;30;45
89;01.05.2011;2011;05;17;Sunnuntai;77;80;157;28;26;54
89;01.05.2011;2011;05;18;Sunnuntai;76;50;126;22;19;41
89;01.05.2011;2011;05;19;Sunnuntai;51;39;90;19;32;51
89;01.05.2011;2011;05;20;Sunnuntai;41;37;78;17;18;35
89;01.05.2011;2011;05;21;Sunnuntai;35;11;46;5;9;14
89;01.05.2011;2011;05;22;Sunnuntai;29;9;38;8;5;13
89;01.05.2011;2011;05;23;Sunnuntai;9;13;22;2;1;3
89;02.05.2011;2011;05;00;Maanantai;1;5;6;2;2;4
89;02.05.2011;2011;05;01;Maanantai;8;2;10;0;0;0
89;02.05.2011;2011;05;02;Maanantai;5;2;7;2;0;2
89;02.05.2011;2011;05;03;Maanantai;3;0;3;0;0;0
89;02.05.2011;2011;05;04;Maanantai;1;9;10;0;0;0
89;02.05.2011;2011;05;05;Maanantai;8;15;23;0;1;1
89;02.05.2011;2011;05;06;Maanantai;32;74;106;5;5;10
89;02.05.2011;2011;05;07;Maanantai;65;241;306;4;33;37
89;02.05.2011;2011;05;08;Maanantai;75;246;321;9;41;50
89;02.05.2011;2011;05;09;Maanantai;48;142;190;7;36;43
89;02.05.2011;2011;05;10;Maanantai;64;86;150;10;18;28
89;02.05.2011;2011;05;11;Maanantai;85;105;190;19;23;42
89;02.05.2011;2011;05;12;Maanantai;82;96;178;21;31;52
89;02.05.2011;2011;05;13;Maanantai;84;102;186;29;15;44
89;02.05.2011;2011;05;14;Maanantai;130;96;226;22;16;38
89;02.05.2011;2011;05;15;Maanantai;196;116;312;33;18;51
89;02.05.2011;2011;05;16;Maanantai;230;159;389;23;17;40
89;02.05.2011;2011;05;17;Maanantai;137;95;232;19;22;41
89;02.05.2011;2011;05;18;Maanantai;101;64;165;30;32;62
89;02.05.2011;2011;05;19;Maanantai;93;56;149;37;29;66
89;02.05.2011;2011;05;20;Maanantai;70;32;102;22;29;51
89;02.05.2011;2011;05;21;Maanantai;39;25;64;9;4;13
89;02.05.2011;2011;05;22;Maanantai;18;6;24;8;6;14
89;02.05.2011;2011;05;23;Maanantai;6;7;13;3;2;5
89;03.05.2011;2011;05;00;Tiistai;2;4;6;1;0;1
89;03.05.2011;2011;05;01;Tiistai;3;1;4;0;0;0
89;03.05.2011;2011;05;02;Tiistai;1;2;3;0;0;0
89;03.05.2011;2011;05;03;Tiistai;0;2;2;0;0;0
89;03.05.2011;2011;05;04;Tiistai;2;7;9;0;0;0
89;03.05.2011;2011;05;05;Tiistai;6;20;26;0;1;1
89;03.05.2011;2011;05;06;Tiistai;43;78;121;3;10;13
89;03.05.2011;2011;05;07;Tiistai;50;265;315;7;35;42
89;03.05.2011;2011;05;08;Tiistai;81;214;295;10;44;54
89;03.05.2011;2011;05;09;Tiistai;44;124;168;11;45;56
89;03.05.2011;2011;05;10;Tiistai;42;92;134;38;27;65
89;03.05.2011;2011;05;11;Tiistai;66;100;166;17;30;47
89;03.05.2011;2011;05;12;Tiistai;57;97;154;10;41;51
89;03.05.2011;2011;05;13;Tiistai;97;94;191;29;33;62
89;03.05.2011;2011;05;14;Tiistai;149;108;257;26;20;46
89;03.05.2011;2011;05;15;Tiistai;194;135;329;31;25;56
89;03.05.2011;2011;05;16;Tiistai;257;150;407;27;22;49
89;03.05.2011;2011;05;17;Tiistai;111;98;209;36;33;69
89;03.05.2011;2011;05;18;Tiistai;106;74;180;34;36;70
89;03.05.2011;2011;05;19;Tiistai;111;54;165;24;28;52
89;03.05.2011;2011;05;20;Tiistai;77;43;120;32;28;60
89;03.05.2011;2011;05;21;Tiistai;44;23;67;8;12;20
89;03.05.2011;2011;05;22;Tiistai;17;10;27;7;5;12
89;03.05.2011;2011;05;23;Tiistai;5;8;13;2;3;5
89;04.05.2011;2011;05;00;Keskiviikko;6;1;7;0;3;3
89;04.05.2011;2011;05;01;Keskiviikko;2;4;6;0;0;0
89;04.05.2011;2011;05;02;Keskiviikko;0;0;0;0;1;1
89;04.05.2011;2011;05;03;Keskiviikko;1;2;3;0;0;0
89;04.05.2011;2011;05;04;Keskiviikko;3;7;10;2;0;2
89;04.05.2011;2011;05;05;Keskiviikko;8;11;19;0;2;2
89;04.05.2011;2011;05;06;Keskiviikko;33;81;114;3;9;12
89;04.05.2011;2011;05;07;Keskiviikko;70;264;334;4;34;38
89;04.05.2011;2011;05;08;Keskiviikko;75;206;281;10;34;44
89;04.05.2011;2011;05;09;Keskiviikko;56;117;173;16;24;40
89;04.05.2011;2011;05;10;Keskiviikko;40;109;149;14;36;50
89;04.05.2011;2011;05;11;Keskiviikko;64;105;169;19;18;37
89;04.05.2011;2011;05;12;Keskiviikko;82;112;194;12;26;38
89;04.05.2011;2011;05;13;Keskiviikko;104;131;235;30;39;69
89;04.05.2011;2011;05;14;Keskiviikko;170;98;268;27;23;50
89;04.05.2011;2011;05;15;Keskiviikko;221;142;363;26;13;39
89;04.05.2011;2011;05;16;Keskiviikko;283;125;408;35;23;58
89;04.05.2011;2011;05;17;Keskiviikko;149;124;273;25;32;57
89;04.05.2011;2011;05;18;Keskiviikko;115;82;197;35;41;76
89;04.05.2011;2011;05;19;Keskiviikko;132;72;204;27;23;50
89;04.05.2011;2011;05;20;Keskiviikko;98;46;144;23;22;45
89;04.05.2011;2011;05;21;Keskiviikko;63;37;100;8;6;14
89;04.05.2011;2011;05;22;Keskiviikko;19;14;33;1;5;6
89;04.05.2011;2011;05;23;Keskiviikko;19;15;34;1;3;4
89;05.05.2011;2011;05;00;Torstai;8;6;14;1;2;3
89;05.05.2011;2011;05;01;Torstai;2;1;3;1;2;3
89;05.05.2011;2011;05;02;Torstai;0;0;0;0;1;1
89;05.05.2011;2011;05;03;Torstai;2;3;5;0;0;0
89;05.05.2011;2011;05;04;Torstai;2;9;11;0;0;0
89;05.05.2011;2011;05;05;Torstai;7;18;25;0;0;0
89;05.05.2011;2011;05;06;Torstai;35;87;122;2;8;10
89;05.05.2011;2011;05;07;Torstai;66;243;309;5;33;38
89;05.05.2011;2011;05;08;Torstai;79;230;309;8;43;51
89;05.05.2011;2011;05;09;Torstai;57;137;194;19;30;49
89;05.05.2011;2011;05;10;Torstai;49;111;160;20;32;52
89;05.05.2011;2011;05;11;Torstai;78;98;176;39;57;96
89;05.05.2011;2011;05;12;Torstai;82;109;191;18;20;38
89;05.05.2011;2011;05;13;Torstai;107;101;208;14;26;40
89;05.05.2011;2011;05;14;Torstai;147;127;274;29;37;66
89;05.05.2011;2011;05;15;Torstai;208;144;352;30;19;49
89;05.05.2011;2011;05;16;Torstai;262;117;379;25;21;46
89;05.05.2011;2011;05;17;Torstai;148;115;263;42;33;75
89;05.05.2011;2011;05;18;Torstai;121;93;214;33;42;75
89;05.05.2011;2011;05;19;Torstai;107;58;165;31;19;50
89;05.05.2011;2011;05;20;Torstai;76;41;117;20;28;48
89;05.05.2011;2011;05;21;Torstai;47;42;89;15;11;26
89;05.05.2011;2011;05;22;Torstai;22;9;31;6;4;10
89;05.05.2011;2011;05;23;Torstai;11;4;15;2;4;6
89;06.05.2011;2011;05;00;Perjantai;11;5;16;1;2;3
89;06.05.2011;2011;05;01;Perjantai;7;4;11;0;0;0
89;06.05.2011;2011;05;02;Perjantai;0;0;0;0;2;2
89;06.05.2011;2011;05;03;Perjantai;4;2;6;1;0;1
89;06.05.2011;2011;05;04;Perjantai;0;7;7;0;2;2
89;06.05.2011;2011;05;05;Perjantai;5;16;21;0;0;0
89;06.05.2011;2011;05;06;Perjantai;32;78;110;4;9;13
89;06.05.2011;2011;05;07;Perjantai;74;223;297;12;19;31
89;06.05.2011;2011;05;08;Perjantai;83;201;284;13;40;53
89;06.05.2011;2011;05;09;Perjantai;42;137;179;9;44;53
89;06.05.2011;2011;05;10;Perjantai;47;108;155;11;21;32
89;06.05.2011;2011;05;11;Perjantai;80;112;192;17;31;48
89;06.05.2011;2011;05;12;Perjantai;87;129;216;24;40;64
89;06.05.2011;2011;05;13;Perjantai;115;126;241;24;17;41
89;06.05.2011;2011;05;14;Perjantai;178;136;314;25;23;48
89;06.05.2011;2011;05;15;Perjantai;257;131;388;36;24;60
89;06.05.2011;2011;05;16;Perjantai;191;141;332;33;32;65
89;06.05.2011;2011;05;17;Perjantai;160;93;253;25;33;58
89;06.05.2011;2011;05;18;Perjantai;88;74;162;18;16;34
89;06.05.2011;2011;05;19;Perjantai;90;56;146;17;13;30
89;06.05.2011;2011;05;20;Perjantai;88;62;150;20;30;50
89;06.05.2011;2011;05;21;Perjantai;51;43;94;11;19;30
89;06.05.2011;2011;05;22;Perjantai;37;34;71;9;16;25
89;06.05.2011;2011;05;23;Perjantai;29;28;57;9;3;12
89;07.05.2011;2011;05;00;Lauantai;17;21;38;3;6;9
89;07.05.2011;2011;05;01;Lauantai;24;15;39;3;2;5
89;07.05.2011;2011;05;02;Lauantai;23;9;32;0;1;1
89;07.05.2011;2011;05;03;Lauantai;27;6;33;3;0;3
89;07.05.2011;2011;05;04;Lauantai;17;5;22;2;0;2
89;07.05.2011;2011;05;05;Lauantai;6;9;15;1;2;3
89;07.05.2011;2011;05;06;Lauantai;6;15;21;1;7;8
89;07.05.2011;2011;05;07;Lauantai;8;15;23;3;7;10
89;07.05.2011;2011;05;08;Lauantai;15;31;46;13;14;27
89;07.05.2011;2011;05;09;Lauantai;10;41;51;10;25;35
89;07.05.2011;2011;05;10;Lauantai;25;61;86;10;27;37
89;07.05.2011;2011;05;11;Lauantai;37;88;125;12;18;30
89;07.05.2011;2011;05;12;Lauantai;61;79;140;25;26;51
89;07.05.2011;2011;05;13;Lauantai;67;88;155;18;30;48
89;07.05.2011;2011;05;14;Lauantai;111;81;192;25;31;56
89;07.05.2011;2011;05;15;Lauantai;97;83;180;31;50;81
89;07.05.2011;2011;05;16;Lauantai;86;74;160;48;32;80
89;07.05.2011;2011;05;17;Lauantai;70;85;155;38;39;77
89;07.05.2011;2011;05;18;Lauantai;100;60;160;25;34;59
89;07.05.2011;2011;05;19;Lauantai;77;68;145;27;30;57
89;07.05.2011;2011;05;20;Lauantai;56;50;106;19;28;47
89;07.05.2011;2011;05;21;Lauantai;45;29;74;8;8;16
89;07.05.2011;2011;05;22;Lauantai;26;40;66;5;8;13
89;07.05.2011;2011;05;23;Lauantai;15;34;49;7;8;15
89;08.05.2011;2011;05;00;Sunnuntai;34;32;66;8;2;10
89;08.05.2011;2011;05;01;Sunnuntai;11;16;27;2;3;5
89;08.05.2011;2011;05;02;Sunnuntai;22;1;23;5;2;7
89;08.05.2011;2011;05;03;Sunnuntai;27;3;30;7;2;9
89;08.05.2011;2011;05;04;Sunnuntai;18;1;19;3;1;4
89;08.05.2011;2011;05;05;Sunnuntai;5;6;11;2;2;4
89;08.05.2011;2011;05;06;Sunnuntai;6;15;21;2;1;3
89;08.05.2011;2011;05;07;Sunnuntai;10;12;22;6;11;17
89;08.05.2011;2011;05;08;Sunnuntai;14;9;23;7;12;19
89;08.05.2011;2011;05;09;Sunnuntai;23;46;69;19;28;47
89;08.05.2011;2011;05;10;Sunnuntai;47;81;128;28;51;79
89;08.05.2011;2011;05;11;Sunnuntai;74;107;181;49;63;112
89;08.05.2011;2011;05;12;Sunnuntai;92;83;175;47;51;98
89;08.05.2011;2011;05;13;Sunnuntai;106;128;234;44;69;113
89;08.05.2011;2011;05;14;Sunnuntai;109;100;209;49;46;95
89;08.05.2011;2011;05;15;Sunnuntai;119;98;217;30;44;74
89;08.05.2011;2011;05;16;Sunnuntai;89;81;170;48;43;91
89;08.05.2011;2011;05;17;Sunnuntai;91;93;184;47;36;83
89;08.05.2011;2011;05;18;Sunnuntai;80;68;148;37;31;68
89;08.05.2011;2011;05;19;Sunnuntai;61;57;118;31;27;58
89;08.05.2011;2011;05;20;Sunnuntai;65;40;105;23;22;45
89;08.05.2011;2011;05;21;Sunnuntai;32;16;48;14;14;28
89;08.05.2011;2011;05;22;Sunnuntai;23;12;35;5;6;11
89;08.05.2011;2011;05;23;Sunnuntai;6;8;14;1;4;5
89;09.05.2011;2011;05;00;Maanantai;3;3;6;2;1;3
89;09.05.2011;2011;05;01;Maanantai;2;2;4;0;4;4
89;09.05.2011;2011;05;02;Maanantai;2;2;4;0;1;1
89;09.05.2011;2011;05;03;Maanantai;4;2;6;0;0;0
89;09.05.2011;2011;05;04;Maanantai;1;10;11;1;0;1
89;09.05.2011;2011;05;05;Maanantai;7;19;26;0;0;0
89;09.05.2011;2011;05;06;Maanantai;49;82;131;2;6;8
89;09.05.2011;2011;05;07;Maanantai;82;280;362;5;34;39
89;09.05.2011;2011;05;08;Maanantai;80;244;324;42;52;94
89;09.05.2011;2011;05;09;Maanantai;71;147;218;21;39;60
89;09.05.2011;2011;05;10;Maanantai;64;113;177;9;20;29
89;09.05.2011;2011;05;11;Maanantai;99;124;223;18;23;41
89;09.05.2011;2011;05;12;Maanantai;104;129;233;27;28;55
89;09.05.2011;2011;05;13;Maanantai;121;117;238;40;23;63
89;09.05.2011;2011;05;14;Maanantai;160;124;284;41;31;72
89;09.05.2011;2011;05;15;Maanantai;285;146;431;29;22;51
89;09.05.2011;2011;05;16;Maanantai;291;129;420;28;22;50
89;09.05.2011;2011;05;17;Maanantai;152;103;255;18;17;35
89;09.05.2011;2011;05;18;Maanantai;115;84;199;25;25;50
89;09.05.2011;2011;05;19;Maanantai;102;48;150;31;19;50
89;09.05.2011;2011;05;20;Maanantai;85;74;159;25;34;59
89;09.05.2011;2011;05;21;Maanantai;50;25;75;14;13;27
89;09.05.2011;2011;05;22;Maanantai;23;10;33;2;6;8
89;09.05.2011;2011;05;23;Maanantai;7;9;16;6;4;10
89;10.05.2011;2011;05;00;Tiistai;5;4;9;3;4;7
89;10.05.2011;2011;05;01;Tiistai;1;1;2;1;1;2
89;10.05.2011;2011;05;02;Tiistai;2;0;2;4;0;4
89;10.05.2011;2011;05;03;Tiistai;0;0;0;0;0;0
89;10.05.2011;2011;05;04;Tiistai;2;9;11;0;0;0
89;10.05.2011;2011;05;05;Tiistai;11;12;23;2;3;5
89;10.05.2011;2011;05;06;Tiistai;51;95;146;1;5;6
89;10.05.2011;2011;05;07;Tiistai;96;265;361;11;33;44
89;10.05.2011;2011;05;08;Tiistai;108;249;357;14;44;58
89;10.05.2011;2011;05;09;Tiistai;47;185;232;18;34;52
89;10.05.2011;2011;05;10;Tiistai;53;106;159;28;43;71
89;10.05.2011;2011;05;11;Tiistai;75;96;171;16;24;40
89;10.05.2011;2011;05;12;Tiistai;98;130;228;21;33;54
89;10.05.2011;2011;05;13;Tiistai;136;122;258;39;36;75
89;10.05.2011;2011;05;14;Tiistai;186;140;326;39;30;69
89;10.05.2011;2011;05;15;Tiistai;293;149;442;35;27;62
89;10.05.2011;2011;05;16;Tiistai;307;161;468;32;27;59
89;10.05.2011;2011;05;17;Tiistai;196;149;345;27;27;54
89;10.05.2011;2011;05;18;Tiistai;192;89;281;53;47;100
89;10.05.2011;2011;05;19;Tiistai;124;67;191;41;38;79
89;10.05.2011;2011;05;20;Tiistai;108;75;183;30;33;63
89;10.05.2011;2011;05;21;Tiistai;74;33;107;25;15;40
89;10.05.2011;2011;05;22;Tiistai;28;16;44;10;3;13
89;10.05.2011;2011;05;23;Tiistai;16;7;23;2;5;7
89;11.05.2011;2011;05;00;Keskiviikko;12;4;16;0;2;2
89;11.05.2011;2011;05;01;Keskiviikko;0;0;0;0;1;1
89;11.05.2011;2011;05;02;Keskiviikko;3;4;7;1;1;2
89;11.05.2011;2011;05;03;Keskiviikko;2;1;3;0;2;2
89;11.05.2011;2011;05;04;Keskiviikko;3;8;11;3;2;5
89;11.05.2011;2011;05;05;Keskiviikko;7;14;21;2;1;3
89;11.05.2011;2011;05;06;Keskiviikko;60;85;145;3;2;5
89;11.05.2011;2011;05;07;Keskiviikko;119;240;359;4;27;31
89;11.05.2011;2011;05;08;Keskiviikko;103;240;343;16;37;53
89;11.05.2011;2011;05;09;Keskiviikko;50;132;182;9;36;45
89;11.05.2011;2011;05;10;Keskiviikko;54;106;160;16;23;39
89;11.05.2011;2011;05;11;Keskiviikko;77;125;202;15;31;46
89;11.05.2011;2011;05;12;Keskiviikko;100;137;237;7;27;34
89;11.05.2011;2011;05;13;Keskiviikko;128;110;238;23;20;43
89;11.05.2011;2011;05;14;Keskiviikko;200;148;348;37;27;64
89;11.05.2011;2011;05;15;Keskiviikko;277;150;427;33;25;58
89;11.05.2011;2011;05;16;Keskiviikko;293;124;417;24;23;47
89;11.05.2011;2011;05;17;Keskiviikko;124;63;187;16;11;27
89;11.05.2011;2011;05;18;Keskiviikko;92;58;150;17;11;28
89;11.05.2011;2011;05;19;Keskiviikko;80;42;122;25;24;49
89;11.05.2011;2011;05;20;Keskiviikko;60;66;126;21;27;48
89;11.05.2011;2011;05;21;Keskiviikko;58;17;75;10;12;22
89;11.05.2011;2011;05;22;Keskiviikko;23;18;41;4;4;8
89;11.05.2011;2011;05;23;Keskiviikko;11;4;15;4;1;5
89;12.05.2011;2011;05;00;Torstai;9;4;13;1;5;6
89;12.05.2011;2011;05;01;Torstai;7;3;10;1;0;1
89;12.05.2011;2011;05;02;Torstai;2;1;3;0;1;1
89;12.05.2011;2011;05;03;Torstai;5;2;7;0;2;2
89;12.05.2011;2011;05;04;Torstai;6;6;12;3;0;3
89;12.05.2011;2011;05;05;Torstai;7;14;21;1;3;4
89;12.05.2011;2011;05;06;Torstai;58;78;136;2;2;4
89;12.05.2011;2011;05;07;Torstai;102;245;347;8;27;35
89;12.05.2011;2011;05;08;Torstai;85;237;322;6;50;56
89;12.05.2011;2011;05;09;Torstai;47;125;172;12;37;49
89;12.05.2011;2011;05;10;Torstai;51;118;169;11;22;33
89;12.05.2011;2011;05;11;Torstai;101;110;211;40;40;80
89;12.05.2011;2011;05;12;Torstai;110;123;233;22;30;52
89;12.05.2011;2011;05;13;Torstai;118;136;254;20;34;54
89;12.05.2011;2011;05;14;Torstai;182;130;312;34;30;64
89;12.05.2011;2011;05;15;Torstai;257;154;411;40;31;71
89;12.05.2011;2011;05;16;Torstai;306;142;448;39;24;63
89;12.05.2011;2011;05;17;Torstai;147;115;262;28;29;57
89;12.05.2011;2011;05;18;Torstai;126;104;230;33;36;69
89;12.05.2011;2011;05;19;Torstai;121;61;182;45;40;85
89;12.05.2011;2011;05;20;Torstai;125;80;205;36;41;77
89;12.05.2011;2011;05;21;Torstai;75;35;110;27;31;58
89;12.05.2011;2011;05;22;Torstai;36;22;58;8;14;22
89;12.05.2011;2011;05;23;Torstai;26;10;36;5;3;8
89;13.05.2011;2011;05;00;Perjantai;17;3;20;5;1;6
89;13.05.2011;2011;05;01;Perjantai;9;6;15;0;1;1
89;13.05.2011;2011;05;02;Perjantai;5;2;7;2;3;5
89;13.05.2011;2011;05;03;Perjantai;4;1;5;0;1;1
89;13.05.2011;2011;05;04;Perjantai;9;8;17;3;0;3
89;13.05.2011;2011;05;05;Perjantai;8;13;21;3;1;4
89;13.05.2011;2011;05;06;Perjantai;39;81;120;2;4;6
89;13.05.2011;2011;05;07;Perjantai;99;233;332;8;20;28
89;13.05.2011;2011;05;08;Perjantai;110;226;336;17;37;54
89;13.05.2011;2011;05;09;Perjantai;47;196;243;8;36;44
89;13.05.2011;2011;05;10;Perjantai;49;109;158;17;30;47
89;13.05.2011;2011;05;11;Perjantai;80;136;216;28;24;52
89;13.05.2011;2011;05;12;Perjantai;130;141;271;21;41;62
89;13.05.2011;2011;05;13;Perjantai;149;131;280;28;36;64
89;13.05.2011;2011;05;14;Perjantai;193;149;342;32;34;66
89;13.05.2011;2011;05;15;Perjantai;256;146;402;26;33;59
89;13.05.2011;2011;05;16;Perjantai;227;169;396;30;21;51
89;13.05.2011;2011;05;17;Perjantai;156;103;259;21;39;60
89;13.05.2011;2011;05;18;Perjantai;157;90;247;23;26;49
89;13.05.2011;2011;05;19;Perjantai;109;76;185;28;18;46
89;13.05.2011;2011;05;20;Perjantai;91;69;160;21;32;53
89;13.05.2011;2011;05;21;Perjantai;78;64;142;17;14;31
89;13.05.2011;2011;05;22;Perjantai;17;21;38;5;4;9
89;13.05.2011;2011;05;23;Perjantai;23;14;37;10;8;18
89;14.05.2011;2011;05;00;Lauantai;37;44;81;2;9;11
89;14.05.2011;2011;05;01;Lauantai;29;20;49;9;5;14
89;14.05.2011;2011;05;02;Lauantai;31;4;35;1;2;3
89;14.05.2011;2011;05;03;Lauantai;26;4;30;5;1;6
89;14.05.2011;2011;05;04;Lauantai;13;3;16;6;0;6
89;14.05.2011;2011;05;05;Lauantai;5;3;8;0;1;1
89;14.05.2011;2011;05;06;Lauantai;7;16;23;4;1;5
89;14.05.2011;2011;05;07;Lauantai;14;14;28;5;6;11
89;14.05.2011;2011;05;08;Lauantai;21;43;64;11;11;22
89;14.05.2011;2011;05;09;Lauantai;29;79;108;17;28;45
89;14.05.2011;2011;05;10;Lauantai;39;103;142;13;32;45
89;14.05.2011;2011;05;11;Lauantai;68;128;196;26;33;59
89;14.05.2011;2011;05;12;Lauantai;95;164;259;26;37;63
89;14.05.2011;2011;05;13;Lauantai;111;129;240;24;39;63
89;14.05.2011;2011;05;14;Lauantai;133;122;255;41;31;72
89;14.05.2011;2011;05;15;Lauantai;147;93;240;35;42;77
89;14.05.2011;2011;05;16;Lauantai;115;75;190;30;41;71
89;14.05.2011;2011;05;17;Lauantai;119;123;242;38;38;76
89;14.05.2011;2011;05;18;Lauantai;97;91;188;34;38;72
89;14.05.2011;2011;05;19;Lauantai;93;58;151;29;31;60
89;14.05.2011;2011;05;20;Lauantai;70;57;127;16;17;33
89;14.05.2011;2011;05;21;Lauantai;43;62;105;9;14;23
89;14.05.2011;2011;05;22;Lauantai;36;30;66;7;10;17
89;14.05.2011;2011;05;23;Lauantai;22;25;47;4;6;10
89;15.05.2011;2011;05;00;Sunnuntai;19;24;43;2;6;8
89;15.05.2011;2011;05;01;Sunnuntai;55;23;78;7;2;9
89;15.05.2011;2011;05;02;Sunnuntai;24;10;34;6;1;7
89;15.05.2011;2011;05;03;Sunnuntai;27;1;28;10;4;14
89;15.05.2011;2011;05;04;Sunnuntai;20;2;22;3;1;4
89;15.05.2011;2011;05;05;Sunnuntai;3;0;3;3;0;3
89;15.05.2011;2011;05;06;Sunnuntai;6;6;12;3;4;7
89;15.05.2011;2011;05;07;Sunnuntai;11;10;21;6;14;20
89;15.05.2011;2011;05;08;Sunnuntai;13;11;24;9;10;19
89;15.05.2011;2011;05;09;Sunnuntai;31;35;66;14;25;39
89;15.05.2011;2011;05;10;Sunnuntai;31;79;110;23;32;55
89;15.05.2011;2011;05;11;Sunnuntai;67;109;176;30;50;80
89;15.05.2011;2011;05;12;Sunnuntai;63;88;151;45;37;82
89;15.05.2011;2011;05;13;Sunnuntai;108;104;212;24;23;47
89;15.05.2011;2011;05;14;Sunnuntai;93;97;190;32;75;107
89;15.05.2011;2011;05;15;Sunnuntai;95;98;193;16;33;49
89;15.05.2011;2011;05;16;Sunnuntai;102;82;184;38;45;83
89;15.05.2011;2011;05;17;Sunnuntai;99;90;189;33;37;70
89;15.05.2011;2011;05;18;Sunnuntai;105;63;168;40;40;80
89;15.05.2011;2011;05;19;Sunnuntai;73;67;140;25;25;50
89;15.05.2011;2011;05;20;Sunnuntai;83;59;142;16;17;33
89;15.05.2011;2011;05;21;Sunnuntai;28;18;46;2;2;4
89;15.05.2011;2011;05;22;Sunnuntai;22;13;35;0;2;2
89;15.05.2011;2011;05;23;Sunnuntai;7;6;13;0;0;0
89;16.05.2011;2011;05;00;Maanantai;31;77;108;5;10;15
89;16.05.2011;2011;05;01;Maanantai;22;26;48;2;4;6
89;16.05.2011;2011;05;02;Maanantai;39;8;47;7;4;11
89;16.05.2011;2011;05;03;Maanantai;28;3;31;8;0;8
89;16.05.2011;2011;05;04;Maanantai;10;5;15;6;1;7
89;16.05.2011;2011;05;05;Maanantai;11;12;23;1;0;1
89;16.05.2011;2011;05;06;Maanantai;38;63;101;1;8;9
89;16.05.2011;2011;05;07;Maanantai;61;213;274;5;36;41
89;16.05.2011;2011;05;08;Maanantai;72;242;314;7;50;57
89;16.05.2011;2011;05;09;Maanantai;70;158;228;17;38;55
89;16.05.2011;2011;05;10;Maanantai;67;80;147;8;18;26
89;16.05.2011;2011;05;11;Maanantai;81;96;177;14;35;49
89;16.05.2011;2011;05;12;Maanantai;112;88;200;26;23;49
89;16.05.2011;2011;05;13;Maanantai;96;67;163;23;17;40
89;16.05.2011;2011;05;14;Maanantai;167;81;248;18;13;31
89;16.05.2011;2011;05;15;Maanantai;194;120;314;20;26;46
89;16.05.2011;2011;05;16;Maanantai;267;122;389;29;17;46
89;16.05.2011;2011;05;17;Maanantai;145;67;212;22;15;37
89;16.05.2011;2011;05;18;Maanantai;65;29;94;6;10;16
89;16.05.2011;2011;05;19;Maanantai;88;3;91;24;6;30
89;16.05.2011;2011;05;20;Maanantai;84;0;84;11;0;11
89;16.05.2011;2011;05;21;Maanantai;43;1;44;11;0;11
89;16.05.2011;2011;05;22;Maanantai;17;1;18;10;2;12
89;16.05.2011;2011;05;23;Maanantai;7;5;12;2;2;4
89;17.05.2011;2011;05;00;Tiistai;0;2;2;1;1;2
89;17.05.2011;2011;05;01;Tiistai;4;0;4;2;1;3
89;17.05.2011;2011;05;02;Tiistai;1;0;1;0;0;0
89;17.05.2011;2011;05;03;Tiistai;0;0;0;1;0;1
89;17.05.2011;2011;05;04;Tiistai;1;5;6;1;0;1
89;17.05.2011;2011;05;05;Tiistai;4;18;22;1;1;2
89;17.05.2011;2011;05;06;Tiistai;36;87;123;5;4;9
89;17.05.2011;2011;05;07;Tiistai;57;237;294;7;24;31
89;17.05.2011;2011;05;08;Tiistai;84;200;284;5;36;41
89;17.05.2011;2011;05;09;Tiistai;43;134;177;10;28;38
89;17.05.2011;2011;05;10;Tiistai;48;82;130;16;23;39
89;17.05.2011;2011;05;11;Tiistai;74;75;149;13;23;36
89;17.05.2011;2011;05;12;Tiistai;52;96;148;27;28;55
89;17.05.2011;2011;05;13;Tiistai;90;69;159;28;34;62
89;17.05.2011;2011;05;14;Tiistai;102;88;190;30;30;60
89;17.05.2011;2011;05;15;Tiistai;206;107;313;32;24;56
89;17.05.2011;2011;05;16;Tiistai;234;123;357;34;17;51
89;17.05.2011;2011;05;17;Tiistai;147;106;253;33;35;68
89;17.05.2011;2011;05;18;Tiistai;143;84;227;52;56;108
89;17.05.2011;2011;05;19;Tiistai;121;75;196;45;47;92
89;17.05.2011;2011;05;20;Tiistai;111;58;169;45;26;71
89;17.05.2011;2011;05;21;Tiistai;69;43;112;22;29;51
89;17.05.2011;2011;05;22;Tiistai;26;14;40;10;11;21
89;17.05.2011;2011;05;23;Tiistai;10;5;15;0;5;5
89;18.05.2011;2011;05;00;Keskiviikko;11;3;14;1;2;3
89;18.05.2011;2011;05;01;Keskiviikko;8;1;9;0;0;0
89;18.05.2011;2011;05;02;Keskiviikko;2;0;2;0;2;2
89;18.05.2011;2011;05;03;Keskiviikko;1;2;3;0;1;1
89;18.05.2011;2011;05;04;Keskiviikko;1;5;6;1;1;2
89;18.05.2011;2011;05;05;Keskiviikko;11;15;26;2;0;2
89;18.05.2011;2011;05;06;Keskiviikko;61;59;120;6;10;16
89;18.05.2011;2011;05;07;Keskiviikko;91;238;329;8;20;28
89;18.05.2011;2011;05;08;Keskiviikko;80;252;332;9;41;50
89;18.05.2011;2011;05;09;Keskiviikko;48;145;193;19;40;59
89;18.05.2011;2011;05;10;Keskiviikko;70;103;173;17;22;39
89;18.05.2011;2011;05;11;Keskiviikko;73;120;193;18;28;46
89;18.05.2011;2011;05;12;Keskiviikko;98;118;216;21;33;54
89;18.05.2011;2011;05;13;Keskiviikko;136;123;259;15;38;53
89;18.05.2011;2011;05;14;Keskiviikko;188;131;319;30;23;53
89;18.05.2011;2011;05;15;Keskiviikko;240;171;411;24;30;54
89;18.05.2011;2011;05;16;Keskiviikko;287;153;440;30;27;57
89;18.05.2011;2011;05;17;Keskiviikko;191;163;354;34;41;75
89;18.05.2011;2011;05;18;Keskiviikko;150;110;260;45;42;87
89;18.05.2011;2011;05;19;Keskiviikko;162;54;216;37;30;67
89;18.05.2011;2011;05;20;Keskiviikko;128;66;194;34;38;72
89;18.05.2011;2011;05;21;Keskiviikko;57;28;85;14;21;35
89;18.05.2011;2011;05;22;Keskiviikko;32;33;65;4;4;8
89;18.05.2011;2011;05;23;Keskiviikko;24;17;41;5;4;9
89;19.05.2011;2011;05;00;Torstai;10;2;12;2;3;5
89;19.05.2011;2011;05;01;Torstai;12;4;16;1;0;1
89;19.05.2011;2011;05;02;Torstai;9;11;20;1;2;3
89;19.05.2011;2011;05;03;Torstai;8;1;9;0;2;2
89;19.05.2011;2011;05;04;Torstai;5;6;11;2;0;2
89;19.05.2011;2011;05;05;Torstai;6;12;18;1;0;1
89;19.05.2011;2011;05;06;Torstai;39;80;119;3;9;12
89;19.05.2011;2011;05;07;Torstai;75;242;317;12;27;39
89;19.05.2011;2011;05;08;Torstai;88;233;321;17;48;65
89;19.05.2011;2011;05;09;Torstai;109;122;231;54;82;136
89;19.05.2011;2011;05;10;Torstai;83;63;146;47;38;85
89;19.05.2011;2011;05;11;Torstai;44;30;74;6;20;26
89;19.05.2011;2011;05;12;Torstai;57;44;101;10;11;21
89;19.05.2011;2011;05;13;Torstai;80;36;116;13;7;20
89;19.05.2011;2011;05;14;Torstai;113;59;172;10;10;20
89;19.05.2011;2011;05;15;Torstai;174;83;257;15;3;18
89;19.05.2011;2011;05;16;Torstai;189;96;285;14;8;22
89;19.05.2011;2011;05;17;Torstai;111;77;188;21;20;41
89;19.05.2011;2011;05;18;Torstai;105;81;186;36;33;69
89;19.05.2011;2011;05;19;Torstai;82;48;130;34;40;74
89;19.05.2011;2011;05;20;Torstai;73;43;116;27;31;58
89;19.05.2011;2011;05;21;Torstai;53;30;83;23;25;48
89;19.05.2011;2011;05;22;Torstai;20;14;34;5;7;12
89;19.05.2011;2011;05;23;Torstai;9;13;22;5;2;7
89;20.05.2011;2011;05;00;Perjantai;4;3;7;3;0;3
89;20.05.2011;2011;05;01;Perjantai;16;5;21;0;2;2
89;20.05.2011;2011;05;02;Perjantai;10;4;14;1;2;3
89;20.05.2011;2011;05;03;Perjantai;1;2;3;3;0;3
89;20.05.2011;2011;05;04;Perjantai;2;8;10;2;0;2
89;20.05.2011;2011;05;05;Perjantai;6;14;20;3;0;3
89;20.05.2011;2011;05;06;Perjantai;34;75;109;2;4;6
89;20.05.2011;2011;05;07;Perjantai;68;195;263;5;23;28
89;20.05.2011;2011;05;08;Perjantai;88;206;294;9;26;35
89;20.05.2011;2011;05;09;Perjantai;58;152;210;16;35;51
89;20.05.2011;2011;05;10;Perjantai;57;123;180;24;29;53
89;20.05.2011;2011;05;11;Perjantai;96;123;219;24;30;54
89;20.05.2011;2011;05;12;Perjantai;140;126;266;30;32;62
89;20.05.2011;2011;05;13;Perjantai;171;141;312;36;33;69
89;20.05.2011;2011;05;14;Perjantai;194;138;332;21;18;39
89;20.05.2011;2011;05;15;Perjantai;209;118;327;37;23;60
89;20.05.2011;2011;05;16;Perjantai;217;138;355;33;28;61
89;20.05.2011;2011;05;17;Perjantai;140;124;264;29;33;62
89;20.05.2011;2011;05;18;Perjantai;135;101;236;25;47;72
89;20.05.2011;2011;05;19;Perjantai;112;97;209;36;43;79
89;20.05.2011;2011;05;20;Perjantai;110;80;190;22;25;47
89;20.05.2011;2011;05;21;Perjantai;63;57;120;25;34;59
89;20.05.2011;2011;05;22;Perjantai;62;85;147;13;19;32
89;20.05.2011;2011;05;23;Perjantai;40;50;90;8;11;19
89;21.05.2011;2011;05;00;Lauantai;42;29;71;13;11;24
89;21.05.2011;2011;05;01;Lauantai;41;18;59;4;7;11
89;21.05.2011;2011;05;02;Lauantai;38;6;44;8;4;12
89;21.05.2011;2011;05;03;Lauantai;31;4;35;10;0;10
89;21.05.2011;2011;05;04;Lauantai;15;8;23;4;0;4
89;21.05.2011;2011;05;05;Lauantai;8;1;9;1;1;2
89;21.05.2011;2011;05;06;Lauantai;8;13;21;3;2;5
89;21.05.2011;2011;05;07;Lauantai;18;18;36;6;7;13
89;21.05.2011;2011;05;08;Lauantai;15;37;52;7;10;17
89;21.05.2011;2011;05;09;Lauantai;23;90;113;19;20;39
89;21.05.2011;2011;05;10;Lauantai;49;128;177;9;27;36
89;21.05.2011;2011;05;11;Lauantai;84;142;226;35;126;161
89;21.05.2011;2011;05;12;Lauantai;113;197;310;77;388;465
89;21.05.2011;2011;05;13;Lauantai;61;195;256;179;1016;1195
89;21.05.2011;2011;05;14;Lauantai;134;135;269;70;296;366
89;21.05.2011;2011;05;15;Lauantai;147;102;249;38;199;237
89;21.05.2011;2011;05;16;Lauantai;100;74;174;35;61;96
89;21.05.2011;2011;05;17;Lauantai;87;71;158;30;24;54
89;21.05.2011;2011;05;18;Lauantai;80;79;159;22;19;41
89;21.05.2011;2011;05;19;Lauantai;48;56;104;14;19;33
89;21.05.2011;2011;05;20;Lauantai;56;62;118;20;13;33
89;21.05.2011;2011;05;21;Lauantai;56;29;85;17;9;26
89;21.05.2011;2011;05;22;Lauantai;33;13;46;1;3;4
89;21.05.2011;2011;05;23;Lauantai;22;11;33;6;4;10
89;22.05.2011;2011;05;00;Sunnuntai;24;37;61;3;5;8
89;22.05.2011;2011;05;01;Sunnuntai;16;7;23;4;3;7
89;22.05.2011;2011;05;02;Sunnuntai;26;9;35;3;3;6
89;22.05.2011;2011;05;03;Sunnuntai;17;0;17;13;1;14
89;22.05.2011;2011;05;04;Sunnuntai;17;1;18;3;1;4
89;22.05.2011;2011;05;05;Sunnuntai;9;3;12;1;1;2
89;22.05.2011;2011;05;06;Sunnuntai;4;11;15;2;0;2
89;22.05.2011;2011;05;07;Sunnuntai;13;8;21;6;13;19
89;22.05.2011;2011;05;08;Sunnuntai;12;18;30;6;12;18
89;22.05.2011;2011;05;09;Sunnuntai;22;51;73;15;21;36
89;22.05.2011;2011;05;10;Sunnuntai;29;93;122;38;48;86
89;22.05.2011;2011;05;11;Sunnuntai;84;150;234;38;63;101
89;22.05.2011;2011;05;12;Sunnuntai;101;141;242;36;55;91
89;22.05.2011;2011;05;13;Sunnuntai;147;147;294;58;66;124
89;22.05.2011;2011;05;14;Sunnuntai;175;126;301;50;95;145
89;22.05.2011;2011;05;15;Sunnuntai;168;173;341;55;56;111
89;22.05.2011;2011;05;16;Sunnuntai;188;147;335;45;63;108
89;22.05.2011;2011;05;17;Sunnuntai;135;102;237;43;46;89
89;22.05.2011;2011;05;18;Sunnuntai;128;131;259;45;61;106
89;22.05.2011;2011;05;19;Sunnuntai;133;77;210;48;37;85
89;22.05.2011;2011;05;20;Sunnuntai;83;44;127;30;29;59
89;22.05.2011;2011;05;21;Sunnuntai;59;23;82;14;8;22
89;22.05.2011;2011;05;22;Sunnuntai;20;15;35;5;10;15
89;22.05.2011;2011;05;23;Sunnuntai;16;9;25;5;4;9
89;23.05.2011;2011;05;00;Maanantai;8;2;10;3;4;7
89;23.05.2011;2011;05;01;Maanantai;6;3;9;0;2;2
89;23.05.2011;2011;05;02;Maanantai;1;6;7;5;5;10
89;23.05.2011;2011;05;03;Maanantai;1;4;5;1;2;3
89;23.05.2011;2011;05;04;Maanantai;5;10;15;5;1;6
89;23.05.2011;2011;05;05;Maanantai;7;19;26;1;0;1
89;23.05.2011;2011;05;06;Maanantai;67;74;141;4;5;9
89;23.05.2011;2011;05;07;Maanantai;122;243;365;6;30;36
89;23.05.2011;2011;05;08;Maanantai;121;256;377;14;44;58
89;23.05.2011;2011;05;09;Maanantai;65;173;238;10;30;40
89;23.05.2011;2011;05;10;Maanantai;81;109;190;26;26;52
89;23.05.2011;2011;05;11;Maanantai;118;131;249;21;40;61
89;23.05.2011;2011;05;12;Maanantai;135;123;258;24;32;56
89;23.05.2011;2011;05;13;Maanantai;219;111;330;22;31;53
89;23.05.2011;2011;05;14;Maanantai;193;118;311;15;31;46
89;23.05.2011;2011;05;15;Maanantai;276;107;383;22;31;53
89;23.05.2011;2011;05;16;Maanantai;334;138;472;20;15;35
89;23.05.2011;2011;05;17;Maanantai;193;76;269;25;23;48
89;23.05.2011;2011;05;18;Maanantai;115;55;170;34;30;64
89;23.05.2011;2011;05;19;Maanantai;96;38;134;16;11;27
89;23.05.2011;2011;05;20;Maanantai;77;26;103;8;20;28
89;23.05.2011;2011;05;21;Maanantai;39;17;56;6;5;11
89;23.05.2011;2011;05;22;Maanantai;19;13;32;3;2;5
89;23.05.2011;2011;05;23;Maanantai;16;6;22;1;0;1
89;24.05.2011;2011;05;00;Tiistai;3;0;3;2;1;3
89;24.05.2011;2011;05;01;Tiistai;2;1;3;3;1;4
89;24.05.2011;2011;05;02;Tiistai;3;0;3;3;0;3
89;24.05.2011;2011;05;03;Tiistai;1;2;3;0;1;1
89;24.05.2011;2011;05;04;Tiistai;3;8;11;1;0;1
89;24.05.2011;2011;05;05;Tiistai;8;17;25;4;6;10
89;24.05.2011;2011;05;06;Tiistai;41;83;124;1;8;9
89;24.05.2011;2011;05;07;Tiistai;96;255;351;4;28;32
89;24.05.2011;2011;05;08;Tiistai;106;237;343;10;37;47
89;24.05.2011;2011;05;09;Tiistai;56;155;211;25;31;56
89;24.05.2011;2011;05;10;Tiistai;62;119;181;21;31;52
89;24.05.2011;2011;05;11;Tiistai;106;129;235;30;42;72
89;24.05.2011;2011;05;12;Tiistai;110;122;232;27;43;70
89;24.05.2011;2011;05;13;Tiistai;145;104;249;23;29;52
89;24.05.2011;2011;05;14;Tiistai;156;112;268;47;31;78
89;24.05.2011;2011;05;15;Tiistai;238;116;354;22;16;38
89;24.05.2011;2011;05;16;Tiistai;325;116;441;26;17;43
89;24.05.2011;2011;05;17;Tiistai;166;93;259;20;19;39
89;24.05.2011;2011;05;18;Tiistai;149;79;228;30;33;63
89;24.05.2011;2011;05;19;Tiistai;101;34;135;28;17;45
89;24.05.2011;2011;05;20;Tiistai;61;32;93;12;6;18
89;24.05.2011;2011;05;21;Tiistai;51;37;88;11;14;25
89;24.05.2011;2011;05;22;Tiistai;28;17;45;5;9;14
89;24.05.2011;2011;05;23;Tiistai;16;7;23;4;0;4
89;25.05.2011;2011;05;00;Keskiviikko;10;4;14;1;0;1
89;25.05.2011;2011;05;01;Keskiviikko;7;1;8;0;0;0
89;25.05.2011;2011;05;02;Keskiviikko;1;1;2;1;1;2
89;25.05.2011;2011;05;03;Keskiviikko;3;0;3;0;0;0
89;25.05.2011;2011;05;04;Keskiviikko;1;9;10;1;0;1
89;25.05.2011;2011;05;05;Keskiviikko;7;8;15;4;1;5
89;25.05.2011;2011;05;06;Keskiviikko;36;90;126;1;7;8
89;25.05.2011;2011;05;07;Keskiviikko;68;264;332;7;40;47
89;25.05.2011;2011;05;08;Keskiviikko;75;241;316;10;31;41
89;25.05.2011;2011;05;09;Keskiviikko;35;150;185;9;33;42
89;25.05.2011;2011;05;10;Keskiviikko;66;98;164;19;23;42
89;25.05.2011;2011;05;11;Keskiviikko;94;148;242;25;44;69
89;25.05.2011;2011;05;12;Keskiviikko;114;125;239;27;34;61
89;25.05.2011;2011;05;13;Keskiviikko;184;106;290;33;32;65
89;25.05.2011;2011;05;14;Keskiviikko;191;106;297;26;21;47
89;25.05.2011;2011;05;15;Keskiviikko;232;173;405;29;25;54
89;25.05.2011;2011;05;16;Keskiviikko;293;160;453;34;45;79
89;25.05.2011;2011;05;17;Keskiviikko;183;202;385;24;43;67
89;25.05.2011;2011;05;18;Keskiviikko;141;235;376;20;54;74
89;25.05.2011;2011;05;19;Keskiviikko;143;140;283;37;46;83
89;25.05.2011;2011;05;20;Keskiviikko;296;67;363;58;24;82
89;25.05.2011;2011;05;21;Keskiviikko;135;39;174;27;16;43
89;25.05.2011;2011;05;22;Keskiviikko;66;22;88;4;6;10
89;25.05.2011;2011;05;23;Keskiviikko;34;22;56;3;4;7
89;26.05.2011;2011;05;00;Torstai;29;7;36;5;2;7
89;26.05.2011;2011;05;01;Torstai;15;9;24;4;1;5
89;26.05.2011;2011;05;02;Torstai;21;8;29;1;0;1
89;26.05.2011;2011;05;03;Torstai;16;0;16;4;0;4
89;26.05.2011;2011;05;04;Torstai;7;7;14;4;0;4
89;26.05.2011;2011;05;05;Torstai;6;19;25;3;0;3
89;26.05.2011;2011;05;06;Torstai;44;91;135;4;8;12
89;26.05.2011;2011;05;07;Torstai;75;248;323;3;27;30
89;26.05.2011;2011;05;08;Torstai;66;274;340;10;23;33
89;26.05.2011;2011;05;09;Torstai;52;146;198;16;43;59
89;26.05.2011;2011;05;10;Torstai;70;79;149;31;28;59
89;26.05.2011;2011;05;11;Torstai;69;67;136;17;19;36
89;26.05.2011;2011;05;12;Torstai;79;89;168;16;27;43
89;26.05.2011;2011;05;13;Torstai;106;87;193;26;11;37
89;26.05.2011;2011;05;14;Torstai;137;108;245;27;24;51
89;26.05.2011;2011;05;15;Torstai;214;125;339;33;24;57
89;26.05.2011;2011;05;16;Torstai;256;131;387;31;27;58
89;26.05.2011;2011;05;17;Torstai;186;116;302;16;28;44
89;26.05.2011;2011;05;18;Torstai;141;71;212;35;24;59
89;26.05.2011;2011;05;19;Torstai;132;70;202;32;25;57
89;26.05.2011;2011;05;20;Torstai;79;42;121;14;27;41
89;26.05.2011;2011;05;21;Torstai;56;42;98;22;13;35
89;26.05.2011;2011;05;22;Torstai;29;23;52;2;4;6
89;26.05.2011;2011;05;23;Torstai;25;6;31;2;8;10
89;27.05.2011;2011;05;00;Perjantai;14;9;23;3;4;7
89;27.05.2011;2011;05;01;Perjantai;5;7;12;6;2;8
89;27.05.2011;2011;05;02;Perjantai;2;4;6;3;3;6
89;27.05.2011;2011;05;03;Perjantai;13;2;15;2;0;2
89;27.05.2011;2011;05;04;Perjantai;13;8;21;2;2;4
89;27.05.2011;2011;05;05;Perjantai;5;15;20;4;2;6
89;27.05.2011;2011;05;06;Perjantai;53;64;117;3;8;11
89;27.05.2011;2011;05;07;Perjantai;86;247;333;3;24;27
89;27.05.2011;2011;05;08;Perjantai;93;215;308;10;25;35
89;27.05.2011;2011;05;09;Perjantai;58;167;225;35;38;73
89;27.05.2011;2011;05;10;Perjantai;70;132;202;11;46;57
89;27.05.2011;2011;05;11;Perjantai;117;126;243;30;23;53
89;27.05.2011;2011;05;12;Perjantai;101;129;230;19;29;48
89;27.05.2011;2011;05;13;Perjantai;171;145;316;25;35;60
89;27.05.2011;2011;05;14;Perjantai;205;142;347;26;23;49
89;27.05.2011;2011;05;15;Perjantai;242;139;381;21;25;46
89;27.05.2011;2011;05;16;Perjantai;210;100;310;39;35;74
89;27.05.2011;2011;05;17;Perjantai;135;110;245;34;22;56
89;27.05.2011;2011;05;18;Perjantai;116;75;191;19;23;42
89;27.05.2011;2011;05;19;Perjantai;77;68;145;20;28;48
89;27.05.2011;2011;05;20;Perjantai;87;63;150;23;25;48
89;27.05.2011;2011;05;21;Perjantai;80;37;117;10;15;25
89;27.05.2011;2011;05;22;Perjantai;30;17;47;7;7;14
89;27.05.2011;2011;05;23;Perjantai;22;19;41;5;1;6
89;28.05.2011;2011;05;00;Lauantai;31;12;43;2;0;2
89;28.05.2011;2011;05;01;Lauantai;26;20;46;4;0;4
89;28.05.2011;2011;05;02;Lauantai;18;3;21;6;1;7
89;28.05.2011;2011;05;03;Lauantai;27;4;31;4;1;5
89;28.05.2011;2011;05;04;Lauantai;13;3;16;4;2;6
89;28.05.2011;2011;05;05;Lauantai;4;11;15;0;2;2
89;28.05.2011;2011;05;06;Lauantai;6;21;27;4;4;8
89;28.05.2011;2011;05;07;Lauantai;11;21;32;0;9;9
89;28.05.2011;2011;05;08;Lauantai;13;24;37;10;6;16
89;28.05.2011;2011;05;09;Lauantai;17;42;59;16;25;41
89;28.05.2011;2011;05;10;Lauantai;36;48;84;10;22;32
89;28.05.2011;2011;05;11;Lauantai;26;33;59;8;13;21
89;28.05.2011;2011;05;12;Lauantai;39;71;110;15;9;24
89;28.05.2011;2011;05;13;Lauantai;46;65;111;15;19;34
89;28.05.2011;2011;05;14;Lauantai;63;46;109;21;21;42
89;28.05.2011;2011;05;15;Lauantai;49;24;73;16;11;27
89;28.05.2011;2011;05;16;Lauantai;55;17;72;17;19;36
89;28.05.2011;2011;05;17;Lauantai;46;38;84;13;9;22
89;28.05.2011;2011;05;18;Lauantai;40;37;77;21;18;39
89;28.05.2011;2011;05;19;Lauantai;26;25;51;15;16;31
89;28.05.2011;2011;05;20;Lauantai;34;35;69;11;14;25
89;28.05.2011;2011;05;21;Lauantai;23;30;53;11;20;31
89;28.05.2011;2011;05;22;Lauantai;18;32;50;5;10;15
89;28.05.2011;2011;05;23;Lauantai;12;21;33;5;6;11
89;29.05.2011;2011;05;00;Sunnuntai;23;25;48;0;6;6
89;29.05.2011;2011;05;01;Sunnuntai;23;22;45;4;1;5
89;29.05.2011;2011;05;02;Sunnuntai;16;5;21;8;4;12
89;29.05.2011;2011;05;03;Sunnuntai;34;0;34;7;0;7
89;29.05.2011;2011;05;04;Sunnuntai;14;0;14;9;0;9
89;29.05.2011;2011;05;05;Sunnuntai;7;10;17;8;6;14
89;29.05.2011;2011;05;06;Sunnuntai;4;5;9;3;2;5
89;29.05.2011;2011;05;07;Sunnuntai;6;8;14;3;14;17
89;29.05.2011;2011;05;08;Sunnuntai;4;8;12;6;7;13
89;29.05.2011;2011;05;09;Sunnuntai;11;24;35;13;13;26
89;29.05.2011;2011;05;10;Sunnuntai;31;47;78;27;24;51
89;29.05.2011;2011;05;11;Sunnuntai;43;92;135;37;52;89
89;29.05.2011;2011;05;12;Sunnuntai;64;85;149;30;36;66
89;29.05.2011;2011;05;13;Sunnuntai;87;93;180;30;45;75
89;29.05.2011;2011;05;14;Sunnuntai;89;83;172;42;33;75
89;29.05.2011;2011;05;15;Sunnuntai;61;47;108;20;29;49
89;29.05.2011;2011;05;16;Sunnuntai;77;34;111;24;16;40
89;29.05.2011;2011;05;17;Sunnuntai;54;40;94;18;27;45
89;29.05.2011;2011;05;18;Sunnuntai;49;38;87;10;13;23
89;29.05.2011;2011;05;19;Sunnuntai;50;21;71;12;19;31
89;29.05.2011;2011;05;20;Sunnuntai;34;13;47;11;9;20
89;29.05.2011;2011;05;21;Sunnuntai;31;14;45;12;11;23
89;29.05.2011;2011;05;22;Sunnuntai;13;6;19;3;4;7
89;29.05.2011;2011;05;23;Sunnuntai;6;12;18;3;2;5
89;30.05.2011;2011;05;00;Maanantai;4;2;6;0;2;2
89;30.05.2011;2011;05;01;Maanantai;1;4;5;2;2;4
89;30.05.2011;2011;05;02;Maanantai;3;7;10;4;1;5
89;30.05.2011;2011;05;03;Maanantai;0;3;3;2;0;2
89;30.05.2011;2011;05;04;Maanantai;1;6;7;1;3;4
89;30.05.2011;2011;05;05;Maanantai;7;16;23;1;0;1
89;30.05.2011;2011;05;06;Maanantai;34;90;124;3;2;5
89;30.05.2011;2011;05;07;Maanantai;71;197;268;5;35;40
89;30.05.2011;2011;05;08;Maanantai;61;242;303;8;26;34
89;30.05.2011;2011;05;09;Maanantai;51;144;195;9;44;53
89;30.05.2011;2011;05;10;Maanantai;88;140;228;24;28;52
89;30.05.2011;2011;05;11;Maanantai;119;102;221;22;27;49
89;30.05.2011;2011;05;12;Maanantai;111;101;212;25;18;43
89;30.05.2011;2011;05;13;Maanantai;172;94;266;23;16;39
89;30.05.2011;2011;05;14;Maanantai;140;96;236;19;18;37
89;30.05.2011;2011;05;15;Maanantai;209;136;345;35;36;71
89;30.05.2011;2011;05;16;Maanantai;246;125;371;28;26;54
89;30.05.2011;2011;05;17;Maanantai;169;96;265;44;31;75
89;30.05.2011;2011;05;18;Maanantai;145;90;235;33;46;79
89;30.05.2011;2011;05;19;Maanantai;117;80;197;46;49;95
89;30.05.2011;2011;05;20;Maanantai;101;54;155;37;33;70
89;30.05.2011;2011;05;21;Maanantai;58;32;90;15;15;30
89;30.05.2011;2011;05;22;Maanantai;39;17;56;11;10;21
89;30.05.2011;2011;05;23;Maanantai;12;10;22;4;3;7
89;31.05.2011;2011;05;00;Tiistai;7;4;11;5;6;11
89;31.05.2011;2011;05;01;Tiistai;6;8;14;0;1;1
89;31.05.2011;2011;05;02;Tiistai;4;2;6;2;1;3
89;31.05.2011;2011;05;03;Tiistai;1;3;4;1;0;1
89;31.05.2011;2011;05;04;Tiistai;2;7;9;2;1;3
89;31.05.2011;2011;05;05;Tiistai;11;22;33;1;4;5
89;31.05.2011;2011;05;06;Tiistai;53;82;135;4;8;12
89;31.05.2011;2011;05;07;Tiistai;106;243;349;5;33;38
89;31.05.2011;2011;05;08;Tiistai;136;268;404;8;34;42
89;31.05.2011;2011;05;09;Tiistai;78;200;278;21;58;79
89;31.05.2011;2011;05;10;Tiistai;84;159;243;37;81;118
89;31.05.2011;2011;05;11;Tiistai;121;171;292;44;75;119
89;31.05.2011;2011;05;12;Tiistai;137;122;259;32;31;63
89;31.05.2011;2011;05;13;Tiistai;163;114;277;34;24;58
89;31.05.2011;2011;05;14;Tiistai;170;123;293;25;37;62
89;31.05.2011;2011;05;15;Tiistai;249;165;414;30;21;51
89;31.05.2011;2011;05;16;Tiistai;309;153;462;40;30;70
89;31.05.2011;2011;05;17;Tiistai;218;135;353;42;43;85
89;31.05.2011;2011;05;18;Tiistai;212;134;346;47;41;88
89;31.05.2011;2011;05;19;Tiistai;147;64;211;44;38;82
89;31.05.2011;2011;05;20;Tiistai;97;56;153;14;17;31
89;31.05.2011;2011;05;21;Tiistai;65;33;98;14;13;27
89;31.05.2011;2011;05;22;Tiistai;50;22;72;12;11;23
89;31.05.2011;2011;05;23;Tiistai;22;6;28;6;5;11
89;01.06.2011;2011;06;00;Keskiviikko;13;9;22;11;13;24
89;01.06.2011;2011;06;01;Keskiviikko;10;1;11;4;0;4
89;01.06.2011;2011;06;02;Keskiviikko;7;0;7;1;0;1
89;01.06.2011;2011;06;03;Keskiviikko;5;0;5;2;2;4
89;01.06.2011;2011;06;04;Keskiviikko;5;8;13;3;1;4
89;01.06.2011;2011;06;05;Keskiviikko;11;18;29;1;5;6
89;01.06.2011;2011;06;06;Keskiviikko;43;77;120;3;9;12
89;01.06.2011;2011;06;07;Keskiviikko;66;225;291;6;25;31
89;01.06.2011;2011;06;08;Keskiviikko;63;240;303;14;33;47
89;01.06.2011;2011;06;09;Keskiviikko;64;145;209;23;30;53
89;01.06.2011;2011;06;10;Keskiviikko;79;138;217;15;35;50
89;01.06.2011;2011;06;11;Keskiviikko;84;102;186;25;26;51
89;01.06.2011;2011;06;12;Keskiviikko;93;55;148;16;11;27
89;01.06.2011;2011;06;13;Keskiviikko;99;65;164;14;12;26
89;01.06.2011;2011;06;14;Keskiviikko;108;98;206;15;17;32
89;01.06.2011;2011;06;15;Keskiviikko;181;101;282;15;6;21
89;01.06.2011;2011;06;16;Keskiviikko;178;76;254;23;16;39
89;01.06.2011;2011;06;17;Keskiviikko;96;48;144;13;14;27
89;01.06.2011;2011;06;18;Keskiviikko;67;35;102;12;12;24
89;01.06.2011;2011;06;19;Keskiviikko;53;36;89;12;16;28
89;01.06.2011;2011;06;20;Keskiviikko;58;46;104;16;21;37
89;01.06.2011;2011;06;21;Keskiviikko;46;39;85;10;8;18
89;01.06.2011;2011;06;22;Keskiviikko;34;28;62;12;15;27
89;01.06.2011;2011;06;23;Keskiviikko;21;29;50;7;7;14
89;02.06.2011;2011;06;00;Torstai;14;12;26;18;14;32
89;02.06.2011;2011;06;01;Torstai;20;8;28;2;2;4
89;02.06.2011;2011;06;02;Torstai;19;8;27;7;3;10
89;02.06.2011;2011;06;03;Torstai;28;4;32;8;2;10
89;02.06.2011;2011;06;04;Torstai;22;2;24;10;0;10
89;02.06.2011;2011;06;05;Torstai;7;1;8;0;0;0
89;02.06.2011;2011;06;06;Torstai;8;19;27;4;3;7
89;02.06.2011;2011;06;07;Torstai;8;12;20;2;3;5
89;02.06.2011;2011;06;08;Torstai;10;24;34;5;10;15
89;02.06.2011;2011;06;09;Torstai;18;28;46;12;19;31
89;02.06.2011;2011;06;10;Torstai;36;54;90;21;23;44
89;02.06.2011;2011;06;11;Torstai;63;80;143;35;36;71
89;02.06.2011;2011;06;12;Torstai;88;95;183;41;49;90
89;02.06.2011;2011;06;13;Torstai;94;117;211;38;71;109
89;02.06.2011;2011;06;14;Torstai;103;113;216;33;44;77
89;02.06.2011;2011;06;15;Torstai;98;86;184;30;35;65
89;02.06.2011;2011;06;16;Torstai;89;70;159;29;39;68
89;02.06.2011;2011;06;17;Torstai;87;90;177;41;43;84
89;02.06.2011;2011;06;18;Torstai;82;84;166;35;23;58
89;02.06.2011;2011;06;19;Torstai;91;88;179;28;42;70
89;02.06.2011;2011;06;20;Torstai;74;66;140;29;40;69
89;02.06.2011;2011;06;21;Torstai;66;41;107;15;14;29
89;02.06.2011;2011;06;22;Torstai;30;38;68;7;10;17
89;02.06.2011;2011;06;23;Torstai;22;13;35;3;2;5
89;03.06.2011;2011;06;00;Perjantai;14;12;26;3;3;6
89;03.06.2011;2011;06;01;Perjantai;10;8;18;0;5;5
89;03.06.2011;2011;06;02;Perjantai;5;8;13;1;2;3
89;03.06.2011;2011;06;03;Perjantai;7;4;11;1;1;2
89;03.06.2011;2011;06;04;Perjantai;7;8;15;1;1;2
89;03.06.2011;2011;06;05;Perjantai;7;18;25;0;5;5
89;03.06.2011;2011;06;06;Perjantai;28;60;88;6;2;8
89;03.06.2011;2011;06;07;Perjantai;53;153;206;4;25;29
89;03.06.2011;2011;06;08;Perjantai;72;169;241;8;19;27
89;03.06.2011;2011;06;09;Perjantai;48;163;211;11;29;40
89;03.06.2011;2011;06;10;Perjantai;91;211;302;18;45;63
89;03.06.2011;2011;06;11;Perjantai;131;136;267;18;22;40
89;03.06.2011;2011;06;12;Perjantai;138;171;309;38;42;80
89;03.06.2011;2011;06;13;Perjantai;158;187;345;31;45;76
89;03.06.2011;2011;06;14;Perjantai;191;148;339;25;38;63
89;03.06.2011;2011;06;15;Perjantai;218;146;364;38;30;68
89;03.06.2011;2011;06;16;Perjantai;217;138;355;29;32;61
89;03.06.2011;2011;06;17;Perjantai;181;129;310;31;37;68
89;03.06.2011;2011;06;18;Perjantai;151;111;262;35;48;83
89;03.06.2011;2011;06;19;Perjantai;104;99;203;33;35;68
89;03.06.2011;2011;06;20;Perjantai;98;85;183;27;18;45
89;03.06.2011;2011;06;21;Perjantai;64;46;110;8;23;31
89;03.06.2011;2011;06;22;Perjantai;61;51;112;18;21;39
89;03.06.2011;2011;06;23;Perjantai;36;35;71;14;13;27
89;04.06.2011;2011;06;00;Lauantai;43;31;74;6;9;15
89;04.06.2011;2011;06;01;Lauantai;23;9;32;9;5;14
89;04.06.2011;2011;06;02;Lauantai;26;6;32;7;2;9
89;04.06.2011;2011;06;03;Lauantai;21;4;25;8;2;10
89;04.06.2011;2011;06;04;Lauantai;15;4;19;4;1;5
89;04.06.2011;2011;06;05;Lauantai;6;10;16;1;5;6
89;04.06.2011;2011;06;06;Lauantai;11;17;28;5;0;5
89;04.06.2011;2011;06;07;Lauantai;19;26;45;3;8;11
89;04.06.2011;2011;06;08;Lauantai;21;72;93;11;14;25
89;04.06.2011;2011;06;09;Lauantai;46;97;143;18;30;48
89;04.06.2011;2011;06;10;Lauantai;80;111;191;16;34;50
89;04.06.2011;2011;06;11;Lauantai;93;120;213;16;30;46
89;04.06.2011;2011;06;12;Lauantai;90;136;226;25;47;72
89;04.06.2011;2011;06;13;Lauantai;109;126;235;38;36;74
89;04.06.2011;2011;06;14;Lauantai;115;93;208;25;33;58
89;04.06.2011;2011;06;15;Lauantai;118;45;163;19;21;40
89;04.06.2011;2011;06;16;Lauantai;78;41;119;15;25;40
89;04.06.2011;2011;06;17;Lauantai;48;34;82;11;15;26
89;04.06.2011;2011;06;18;Lauantai;70;119;189;18;30;48
89;04.06.2011;2011;06;19;Lauantai;44;102;146;29;34;63
89;04.06.2011;2011;06;20;Lauantai;70;102;172;26;33;59
89;04.06.2011;2011;06;21;Lauantai;39;111;150;10;31;41
89;04.06.2011;2011;06;22;Lauantai;60;92;152;7;29;36
89;04.06.2011;2011;06;23;Lauantai;54;42;96;10;14;24
89;05.06.2011;2011;06;00;Sunnuntai;44;24;68;10;11;21
89;05.06.2011;2011;06;01;Sunnuntai;59;13;72;7;11;18
89;05.06.2011;2011;06;02;Sunnuntai;66;9;75;14;1;15
89;05.06.2011;2011;06;03;Sunnuntai;48;3;51;34;7;41
89;05.06.2011;2011;06;04;Sunnuntai;29;1;30;14;0;14
89;05.06.2011;2011;06;05;Sunnuntai;10;7;17;3;0;3
89;05.06.2011;2011;06;06;Sunnuntai;4;10;14;1;0;1
89;05.06.2011;2011;06;07;Sunnuntai;8;9;17;7;15;22
89;05.06.2011;2011;06;08;Sunnuntai;20;14;34;3;8;11
89;05.06.2011;2011;06;09;Sunnuntai;21;29;50;16;23;39
89;05.06.2011;2011;06;10;Sunnuntai;31;83;114;20;30;50
89;05.06.2011;2011;06;11;Sunnuntai;57;96;153;32;52;84
89;05.06.2011;2011;06;12;Sunnuntai;89;100;189;21;47;68
89;05.06.2011;2011;06;13;Sunnuntai;121;125;246;24;51;75
89;05.06.2011;2011;06;14;Sunnuntai;108;114;222;39;44;83
89;05.06.2011;2011;06;15;Sunnuntai;127;102;229;29;29;58
89;05.06.2011;2011;06;16;Sunnuntai;122;83;205;24;28;52
89;05.06.2011;2011;06;17;Sunnuntai;102;119;221;37;31;68
89;05.06.2011;2011;06;18;Sunnuntai;110;79;189;33;35;68
89;05.06.2011;2011;06;19;Sunnuntai;78;42;120;29;22;51
89;05.06.2011;2011;06;20;Sunnuntai;59;68;127;20;21;41
89;05.06.2011;2011;06;21;Sunnuntai;41;39;80;22;13;35
89;05.06.2011;2011;06;22;Sunnuntai;25;13;38;8;4;12
89;05.06.2011;2011;06;23;Sunnuntai;14;8;22;1;3;4
89;06.06.2011;2011;06;00;Maanantai;3;7;10;3;2;5
89;06.06.2011;2011;06;01;Maanantai;7;4;11;0;2;2
89;06.06.2011;2011;06;02;Maanantai;3;4;7;1;0;1
89;06.06.2011;2011;06;03;Maanantai;5;4;9;2;0;2
89;06.06.2011;2011;06;04;Maanantai;5;14;19;2;2;4
89;06.06.2011;2011;06;05;Maanantai;4;23;27;1;3;4
89;06.06.2011;2011;06;06;Maanantai;44;81;125;1;4;5
89;06.06.2011;2011;06;07;Maanantai;87;207;294;7;18;25
89;06.06.2011;2011;06;08;Maanantai;84;218;302;8;20;28
89;06.06.2011;2011;06;09;Maanantai;71;144;215;10;20;30
89;06.06.2011;2011;06;10;Maanantai;78;110;188;16;19;35
89;06.06.2011;2011;06;11;Maanantai;82;137;219;15;38;53
89;06.06.2011;2011;06;12;Maanantai;116;130;246;24;42;66
89;06.06.2011;2011;06;13;Maanantai;162;138;300;27;23;50
89;06.06.2011;2011;06;14;Maanantai;186;137;323;40;28;68
89;06.06.2011;2011;06;15;Maanantai;272;156;428;34;28;62
89;06.06.2011;2011;06;16;Maanantai;299;157;456;25;23;48
89;06.06.2011;2011;06;17;Maanantai;230;122;352;45;38;83
89;06.06.2011;2011;06;18;Maanantai;212;108;320;53;44;97
89;06.06.2011;2011;06;19;Maanantai;143;89;232;39;37;76
89;06.06.2011;2011;06;20;Maanantai;133;107;240;35;45;80
89;06.06.2011;2011;06;21;Maanantai;103;60;163;41;40;81
89;06.06.2011;2011;06;22;Maanantai;43;36;79;10;10;20
89;06.06.2011;2011;06;23;Maanantai;33;22;55;6;3;9
89;07.06.2011;2011;06;00;Tiistai;16;14;30;5;2;7
89;07.06.2011;2011;06;01;Tiistai;13;7;20;2;4;6
89;07.06.2011;2011;06;02;Tiistai;6;4;10;2;1;3
89;07.06.2011;2011;06;03;Tiistai;6;3;9;2;0;2
89;07.06.2011;2011;06;04;Tiistai;3;11;14;2;1;3
89;07.06.2011;2011;06;05;Tiistai;9;23;32;1;1;2
89;07.06.2011;2011;06;06;Tiistai;56;91;147;4;6;10
89;07.06.2011;2011;06;07;Tiistai;146;183;329;5;18;23
89;07.06.2011;2011;06;08;Tiistai;142;160;302;13;32;45
89;07.06.2011;2011;06;09;Tiistai;95;145;240;10;34;44
89;07.06.2011;2011;06;10;Tiistai;85;135;220;22;33;55
89;07.06.2011;2011;06;11;Tiistai;138;148;286;25;39;64
89;07.06.2011;2011;06;12;Tiistai;201;133;334;22;26;48
89;07.06.2011;2011;06;13;Tiistai;208;197;405;47;63;110
89;07.06.2011;2011;06;14;Tiistai;245;183;428;46;41;87
89;07.06.2011;2011;06;15;Tiistai;384;242;626;41;34;75
89;07.06.2011;2011;06;16;Tiistai;464;184;648;40;32;72
89;07.06.2011;2011;06;17;Tiistai;342;170;512;62;42;104
89;07.06.2011;2011;06;18;Tiistai;332;209;541;64;40;104
89;07.06.2011;2011;06;19;Tiistai;231;110;341;26;39;65
89;07.06.2011;2011;06;20;Tiistai;148;103;251;32;36;68
89;07.06.2011;2011;06;21;Tiistai;93;46;139;10;14;24
89;07.06.2011;2011;06;22;Tiistai;43;25;68;10;13;23
89;07.06.2011;2011;06;23;Tiistai;34;16;50;9;5;14
89;08.06.2011;2011;06;00;Keskiviikko;15;8;23;4;1;5
89;08.06.2011;2011;06;01;Keskiviikko;9;4;13;3;10;13
89;08.06.2011;2011;06;02;Keskiviikko;4;5;9;0;0;0
89;08.06.2011;2011;06;03;Keskiviikko;1;2;3;3;0;3
89;08.06.2011;2011;06;04;Keskiviikko;6;13;19;1;0;1
89;08.06.2011;2011;06;05;Keskiviikko;11;17;28;3;3;6
89;08.06.2011;2011;06;06;Keskiviikko;56;95;151;5;9;14
89;08.06.2011;2011;06;07;Keskiviikko;168;195;363;4;14;18
89;08.06.2011;2011;06;08;Keskiviikko;154;150;304;4;26;30
89;08.06.2011;2011;06;09;Keskiviikko;100;134;234;17;26;43
89;08.06.2011;2011;06;10;Keskiviikko;94;164;258;16;31;47
89;08.06.2011;2011;06;11;Keskiviikko;189;143;332;24;26;50
89;08.06.2011;2011;06;12;Keskiviikko;253;148;401;19;41;60
89;08.06.2011;2011;06;13;Keskiviikko;237;174;411;33;31;64
89;08.06.2011;2011;06;14;Keskiviikko;275;203;478;43;36;79
89;08.06.2011;2011;06;15;Keskiviikko;437;184;621;46;37;83
89;08.06.2011;2011;06;16;Keskiviikko;504;208;712;49;29;78
89;08.06.2011;2011;06;17;Keskiviikko;376;177;553;41;34;75
89;08.06.2011;2011;06;18;Keskiviikko;312;139;451;35;45;80
89;08.06.2011;2011;06;19;Keskiviikko;311;171;482;63;50;113
89;08.06.2011;2011;06;20;Keskiviikko;225;157;382;26;34;60
89;08.06.2011;2011;06;21;Keskiviikko;152;102;254;26;29;55
89;08.06.2011;2011;06;22;Keskiviikko;95;69;164;15;15;30
89;08.06.2011;2011;06;23;Keskiviikko;26;37;63;7;7;14
89;09.06.2011;2011;06;00;Torstai;30;16;46;3;3;6
89;09.06.2011;2011;06;01;Torstai;18;6;24;5;4;9
89;09.06.2011;2011;06;02;Torstai;14;5;19;2;0;2
89;09.06.2011;2011;06;03;Torstai;13;7;20;1;1;2
89;09.06.2011;2011;06;04;Torstai;11;11;22;7;2;9
89;09.06.2011;2011;06;05;Torstai;7;20;27;0;2;2
89;09.06.2011;2011;06;06;Torstai;46;110;156;3;4;7
89;09.06.2011;2011;06;07;Torstai;125;210;335;10;23;33
89;09.06.2011;2011;06;08;Torstai;150;192;342;7;26;33
89;09.06.2011;2011;06;09;Torstai;82;156;238;11;41;52
89;09.06.2011;2011;06;10;Torstai;92;141;233;23;20;43
89;09.06.2011;2011;06;11;Torstai;168;147;315;16;24;40
89;09.06.2011;2011;06;12;Torstai;196;153;349;24;26;50
89;09.06.2011;2011;06;13;Torstai;206;174;380;31;29;60
89;09.06.2011;2011;06;14;Torstai;276;192;468;25;49;74
89;09.06.2011;2011;06;15;Torstai;368;194;562;33;28;61
89;09.06.2011;2011;06;16;Torstai;427;230;657;28;33;61
89;09.06.2011;2011;06;17;Torstai;323;207;530;58;32;90
89;09.06.2011;2011;06;18;Torstai;258;193;451;43;40;83
89;09.06.2011;2011;06;19;Torstai;249;158;407;45;45;90
89;09.06.2011;2011;06;20;Torstai;211;150;361;24;40;64
89;09.06.2011;2011;06;21;Torstai;160;92;252;24;29;53
89;09.06.2011;2011;06;22;Torstai;103;70;173;20;25;45
89;09.06.2011;2011;06;23;Torstai;48;27;75;10;16;26
89;10.06.2011;2011;06;00;Perjantai;19;12;31;6;4;10
89;10.06.2011;2011;06;01;Perjantai;8;4;12;3;1;4
89;10.06.2011;2011;06;02;Perjantai;8;5;13;2;1;3
89;10.06.2011;2011;06;03;Perjantai;8;1;9;6;8;14
89;10.06.2011;2011;06;04;Perjantai;5;11;16;2;1;3
89;10.06.2011;2011;06;05;Perjantai;14;18;32;0;3;3
89;10.06.2011;2011;06;06;Perjantai;76;99;175;4;5;9
89;10.06.2011;2011;06;07;Perjantai;174;157;331;5;13;18
89;10.06.2011;2011;06;08;Perjantai;202;106;308;7;20;27
89;10.06.2011;2011;06;09;Perjantai;107;89;196;8;31;39
89;10.06.2011;2011;06;10;Perjantai;141;93;234;10;20;30
89;10.06.2011;2011;06;11;Perjantai;200;90;290;25;29;54
89;10.06.2011;2011;06;12;Perjantai;212;114;326;13;40;53
89;10.06.2011;2011;06;13;Perjantai;269;162;431;28;24;52
89;10.06.2011;2011;06;14;Perjantai;276;154;430;40;36;76
89;10.06.2011;2011;06;15;Perjantai;387;116;503;34;21;55
89;10.06.2011;2011;06;16;Perjantai;384;135;519;37;27;64
89;10.06.2011;2011;06;17;Perjantai;303;110;413;36;29;65
89;10.06.2011;2011;06;18;Perjantai;259;103;362;65;58;123
89;10.06.2011;2011;06;19;Perjantai;299;108;407;43;34;77
89;10.06.2011;2011;06;20;Perjantai;226;146;372;26;41;67
89;10.06.2011;2011;06;21;Perjantai;175;182;357;33;29;62
89;10.06.2011;2011;06;22;Perjantai;118;125;243;38;58;96
89;10.06.2011;2011;06;23;Perjantai;103;121;224;27;48;75
89;11.06.2011;2011;06;00;Lauantai;73;74;147;15;30;45
89;11.06.2011;2011;06;01;Lauantai;74;41;115;15;13;28
89;11.06.2011;2011;06;02;Lauantai;81;12;93;18;7;25
89;11.06.2011;2011;06;03;Lauantai;39;11;50;8;5;13
89;11.06.2011;2011;06;04;Lauantai;28;3;31;10;2;12
89;11.06.2011;2011;06;05;Lauantai;12;12;24;7;1;8
89;11.06.2011;2011;06;06;Lauantai;15;19;34;0;7;7
89;11.06.2011;2011;06;07;Lauantai;24;26;50;6;11;17
89;11.06.2011;2011;06;08;Lauantai;44;41;85;6;18;24
89;11.06.2011;2011;06;09;Lauantai;47;101;148;20;26;46
89;11.06.2011;2011;06;10;Lauantai;83;149;232;16;25;41
89;11.06.2011;2011;06;11;Lauantai;135;170;305;11;30;41
89;11.06.2011;2011;06;12;Lauantai;176;178;354;29;34;63
89;11.06.2011;2011;06;13;Lauantai;209;164;373;31;31;62
89;11.06.2011;2011;06;14;Lauantai;254;161;415;27;47;74
89;11.06.2011;2011;06;15;Lauantai;246;151;397;39;44;83
89;11.06.2011;2011;06;16;Lauantai;204;147;351;31;46;77
89;11.06.2011;2011;06;17;Lauantai;214;146;360;24;35;59
89;11.06.2011;2011;06;18;Lauantai;203;138;341;29;38;67
89;11.06.2011;2011;06;19;Lauantai;210;94;304;36;36;72
89;11.06.2011;2011;06;20;Lauantai;146;127;273;39;34;73
89;11.06.2011;2011;06;21;Lauantai;123;144;267;26;41;67
89;11.06.2011;2011;06;22;Lauantai;127;140;267;9;23;32
89;11.06.2011;2011;06;23;Lauantai;81;138;219;9;33;42
89;12.06.2011;2011;06;00;Sunnuntai;105;97;202;14;26;40
89;12.06.2011;2011;06;01;Sunnuntai;65;39;104;13;13;26
89;12.06.2011;2011;06;02;Sunnuntai;82;15;97;8;5;13
89;12.06.2011;2011;06;03;Sunnuntai;60;7;67;9;3;12
89;12.06.2011;2011;06;04;Sunnuntai;41;4;45;4;0;4
89;12.06.2011;2011;06;05;Sunnuntai;18;8;26;1;2;3
89;12.06.2011;2011;06;06;Sunnuntai;6;10;16;4;4;8
89;12.06.2011;2011;06;07;Sunnuntai;13;12;25;1;14;15
89;12.06.2011;2011;06;08;Sunnuntai;8;15;23;4;5;9
89;12.06.2011;2011;06;09;Sunnuntai;17;21;38;8;12;20
89;12.06.2011;2011;06;10;Sunnuntai;19;32;51;14;14;28
89;12.06.2011;2011;06;11;Sunnuntai;29;43;72;10;23;33
89;12.06.2011;2011;06;12;Sunnuntai;50;72;122;23;35;58
89;12.06.2011;2011;06;13;Sunnuntai;54;74;128;22;27;49
89;12.06.2011;2011;06;14;Sunnuntai;86;69;155;27;51;78
89;12.06.2011;2011;06;15;Sunnuntai;74;77;151;35;41;76
89;12.06.2011;2011;06;16;Sunnuntai;57;103;160;33;38;71
89;12.06.2011;2011;06;17;Sunnuntai;99;69;168;33;30;63
89;12.06.2011;2011;06;18;Sunnuntai;72;51;123;27;31;58
89;12.06.2011;2011;06;19;Sunnuntai;82;54;136;27;18;45
89;12.06.2011;2011;06;20;Sunnuntai;71;37;108;19;25;44
89;12.06.2011;2011;06;21;Sunnuntai;34;31;65;17;22;39
89;12.06.2011;2011;06;22;Sunnuntai;30;10;40;11;5;16
89;12.06.2011;2011;06;23;Sunnuntai;11;11;22;3;3;6
89;13.06.2011;2011;06;00;Maanantai;7;9;16;0;4;4
89;13.06.2011;2011;06;01;Maanantai;8;3;11;0;1;1
89;13.06.2011;2011;06;02;Maanantai;4;2;6;2;2;4
89;13.06.2011;2011;06;03;Maanantai;8;2;10;0;0;0
89;13.06.2011;2011;06;04;Maanantai;5;11;16;2;3;5
89;13.06.2011;2011;06;05;Maanantai;10;19;29;1;2;3
89;13.06.2011;2011;06;06;Maanantai;36;107;143;4;9;13
89;13.06.2011;2011;06;07;Maanantai;63;198;261;2;23;25
89;13.06.2011;2011;06;08;Maanantai;88;218;306;6;18;24
89;13.06.2011;2011;06;09;Maanantai;48;135;183;9;29;38
89;13.06.2011;2011;06;10;Maanantai;62;96;158;14;24;38
89;13.06.2011;2011;06;11;Maanantai;82;120;202;21;37;58
89;13.06.2011;2011;06;12;Maanantai;93;138;231;20;20;40
89;13.06.2011;2011;06;13;Maanantai;128;140;268;31;35;66
89;13.06.2011;2011;06;14;Maanantai;135;143;278;52;46;98
89;13.06.2011;2011;06;15;Maanantai;243;146;389;42;29;71
89;13.06.2011;2011;06;16;Maanantai;317;167;484;32;33;65
89;13.06.2011;2011;06;17;Maanantai;180;124;304;28;25;53
89;13.06.2011;2011;06;18;Maanantai;168;89;257;25;24;49
89;13.06.2011;2011;06;19;Maanantai;134;68;202;22;25;47
89;13.06.2011;2011;06;20;Maanantai;95;47;142;19;26;45
89;13.06.2011;2011;06;21;Maanantai;54;49;103;15;24;39
89;13.06.2011;2011;06;22;Maanantai;30;20;50;15;18;33
89;13.06.2011;2011;06;23;Maanantai;16;7;23;3;4;7
89;14.06.2011;2011;06;00;Tiistai;9;3;12;4;3;7
89;14.06.2011;2011;06;01;Tiistai;11;5;16;0;1;1
89;14.06.2011;2011;06;02;Tiistai;6;1;7;0;0;0
89;14.06.2011;2011;06;03;Tiistai;4;4;8;0;0;0
89;14.06.2011;2011;06;04;Tiistai;2;12;14;0;0;0
89;14.06.2011;2011;06;05;Tiistai;5;18;23;2;1;3
89;14.06.2011;2011;06;06;Tiistai;35;117;152;4;5;9
89;14.06.2011;2011;06;07;Tiistai;77;219;296;6;22;28
89;14.06.2011;2011;06;08;Tiistai;80;201;281;6;35;41
89;14.06.2011;2011;06;09;Tiistai;63;151;214;13;30;43
89;14.06.2011;2011;06;10;Tiistai;76;88;164;36;37;73
89;14.06.2011;2011;06;11;Tiistai;92;129;221;23;27;50
89;14.06.2011;2011;06;12;Tiistai;103;128;231;14;24;38
89;14.06.2011;2011;06;13;Tiistai;113;132;245;13;42;55
89;14.06.2011;2011;06;14;Tiistai;156;150;306;28;27;55
89;14.06.2011;2011;06;15;Tiistai;242;146;388;27;23;50
89;14.06.2011;2011;06;16;Tiistai;316;159;475;38;18;56
89;14.06.2011;2011;06;17;Tiistai;188;150;338;33;25;58
89;14.06.2011;2011;06;18;Tiistai;154;91;245;28;30;58
89;14.06.2011;2011;06;19;Tiistai;168;100;268;51;34;85
89;14.06.2011;2011;06;20;Tiistai;146;68;214;37;33;70
89;14.06.2011;2011;06;21;Tiistai;91;64;155;20;17;37
89;14.06.2011;2011;06;22;Tiistai;40;28;68;11;7;18
89;14.06.2011;2011;06;23;Tiistai;11;14;25;3;5;8
89;15.06.2011;2011;06;00;Keskiviikko;13;13;26;0;0;0
89;15.06.2011;2011;06;01;Keskiviikko;11;7;18;0;0;0
89;15.06.2011;2011;06;02;Keskiviikko;1;7;8;1;1;2
89;15.06.2011;2011;06;03;Keskiviikko;6;6;12;3;0;3
89;15.06.2011;2011;06;04;Keskiviikko;8;7;15;2;2;4
89;15.06.2011;2011;06;05;Keskiviikko;10;18;28;1;2;3
89;15.06.2011;2011;06;06;Keskiviikko;44;114;158;5;12;17
89;15.06.2011;2011;06;07;Keskiviikko;78;211;289;8;19;27
89;15.06.2011;2011;06;08;Keskiviikko;108;216;324;3;21;24
89;15.06.2011;2011;06;09;Keskiviikko;56;138;194;16;23;39
89;15.06.2011;2011;06;10;Keskiviikko;73;142;215;9;34;43
89;15.06.2011;2011;06;11;Keskiviikko;89;169;258;17;35;52
89;15.06.2011;2011;06;12;Keskiviikko;122;161;283;29;41;70
89;15.06.2011;2011;06;13;Keskiviikko;153;135;288;26;37;63
89;15.06.2011;2011;06;14;Keskiviikko;210;169;379;35;27;62
89;15.06.2011;2011;06;15;Keskiviikko;264;178;442;27;23;50
89;15.06.2011;2011;06;16;Keskiviikko;340;141;481;41;30;71
89;15.06.2011;2011;06;17;Keskiviikko;196;153;349;23;19;42
89;15.06.2011;2011;06;18;Keskiviikko;190;167;357;40;30;70
89;15.06.2011;2011;06;19;Keskiviikko;166;123;289;28;33;61
89;15.06.2011;2011;06;20;Keskiviikko;142;73;215;33;35;68
89;15.06.2011;2011;06;21;Keskiviikko;113;52;165;20;13;33
89;15.06.2011;2011;06;22;Keskiviikko;48;33;81;15;15;30
89;15.06.2011;2011;06;23;Keskiviikko;31;15;46;3;7;10
89;16.06.2011;2011;06;00;Torstai;18;11;29;3;3;6
89;16.06.2011;2011;06;01;Torstai;17;5;22;2;0;2
89;16.06.2011;2011;06;02;Torstai;10;5;15;4;2;6
89;16.06.2011;2011;06;03;Torstai;11;4;15;3;0;3
89;16.06.2011;2011;06;04;Torstai;13;9;22;0;0;0
89;16.06.2011;2011;06;05;Torstai;12;16;28;0;1;1
89;16.06.2011;2011;06;06;Torstai;55;92;147;1;7;8
89;16.06.2011;2011;06;07;Torstai;98;199;297;4;17;21
89;16.06.2011;2011;06;08;Torstai;91;177;268;11;33;44
89;16.06.2011;2011;06;09;Torstai;60;142;202;13;37;50
89;16.06.2011;2011;06;10;Torstai;95;132;227;16;36;52
89;16.06.2011;2011;06;11;Torstai;80;124;204;22;36;58
89;16.06.2011;2011;06;12;Torstai;122;135;257;18;24;42
89;16.06.2011;2011;06;13;Torstai;156;167;323;35;49;84
89;16.06.2011;2011;06;14;Torstai;169;131;300;20;30;50
89;16.06.2011;2011;06;15;Torstai;265;179;444;57;29;86
89;16.06.2011;2011;06;16;Torstai;316;154;470;38;25;63
89;16.06.2011;2011;06;17;Torstai;205;147;352;26;33;59
89;16.06.2011;2011;06;18;Torstai;175;133;308;39;23;62
89;16.06.2011;2011;06;19;Torstai;178;73;251;27;40;67
89;16.06.2011;2011;06;20;Torstai;130;62;192;21;17;38
89;16.06.2011;2011;06;21;Torstai;75;27;102;11;6;17
89;16.06.2011;2011;06;22;Torstai;32;24;56;4;1;5
89;16.06.2011;2011;06;23;Torstai;22;11;33;6;2;8
89;17.06.2011;2011;06;00;Perjantai;5;9;14;2;2;4
89;17.06.2011;2011;06;01;Perjantai;7;3;10;5;0;5
89;17.06.2011;2011;06;02;Perjantai;9;2;11;1;1;2
89;17.06.2011;2011;06;03;Perjantai;3;6;9;0;0;0
89;17.06.2011;2011;06;04;Perjantai;6;8;14;2;0;2
89;17.06.2011;2011;06;05;Perjantai;10;21;31;1;3;4
89;17.06.2011;2011;06;06;Perjantai;45;96;141;5;6;11
89;17.06.2011;2011;06;07;Perjantai;66;192;258;6;23;29
89;17.06.2011;2011;06;08;Perjantai;64;195;259;9;17;26
89;17.06.2011;2011;06;09;Perjantai;49;133;182;14;31;45
89;17.06.2011;2011;06;10;Perjantai;57;111;168;13;23;36
89;17.06.2011;2011;06;11;Perjantai;90;120;210;25;26;51
89;17.06.2011;2011;06;12;Perjantai;118;180;298;12;31;43
89;17.06.2011;2011;06;13;Perjantai;138;157;295;19;29;48
89;17.06.2011;2011;06;14;Perjantai;195;158;353;46;32;78
89;17.06.2011;2011;06;15;Perjantai;223;164;387;32;41;73
89;17.06.2011;2011;06;16;Perjantai;223;155;378;22;21;43
89;17.06.2011;2011;06;17;Perjantai;175;116;291;40;34;74
89;17.06.2011;2011;06;18;Perjantai;139;153;292;28;33;61
89;17.06.2011;2011;06;19;Perjantai;111;61;172;22;18;40
89;17.06.2011;2011;06;20;Perjantai;115;80;195;19;23;42
89;17.06.2011;2011;06;21;Perjantai;96;99;195;17;9;26
89;17.06.2011;2011;06;22;Perjantai;63;60;123;9;8;17
89;17.06.2011;2011;06;23;Perjantai;44;47;91;13;9;22
89;18.06.2011;2011;06;00;Lauantai;57;52;109;5;10;15
89;18.06.2011;2011;06;01;Lauantai;31;27;58;8;5;13
89;18.06.2011;2011;06;02;Lauantai;32;10;42;6;2;8
89;18.06.2011;2011;06;03;Lauantai;32;10;42;5;0;5
89;18.06.2011;2011;06;04;Lauantai;21;4;25;2;0;2
89;18.06.2011;2011;06;05;Lauantai;5;9;14;1;0;1
89;18.06.2011;2011;06;06;Lauantai;11;23;34;1;0;1
89;18.06.2011;2011;06;07;Lauantai;14;25;39;2;10;12
89;18.06.2011;2011;06;08;Lauantai;17;38;55;7;11;18
89;18.06.2011;2011;06;09;Lauantai;28;91;119;12;18;30
89;18.06.2011;2011;06;10;Lauantai;59;107;166;13;26;39
89;18.06.2011;2011;06;11;Lauantai;80;97;177;21;34;55
89;18.06.2011;2011;06;12;Lauantai;93;105;198;31;31;62
89;18.06.2011;2011;06;13;Lauantai;70;53;123;13;9;22
89;18.06.2011;2011;06;14;Lauantai;64;43;107;11;15;26
89;18.06.2011;2011;06;15;Lauantai;87;61;148;17;27;44
89;18.06.2011;2011;06;16;Lauantai;63;55;118;18;18;36
89;18.06.2011;2011;06;17;Lauantai;59;51;110;23;25;48
89;18.06.2011;2011;06;18;Lauantai;104;34;138;23;11;34
89;18.06.2011;2011;06;19;Lauantai;58;58;116;22;29;51
89;18.06.2011;2011;06;20;Lauantai;61;62;123;16;9;25
89;18.06.2011;2011;06;21;Lauantai;49;43;92;8;17;25
89;18.06.2011;2011;06;22;Lauantai;35;53;88;16;13;29
89;18.06.2011;2011;06;23;Lauantai;43;46;89;9;9;18
89;19.06.2011;2011;06;00;Sunnuntai;41;39;80;5;13;18
89;19.06.2011;2011;06;01;Sunnuntai;16;15;31;2;1;3
89;19.06.2011;2011;06;02;Sunnuntai;28;9;37;13;0;13
89;19.06.2011;2011;06;03;Sunnuntai;37;7;44;14;0;14
89;19.06.2011;2011;06;04;Sunnuntai;19;2;21;6;1;7
89;19.06.2011;2011;06;05;Sunnuntai;6;6;12;4;1;5
89;19.06.2011;2011;06;06;Sunnuntai;8;12;20;0;4;4
89;19.06.2011;2011;06;07;Sunnuntai;8;12;20;3;4;7
89;19.06.2011;2011;06;08;Sunnuntai;15;11;26;6;11;17
89;19.06.2011;2011;06;09;Sunnuntai;20;22;42;10;12;22
89;19.06.2011;2011;06;10;Sunnuntai;21;50;71;13;24;37
89;19.06.2011;2011;06;11;Sunnuntai;37;68;105;29;47;76
89;19.06.2011;2011;06;12;Sunnuntai;64;96;160;29;45;74
89;19.06.2011;2011;06;13;Sunnuntai;87;103;190;30;40;70
89;19.06.2011;2011;06;14;Sunnuntai;80;58;138;24;20;44
89;19.06.2011;2011;06;15;Sunnuntai;62;57;119;13;13;26
89;19.06.2011;2011;06;16;Sunnuntai;81;65;146;11;24;35
89;19.06.2011;2011;06;17;Sunnuntai;63;48;111;16;16;32
89;19.06.2011;2011;06;18;Sunnuntai;77;42;119;20;19;39
89;19.06.2011;2011;06;19;Sunnuntai;55;32;87;23;19;42
89;19.06.2011;2011;06;20;Sunnuntai;51;48;99;20;28;48
89;19.06.2011;2011;06;21;Sunnuntai;38;34;72;12;16;28
89;19.06.2011;2011;06;22;Sunnuntai;29;19;48;17;6;23
89;19.06.2011;2011;06;23;Sunnuntai;18;6;24;5;5;10
89;20.06.2011;2011;06;00;Maanantai;15;4;19;1;3;4
89;20.06.2011;2011;06;01;Maanantai;5;3;8;1;1;2
89;20.06.2011;2011;06;02;Maanantai;6;1;7;0;0;0
89;20.06.2011;2011;06;03;Maanantai;3;4;7;0;0;0
89;20.06.2011;2011;06;04;Maanantai;4;11;15;1;1;2
89;20.06.2011;2011;06;05;Maanantai;8;8;16;2;0;2
89;20.06.2011;2011;06;06;Maanantai;52;81;133;3;6;9
89;20.06.2011;2011;06;07;Maanantai;66;181;247;9;36;45
89;20.06.2011;2011;06;08;Maanantai;53;149;202;6;17;23
89;20.06.2011;2011;06;09;Maanantai;65;92;157;8;29;37
89;20.06.2011;2011;06;10;Maanantai;46;82;128;17;25;42
89;20.06.2011;2011;06;11;Maanantai;73;67;140;13;25;38
89;20.06.2011;2011;06;12;Maanantai;75;43;118;12;20;32
89;20.06.2011;2011;06;13;Maanantai;76;50;126;10;19;29
89;20.06.2011;2011;06;14;Maanantai;77;41;118;12;13;25
89;20.06.2011;2011;06;15;Maanantai;137;86;223;15;6;21
89;20.06.2011;2011;06;16;Maanantai;170;63;233;27;10;37
89;20.06.2011;2011;06;17;Maanantai;98;26;124;14;15;29
89;20.06.2011;2011;06;18;Maanantai;77;33;110;15;5;20
89;20.06.2011;2011;06;19;Maanantai;45;23;68;15;9;24
89;20.06.2011;2011;06;20;Maanantai;52;25;77;7;20;27
89;20.06.2011;2011;06;21;Maanantai;27;12;39;5;15;20
89;20.06.2011;2011;06;22;Maanantai;25;11;36;11;4;15
89;20.06.2011;2011;06;23;Maanantai;5;4;9;4;2;6
89;21.06.2011;2011;06;00;Tiistai;5;1;6;1;2;3
89;21.06.2011;2011;06;01;Tiistai;2;0;2;2;3;5
89;21.06.2011;2011;06;02;Tiistai;0;2;2;2;2;4
89;21.06.2011;2011;06;03;Tiistai;0;4;4;0;1;1
89;21.06.2011;2011;06;04;Tiistai;1;8;9;0;0;0
89;21.06.2011;2011;06;05;Tiistai;8;13;21;0;1;1
89;21.06.2011;2011;06;06;Tiistai;49;45;94;0;11;11
89;21.06.2011;2011;06;07;Tiistai;68;58;126;6;33;39
89;21.06.2011;2011;06;08;Tiistai;56;80;136;1;8;9
89;21.06.2011;2011;06;09;Tiistai;33;48;81;4;15;19
89;21.06.2011;2011;06;10;Tiistai;39;25;64;4;9;13
89;21.06.2011;2011;06;11;Tiistai;39;22;61;9;14;23
89;21.06.2011;2011;06;12;Tiistai;35;40;75;9;7;16
89;21.06.2011;2011;06;13;Tiistai;41;30;71;9;19;28
89;21.06.2011;2011;06;14;Tiistai;63;49;112;19;13;32
89;21.06.2011;2011;06;15;Tiistai;100;83;183;26;25;51
89;21.06.2011;2011;06;16;Tiistai;136;56;192;24;14;38
89;21.06.2011;2011;06;17;Tiistai;99;56;155;13;28;41
89;21.06.2011;2011;06;18;Tiistai;87;73;160;31;34;65
89;21.06.2011;2011;06;19;Tiistai;100;67;167;47;37;84
89;21.06.2011;2011;06;20;Tiistai;65;50;115;38;49;87
89;21.06.2011;2011;06;21;Tiistai;49;39;88;18;18;36
89;21.06.2011;2011;06;22;Tiistai;31;27;58;8;7;15
89;21.06.2011;2011;06;23;Tiistai;15;11;26;11;11;22
89;22.06.2011;2011;06;00;Keskiviikko;6;4;10;4;1;5
89;22.06.2011;2011;06;01;Keskiviikko;8;1;9;1;0;1
89;22.06.2011;2011;06;02;Keskiviikko;8;1;9;2;1;3
89;22.06.2011;2011;06;03;Keskiviikko;3;3;6;0;0;0
89;22.06.2011;2011;06;04;Keskiviikko;3;8;11;0;1;1
89;22.06.2011;2011;06;05;Keskiviikko;3;13;16;3;2;5
89;22.06.2011;2011;06;06;Keskiviikko;44;78;122;2;7;9
89;22.06.2011;2011;06;07;Keskiviikko;66;117;183;3;15;18
89;22.06.2011;2011;06;08;Keskiviikko;56;117;173;3;21;24
89;22.06.2011;2011;06;09;Keskiviikko;41;58;99;4;16;20
89;22.06.2011;2011;06;10;Keskiviikko;41;73;114;15;25;40
89;22.06.2011;2011;06;11;Keskiviikko;42;64;106;9;17;26
89;22.06.2011;2011;06;12;Keskiviikko;51;63;114;17;28;45
89;22.06.2011;2011;06;13;Keskiviikko;71;51;122;12;18;30
89;22.06.2011;2011;06;14;Keskiviikko;89;62;151;19;25;44
89;22.06.2011;2011;06;15;Keskiviikko;133;87;220;18;19;37
89;22.06.2011;2011;06;16;Keskiviikko;144;95;239;16;8;24
89;22.06.2011;2011;06;17;Keskiviikko;107;65;172;16;15;31
89;22.06.2011;2011;06;18;Keskiviikko;76;63;139;21;14;35
89;22.06.2011;2011;06;19;Keskiviikko;95;35;130;22;23;45
89;22.06.2011;2011;06;20;Keskiviikko;86;40;126;19;20;39
89;22.06.2011;2011;06;21;Keskiviikko;65;29;94;17;6;23
89;22.06.2011;2011;06;22;Keskiviikko;31;16;47;9;5;14
89;22.06.2011;2011;06;23;Keskiviikko;15;21;36;8;6;14
89;23.06.2011;2011;06;00;Torstai;12;10;22;17;20;37
89;23.06.2011;2011;06;01;Torstai;9;2;11;0;1;1
89;23.06.2011;2011;06;02;Torstai;9;3;12;1;2;3
89;23.06.2011;2011;06;03;Torstai;10;3;13;2;1;3
89;23.06.2011;2011;06;04;Torstai;10;6;16;3;1;4
89;23.06.2011;2011;06;05;Torstai;11;12;23;1;1;2
89;23.06.2011;2011;06;06;Torstai;49;77;126;3;10;13
89;23.06.2011;2011;06;07;Torstai;74;141;215;2;20;22
89;23.06.2011;2011;06;08;Torstai;75;150;225;10;23;33
89;23.06.2011;2011;06;09;Torstai;53;119;172;13;27;40
89;23.06.2011;2011;06;10;Torstai;68;132;200;27;25;52
89;23.06.2011;2011;06;11;Torstai;121;145;266;12;28;40
89;23.06.2011;2011;06;12;Torstai;124;116;240;15;25;40
89;23.06.2011;2011;06;13;Torstai;150;142;292;23;25;48
89;23.06.2011;2011;06;14;Torstai;184;124;308;23;23;46
89;23.06.2011;2011;06;15;Torstai;224;146;370;17;14;31
89;23.06.2011;2011;06;16;Torstai;137;91;228;16;20;36
89;23.06.2011;2011;06;17;Torstai;160;86;246;29;22;51
89;23.06.2011;2011;06;18;Torstai;118;83;201;23;18;41
89;23.06.2011;2011;06;19;Torstai;83;73;156;23;18;41
89;23.06.2011;2011;06;20;Torstai;92;49;141;20;23;43
89;23.06.2011;2011;06;21;Torstai;59;42;101;8;5;13
89;23.06.2011;2011;06;22;Torstai;35;33;68;10;10;20
89;23.06.2011;2011;06;23;Torstai;20;13;33;1;8;9
89;24.06.2011;2011;06;00;Perjantai;18;9;27;3;7;10
89;24.06.2011;2011;06;01;Perjantai;16;4;20;4;3;7
89;24.06.2011;2011;06;02;Perjantai;9;0;9;7;3;10
89;24.06.2011;2011;06;03;Perjantai;14;3;17;1;0;1
89;24.06.2011;2011;06;04;Perjantai;6;1;7;6;0;6
89;24.06.2011;2011;06;05;Perjantai;3;2;5;3;1;4
89;24.06.2011;2011;06;06;Perjantai;10;14;24;2;0;2
89;24.06.2011;2011;06;07;Perjantai;12;21;33;3;21;24
89;24.06.2011;2011;06;08;Perjantai;21;31;52;9;13;22
89;24.06.2011;2011;06;09;Perjantai;24;43;67;5;10;15
89;24.06.2011;2011;06;10;Perjantai;37;56;93;15;25;40
89;24.06.2011;2011;06;11;Perjantai;53;55;108;13;14;27
89;24.06.2011;2011;06;12;Perjantai;49;37;86;11;11;22
89;24.06.2011;2011;06;13;Perjantai;40;47;87;14;22;36
89;24.06.2011;2011;06;14;Perjantai;57;54;111;11;31;42
89;24.06.2011;2011;06;15;Perjantai;55;44;99;19;27;46
89;24.06.2011;2011;06;16;Perjantai;51;35;86;27;22;49
89;24.06.2011;2011;06;17;Perjantai;55;70;125;18;23;41
89;24.06.2011;2011;06;18;Perjantai;51;100;151;20;65;85
89;24.06.2011;2011;06;19;Perjantai;47;38;85;13;11;24
89;24.06.2011;2011;06;20;Perjantai;41;41;82;13;11;24
89;24.06.2011;2011;06;21;Perjantai;64;36;100;29;14;43
89;24.06.2011;2011;06;22;Perjantai;26;24;50;4;6;10
89;24.06.2011;2011;06;23;Perjantai;23;34;57;3;8;11
89;25.06.2011;2011;06;00;Lauantai;20;58;78;2;6;8
89;25.06.2011;2011;06;01;Lauantai;27;19;46;7;7;14
89;25.06.2011;2011;06;02;Lauantai;25;9;34;7;0;7
89;25.06.2011;2011;06;03;Lauantai;38;4;42;10;0;10
89;25.06.2011;2011;06;04;Lauantai;15;8;23;5;4;9
89;25.06.2011;2011;06;05;Lauantai;2;6;8;5;2;7
89;25.06.2011;2011;06;06;Lauantai;6;15;21;1;1;2
89;25.06.2011;2011;06;07;Lauantai;7;8;15;2;3;5
89;25.06.2011;2011;06;08;Lauantai;8;10;18;6;5;11
89;25.06.2011;2011;06;09;Lauantai;15;16;31;8;10;18
89;25.06.2011;2011;06;10;Lauantai;26;41;67;18;13;31
89;25.06.2011;2011;06;11;Lauantai;53;45;98;22;21;43
89;25.06.2011;2011;06;12;Lauantai;51;79;130;23;24;47
89;25.06.2011;2011;06;13;Lauantai;70;100;170;18;36;54
89;25.06.2011;2011;06;14;Lauantai;98;100;198;59;49;108
89;25.06.2011;2011;06;15;Lauantai;105;138;243;39;64;103
89;25.06.2011;2011;06;16;Lauantai;98;115;213;24;31;55
89;25.06.2011;2011;06;17;Lauantai;110;132;242;27;29;56
89;25.06.2011;2011;06;18;Lauantai;102;102;204;26;34;60
89;25.06.2011;2011;06;19;Lauantai;86;78;164;22;27;49
89;25.06.2011;2011;06;20;Lauantai;66;79;145;23;27;50
89;25.06.2011;2011;06;21;Lauantai;54;79;133;16;19;35
89;25.06.2011;2011;06;22;Lauantai;47;46;93;8;10;18
89;25.06.2011;2011;06;23;Lauantai;32;30;62;5;15;20
89;26.06.2011;2011;06;00;Sunnuntai;17;19;36;6;6;12
89;26.06.2011;2011;06;01;Sunnuntai;28;19;47;1;4;5
89;26.06.2011;2011;06;02;Sunnuntai;23;9;32;6;4;10
89;26.06.2011;2011;06;03;Sunnuntai;21;1;22;5;1;6
89;26.06.2011;2011;06;04;Sunnuntai;14;1;15;6;2;8
89;26.06.2011;2011;06;05;Sunnuntai;3;2;5;3;0;3
89;26.06.2011;2011;06;06;Sunnuntai;6;10;16;0;0;0
89;26.06.2011;2011;06;07;Sunnuntai;12;5;17;3;1;4
89;26.06.2011;2011;06;08;Sunnuntai;7;2;9;5;2;7
89;26.06.2011;2011;06;09;Sunnuntai;5;4;9;6;6;12
89;26.06.2011;2011;06;10;Sunnuntai;4;4;8;6;4;10
89;26.06.2011;2011;06;11;Sunnuntai;15;22;37;4;6;10
89;26.06.2011;2011;06;12;Sunnuntai;23;43;66;10;17;27
89;26.06.2011;2011;06;13;Sunnuntai;35;75;110;23;43;66
89;26.06.2011;2011;06;14;Sunnuntai;55;84;139;18;31;49
89;26.06.2011;2011;06;15;Sunnuntai;107;91;198;30;25;55
89;26.06.2011;2011;06;16;Sunnuntai;100;93;193;23;26;49
89;26.06.2011;2011;06;17;Sunnuntai;92;59;151;31;25;56
89;26.06.2011;2011;06;18;Sunnuntai;84;61;145;32;29;61
89;26.06.2011;2011;06;19;Sunnuntai;44;41;85;27;32;59
89;26.06.2011;2011;06;20;Sunnuntai;73;41;114;17;22;39
89;26.06.2011;2011;06;21;Sunnuntai;41;30;71;17;12;29
89;26.06.2011;2011;06;22;Sunnuntai;21;15;36;2;7;9
89;26.06.2011;2011;06;23;Sunnuntai;20;12;32;4;8;12
89;27.06.2011;2011;06;00;Maanantai;5;12;17;2;1;3
89;27.06.2011;2011;06;01;Maanantai;8;5;13;2;2;4
89;27.06.2011;2011;06;02;Maanantai;2;2;4;1;1;2
89;27.06.2011;2011;06;03;Maanantai;3;1;4;1;1;2
89;27.06.2011;2011;06;04;Maanantai;8;6;14;1;1;2
89;27.06.2011;2011;06;05;Maanantai;11;16;27;3;2;5
89;27.06.2011;2011;06;06;Maanantai;43;78;121;2;8;10
89;27.06.2011;2011;06;07;Maanantai;72;144;216;6;20;26
89;27.06.2011;2011;06;08;Maanantai;69;148;217;11;18;29
89;27.06.2011;2011;06;09;Maanantai;58;153;211;17;17;34
89;27.06.2011;2011;06;10;Maanantai;65;142;207;15;25;40
89;27.06.2011;2011;06;11;Maanantai;99;116;215;19;16;35
89;27.06.2011;2011;06;12;Maanantai;114;147;261;33;30;63
89;27.06.2011;2011;06;13;Maanantai;149;179;328;28;34;62
89;27.06.2011;2011;06;14;Maanantai;190;145;335;29;23;52
89;27.06.2011;2011;06;15;Maanantai;223;148;371;20;27;47
89;27.06.2011;2011;06;16;Maanantai;273;173;446;17;29;46
89;27.06.2011;2011;06;17;Maanantai;225;195;420;26;30;56
89;27.06.2011;2011;06;18;Maanantai;176;171;347;41;51;92
89;27.06.2011;2011;06;19;Maanantai;268;134;402;66;50;116
89;27.06.2011;2011;06;20;Maanantai;185;86;271;33;34;67
89;27.06.2011;2011;06;21;Maanantai;107;63;170;24;34;58
89;27.06.2011;2011;06;22;Maanantai;66;45;111;8;17;25
89;27.06.2011;2011;06;23;Maanantai;22;23;45;5;8;13
89;28.06.2011;2011;06;00;Tiistai;10;3;13;3;5;8
89;28.06.2011;2011;06;01;Tiistai;14;15;29;1;0;1
89;28.06.2011;2011;06;02;Tiistai;8;4;12;3;1;4
89;28.06.2011;2011;06;03;Tiistai;4;2;6;1;0;1
89;28.06.2011;2011;06;04;Tiistai;6;6;12;1;0;1
89;28.06.2011;2011;06;05;Tiistai;8;19;27;0;4;4
89;28.06.2011;2011;06;06;Tiistai;56;96;152;3;8;11
89;28.06.2011;2011;06;07;Tiistai;98;157;255;5;16;21
89;28.06.2011;2011;06;08;Tiistai;104;146;250;8;27;35
89;28.06.2011;2011;06;09;Tiistai;72;161;233;12;23;35
89;28.06.2011;2011;06;10;Tiistai;86;164;250;18;32;50
89;28.06.2011;2011;06;11;Tiistai;113;163;276;21;36;57
89;28.06.2011;2011;06;12;Tiistai;160;200;360;17;21;38
89;28.06.2011;2011;06;13;Tiistai;188;174;362;31;35;66
89;28.06.2011;2011;06;14;Tiistai;240;198;438;33;41;74
89;28.06.2011;2011;06;15;Tiistai;297;205;502;32;30;62
89;28.06.2011;2011;06;16;Tiistai;360;229;589;46;41;87
89;28.06.2011;2011;06;17;Tiistai;257;215;472;27;31;58
89;28.06.2011;2011;06;18;Tiistai;256;147;403;42;43;85
89;28.06.2011;2011;06;19;Tiistai;194;132;326;45;45;90
89;28.06.2011;2011;06;20;Tiistai;171;106;277;33;41;74
89;28.06.2011;2011;06;21;Tiistai;123;90;213;25;30;55
89;28.06.2011;2011;06;22;Tiistai;65;63;128;11;10;21
89;28.06.2011;2011;06;23;Tiistai;36;32;68;5;11;16
89;29.06.2011;2011;06;00;Keskiviikko;19;11;30;3;3;6
89;29.06.2011;2011;06;01;Keskiviikko;29;11;40;4;3;7
89;29.06.2011;2011;06;02;Keskiviikko;7;6;13;0;0;0
89;29.06.2011;2011;06;03;Keskiviikko;5;1;6;0;0;0
89;29.06.2011;2011;06;04;Keskiviikko;9;11;20;0;0;0
89;29.06.2011;2011;06;05;Keskiviikko;10;15;25;3;3;6
89;29.06.2011;2011;06;06;Keskiviikko;53;113;166;4;7;11
89;29.06.2011;2011;06;07;Keskiviikko;94;172;266;7;14;21
89;29.06.2011;2011;06;08;Keskiviikko;100;134;234;12;32;44
89;29.06.2011;2011;06;09;Keskiviikko;78;157;235;13;26;39
89;29.06.2011;2011;06;10;Keskiviikko;77;167;244;26;62;88
89;29.06.2011;2011;06;11;Keskiviikko;148;145;293;31;36;67
89;29.06.2011;2011;06;12;Keskiviikko;183;156;339;27;25;52
89;29.06.2011;2011;06;13;Keskiviikko;194;162;356;18;29;47
89;29.06.2011;2011;06;14;Keskiviikko;257;177;434;28;29;57
89;29.06.2011;2011;06;15;Keskiviikko;331;255;586;37;42;79
89;29.06.2011;2011;06;16;Keskiviikko;343;250;593;37;38;75
89;29.06.2011;2011;06;17;Keskiviikko;248;183;431;46;38;84
89;29.06.2011;2011;06;18;Keskiviikko;270;233;503;38;40;78
89;29.06.2011;2011;06;19;Keskiviikko;232;161;393;29;34;63
89;29.06.2011;2011;06;20;Keskiviikko;205;166;371;42;39;81
89;29.06.2011;2011;06;21;Keskiviikko;171;116;287;48;45;93
89;29.06.2011;2011;06;22;Keskiviikko;87;83;170;15;21;36
89;29.06.2011;2011;06;23;Keskiviikko;55;31;86;5;3;8
89;30.06.2011;2011;06;00;Torstai;56;24;80;13;6;19
89;30.06.2011;2011;06;01;Torstai;38;12;50;2;7;9
89;30.06.2011;2011;06;02;Torstai;21;5;26;4;2;6
89;30.06.2011;2011;06;03;Torstai;23;1;24;2;1;3
89;30.06.2011;2011;06;04;Torstai;14;13;27;6;1;7
89;30.06.2011;2011;06;05;Torstai;13;16;29;0;3;3
89;30.06.2011;2011;06;06;Torstai;52;95;147;2;8;10
89;30.06.2011;2011;06;07;Torstai;97;159;256;5;13;18
89;30.06.2011;2011;06;08;Torstai;104;161;265;11;24;35
89;30.06.2011;2011;06;09;Torstai;72;145;217;10;21;31
89;30.06.2011;2011;06;10;Torstai;86;180;266;17;21;38
89;30.06.2011;2011;06;11;Torstai;151;157;308;19;38;57
89;30.06.2011;2011;06;12;Torstai;205;156;361;35;29;64
89;30.06.2011;2011;06;13;Torstai;206;197;403;32;24;56
89;30.06.2011;2011;06;14;Torstai;252;183;435;31;43;74
89;30.06.2011;2011;06;15;Torstai;298;191;489;35;30;65
89;30.06.2011;2011;06;16;Torstai;359;191;550;30;32;62
89;30.06.2011;2011;06;17;Torstai;248;230;478;28;20;48
89;30.06.2011;2011;06;18;Torstai;199;202;401;34;52;86
89;30.06.2011;2011;06;19;Torstai;211;178;389;47;44;91
89;30.06.2011;2011;06;20;Torstai;223;141;364;35;32;67
89;30.06.2011;2011;06;21;Torstai;166;97;263;30;26;56
89;30.06.2011;2011;06;22;Torstai;64;62;126;15;14;29
89;30.06.2011;2011;06;23;Torstai;58;44;102;5;5;10
89;01.07.2011;2011;07;00;Perjantai;28;12;40;6;5;11
89;01.07.2011;2011;07;01;Perjantai;27;16;43;4;6;10
89;01.07.2011;2011;07;02;Perjantai;16;11;27;7;0;7
89;01.07.2011;2011;07;03;Perjantai;17;4;21;2;1;3
89;01.07.2011;2011;07;04;Perjantai;19;9;28;2;2;4
89;01.07.2011;2011;07;05;Perjantai;17;16;33;4;3;7
89;01.07.2011;2011;07;06;Perjantai;54;102;156;2;6;8
89;01.07.2011;2011;07;07;Perjantai;90;132;222;2;14;16
89;01.07.2011;2011;07;08;Perjantai;97;138;235;14;10;24
89;01.07.2011;2011;07;09;Perjantai;60;119;179;11;18;29
89;01.07.2011;2011;07;10;Perjantai;102;150;252;20;41;61
89;01.07.2011;2011;07;11;Perjantai;121;183;304;24;32;56
89;01.07.2011;2011;07;12;Perjantai;168;171;339;34;36;70
89;01.07.2011;2011;07;13;Perjantai;228;183;411;23;26;49
89;01.07.2011;2011;07;14;Perjantai;287;181;468;13;20;33
89;01.07.2011;2011;07;15;Perjantai;197;136;333;12;22;34
89;01.07.2011;2011;07;16;Perjantai;200;99;299;17;14;31
89;01.07.2011;2011;07;17;Perjantai;215;119;334;27;21;48
89;01.07.2011;2011;07;18;Perjantai;126;99;225;29;28;57
89;01.07.2011;2011;07;19;Perjantai;100;75;175;12;10;22
89;01.07.2011;2011;07;20;Perjantai;77;70;147;15;23;38
89;01.07.2011;2011;07;21;Perjantai;75;74;149;14;27;41
89;01.07.2011;2011;07;22;Perjantai;52;72;124;12;10;22
89;01.07.2011;2011;07;23;Perjantai;51;44;95;10;10;20
89;02.07.2011;2011;07;00;Lauantai;37;41;78;7;10;17
89;02.07.2011;2011;07;01;Lauantai;47;32;79;8;2;10
89;02.07.2011;2011;07;02;Lauantai;30;10;40;7;2;9
89;02.07.2011;2011;07;03;Lauantai;54;5;59;4;5;9
89;02.07.2011;2011;07;04;Lauantai;31;11;42;7;0;7
89;02.07.2011;2011;07;05;Lauantai;6;6;12;3;1;4
89;02.07.2011;2011;07;06;Lauantai;12;22;34;1;2;3
89;02.07.2011;2011;07;07;Lauantai;19;13;32;7;5;12
89;02.07.2011;2011;07;08;Lauantai;27;33;60;7;15;22
89;02.07.2011;2011;07;09;Lauantai;38;73;111;12;16;28
89;02.07.2011;2011;07;10;Lauantai;56;94;150;14;28;42
89;02.07.2011;2011;07;11;Lauantai;63;138;201;15;32;47
89;02.07.2011;2011;07;12;Lauantai;121;170;291;26;49;75
89;02.07.2011;2011;07;13;Lauantai;171;158;329;38;53;91
89;02.07.2011;2011;07;14;Lauantai;174;140;314;38;42;80
89;02.07.2011;2011;07;15;Lauantai;203;141;344;34;24;58
89;02.07.2011;2011;07;16;Lauantai;160;119;279;29;25;54
89;02.07.2011;2011;07;17;Lauantai;136;99;235;23;21;44
89;02.07.2011;2011;07;18;Lauantai;133;107;240;28;19;47
89;02.07.2011;2011;07;19;Lauantai;101;95;196;18;32;50
89;02.07.2011;2011;07;20;Lauantai;93;82;175;12;22;34
89;02.07.2011;2011;07;21;Lauantai;67;88;155;22;17;39
89;02.07.2011;2011;07;22;Lauantai;46;74;120;7;19;26
89;02.07.2011;2011;07;23;Lauantai;39;62;101;6;12;18
89;03.07.2011;2011;07;00;Sunnuntai;41;45;86;6;7;13
89;03.07.2011;2011;07;01;Sunnuntai;34;21;55;3;4;7
89;03.07.2011;2011;07;02;Sunnuntai;45;19;64;4;2;6
89;03.07.2011;2011;07;03;Sunnuntai;60;4;64;10;2;12
89;03.07.2011;2011;07;04;Sunnuntai;27;1;28;8;0;8
89;03.07.2011;2011;07;05;Sunnuntai;9;5;14;3;2;5
89;03.07.2011;2011;07;06;Sunnuntai;3;12;15;2;3;5
89;03.07.2011;2011;07;07;Sunnuntai;13;13;26;5;6;11
89;03.07.2011;2011;07;08;Sunnuntai;17;14;31;6;10;16
89;03.07.2011;2011;07;09;Sunnuntai;24;30;54;7;15;22
89;03.07.2011;2011;07;10;Sunnuntai;43;78;121;34;28;62
89;03.07.2011;2011;07;11;Sunnuntai;57;121;178;39;46;85
89;03.07.2011;2011;07;12;Sunnuntai;99;126;225;47;58;105
89;03.07.2011;2011;07;13;Sunnuntai;105;170;275;50;83;133
89;03.07.2011;2011;07;14;Sunnuntai;119;127;246;38;47;85
89;03.07.2011;2011;07;15;Sunnuntai;122;98;220;33;45;78
89;03.07.2011;2011;07;16;Sunnuntai;120;102;222;38;26;64
89;03.07.2011;2011;07;17;Sunnuntai;103;119;222;42;39;81
89;03.07.2011;2011;07;18;Sunnuntai;120;98;218;34;36;70
89;03.07.2011;2011;07;19;Sunnuntai;93;66;159;27;16;43
89;03.07.2011;2011;07;20;Sunnuntai;80;72;152;22;25;47
89;03.07.2011;2011;07;21;Sunnuntai;54;39;93;19;23;42
89;03.07.2011;2011;07;22;Sunnuntai;29;26;55;7;10;17
89;03.07.2011;2011;07;23;Sunnuntai;16;22;38;2;7;9
89;04.07.2011;2011;07;00;Maanantai;8;6;14;3;2;5
89;04.07.2011;2011;07;01;Maanantai;7;6;13;1;1;2
89;04.07.2011;2011;07;02;Maanantai;4;6;10;3;0;3
89;04.07.2011;2011;07;03;Maanantai;7;3;10;1;0;1
89;04.07.2011;2011;07;04;Maanantai;5;9;14;1;0;1
89;04.07.2011;2011;07;05;Maanantai;14;10;24;0;2;2
89;04.07.2011;2011;07;06;Maanantai;33;98;131;2;8;10
89;04.07.2011;2011;07;07;Maanantai;60;130;190;3;14;17
89;04.07.2011;2011;07;08;Maanantai;51;145;196;7;24;31
89;04.07.2011;2011;07;09;Maanantai;61;133;194;10;27;37
89;04.07.2011;2011;07;10;Maanantai;63;120;183;25;37;62
89;04.07.2011;2011;07;11;Maanantai;97;123;220;23;33;56
89;04.07.2011;2011;07;12;Maanantai;112;165;277;18;41;59
89;04.07.2011;2011;07;13;Maanantai;133;175;308;23;21;44
89;04.07.2011;2011;07;14;Maanantai;175;134;309;29;27;56
89;04.07.2011;2011;07;15;Maanantai;229;131;360;39;25;64
89;04.07.2011;2011;07;16;Maanantai;237;148;385;30;20;50
89;04.07.2011;2011;07;17;Maanantai;186;140;326;38;42;80
89;04.07.2011;2011;07;18;Maanantai;174;170;344;40;61;101
89;04.07.2011;2011;07;19;Maanantai;208;87;295;83;32;115
89;04.07.2011;2011;07;20;Maanantai;123;69;192;33;38;71
89;04.07.2011;2011;07;21;Maanantai;89;42;131;41;32;73
89;04.07.2011;2011;07;22;Maanantai;30;28;58;10;6;16
89;04.07.2011;2011;07;23;Maanantai;26;7;33;15;7;22
89;05.07.2011;2011;07;00;Tiistai;20;10;30;0;0;0
89;05.07.2011;2011;07;01;Tiistai;7;6;13;0;1;1
89;05.07.2011;2011;07;02;Tiistai;8;4;12;1;1;2
89;05.07.2011;2011;07;03;Tiistai;7;0;7;1;0;1
89;05.07.2011;2011;07;04;Tiistai;6;9;15;3;2;5
89;05.07.2011;2011;07;05;Tiistai;15;19;34;1;1;2
89;05.07.2011;2011;07;06;Tiistai;39;90;129;4;8;12
89;05.07.2011;2011;07;07;Tiistai;66;154;220;2;14;16
89;05.07.2011;2011;07;08;Tiistai;43;149;192;8;13;21
89;05.07.2011;2011;07;09;Tiistai;42;109;151;14;23;37
89;05.07.2011;2011;07;10;Tiistai;62;140;202;14;30;44
89;05.07.2011;2011;07;11;Tiistai;89;142;231;21;33;54
89;05.07.2011;2011;07;12;Tiistai;128;142;270;25;28;53
89;05.07.2011;2011;07;13;Tiistai;147;161;308;35;33;68
89;05.07.2011;2011;07;14;Tiistai;160;166;326;25;31;56
89;05.07.2011;2011;07;15;Tiistai;273;158;431;33;28;61
89;05.07.2011;2011;07;16;Tiistai;263;176;439;34;31;65
89;05.07.2011;2011;07;17;Tiistai;179;188;367;31;28;59
89;05.07.2011;2011;07;18;Tiistai;208;133;341;33;34;67
89;05.07.2011;2011;07;19;Tiistai;214;106;320;43;34;77
89;05.07.2011;2011;07;20;Tiistai;141;82;223;37;28;65
89;05.07.2011;2011;07;21;Tiistai;85;84;169;19;16;35
89;05.07.2011;2011;07;22;Tiistai;61;51;112;7;9;16
89;05.07.2011;2011;07;23;Tiistai;32;24;56;9;10;19
89;06.07.2011;2011;07;00;Keskiviikko;21;13;34;3;3;6
89;06.07.2011;2011;07;01;Keskiviikko;23;7;30;2;2;4
89;06.07.2011;2011;07;02;Keskiviikko;9;4;13;0;4;4
89;06.07.2011;2011;07;03;Keskiviikko;10;5;15;4;3;7
89;06.07.2011;2011;07;04;Keskiviikko;4;8;12;2;3;5
89;06.07.2011;2011;07;05;Keskiviikko;11;16;27;3;3;6
89;06.07.2011;2011;07;06;Keskiviikko;42;85;127;0;6;6
89;06.07.2011;2011;07;07;Keskiviikko;61;139;200;2;12;14
89;06.07.2011;2011;07;08;Keskiviikko;62;124;186;6;19;25
89;06.07.2011;2011;07;09;Keskiviikko;55;88;143;8;15;23
89;06.07.2011;2011;07;10;Keskiviikko;54;120;174;18;30;48
89;06.07.2011;2011;07;11;Keskiviikko;102;117;219;20;27;47
89;06.07.2011;2011;07;12;Keskiviikko;103;143;246;30;36;66
89;06.07.2011;2011;07;13;Keskiviikko;142;127;269;24;44;68
89;06.07.2011;2011;07;14;Keskiviikko;178;156;334;21;25;46
89;06.07.2011;2011;07;15;Keskiviikko;255;164;419;36;38;74
89;06.07.2011;2011;07;16;Keskiviikko;263;167;430;33;22;55
89;06.07.2011;2011;07;17;Keskiviikko;202;192;394;23;35;58
89;06.07.2011;2011;07;18;Keskiviikko;158;168;326;52;62;114
89;06.07.2011;2011;07;19;Keskiviikko;180;114;294;45;35;80
89;06.07.2011;2011;07;20;Keskiviikko;139;86;225;21;28;49
89;06.07.2011;2011;07;21;Keskiviikko;144;87;231;35;24;59
89;06.07.2011;2011;07;22;Keskiviikko;66;60;126;14;14;28
89;06.07.2011;2011;07;23;Keskiviikko;47;16;63;9;11;20
89;07.07.2011;2011;07;00;Torstai;24;21;45;2;1;3
89;07.07.2011;2011;07;01;Torstai;28;12;40;5;4;9
89;07.07.2011;2011;07;02;Torstai;9;6;15;4;3;7
89;07.07.2011;2011;07;03;Torstai;14;1;15;2;2;4
89;07.07.2011;2011;07;04;Torstai;14;8;22;10;1;11
89;07.07.2011;2011;07;05;Torstai;8;18;26;5;3;8
89;07.07.2011;2011;07;06;Torstai;46;79;125;0;3;3
89;07.07.2011;2011;07;07;Torstai;79;129;208;6;12;18
89;07.07.2011;2011;07;08;Torstai;74;125;199;19;22;41
89;07.07.2011;2011;07;09;Torstai;84;140;224;8;17;25
89;07.07.2011;2011;07;10;Torstai;76;176;252;13;25;38
89;07.07.2011;2011;07;11;Torstai;136;136;272;15;25;40
89;07.07.2011;2011;07;12;Torstai;165;157;322;24;34;58
89;07.07.2011;2011;07;13;Torstai;176;221;397;34;34;68
89;07.07.2011;2011;07;14;Torstai;204;165;369;38;40;78
89;07.07.2011;2011;07;15;Torstai;292;229;521;33;33;66
89;07.07.2011;2011;07;16;Torstai;290;186;476;46;26;72
89;07.07.2011;2011;07;17;Torstai;246;156;402;33;39;72
89;07.07.2011;2011;07;18;Torstai;221;195;416;38;50;88
89;07.07.2011;2011;07;19;Torstai;220;143;363;53;68;121
89;07.07.2011;2011;07;20;Torstai;209;123;332;35;45;80
89;07.07.2011;2011;07;21;Torstai;143;85;228;24;26;50
89;07.07.2011;2011;07;22;Torstai;87;69;156;23;13;36
89;07.07.2011;2011;07;23;Torstai;59;58;117;7;13;20
89;08.07.2011;2011;07;00;Perjantai;24;14;38;5;3;8
89;08.07.2011;2011;07;01;Perjantai;32;10;42;4;2;6
89;08.07.2011;2011;07;02;Perjantai;25;4;29;2;3;5
89;08.07.2011;2011;07;03;Perjantai;10;3;13;2;0;2
89;08.07.2011;2011;07;04;Perjantai;11;7;18;2;0;2
89;08.07.2011;2011;07;05;Perjantai;15;10;25;2;1;3
89;08.07.2011;2011;07;06;Perjantai;55;71;126;3;8;11
89;08.07.2011;2011;07;07;Perjantai;87;109;196;7;11;18
89;08.07.2011;2011;07;08;Perjantai;103;111;214;6;13;19
89;08.07.2011;2011;07;09;Perjantai;94;112;206;15;7;22
89;08.07.2011;2011;07;10;Perjantai;82;141;223;5;30;35
89;08.07.2011;2011;07;11;Perjantai;130;132;262;23;27;50
89;08.07.2011;2011;07;12;Perjantai;183;155;338;21;20;41
89;08.07.2011;2011;07;13;Perjantai;215;207;422;40;36;76
89;08.07.2011;2011;07;14;Perjantai;242;170;412;16;24;40
89;08.07.2011;2011;07;15;Perjantai;283;146;429;27;26;53
89;08.07.2011;2011;07;16;Perjantai;258;142;400;29;25;54
89;08.07.2011;2011;07;17;Perjantai;224;115;339;35;27;62
89;08.07.2011;2011;07;18;Perjantai;221;126;347;35;31;66
89;08.07.2011;2011;07;19;Perjantai;245;94;339;33;49;82
89;08.07.2011;2011;07;20;Perjantai;204;114;318;20;22;42
89;08.07.2011;2011;07;21;Perjantai;148;124;272;23;28;51
89;08.07.2011;2011;07;22;Perjantai;124;143;267;23;26;49
89;08.07.2011;2011;07;23;Perjantai;91;86;177;10;18;28
89;09.07.2011;2011;07;00;Lauantai;107;44;151;8;16;24
89;09.07.2011;2011;07;01;Lauantai;79;20;99;13;12;25
89;09.07.2011;2011;07;02;Lauantai;67;13;80;10;4;14
89;09.07.2011;2011;07;03;Lauantai;50;6;56;14;3;17
89;09.07.2011;2011;07;04;Lauantai;35;5;40;11;3;14
89;09.07.2011;2011;07;05;Lauantai;17;8;25;4;5;9
89;09.07.2011;2011;07;06;Lauantai;12;24;36;4;4;8
89;09.07.2011;2011;07;07;Lauantai;37;15;52;6;10;16
89;09.07.2011;2011;07;08;Lauantai;62;29;91;4;9;13
89;09.07.2011;2011;07;09;Lauantai;79;94;173;7;18;25
89;09.07.2011;2011;07;10;Lauantai;83;154;237;10;15;25
89;09.07.2011;2011;07;11;Lauantai;128;116;244;13;16;29
89;09.07.2011;2011;07;12;Lauantai;178;125;303;30;31;61
89;09.07.2011;2011;07;13;Lauantai;168;143;311;30;45;75
89;09.07.2011;2011;07;14;Lauantai;168;75;243;24;31;55
89;09.07.2011;2011;07;15;Lauantai;117;74;191;23;12;35
89;09.07.2011;2011;07;16;Lauantai;106;41;147;13;13;26
89;09.07.2011;2011;07;17;Lauantai;84;42;126;12;8;20
89;09.07.2011;2011;07;18;Lauantai;89;64;153;19;19;38
89;09.07.2011;2011;07;19;Lauantai;85;65;150;10;28;38
89;09.07.2011;2011;07;20;Lauantai;48;33;81;9;14;23
89;09.07.2011;2011;07;21;Lauantai;40;36;76;10;9;19
89;09.07.2011;2011;07;22;Lauantai;39;51;90;5;11;16
89;09.07.2011;2011;07;23;Lauantai;38;38;76;8;18;26
89;10.07.2011;2011;07;00;Sunnuntai;28;49;77;5;12;17
89;10.07.2011;2011;07;01;Sunnuntai;33;24;57;2;1;3
89;10.07.2011;2011;07;02;Sunnuntai;30;14;44;7;9;16
89;10.07.2011;2011;07;03;Sunnuntai;39;7;46;9;0;9
89;10.07.2011;2011;07;04;Sunnuntai;28;4;32;8;2;10
89;10.07.2011;2011;07;05;Sunnuntai;16;9;25;2;2;4
89;10.07.2011;2011;07;06;Sunnuntai;7;16;23;4;0;4
89;10.07.2011;2011;07;07;Sunnuntai;13;12;25;5;5;10
89;10.07.2011;2011;07;08;Sunnuntai;10;12;22;7;6;13
89;10.07.2011;2011;07;09;Sunnuntai;15;29;44;10;12;22
89;10.07.2011;2011;07;10;Sunnuntai;33;52;85;11;8;19
89;10.07.2011;2011;07;11;Sunnuntai;60;105;165;18;26;44
89;10.07.2011;2011;07;12;Sunnuntai;86;103;189;34;50;84
89;10.07.2011;2011;07;13;Sunnuntai;104;130;234;30;41;71
89;10.07.2011;2011;07;14;Sunnuntai;137;103;240;18;22;40
89;10.07.2011;2011;07;15;Sunnuntai;109;58;167;16;20;36
89;10.07.2011;2011;07;16;Sunnuntai;72;52;124;16;21;37
89;10.07.2011;2011;07;17;Sunnuntai;64;19;83;8;7;15
89;10.07.2011;2011;07;18;Sunnuntai;55;35;90;11;13;24
89;10.07.2011;2011;07;19;Sunnuntai;46;41;87;17;29;46
89;10.07.2011;2011;07;20;Sunnuntai;79;61;140;22;30;52
89;10.07.2011;2011;07;21;Sunnuntai;69;42;111;26;20;46
89;10.07.2011;2011;07;22;Sunnuntai;31;20;51;13;10;23
89;10.07.2011;2011;07;23;Sunnuntai;30;22;52;5;4;9
89;11.07.2011;2011;07;00;Maanantai;10;9;19;9;5;14
89;11.07.2011;2011;07;01;Maanantai;2;8;10;2;2;4
89;11.07.2011;2011;07;02;Maanantai;6;6;12;2;1;3
89;11.07.2011;2011;07;03;Maanantai;5;5;10;0;1;1
89;11.07.2011;2011;07;04;Maanantai;2;4;6;1;3;4
89;11.07.2011;2011;07;05;Maanantai;15;14;29;0;2;2
89;11.07.2011;2011;07;06;Maanantai;32;86;118;1;9;10
89;11.07.2011;2011;07;07;Maanantai;38;116;154;4;13;17
89;11.07.2011;2011;07;08;Maanantai;46;136;182;7;16;23
89;11.07.2011;2011;07;09;Maanantai;57;114;171;8;20;28
89;11.07.2011;2011;07;10;Maanantai;67;144;211;19;28;47
89;11.07.2011;2011;07;11;Maanantai;115;167;282;20;34;54
89;11.07.2011;2011;07;12;Maanantai;163;141;304;23;17;40
89;11.07.2011;2011;07;13;Maanantai;156;129;285;32;43;75
89;11.07.2011;2011;07;14;Maanantai;186;157;343;33;21;54
89;11.07.2011;2011;07;15;Maanantai;249;166;415;33;19;52
89;11.07.2011;2011;07;16;Maanantai;228;195;423;24;20;44
89;11.07.2011;2011;07;17;Maanantai;187;135;322;18;43;61
89;11.07.2011;2011;07;18;Maanantai;164;140;304;37;40;77
89;11.07.2011;2011;07;19;Maanantai;201;110;311;53;34;87
89;11.07.2011;2011;07;20;Maanantai;141;74;215;31;22;53
89;11.07.2011;2011;07;21;Maanantai;87;35;122;21;12;33
89;11.07.2011;2011;07;22;Maanantai;31;31;62;4;5;9
89;11.07.2011;2011;07;23;Maanantai;20;11;31;4;6;10
89;12.07.2011;2011;07;00;Tiistai;17;10;27;8;3;11
89;12.07.2011;2011;07;01;Tiistai;8;20;28;0;5;5
89;12.07.2011;2011;07;02;Tiistai;3;5;8;0;1;1
89;12.07.2011;2011;07;03;Tiistai;4;2;6;0;1;1
89;12.07.2011;2011;07;04;Tiistai;3;3;6;0;0;0
89;12.07.2011;2011;07;05;Tiistai;6;12;18;1;3;4
89;12.07.2011;2011;07;06;Tiistai;41;72;113;2;8;10
89;12.07.2011;2011;07;07;Tiistai;48;127;175;1;19;20
89;12.07.2011;2011;07;08;Tiistai;38;120;158;7;22;29
89;12.07.2011;2011;07;09;Tiistai;61;72;133;12;19;31
89;12.07.2011;2011;07;10;Tiistai;34;54;88;12;20;32
89;12.07.2011;2011;07;11;Tiistai;38;46;84;11;9;20
89;12.07.2011;2011;07;12;Tiistai;46;45;91;13;14;27
89;12.07.2011;2011;07;13;Tiistai;56;28;84;5;7;12
89;12.07.2011;2011;07;14;Tiistai;76;46;122;9;15;24
89;12.07.2011;2011;07;15;Tiistai;96;47;143;14;15;29
89;12.07.2011;2011;07;16;Tiistai;104;37;141;18;5;23
89;12.07.2011;2011;07;17;Tiistai;56;33;89;13;7;20
89;12.07.2011;2011;07;18;Tiistai;48;17;65;9;8;17
89;12.07.2011;2011;07;19;Tiistai;40;25;65;8;16;24
89;12.07.2011;2011;07;20;Tiistai;45;21;66;13;9;22
89;12.07.2011;2011;07;21;Tiistai;40;20;60;9;9;18
89;12.07.2011;2011;07;22;Tiistai;18;17;35;9;6;15
89;12.07.2011;2011;07;23;Tiistai;18;11;29;1;1;2
89;13.07.2011;2011;07;00;Keskiviikko;8;2;10;0;0;0
89;13.07.2011;2011;07;01;Keskiviikko;0;1;1;2;1;3
89;13.07.2011;2011;07;02;Keskiviikko;8;4;12;2;2;4
89;13.07.2011;2011;07;03;Keskiviikko;5;1;6;0;0;0
89;13.07.2011;2011;07;04;Keskiviikko;3;2;5;0;0;0
89;13.07.2011;2011;07;05;Keskiviikko;5;4;9;0;1;1
89;13.07.2011;2011;07;06;Keskiviikko;22;38;60;2;13;15
89;13.07.2011;2011;07;07;Keskiviikko;34;76;110;3;17;20
89;13.07.2011;2011;07;08;Keskiviikko;29;93;122;7;20;27
89;13.07.2011;2011;07;09;Keskiviikko;24;68;92;13;23;36
89;13.07.2011;2011;07;10;Keskiviikko;39;108;147;16;19;35
89;13.07.2011;2011;07;11;Keskiviikko;62;112;174;22;31;53
89;13.07.2011;2011;07;12;Keskiviikko;79;102;181;12;31;43
89;13.07.2011;2011;07;13;Keskiviikko;112;145;257;20;33;53
89;13.07.2011;2011;07;14;Keskiviikko;142;119;261;17;34;51
89;13.07.2011;2011;07;15;Keskiviikko;186;126;312;23;18;41
89;13.07.2011;2011;07;16;Keskiviikko;190;148;338;23;37;60
89;13.07.2011;2011;07;17;Keskiviikko;129;158;287;29;22;51
89;13.07.2011;2011;07;18;Keskiviikko;135;127;262;33;57;90
89;13.07.2011;2011;07;19;Keskiviikko;155;116;271;37;36;73
89;13.07.2011;2011;07;20;Keskiviikko;126;97;223;26;22;48
89;13.07.2011;2011;07;21;Keskiviikko;107;52;159;20;33;53
89;13.07.2011;2011;07;22;Keskiviikko;50;46;96;14;12;26
89;13.07.2011;2011;07;23;Keskiviikko;42;20;62;10;12;22
89;14.07.2011;2011;07;00;Torstai;35;30;65;5;4;9
89;14.07.2011;2011;07;01;Torstai;37;13;50;5;1;6
89;14.07.2011;2011;07;02;Torstai;20;8;28;8;5;13
89;14.07.2011;2011;07;03;Torstai;17;4;21;3;8;11
89;14.07.2011;2011;07;04;Torstai;15;4;19;7;1;8
89;14.07.2011;2011;07;05;Torstai;9;17;26;3;6;9
89;14.07.2011;2011;07;06;Torstai;31;77;108;2;5;7
89;14.07.2011;2011;07;07;Torstai;59;114;173;5;14;19
89;14.07.2011;2011;07;08;Torstai;33;124;157;6;15;21
89;14.07.2011;2011;07;09;Torstai;53;105;158;19;33;52
89;14.07.2011;2011;07;10;Torstai;59;102;161;16;24;40
89;14.07.2011;2011;07;11;Torstai;85;142;227;29;53;82
89;14.07.2011;2011;07;12;Torstai;111;131;242;21;33;54
89;14.07.2011;2011;07;13;Torstai;138;134;272;13;40;53
89;14.07.2011;2011;07;14;Torstai;167;133;300;36;31;67
89;14.07.2011;2011;07;15;Torstai;196;143;339;28;24;52
89;14.07.2011;2011;07;16;Torstai;197;124;321;35;31;66
89;14.07.2011;2011;07;17;Torstai;128;142;270;28;37;65
89;14.07.2011;2011;07;18;Torstai;133;124;257;35;40;75
89;14.07.2011;2011;07;19;Torstai;117;78;195;28;40;68
89;14.07.2011;2011;07;20;Torstai;132;100;232;19;28;47
89;14.07.2011;2011;07;21;Torstai;114;73;187;22;10;32
89;14.07.2011;2011;07;22;Torstai;55;47;102;8;9;17
89;14.07.2011;2011;07;23;Torstai;43;11;54;10;4;14
89;15.07.2011;2011;07;00;Perjantai;44;6;50;9;6;15
89;15.07.2011;2011;07;01;Perjantai;27;13;40;2;1;3
89;15.07.2011;2011;07;02;Perjantai;12;4;16;4;1;5
89;15.07.2011;2011;07;03;Perjantai;8;4;12;1;0;1
89;15.07.2011;2011;07;04;Perjantai;14;4;18;4;5;9
89;15.07.2011;2011;07;05;Perjantai;11;19;30;0;1;1
89;15.07.2011;2011;07;06;Perjantai;32;68;100;5;8;13
89;15.07.2011;2011;07;07;Perjantai;34;105;139;5;10;15
89;15.07.2011;2011;07;08;Perjantai;47;103;150;10;18;28
89;15.07.2011;2011;07;09;Perjantai;42;129;171;12;19;31
89;15.07.2011;2011;07;10;Perjantai;84;116;200;9;28;37
89;15.07.2011;2011;07;11;Perjantai;78;163;241;25;40;65
89;15.07.2011;2011;07;12;Perjantai;118;147;265;26;42;68
89;15.07.2011;2011;07;13;Perjantai;151;204;355;23;40;63
89;15.07.2011;2011;07;14;Perjantai;189;164;353;33;29;62
89;15.07.2011;2011;07;15;Perjantai;216;159;375;33;36;69
89;15.07.2011;2011;07;16;Perjantai;190;129;319;36;36;72
89;15.07.2011;2011;07;17;Perjantai;125;156;281;21;51;72
89;15.07.2011;2011;07;18;Perjantai;119;184;303;26;42;68
89;15.07.2011;2011;07;19;Perjantai;120;138;258;33;20;53
89;15.07.2011;2011;07;20;Perjantai;99;109;208;21;18;39
89;15.07.2011;2011;07;21;Perjantai;96;83;179;14;14;28
89;15.07.2011;2011;07;22;Perjantai;44;88;132;6;14;20
89;15.07.2011;2011;07;23;Perjantai;93;47;140;12;17;29
89;16.07.2011;2011;07;00;Lauantai;73;26;99;6;3;9
89;16.07.2011;2011;07;01;Lauantai;63;15;78;9;3;12
89;16.07.2011;2011;07;02;Lauantai;62;7;69;10;4;14
89;16.07.2011;2011;07;03;Lauantai;44;9;53;10;3;13
89;16.07.2011;2011;07;04;Lauantai;40;5;45;8;0;8
89;16.07.2011;2011;07;05;Lauantai;14;5;19;5;2;7
89;16.07.2011;2011;07;06;Lauantai;4;22;26;7;4;11
89;16.07.2011;2011;07;07;Lauantai;8;11;19;3;5;8
89;16.07.2011;2011;07;08;Lauantai;12;32;44;5;3;8
89;16.07.2011;2011;07;09;Lauantai;24;54;78;9;23;32
89;16.07.2011;2011;07;10;Lauantai;30;34;64;9;11;20
89;16.07.2011;2011;07;11;Lauantai;40;31;71;11;10;21
89;16.07.2011;2011;07;12;Lauantai;49;47;96;9;29;38
89;16.07.2011;2011;07;13;Lauantai;39;26;65;14;7;21
89;16.07.2011;2011;07;14;Lauantai;34;28;62;3;12;15
89;16.07.2011;2011;07;15;Lauantai;33;21;54;10;7;17
89;16.07.2011;2011;07;16;Lauantai;33;19;52;13;7;20
89;16.07.2011;2011;07;17;Lauantai;37;25;62;4;5;9
89;16.07.2011;2011;07;18;Lauantai;42;36;78;32;15;47
89;16.07.2011;2011;07;19;Lauantai;29;68;97;16;22;38
89;16.07.2011;2011;07;20;Lauantai;43;59;102;12;19;31
89;16.07.2011;2011;07;21;Lauantai;27;43;70;19;17;36
89;16.07.2011;2011;07;22;Lauantai;32;30;62;8;9;17
89;16.07.2011;2011;07;23;Lauantai;21;32;53;5;5;10
89;17.07.2011;2011;07;00;Sunnuntai;12;32;44;5;12;17
89;17.07.2011;2011;07;01;Sunnuntai;25;9;34;2;1;3
89;17.07.2011;2011;07;02;Sunnuntai;16;14;30;7;9;16
89;17.07.2011;2011;07;03;Sunnuntai;20;17;37;9;0;9
89;17.07.2011;2011;07;04;Sunnuntai;16;13;29;8;2;10
89;17.07.2011;2011;07;05;Sunnuntai;4;2;6;2;2;4
89;17.07.2011;2011;07;06;Sunnuntai;13;11;24;4;0;4
89;17.07.2011;2011;07;07;Sunnuntai;11;9;20;5;5;10
89;17.07.2011;2011;07;08;Sunnuntai;15;13;28;7;6;13
89;17.07.2011;2011;07;09;Sunnuntai;28;27;55;10;12;22
89;17.07.2011;2011;07;10;Sunnuntai;56;53;109;11;8;19
89;17.07.2011;2011;07;11;Sunnuntai;83;82;165;18;26;44
89;17.07.2011;2011;07;12;Sunnuntai;116;115;231;34;50;84
89;17.07.2011;2011;07;13;Sunnuntai;160;158;318;30;41;71
89;17.07.2011;2011;07;14;Sunnuntai;143;140;283;18;22;40
89;17.07.2011;2011;07;15;Sunnuntai;154;153;307;16;20;36
89;17.07.2011;2011;07;16;Sunnuntai;149;147;296;16;21;37
89;17.07.2011;2011;07;17;Sunnuntai;139;137;276;8;7;15
89;17.07.2011;2011;07;18;Sunnuntai;137;136;273;11;13;24
89;17.07.2011;2011;07;19;Sunnuntai;112;109;221;17;29;46
89;17.07.2011;2011;07;20;Sunnuntai;105;105;210;22;30;52
89;17.07.2011;2011;07;21;Sunnuntai;78;77;155;26;20;46
89;17.07.2011;2011;07;22;Sunnuntai;51;50;101;13;10;23
89;17.07.2011;2011;07;23;Sunnuntai;23;21;44;5;4;9
89;18.07.2011;2011;07;00;Maanantai;15;14;29;9;5;14
89;18.07.2011;2011;07;01;Maanantai;9;9;18;2;2;4
89;18.07.2011;2011;07;02;Maanantai;10;6;16;2;1;3
89;18.07.2011;2011;07;03;Maanantai;7;6;13;0;1;1
89;18.07.2011;2011;07;04;Maanantai;7;6;13;1;3;4
89;18.07.2011;2011;07;05;Maanantai;10;8;18;0;2;2
89;18.07.2011;2011;07;06;Maanantai;53;50;103;1;9;10
89;18.07.2011;2011;07;07;Maanantai;78;77;155;4;13;17
89;18.07.2011;2011;07;08;Maanantai;71;68;139;7;16;23
89;18.07.2011;2011;07;09;Maanantai;71;70;141;8;20;28
89;18.07.2011;2011;07;10;Maanantai;94;93;187;19;28;47
89;18.07.2011;2011;07;11;Maanantai;100;98;198;20;34;54
89;18.07.2011;2011;07;12;Maanantai;123;120;243;23;17;40
89;18.07.2011;2011;07;13;Maanantai;137;135;272;32;43;75
89;18.07.2011;2011;07;14;Maanantai;148;145;293;33;21;54
89;18.07.2011;2011;07;15;Maanantai;201;198;399;33;19;52
89;18.07.2011;2011;07;16;Maanantai;206;203;409;24;20;44
89;18.07.2011;2011;07;17;Maanantai;155;152;307;18;43;61
89;18.07.2011;2011;07;18;Maanantai;146;144;290;37;40;77
89;18.07.2011;2011;07;19;Maanantai;194;113;307;53;34;87
89;18.07.2011;2011;07;20;Maanantai;130;60;190;31;22;53
89;18.07.2011;2011;07;21;Maanantai;80;69;149;21;12;33
89;18.07.2011;2011;07;22;Maanantai;43;35;78;4;5;9
89;18.07.2011;2011;07;23;Maanantai;26;11;37;4;6;10
89;19.07.2011;2011;07;00;Tiistai;6;15;21;2;6;8
89;19.07.2011;2011;07;01;Tiistai;21;3;24;1;0;1
89;19.07.2011;2011;07;02;Tiistai;6;4;10;4;1;5
89;19.07.2011;2011;07;03;Tiistai;8;1;9;1;0;1
89;19.07.2011;2011;07;04;Tiistai;4;14;18;0;2;2
89;19.07.2011;2011;07;05;Tiistai;5;19;24;2;2;4
89;19.07.2011;2011;07;06;Tiistai;38;73;111;4;5;9
89;19.07.2011;2011;07;07;Tiistai;55;105;160;5;12;17
89;19.07.2011;2011;07;08;Tiistai;64;117;181;9;10;19
89;19.07.2011;2011;07;09;Tiistai;72;114;186;11;24;35
89;19.07.2011;2011;07;10;Tiistai;87;119;206;22;49;71
89;19.07.2011;2011;07;11;Tiistai;126;107;233;17;28;45
89;19.07.2011;2011;07;12;Tiistai;73;81;154;19;25;44
89;19.07.2011;2011;07;13;Tiistai;79;66;145;11;9;20
89;19.07.2011;2011;07;14;Tiistai;90;77;167;20;21;41
89;19.07.2011;2011;07;15;Tiistai;170;87;257;20;6;26
89;19.07.2011;2011;07;16;Tiistai;120;62;182;23;14;37
89;19.07.2011;2011;07;17;Tiistai;92;89;181;26;32;58
89;19.07.2011;2011;07;18;Tiistai;99;86;185;18;28;46
89;19.07.2011;2011;07;19;Tiistai;100;55;155;42;37;79
89;19.07.2011;2011;07;20;Tiistai;87;54;141;25;15;40
89;19.07.2011;2011;07;21;Tiistai;37;35;72;15;17;32
89;19.07.2011;2011;07;22;Tiistai;45;26;71;8;7;15
89;19.07.2011;2011;07;23;Tiistai;24;23;47;4;6;10
89;20.07.2011;2011;07;00;Keskiviikko;8;7;15;3;3;6
89;20.07.2011;2011;07;01;Keskiviikko;17;2;19;1;1;2
89;20.07.2011;2011;07;02;Keskiviikko;5;5;10;0;3;3
89;20.07.2011;2011;07;03;Keskiviikko;6;0;6;1;1;2
89;20.07.2011;2011;07;04;Keskiviikko;2;7;9;1;0;1
89;20.07.2011;2011;07;05;Keskiviikko;7;17;24;1;2;3
89;20.07.2011;2011;07;06;Keskiviikko;41;73;114;3;7;10
89;20.07.2011;2011;07;07;Keskiviikko;49;112;161;7;16;23
89;20.07.2011;2011;07;08;Keskiviikko;55;107;162;8;23;31
89;20.07.2011;2011;07;09;Keskiviikko;55;107;162;7;32;39
89;20.07.2011;2011;07;10;Keskiviikko;74;180;254;18;32;50
89;20.07.2011;2011;07;11;Keskiviikko;124;188;312;21;48;69
89;20.07.2011;2011;07;12;Keskiviikko;144;205;349;17;33;50
89;20.07.2011;2011;07;13;Keskiviikko;168;198;366;32;34;66
89;20.07.2011;2011;07;14;Keskiviikko;227;195;422;24;33;57
89;20.07.2011;2011;07;15;Keskiviikko;304;190;494;28;22;50
89;20.07.2011;2011;07;16;Keskiviikko;237;157;394;21;31;52
89;20.07.2011;2011;07;17;Keskiviikko;208;216;424;41;37;78
89;20.07.2011;2011;07;18;Keskiviikko;218;200;418;40;49;89
89;20.07.2011;2011;07;19;Keskiviikko;189;168;357;33;41;74
89;20.07.2011;2011;07;20;Keskiviikko;190;109;299;33;37;70
89;20.07.2011;2011;07;21;Keskiviikko;182;87;269;31;16;47
89;20.07.2011;2011;07;22;Keskiviikko;74;49;123;8;12;20
89;20.07.2011;2011;07;23;Keskiviikko;77;44;121;6;12;18
89;21.07.2011;2011;07;00;Torstai;53;17;70;9;2;11
89;21.07.2011;2011;07;01;Torstai;30;12;42;2;1;3
89;21.07.2011;2011;07;02;Torstai;16;8;24;1;2;3
89;21.07.2011;2011;07;03;Torstai;34;4;38;3;1;4
89;21.07.2011;2011;07;04;Torstai;16;11;27;0;0;0
89;21.07.2011;2011;07;05;Torstai;14;14;28;3;2;5
89;21.07.2011;2011;07;06;Torstai;38;75;113;1;6;7
89;21.07.2011;2011;07;07;Torstai;33;107;140;6;12;18
89;21.07.2011;2011;07;08;Torstai;35;111;146;15;25;40
89;21.07.2011;2011;07;09;Torstai;67;92;159;6;17;23
89;21.07.2011;2011;07;10;Torstai;70;72;142;17;24;41
89;21.07.2011;2011;07;11;Torstai;74;90;164;16;27;43
89;21.07.2011;2011;07;12;Torstai;92;86;178;22;22;44
89;21.07.2011;2011;07;13;Torstai;119;105;224;22;24;46
89;21.07.2011;2011;07;14;Torstai;124;119;243;18;13;31
89;21.07.2011;2011;07;15;Torstai;195;133;328;28;22;50
89;21.07.2011;2011;07;16;Torstai;191;99;290;18;20;38
89;21.07.2011;2011;07;17;Torstai;112;69;181;19;9;28
89;21.07.2011;2011;07;18;Torstai;120;42;162;12;17;29
89;21.07.2011;2011;07;19;Torstai;68;29;97;10;16;26
89;21.07.2011;2011;07;20;Torstai;93;74;167;17;21;38
89;21.07.2011;2011;07;21;Torstai;49;32;81;8;11;19
89;21.07.2011;2011;07;22;Torstai;30;27;57;7;9;16
89;21.07.2011;2011;07;23;Torstai;29;11;40;4;6;10
89;22.07.2011;2011;07;00;Perjantai;19;7;26;3;3;6
89;22.07.2011;2011;07;01;Perjantai;9;8;17;2;0;2
89;22.07.2011;2011;07;02;Perjantai;3;2;5;2;1;3
89;22.07.2011;2011;07;03;Perjantai;9;7;16;7;2;9
89;22.07.2011;2011;07;04;Perjantai;10;9;19;1;0;1
89;22.07.2011;2011;07;05;Perjantai;6;11;17;1;1;2
89;22.07.2011;2011;07;06;Perjantai;28;41;69;5;3;8
89;22.07.2011;2011;07;07;Perjantai;40;56;96;1;5;6
89;22.07.2011;2011;07;08;Perjantai;22;73;95;3;6;9
89;22.07.2011;2011;07;09;Perjantai;24;38;62;19;6;25
89;22.07.2011;2011;07;10;Perjantai;36;34;70;9;22;31
89;22.07.2011;2011;07;11;Perjantai;49;79;128;13;32;45
89;22.07.2011;2011;07;12;Perjantai;65;123;188;38;30;68
89;22.07.2011;2011;07;13;Perjantai;113;121;234;23;23;46
89;22.07.2011;2011;07;14;Perjantai;122;121;243;23;21;44
89;22.07.2011;2011;07;15;Perjantai;151;125;276;41;34;75
89;22.07.2011;2011;07;16;Perjantai;173;124;297;20;18;38
89;22.07.2011;2011;07;17;Perjantai;158;159;317;18;25;43
89;22.07.2011;2011;07;18;Perjantai;159;128;287;16;24;40
89;22.07.2011;2011;07;19;Perjantai;149;135;284;19;32;51
89;22.07.2011;2011;07;20;Perjantai;150;101;251;22;25;47
89;22.07.2011;2011;07;21;Perjantai;94;100;194;23;27;50
89;22.07.2011;2011;07;22;Perjantai;94;81;175;9;10;19
89;22.07.2011;2011;07;23;Perjantai;68;54;122;8;11;19
89;23.07.2011;2011;07;00;Lauantai;80;29;109;4;5;9
89;23.07.2011;2011;07;01;Lauantai;48;14;62;9;2;11
89;23.07.2011;2011;07;02;Lauantai;48;12;60;9;7;16
89;23.07.2011;2011;07;03;Lauantai;43;6;49;3;0;3
89;23.07.2011;2011;07;04;Lauantai;42;11;53;10;0;10
89;23.07.2011;2011;07;05;Lauantai;16;8;24;8;3;11
89;23.07.2011;2011;07;06;Lauantai;7;23;30;0;2;2
89;23.07.2011;2011;07;07;Lauantai;24;23;47;1;4;5
89;23.07.2011;2011;07;08;Lauantai;13;32;45;6;12;18
89;23.07.2011;2011;07;09;Lauantai;47;59;106;12;15;27
89;23.07.2011;2011;07;10;Lauantai;48;101;149;19;20;39
89;23.07.2011;2011;07;11;Lauantai;76;112;188;13;37;50
89;23.07.2011;2011;07;12;Lauantai;123;116;239;32;28;60
89;23.07.2011;2011;07;13;Lauantai;181;137;318;19;25;44
89;23.07.2011;2011;07;14;Lauantai;147;139;286;19;39;58
89;23.07.2011;2011;07;15;Lauantai;185;146;331;47;21;68
89;23.07.2011;2011;07;16;Lauantai;168;115;283;44;30;74
89;23.07.2011;2011;07;17;Lauantai;159;117;276;34;29;63
89;23.07.2011;2011;07;18;Lauantai;143;112;255;20;28;48
89;23.07.2011;2011;07;19;Lauantai;108;88;196;17;28;45
89;23.07.2011;2011;07;20;Lauantai;103;106;209;18;25;43
89;23.07.2011;2011;07;21;Lauantai;84;105;189;8;20;28
89;23.07.2011;2011;07;22;Lauantai;99;86;185;28;34;62
89;23.07.2011;2011;07;23;Lauantai;93;74;167;5;16;21
89;24.07.2011;2011;07;00;Sunnuntai;88;24;112;9;6;15
89;24.07.2011;2011;07;01;Sunnuntai;67;13;80;11;3;14
89;24.07.2011;2011;07;02;Sunnuntai;45;14;59;7;1;8
89;24.07.2011;2011;07;03;Sunnuntai;42;5;47;9;1;10
89;24.07.2011;2011;07;04;Sunnuntai;35;4;39;5;0;5
89;24.07.2011;2011;07;05;Sunnuntai;15;3;18;2;1;3
89;24.07.2011;2011;07;06;Sunnuntai;9;6;15;4;0;4
89;24.07.2011;2011;07;07;Sunnuntai;16;10;26;5;10;15
89;24.07.2011;2011;07;08;Sunnuntai;19;17;36;7;1;8
89;24.07.2011;2011;07;09;Sunnuntai;38;26;64;14;24;38
89;24.07.2011;2011;07;10;Sunnuntai;43;44;87;17;28;45
89;24.07.2011;2011;07;11;Sunnuntai;47;70;117;18;35;53
89;24.07.2011;2011;07;12;Sunnuntai;97;99;196;27;29;56
89;24.07.2011;2011;07;13;Sunnuntai;96;77;173;16;29;45
89;24.07.2011;2011;07;14;Sunnuntai;54;23;77;6;5;11
89;24.07.2011;2011;07;15;Sunnuntai;61;38;99;10;12;22
89;24.07.2011;2011;07;16;Sunnuntai;36;39;75;14;19;33
89;24.07.2011;2011;07;17;Sunnuntai;85;65;150;15;36;51
89;24.07.2011;2011;07;18;Sunnuntai;39;21;60;15;12;27
89;24.07.2011;2011;07;19;Sunnuntai;46;26;72;22;12;34
89;24.07.2011;2011;07;20;Sunnuntai;30;17;47;15;8;23
89;24.07.2011;2011;07;21;Sunnuntai;41;19;60;10;6;16
89;24.07.2011;2011;07;22;Sunnuntai;18;14;32;9;10;19
89;24.07.2011;2011;07;23;Sunnuntai;14;22;36;5;5;10
89;25.07.2011;2011;07;00;Maanantai;2;17;19;1;0;1
89;25.07.2011;2011;07;01;Maanantai;4;6;10;2;0;2
89;25.07.2011;2011;07;02;Maanantai;7;1;8;2;0;2
89;25.07.2011;2011;07;03;Maanantai;4;1;5;1;0;1
89;25.07.2011;2011;07;04;Maanantai;1;4;5;2;0;2
89;25.07.2011;2011;07;05;Maanantai;7;21;28;2;1;3
89;25.07.2011;2011;07;06;Maanantai;29;83;112;3;5;8
89;25.07.2011;2011;07;07;Maanantai;49;127;176;7;18;25
89;25.07.2011;2011;07;08;Maanantai;60;146;206;5;21;26
89;25.07.2011;2011;07;09;Maanantai;54;107;161;11;25;36
89;25.07.2011;2011;07;10;Maanantai;70;111;181;20;30;50
89;25.07.2011;2011;07;11;Maanantai;85;135;220;28;33;61
89;25.07.2011;2011;07;12;Maanantai;115;147;262;23;42;65
89;25.07.2011;2011;07;13;Maanantai;174;201;375;16;48;64
89;25.07.2011;2011;07;14;Maanantai;195;140;335;31;43;74
89;25.07.2011;2011;07;15;Maanantai;248;168;416;34;35;69
89;25.07.2011;2011;07;16;Maanantai;250;148;398;34;25;59
89;25.07.2011;2011;07;17;Maanantai;185;174;359;29;50;79
89;25.07.2011;2011;07;18;Maanantai;174;175;349;38;53;91
89;25.07.2011;2011;07;19;Maanantai;249;140;389;51;37;88
89;25.07.2011;2011;07;20;Maanantai;156;96;252;28;32;60
89;25.07.2011;2011;07;21;Maanantai;89;56;145;15;25;40
89;25.07.2011;2011;07;22;Maanantai;59;47;106;25;23;48
89;25.07.2011;2011;07;23;Maanantai;38;22;60;10;3;13
89;26.07.2011;2011;07;00;Tiistai;14;8;22;2;2;4
89;26.07.2011;2011;07;01;Tiistai;13;9;22;2;3;5
89;26.07.2011;2011;07;02;Tiistai;9;7;16;1;0;1
89;26.07.2011;2011;07;03;Tiistai;8;4;12;3;2;5
89;26.07.2011;2011;07;04;Tiistai;7;11;18;1;0;1
89;26.07.2011;2011;07;05;Tiistai;6;17;23;4;3;7
89;26.07.2011;2011;07;06;Tiistai;36;76;112;2;7;9
89;26.07.2011;2011;07;07;Tiistai;59;117;176;6;18;24
89;26.07.2011;2011;07;08;Tiistai;47;126;173;1;26;27
89;26.07.2011;2011;07;09;Tiistai;51;132;183;13;17;30
89;26.07.2011;2011;07;10;Tiistai;65;116;181;13;32;45
89;26.07.2011;2011;07;11;Tiistai;91;163;254;25;29;54
89;26.07.2011;2011;07;12;Tiistai;146;182;328;25;34;59
89;26.07.2011;2011;07;13;Tiistai;172;134;306;16;28;44
89;26.07.2011;2011;07;14;Tiistai;136;98;234;11;18;29
89;26.07.2011;2011;07;15;Tiistai;220;143;363;23;39;62
89;26.07.2011;2011;07;16;Tiistai;221;131;352;26;28;54
89;26.07.2011;2011;07;17;Tiistai;164;127;291;21;25;46
89;26.07.2011;2011;07;18;Tiistai;175;128;303;30;39;69
89;26.07.2011;2011;07;19;Tiistai;184;118;302;26;36;62
89;26.07.2011;2011;07;20;Tiistai;122;98;220;20;22;42
89;26.07.2011;2011;07;21;Tiistai;101;88;189;19;19;38
89;26.07.2011;2011;07;22;Tiistai;60;37;97;15;12;27
89;26.07.2011;2011;07;23;Tiistai;35;29;64;5;7;12
89;27.07.2011;2011;07;00;Keskiviikko;28;6;34;3;3;6
89;27.07.2011;2011;07;01;Keskiviikko;13;6;19;5;1;6
89;27.07.2011;2011;07;02;Keskiviikko;5;2;7;4;0;4
89;27.07.2011;2011;07;03;Keskiviikko;13;1;14;3;0;3
89;27.07.2011;2011;07;04;Keskiviikko;6;12;18;0;0;0
89;27.07.2011;2011;07;05;Keskiviikko;5;15;20;3;1;4
89;27.07.2011;2011;07;06;Keskiviikko;35;81;116;3;2;5
89;27.07.2011;2011;07;07;Keskiviikko;45;116;161;3;17;20
89;27.07.2011;2011;07;08;Keskiviikko;37;129;166;10;22;32
89;27.07.2011;2011;07;09;Keskiviikko;44;100;144;11;17;28
89;27.07.2011;2011;07;10;Keskiviikko;64;112;176;18;33;51
89;27.07.2011;2011;07;11;Keskiviikko;101;157;258;24;32;56
89;27.07.2011;2011;07;12;Keskiviikko;166;175;341;21;39;60
89;27.07.2011;2011;07;13;Keskiviikko;172;171;343;19;32;51
89;27.07.2011;2011;07;14;Keskiviikko;213;177;390;29;37;66
89;27.07.2011;2011;07;15;Keskiviikko;263;173;436;37;26;63
89;27.07.2011;2011;07;16;Keskiviikko;262;202;464;36;27;63
89;27.07.2011;2011;07;17;Keskiviikko;206;203;409;45;35;80
89;27.07.2011;2011;07;18;Keskiviikko;197;213;410;33;66;99
89;27.07.2011;2011;07;19;Keskiviikko;167;146;313;25;44;69
89;27.07.2011;2011;07;20;Keskiviikko;160;134;294;40;33;73
89;27.07.2011;2011;07;21;Keskiviikko;174;109;283;35;54;89
89;27.07.2011;2011;07;22;Keskiviikko;96;42;138;18;11;29
89;27.07.2011;2011;07;23;Keskiviikko;68;39;107;6;8;14
89;28.07.2011;2011;07;00;Torstai;73;14;87;3;4;7
89;28.07.2011;2011;07;01;Torstai;25;17;42;5;3;8
89;28.07.2011;2011;07;02;Torstai;12;7;19;5;1;6
89;28.07.2011;2011;07;03;Torstai;14;0;14;4;0;4
89;28.07.2011;2011;07;04;Torstai;17;5;22;2;0;2
89;28.07.2011;2011;07;05;Torstai;6;20;26;4;1;5
89;28.07.2011;2011;07;06;Torstai;22;74;96;3;3;6
89;28.07.2011;2011;07;07;Torstai;42;120;162;8;13;21
89;28.07.2011;2011;07;08;Torstai;53;132;185;7;18;25
89;28.07.2011;2011;07;09;Torstai;56;105;161;17;25;42
89;28.07.2011;2011;07;10;Torstai;67;160;227;15;25;40
89;28.07.2011;2011;07;11;Torstai;113;150;263;20;30;50
89;28.07.2011;2011;07;12;Torstai;159;141;300;22;41;63
89;28.07.2011;2011;07;13;Torstai;180;178;358;33;30;63
89;28.07.2011;2011;07;14;Torstai;207;166;373;33;22;55
89;28.07.2011;2011;07;15;Torstai;258;228;486;43;39;82
89;28.07.2011;2011;07;16;Torstai;275;192;467;25;30;55
89;28.07.2011;2011;07;17;Torstai;221;191;412;30;37;67
89;28.07.2011;2011;07;18;Torstai;184;173;357;31;45;76
89;28.07.2011;2011;07;19;Torstai;159;94;253;41;39;80
89;28.07.2011;2011;07;20;Torstai;163;128;291;19;28;47
89;28.07.2011;2011;07;21;Torstai;134;113;247;24;15;39
89;28.07.2011;2011;07;22;Torstai;92;35;127;17;12;29
89;28.07.2011;2011;07;23;Torstai;57;43;100;6;2;8
89;29.07.2011;2011;07;00;Perjantai;35;12;47;7;7;14
89;29.07.2011;2011;07;01;Perjantai;21;7;28;5;4;9
89;29.07.2011;2011;07;02;Perjantai;20;2;22;0;0;0
89;29.07.2011;2011;07;03;Perjantai;13;1;14;3;3;6
89;29.07.2011;2011;07;04;Perjantai;8;10;18;0;1;1
89;29.07.2011;2011;07;05;Perjantai;13;14;27;3;3;6
89;29.07.2011;2011;07;06;Perjantai;25;74;99;1;2;3
89;29.07.2011;2011;07;07;Perjantai;36;123;159;3;15;18
89;29.07.2011;2011;07;08;Perjantai;42;122;164;14;21;35
89;29.07.2011;2011;07;09;Perjantai;46;118;164;10;19;29
89;29.07.2011;2011;07;10;Perjantai;96;142;238;17;27;44
89;29.07.2011;2011;07;11;Perjantai;101;181;282;20;43;63
89;29.07.2011;2011;07;12;Perjantai;150;196;346;22;38;60
89;29.07.2011;2011;07;13;Perjantai;204;172;376;25;63;88
89;29.07.2011;2011;07;14;Perjantai;216;231;447;25;29;54
89;29.07.2011;2011;07;15;Perjantai;246;173;419;23;22;45
89;29.07.2011;2011;07;16;Perjantai;201;163;364;27;29;56
89;29.07.2011;2011;07;17;Perjantai;171;144;315;23;25;48
89;29.07.2011;2011;07;18;Perjantai;166;163;329;25;30;55
89;29.07.2011;2011;07;19;Perjantai;145;173;318;27;26;53
89;29.07.2011;2011;07;20;Perjantai;127;150;277;18;30;48
89;29.07.2011;2011;07;21;Perjantai;124;117;241;14;24;38
89;29.07.2011;2011;07;22;Perjantai;95;111;206;4;14;18
89;29.07.2011;2011;07;23;Perjantai;85;56;141;11;8;19
89;30.07.2011;2011;07;00;Lauantai;94;17;111;14;5;19
89;30.07.2011;2011;07;01;Lauantai;134;17;151;20;5;25
89;30.07.2011;2011;07;02;Lauantai;97;8;105;15;4;19
89;30.07.2011;2011;07;03;Lauantai;93;4;97;24;7;31
89;30.07.2011;2011;07;04;Lauantai;35;4;39;12;0;12
89;30.07.2011;2011;07;05;Lauantai;15;4;19;5;2;7
89;30.07.2011;2011;07;06;Lauantai;14;18;32;7;8;15
89;30.07.2011;2011;07;07;Lauantai;11;30;41;2;5;7
89;30.07.2011;2011;07;08;Lauantai;24;40;64;11;10;21
89;30.07.2011;2011;07;09;Lauantai;29;112;141;10;15;25
89;30.07.2011;2011;07;10;Lauantai;54;152;206;15;23;38
89;30.07.2011;2011;07;11;Lauantai;98;186;284;15;43;58
89;30.07.2011;2011;07;12;Lauantai;143;205;348;19;47;66
89;30.07.2011;2011;07;13;Lauantai;158;194;352;30;45;75
89;30.07.2011;2011;07;14;Lauantai;167;173;340;20;34;54
89;30.07.2011;2011;07;15;Lauantai;167;180;347;44;34;78
89;30.07.2011;2011;07;16;Lauantai;157;170;327;24;23;47
89;30.07.2011;2011;07;17;Lauantai;153;121;274;22;43;65
89;30.07.2011;2011;07;18;Lauantai;148;167;315;24;42;66
89;30.07.2011;2011;07;19;Lauantai;107;140;247;25;32;57
89;30.07.2011;2011;07;20;Lauantai;82;106;188;12;14;26
89;30.07.2011;2011;07;21;Lauantai;76;93;169;4;8;12
89;30.07.2011;2011;07;22;Lauantai;77;71;148;7;13;20
89;30.07.2011;2011;07;23;Lauantai;83;46;129;7;16;23
89;31.07.2011;2011;07;00;Sunnuntai;81;44;125;9;9;18
89;31.07.2011;2011;07;01;Sunnuntai;95;19;114;15;1;16
89;31.07.2011;2011;07;02;Sunnuntai;99;11;110;19;6;25
89;31.07.2011;2011;07;03;Sunnuntai;63;6;69;19;1;20
89;31.07.2011;2011;07;04;Sunnuntai;23;5;28;10;2;12
89;31.07.2011;2011;07;05;Sunnuntai;13;4;17;1;0;1
89;31.07.2011;2011;07;06;Sunnuntai;18;19;37;4;3;7
89;31.07.2011;2011;07;07;Sunnuntai;11;15;26;6;6;12
89;31.07.2011;2011;07;08;Sunnuntai;8;15;23;7;5;12
89;31.07.2011;2011;07;09;Sunnuntai;21;43;64;8;24;32
89;31.07.2011;2011;07;10;Sunnuntai;41;61;102;20;24;44
89;31.07.2011;2011;07;11;Sunnuntai;85;107;192;29;33;62
89;31.07.2011;2011;07;12;Sunnuntai;96;145;241;28;48;76
89;31.07.2011;2011;07;13;Sunnuntai;126;192;318;42;67;109
89;31.07.2011;2011;07;14;Sunnuntai;140;133;273;33;49;82
89;31.07.2011;2011;07;15;Sunnuntai;151;133;284;22;31;53
89;31.07.2011;2011;07;16;Sunnuntai;171;128;299;39;43;82
89;31.07.2011;2011;07;17;Sunnuntai;133;136;269;37;52;89
89;31.07.2011;2011;07;18;Sunnuntai;123;94;217;26;24;50
89;31.07.2011;2011;07;19;Sunnuntai;97;69;166;34;26;60
89;31.07.2011;2011;07;20;Sunnuntai;110;60;170;32;33;65
89;31.07.2011;2011;07;21;Sunnuntai;48;39;87;13;20;33
89;31.07.2011;2011;07;22;Sunnuntai;29;22;51;12;11;23
89;31.07.2011;2011;07;23;Sunnuntai;27;15;42;2;2;4
89;01.08.2011;2011;08;00;Maanantai;9;6;15;2;0;2
89;01.08.2011;2011;08;01;Maanantai;6;4;10;0;0;0
89;01.08.2011;2011;08;02;Maanantai;1;4;5;0;0;0
89;01.08.2011;2011;08;03;Maanantai;7;3;10;1;0;1
89;01.08.2011;2011;08;04;Maanantai;4;4;8;2;1;3
89;01.08.2011;2011;08;05;Maanantai;7;22;29;0;4;4
89;01.08.2011;2011;08;06;Maanantai;26;81;107;0;7;7
89;01.08.2011;2011;08;07;Maanantai;60;164;224;5;7;12
89;01.08.2011;2011;08;08;Maanantai;45;192;237;4;26;30
89;01.08.2011;2011;08;09;Maanantai;60;107;167;6;25;31
89;01.08.2011;2011;08;10;Maanantai;57;117;174;14;20;34
89;01.08.2011;2011;08;11;Maanantai;95;129;224;12;32;44
89;01.08.2011;2011;08;12;Maanantai;104;127;231;20;36;56
89;01.08.2011;2011;08;13;Maanantai;110;171;281;23;33;56
89;01.08.2011;2011;08;14;Maanantai;149;162;311;18;17;35
89;01.08.2011;2011;08;15;Maanantai;234;155;389;19;21;40
89;01.08.2011;2011;08;16;Maanantai;271;151;422;35;22;57
89;01.08.2011;2011;08;17;Maanantai;199;160;359;28;26;54
89;01.08.2011;2011;08;18;Maanantai;153;107;260;35;33;68
89;01.08.2011;2011;08;19;Maanantai;144;77;221;29;32;61
89;01.08.2011;2011;08;20;Maanantai;141;61;202;20;19;39
89;01.08.2011;2011;08;21;Maanantai;72;38;110;16;18;34
89;01.08.2011;2011;08;22;Maanantai;48;22;70;10;6;16
89;01.08.2011;2011;08;23;Maanantai;18;19;37;2;4;6
89;02.08.2011;2011;08;00;Tiistai;15;5;20;0;2;2
89;02.08.2011;2011;08;01;Tiistai;7;5;12;1;4;5
89;02.08.2011;2011;08;02;Tiistai;7;4;11;1;1;2
89;02.08.2011;2011;08;03;Tiistai;5;2;7;1;0;1
89;02.08.2011;2011;08;04;Tiistai;6;3;9;1;2;3
89;02.08.2011;2011;08;05;Tiistai;12;19;31;2;4;6
89;02.08.2011;2011;08;06;Tiistai;25;69;94;5;3;8
89;02.08.2011;2011;08;07;Tiistai;72;170;242;3;14;17
89;02.08.2011;2011;08;08;Tiistai;58;190;248;6;26;32
89;02.08.2011;2011;08;09;Tiistai;62;128;190;15;20;35
89;02.08.2011;2011;08;10;Tiistai;67;168;235;17;31;48
89;02.08.2011;2011;08;11;Tiistai;95;149;244;22;41;63
89;02.08.2011;2011;08;12;Tiistai;104;165;269;28;39;67
89;02.08.2011;2011;08;13;Tiistai;143;175;318;25;31;56
89;02.08.2011;2011;08;14;Tiistai;175;174;349;33;39;72
89;02.08.2011;2011;08;15;Tiistai;238;187;425;30;32;62
89;02.08.2011;2011;08;16;Tiistai;306;164;470;35;28;63
89;02.08.2011;2011;08;17;Tiistai;208;159;367;30;25;55
89;02.08.2011;2011;08;18;Tiistai;181;107;288;35;23;58
89;02.08.2011;2011;08;19;Tiistai;167;114;281;27;35;62
89;02.08.2011;2011;08;20;Tiistai;117;71;188;27;20;47
89;02.08.2011;2011;08;21;Tiistai;91;54;145;21;22;43
89;02.08.2011;2011;08;22;Tiistai;40;17;57;9;9;18
89;02.08.2011;2011;08;23;Tiistai;25;20;45;6;6;12
89;03.08.2011;2011;08;00;Keskiviikko;20;10;30;4;3;7
89;03.08.2011;2011;08;01;Keskiviikko;4;10;14;5;6;11
89;03.08.2011;2011;08;02;Keskiviikko;5;1;6;1;1;2
89;03.08.2011;2011;08;03;Keskiviikko;5;0;5;23;1;24
89;03.08.2011;2011;08;04;Keskiviikko;5;9;14;1;0;1
89;03.08.2011;2011;08;05;Keskiviikko;12;16;28;0;1;1
89;03.08.2011;2011;08;06;Keskiviikko;29;80;109;3;6;9
89;03.08.2011;2011;08;07;Keskiviikko;63;166;229;6;10;16
89;03.08.2011;2011;08;08;Keskiviikko;62;185;247;10;16;26
89;03.08.2011;2011;08;09;Keskiviikko;53;142;195;13;32;45
89;03.08.2011;2011;08;10;Keskiviikko;44;126;170;12;23;35
89;03.08.2011;2011;08;11;Keskiviikko;92;125;217;17;39;56
89;03.08.2011;2011;08;12;Keskiviikko;108;152;260;15;38;53
89;03.08.2011;2011;08;13;Keskiviikko;135;139;274;33;38;71
89;03.08.2011;2011;08;14;Keskiviikko;162;158;320;28;18;46
89;03.08.2011;2011;08;15;Keskiviikko;248;157;405;31;27;58
89;03.08.2011;2011;08;16;Keskiviikko;268;162;430;22;39;61
89;03.08.2011;2011;08;17;Keskiviikko;170;120;290;29;29;58
89;03.08.2011;2011;08;18;Keskiviikko;148;145;293;30;30;60
89;03.08.2011;2011;08;19;Keskiviikko;165;109;274;25;25;50
89;03.08.2011;2011;08;20;Keskiviikko;122;89;211;29;28;57
89;03.08.2011;2011;08;21;Keskiviikko;78;60;138;14;22;36
89;03.08.2011;2011;08;22;Keskiviikko;63;28;91;10;4;14
89;03.08.2011;2011;08;23;Keskiviikko;43;12;55;6;4;10
89;04.08.2011;2011;08;00;Torstai;11;6;17;3;2;5
89;04.08.2011;2011;08;01;Torstai;15;9;24;2;1;3
89;04.08.2011;2011;08;02;Torstai;4;2;6;1;1;2
89;04.08.2011;2011;08;03;Torstai;14;3;17;4;0;4
89;04.08.2011;2011;08;04;Torstai;14;9;23;1;2;3
89;04.08.2011;2011;08;05;Torstai;7;20;27;1;1;2
89;04.08.2011;2011;08;06;Torstai;33;67;100;1;3;4
89;04.08.2011;2011;08;07;Torstai;58;164;222;5;9;14
89;04.08.2011;2011;08;08;Torstai;55;142;197;4;16;20
89;04.08.2011;2011;08;09;Torstai;56;121;177;7;18;25
89;04.08.2011;2011;08;10;Torstai;52;104;156;24;30;54
89;04.08.2011;2011;08;11;Torstai;91;136;227;12;28;40
89;04.08.2011;2011;08;12;Torstai;89;159;248;21;31;52
89;04.08.2011;2011;08;13;Torstai;111;112;223;21;33;54
89;04.08.2011;2011;08;14;Torstai;146;143;289;18;25;43
89;04.08.2011;2011;08;15;Torstai;217;145;362;25;25;50
89;04.08.2011;2011;08;16;Torstai;262;146;408;26;23;49
89;04.08.2011;2011;08;17;Torstai;173;124;297;37;33;70
89;04.08.2011;2011;08;18;Torstai;135;108;243;21;34;55
89;04.08.2011;2011;08;19;Torstai;173;85;258;39;28;67
89;04.08.2011;2011;08;20;Torstai;121;81;202;31;25;56
89;04.08.2011;2011;08;21;Torstai;82;54;136;26;17;43
89;04.08.2011;2011;08;22;Torstai;45;34;79;3;5;8
89;04.08.2011;2011;08;23;Torstai;28;20;48;5;7;12
89;05.08.2011;2011;08;00;Perjantai;9;12;21;3;2;5
89;05.08.2011;2011;08;01;Perjantai;10;11;21;3;3;6
89;05.08.2011;2011;08;02;Perjantai;12;4;16;1;3;4
89;05.08.2011;2011;08;03;Perjantai;11;1;12;1;0;1
89;05.08.2011;2011;08;04;Perjantai;10;5;15;0;0;0
89;05.08.2011;2011;08;05;Perjantai;8;16;24;2;1;3
89;05.08.2011;2011;08;06;Perjantai;31;84;115;1;2;3
89;05.08.2011;2011;08;07;Perjantai;57;150;207;4;5;9
89;05.08.2011;2011;08;08;Perjantai;49;180;229;7;21;28
89;05.08.2011;2011;08;09;Perjantai;41;101;142;16;35;51
89;05.08.2011;2011;08;10;Perjantai;42;110;152;26;27;53
89;05.08.2011;2011;08;11;Perjantai;69;139;208;28;35;63
89;05.08.2011;2011;08;12;Perjantai;94;126;220;17;25;42
89;05.08.2011;2011;08;13;Perjantai;125;153;278;17;35;52
89;05.08.2011;2011;08;14;Perjantai;148;142;290;20;26;46
89;05.08.2011;2011;08;15;Perjantai;220;100;320;25;19;44
89;05.08.2011;2011;08;16;Perjantai;204;153;357;25;25;50
89;05.08.2011;2011;08;17;Perjantai;164;122;286;13;24;37
89;05.08.2011;2011;08;18;Perjantai;129;122;251;13;15;28
89;05.08.2011;2011;08;19;Perjantai;88;104;192;23;32;55
89;05.08.2011;2011;08;20;Perjantai;73;66;139;18;15;33
89;05.08.2011;2011;08;21;Perjantai;84;70;154;9;16;25
89;05.08.2011;2011;08;22;Perjantai;67;61;128;10;1;11
89;05.08.2011;2011;08;23;Perjantai;43;33;76;2;2;4
89;06.08.2011;2011;08;00;Lauantai;52;17;69;5;4;9
89;06.08.2011;2011;08;01;Lauantai;31;17;48;8;5;13
89;06.08.2011;2011;08;02;Lauantai;41;8;49;5;3;8
89;06.08.2011;2011;08;03;Lauantai;25;5;30;8;1;9
89;06.08.2011;2011;08;04;Lauantai;23;4;27;6;1;7
89;06.08.2011;2011;08;05;Lauantai;8;7;15;1;1;2
89;06.08.2011;2011;08;06;Lauantai;11;17;28;2;1;3
89;06.08.2011;2011;08;07;Lauantai;14;11;25;4;9;13
89;06.08.2011;2011;08;08;Lauantai;27;50;77;9;9;18
89;06.08.2011;2011;08;09;Lauantai;21;88;109;11;26;37
89;06.08.2011;2011;08;10;Lauantai;42;90;132;19;29;48
89;06.08.2011;2011;08;11;Lauantai;76;125;201;28;58;86
89;06.08.2011;2011;08;12;Lauantai;108;113;221;32;52;84
89;06.08.2011;2011;08;13;Lauantai;105;139;244;20;41;61
89;06.08.2011;2011;08;14;Lauantai;148;122;270;25;35;60
89;06.08.2011;2011;08;15;Lauantai;119;107;226;36;45;81
89;06.08.2011;2011;08;16;Lauantai;141;78;219;26;28;54
89;06.08.2011;2011;08;17;Lauantai;90;81;171;10;16;26
89;06.08.2011;2011;08;18;Lauantai;92;99;191;16;18;34
89;06.08.2011;2011;08;19;Lauantai;65;82;147;8;15;23
89;06.08.2011;2011;08;20;Lauantai;60;72;132;6;16;22
89;06.08.2011;2011;08;21;Lauantai;36;60;96;7;6;13
89;06.08.2011;2011;08;22;Lauantai;36;45;81;8;11;19
89;06.08.2011;2011;08;23;Lauantai;54;43;97;5;9;14
89;07.08.2011;2011;08;00;Sunnuntai;47;31;78;4;3;7
89;07.08.2011;2011;08;01;Sunnuntai;30;17;47;6;2;8
89;07.08.2011;2011;08;02;Sunnuntai;31;11;42;5;1;6
89;07.08.2011;2011;08;03;Sunnuntai;54;5;59;7;0;7
89;07.08.2011;2011;08;04;Sunnuntai;26;3;29;9;1;10
89;07.08.2011;2011;08;05;Sunnuntai;15;5;20;5;0;5
89;07.08.2011;2011;08;06;Sunnuntai;10;16;26;2;3;5
89;07.08.2011;2011;08;07;Sunnuntai;11;9;20;3;2;5
89;07.08.2011;2011;08;08;Sunnuntai;7;26;33;8;19;27
89;07.08.2011;2011;08;09;Sunnuntai;22;45;67;10;23;33
89;07.08.2011;2011;08;10;Sunnuntai;37;60;97;22;39;61
89;07.08.2011;2011;08;11;Sunnuntai;50;106;156;26;44;70
89;07.08.2011;2011;08;12;Sunnuntai;78;91;169;38;31;69
89;07.08.2011;2011;08;13;Sunnuntai;114;119;233;28;33;61
89;07.08.2011;2011;08;14;Sunnuntai;84;135;219;42;59;101
89;07.08.2011;2011;08;15;Sunnuntai;110;120;230;22;51;73
89;07.08.2011;2011;08;16;Sunnuntai;100;95;195;27;37;64
89;07.08.2011;2011;08;17;Sunnuntai;140;82;222;36;36;72
89;07.08.2011;2011;08;18;Sunnuntai;138;84;222;35;25;60
89;07.08.2011;2011;08;19;Sunnuntai;91;92;183;24;25;49
89;07.08.2011;2011;08;20;Sunnuntai;83;47;130;24;18;42
89;07.08.2011;2011;08;21;Sunnuntai;65;36;101;12;17;29
89;07.08.2011;2011;08;22;Sunnuntai;33;19;52;5;7;12
89;07.08.2011;2011;08;23;Sunnuntai;14;14;28;7;4;11
89;08.08.2011;2011;08;00;Maanantai;18;9;27;1;2;3
89;08.08.2011;2011;08;01;Maanantai;3;3;6;1;2;3
89;08.08.2011;2011;08;02;Maanantai;3;6;9;1;2;3
89;08.08.2011;2011;08;03;Maanantai;7;6;13;2;0;2
89;08.08.2011;2011;08;04;Maanantai;7;8;15;2;2;4
89;08.08.2011;2011;08;05;Maanantai;7;17;24;1;3;4
89;08.08.2011;2011;08;06;Maanantai;37;64;101;2;3;5
89;08.08.2011;2011;08;07;Maanantai;53;78;131;2;16;18
89;08.08.2011;2011;08;08;Maanantai;38;90;128;1;18;19
89;08.08.2011;2011;08;09;Maanantai;32;50;82;5;10;15
89;08.08.2011;2011;08;10;Maanantai;24;28;52;4;12;16
89;08.08.2011;2011;08;11;Maanantai;30;20;50;10;16;26
89;08.08.2011;2011;08;12;Maanantai;32;34;66;10;2;12
89;08.08.2011;2011;08;13;Maanantai;40;45;85;12;6;18
89;08.08.2011;2011;08;14;Maanantai;54;56;110;11;16;27
89;08.08.2011;2011;08;15;Maanantai;119;87;206;23;16;39
89;08.08.2011;2011;08;16;Maanantai;160;78;238;31;14;45
89;08.08.2011;2011;08;17;Maanantai;78;42;120;23;15;38
89;08.08.2011;2011;08;18;Maanantai;65;47;112;27;14;41
89;08.08.2011;2011;08;19;Maanantai;46;19;65;16;6;22
89;08.08.2011;2011;08;20;Maanantai;53;23;76;8;10;18
89;08.08.2011;2011;08;21;Maanantai;30;12;42;8;11;19
89;08.08.2011;2011;08;22;Maanantai;19;8;27;6;15;21
89;08.08.2011;2011;08;23;Maanantai;7;4;11;3;3;6
89;09.08.2011;2011;08;00;Tiistai;6;0;6;2;0;2
89;09.08.2011;2011;08;01;Tiistai;1;1;2;0;1;1
89;09.08.2011;2011;08;02;Tiistai;4;0;4;2;2;4
89;09.08.2011;2011;08;03;Tiistai;2;0;2;0;0;0
89;09.08.2011;2011;08;04;Tiistai;2;3;5;0;0;0
89;09.08.2011;2011;08;05;Tiistai;5;13;18;0;2;2
89;09.08.2011;2011;08;06;Tiistai;40;73;113;2;8;10
89;09.08.2011;2011;08;07;Tiistai;58;144;202;8;12;20
89;09.08.2011;2011;08;08;Tiistai;60;182;242;5;20;25
89;09.08.2011;2011;08;09;Tiistai;59;101;160;14;20;34
89;09.08.2011;2011;08;10;Tiistai;56;105;161;16;37;53
89;09.08.2011;2011;08;11;Tiistai;96;118;214;13;20;33
89;09.08.2011;2011;08;12;Tiistai;91;146;237;16;29;45
89;09.08.2011;2011;08;13;Tiistai;139;125;264;25;26;51
89;09.08.2011;2011;08;14;Tiistai;162;122;284;18;16;34
89;09.08.2011;2011;08;15;Tiistai;229;137;366;28;31;59
89;09.08.2011;2011;08;16;Tiistai;220;157;377;27;18;45
89;09.08.2011;2011;08;17;Tiistai;176;92;268;19;23;42
89;09.08.2011;2011;08;18;Tiistai;125;92;217;35;27;62
89;09.08.2011;2011;08;19;Tiistai;110;75;185;34;37;71
89;09.08.2011;2011;08;20;Tiistai;80;63;143;23;20;43
89;09.08.2011;2011;08;21;Tiistai;64;47;111;29;36;65
89;09.08.2011;2011;08;22;Tiistai;28;24;52;7;7;14
89;09.08.2011;2011;08;23;Tiistai;14;5;19;8;2;10
89;10.08.2011;2011;08;00;Keskiviikko;18;5;23;2;2;4
89;10.08.2011;2011;08;01;Keskiviikko;12;5;17;1;2;3
89;10.08.2011;2011;08;02;Keskiviikko;4;2;6;0;1;1
89;10.08.2011;2011;08;03;Keskiviikko;8;4;12;2;1;3
89;10.08.2011;2011;08;04;Keskiviikko;4;5;9;0;1;1
89;10.08.2011;2011;08;05;Keskiviikko;10;19;29;0;2;2
89;10.08.2011;2011;08;06;Keskiviikko;36;85;121;9;7;16
89;10.08.2011;2011;08;07;Keskiviikko;65;169;234;2;20;22
89;10.08.2011;2011;08;08;Keskiviikko;71;211;282;10;30;40
89;10.08.2011;2011;08;09;Keskiviikko;48;145;193;3;26;29
89;10.08.2011;2011;08;10;Keskiviikko;54;97;151;18;29;47
89;10.08.2011;2011;08;11;Keskiviikko;91;123;214;24;34;58
89;10.08.2011;2011;08;12;Keskiviikko;98;126;224;19;28;47
89;10.08.2011;2011;08;13;Keskiviikko;140;93;233;24;14;38
89;10.08.2011;2011;08;14;Keskiviikko;162;82;244;26;28;54
89;10.08.2011;2011;08;15;Keskiviikko;211;120;331;25;18;43
89;10.08.2011;2011;08;16;Keskiviikko;251;123;374;15;18;33
89;10.08.2011;2011;08;17;Keskiviikko;148;103;251;25;23;48
89;10.08.2011;2011;08;18;Keskiviikko;116;86;202;21;12;33
89;10.08.2011;2011;08;19;Keskiviikko;93;63;156;26;19;45
89;10.08.2011;2011;08;20;Keskiviikko;91;41;132;22;29;51
89;10.08.2011;2011;08;21;Keskiviikko;65;36;101;15;10;25
89;10.08.2011;2011;08;22;Keskiviikko;33;16;49;14;5;19
89;10.08.2011;2011;08;23;Keskiviikko;11;11;22;2;4;6
89;11.08.2011;2011;08;00;Torstai;14;4;18;1;1;2
89;11.08.2011;2011;08;01;Torstai;11;6;17;3;0;3
89;11.08.2011;2011;08;02;Torstai;7;2;9;0;0;0
89;11.08.2011;2011;08;03;Torstai;5;6;11;0;0;0
89;11.08.2011;2011;08;04;Torstai;4;5;9;1;2;3
89;11.08.2011;2011;08;05;Torstai;8;22;30;0;6;6
89;11.08.2011;2011;08;06;Torstai;40;82;122;2;4;6
89;11.08.2011;2011;08;07;Torstai;72;211;283;3;24;27
89;11.08.2011;2011;08;08;Torstai;88;202;290;9;24;33
89;11.08.2011;2011;08;09;Torstai;45;152;197;4;25;29
89;11.08.2011;2011;08;10;Torstai;62;119;181;13;29;42
89;11.08.2011;2011;08;11;Torstai;76;143;219;22;26;48
89;11.08.2011;2011;08;12;Torstai;97;144;241;17;18;35
89;11.08.2011;2011;08;13;Torstai;137;114;251;20;11;31
89;11.08.2011;2011;08;14;Torstai;160;102;262;20;32;52
89;11.08.2011;2011;08;15;Torstai;212;143;355;25;17;42
89;11.08.2011;2011;08;16;Torstai;237;126;363;22;18;40
89;11.08.2011;2011;08;17;Torstai;160;101;261;24;30;54
89;11.08.2011;2011;08;18;Torstai;128;79;207;28;40;68
89;11.08.2011;2011;08;19;Torstai;107;59;166;26;27;53
89;11.08.2011;2011;08;20;Torstai;102;54;156;15;17;32
89;11.08.2011;2011;08;21;Torstai;75;41;116;15;13;28
89;11.08.2011;2011;08;22;Torstai;34;19;53;5;6;11
89;11.08.2011;2011;08;23;Torstai;10;3;13;2;1;3
89;12.08.2011;2011;08;00;Perjantai;6;5;11;2;1;3
89;12.08.2011;2011;08;01;Perjantai;7;4;11;0;0;0
89;12.08.2011;2011;08;02;Perjantai;4;3;7;2;0;2
89;12.08.2011;2011;08;03;Perjantai;11;1;12;1;0;1
89;12.08.2011;2011;08;04;Perjantai;11;9;20;0;2;2
89;12.08.2011;2011;08;05;Perjantai;6;16;22;1;4;5
89;12.08.2011;2011;08;06;Perjantai;38;66;104;5;5;10
89;12.08.2011;2011;08;07;Perjantai;65;239;304;5;33;38
89;12.08.2011;2011;08;08;Perjantai;86;243;329;17;31;48
89;12.08.2011;2011;08;09;Perjantai;58;154;212;23;25;48
89;12.08.2011;2011;08;10;Perjantai;77;110;187;19;22;41
89;12.08.2011;2011;08;11;Perjantai;83;124;207;19;35;54
89;12.08.2011;2011;08;12;Perjantai;118;141;259;20;28;48
89;12.08.2011;2011;08;13;Perjantai;199;151;350;19;22;41
89;12.08.2011;2011;08;14;Perjantai;195;140;335;27;19;46
89;12.08.2011;2011;08;15;Perjantai;240;150;390;22;26;48
89;12.08.2011;2011;08;16;Perjantai;193;151;344;28;16;44
89;12.08.2011;2011;08;17;Perjantai;156;109;265;21;26;47
89;12.08.2011;2011;08;18;Perjantai;127;100;227;19;28;47
89;12.08.2011;2011;08;19;Perjantai;126;86;212;30;29;59
89;12.08.2011;2011;08;20;Perjantai;80;87;167;20;22;42
89;12.08.2011;2011;08;21;Perjantai;76;52;128;11;17;28
89;12.08.2011;2011;08;22;Perjantai;41;37;78;8;14;22
89;12.08.2011;2011;08;23;Perjantai;47;36;83;7;9;16
89;13.08.2011;2011;08;00;Lauantai;12;31;43;2;5;7
89;13.08.2011;2011;08;01;Lauantai;29;10;39;5;2;7
89;13.08.2011;2011;08;02;Lauantai;32;8;40;11;3;14
89;13.08.2011;2011;08;03;Lauantai;33;4;37;5;2;7
89;13.08.2011;2011;08;04;Lauantai;20;2;22;2;1;3
89;13.08.2011;2011;08;05;Lauantai;8;7;15;0;1;1
89;13.08.2011;2011;08;06;Lauantai;8;17;25;0;2;2
89;13.08.2011;2011;08;07;Lauantai;17;26;43;2;5;7
89;13.08.2011;2011;08;08;Lauantai;23;40;63;5;8;13
89;13.08.2011;2011;08;09;Lauantai;27;76;103;15;28;43
89;13.08.2011;2011;08;10;Lauantai;53;98;151;13;23;36
89;13.08.2011;2011;08;11;Lauantai;65;123;188;16;29;45
89;13.08.2011;2011;08;12;Lauantai;82;136;218;27;36;63
89;13.08.2011;2011;08;13;Lauantai;112;134;246;17;29;46
89;13.08.2011;2011;08;14;Lauantai;122;128;250;22;33;55
89;13.08.2011;2011;08;15;Lauantai;126;111;237;32;33;65
89;13.08.2011;2011;08;16;Lauantai;135;112;247;31;27;58
89;13.08.2011;2011;08;17;Lauantai;134;99;233;24;25;49
89;13.08.2011;2011;08;18;Lauantai;126;102;228;26;30;56
89;13.08.2011;2011;08;19;Lauantai;71;69;140;24;16;40
89;13.08.2011;2011;08;20;Lauantai;77;63;140;9;24;33
89;13.08.2011;2011;08;21;Lauantai;62;64;126;4;15;19
89;13.08.2011;2011;08;22;Lauantai;42;35;77;4;11;15
89;13.08.2011;2011;08;23;Lauantai;32;36;68;2;6;8
89;14.08.2011;2011;08;00;Sunnuntai;34;34;68;0;2;2
89;14.08.2011;2011;08;01;Sunnuntai;46;11;57;8;5;13
89;14.08.2011;2011;08;02;Sunnuntai;42;7;49;11;1;12
89;14.08.2011;2011;08;03;Sunnuntai;32;1;33;12;0;12
89;14.08.2011;2011;08;04;Sunnuntai;23;1;24;12;0;12
89;14.08.2011;2011;08;05;Sunnuntai;7;10;17;1;0;1
89;14.08.2011;2011;08;06;Sunnuntai;10;13;23;2;3;5
89;14.08.2011;2011;08;07;Sunnuntai;9;10;19;3;5;8
89;14.08.2011;2011;08;08;Sunnuntai;16;8;24;8;8;16
89;14.08.2011;2011;08;09;Sunnuntai;16;39;55;15;22;37
89;14.08.2011;2011;08;10;Sunnuntai;28;69;97;31;33;64
89;14.08.2011;2011;08;11;Sunnuntai;80;149;229;25;32;57
89;14.08.2011;2011;08;12;Sunnuntai;120;127;247;21;41;62
89;14.08.2011;2011;08;13;Sunnuntai;111;153;264;29;47;76
89;14.08.2011;2011;08;14;Sunnuntai;142;176;318;28;54;82
89;14.08.2011;2011;08;15;Sunnuntai;178;132;310;53;40;93
89;14.08.2011;2011;08;16;Sunnuntai;156;131;287;44;35;79
89;14.08.2011;2011;08;17;Sunnuntai;140;127;267;45;40;85
89;14.08.2011;2011;08;18;Sunnuntai;169;122;291;37;36;73
89;14.08.2011;2011;08;19;Sunnuntai;117;71;188;30;27;57
89;14.08.2011;2011;08;20;Sunnuntai;85;46;131;18;22;40
89;14.08.2011;2011;08;21;Sunnuntai;56;28;84;19;16;35
89;14.08.2011;2011;08;22;Sunnuntai;18;10;28;13;6;19
89;14.08.2011;2011;08;23;Sunnuntai;18;3;21;7;5;12
89;15.08.2011;2011;08;00;Maanantai;7;6;13;10;8;18
89;15.08.2011;2011;08;01;Maanantai;1;5;6;0;1;1
89;15.08.2011;2011;08;02;Maanantai;3;0;3;4;0;4
89;15.08.2011;2011;08;03;Maanantai;6;1;7;0;0;0
89;15.08.2011;2011;08;04;Maanantai;1;8;9;0;2;2
89;15.08.2011;2011;08;05;Maanantai;7;13;20;1;1;2
89;15.08.2011;2011;08;06;Maanantai;36;74;110;2;5;7
89;15.08.2011;2011;08;07;Maanantai;82;278;360;10;24;34
89;15.08.2011;2011;08;08;Maanantai;102;262;364;13;26;39
89;15.08.2011;2011;08;09;Maanantai;80;190;270;12;30;42
89;15.08.2011;2011;08;10;Maanantai;63;118;181;12;16;28
89;15.08.2011;2011;08;11;Maanantai;102;128;230;33;55;88
89;15.08.2011;2011;08;12;Maanantai;143;162;305;22;30;52
89;15.08.2011;2011;08;13;Maanantai;139;137;276;32;39;71
89;15.08.2011;2011;08;14;Maanantai;175;158;333;22;27;49
89;15.08.2011;2011;08;15;Maanantai;300;145;445;34;28;62
89;15.08.2011;2011;08;16;Maanantai;357;159;516;32;28;60
89;15.08.2011;2011;08;17;Maanantai;205;126;331;35;30;65
89;15.08.2011;2011;08;18;Maanantai;185;115;300;38;31;69
89;15.08.2011;2011;08;19;Maanantai;155;94;249;45;32;77
89;15.08.2011;2011;08;20;Maanantai;113;61;174;31;33;64
89;15.08.2011;2011;08;21;Maanantai;82;41;123;15;12;27
89;15.08.2011;2011;08;22;Maanantai;39;12;51;5;7;12
89;15.08.2011;2011;08;23;Maanantai;15;9;24;2;3;5
89;16.08.2011;2011;08;00;Tiistai;5;5;10;2;0;2
89;16.08.2011;2011;08;01;Tiistai;7;2;9;2;2;4
89;16.08.2011;2011;08;02;Tiistai;5;2;7;1;0;1
89;16.08.2011;2011;08;03;Tiistai;1;2;3;1;0;1
89;16.08.2011;2011;08;04;Tiistai;6;7;13;0;2;2
89;16.08.2011;2011;08;05;Tiistai;10;15;25;0;0;0
89;16.08.2011;2011;08;06;Tiistai;41;92;133;3;3;6
89;16.08.2011;2011;08;07;Tiistai;104;268;372;4;27;31
89;16.08.2011;2011;08;08;Tiistai;110;266;376;14;40;54
89;16.08.2011;2011;08;09;Tiistai;48;154;202;24;42;66
89;16.08.2011;2011;08;10;Tiistai;77;114;191;14;20;34
89;16.08.2011;2011;08;11;Tiistai;108;109;217;18;26;44
89;16.08.2011;2011;08;12;Tiistai;99;120;219;15;23;38
89;16.08.2011;2011;08;13;Tiistai;137;113;250;21;33;54
89;16.08.2011;2011;08;14;Tiistai;196;127;323;26;19;45
89;16.08.2011;2011;08;15;Tiistai;243;154;397;26;20;46
89;16.08.2011;2011;08;16;Tiistai;343;126;469;35;24;59
89;16.08.2011;2011;08;17;Tiistai;224;182;406;29;28;57
89;16.08.2011;2011;08;18;Tiistai;186;111;297;50;28;78
89;16.08.2011;2011;08;19;Tiistai;179;90;269;44;34;78
89;16.08.2011;2011;08;20;Tiistai;140;76;216;28;33;61
89;16.08.2011;2011;08;21;Tiistai;84;50;134;15;14;29
89;16.08.2011;2011;08;22;Tiistai;29;22;51;6;13;19
89;16.08.2011;2011;08;23;Tiistai;39;5;44;8;2;10
89;17.08.2011;2011;08;00;Keskiviikko;14;7;21;0;1;1
89;17.08.2011;2011;08;01;Keskiviikko;11;4;15;2;0;2
89;17.08.2011;2011;08;02;Keskiviikko;4;1;5;0;2;2
89;17.08.2011;2011;08;03;Keskiviikko;7;4;11;1;1;2
89;17.08.2011;2011;08;04;Keskiviikko;4;7;11;0;1;1
89;17.08.2011;2011;08;05;Keskiviikko;7;22;29;1;2;3
89;17.08.2011;2011;08;06;Keskiviikko;45;95;140;3;8;11
89;17.08.2011;2011;08;07;Keskiviikko;70;278;348;4;23;27
89;17.08.2011;2011;08;08;Keskiviikko;94;259;353;11;37;48
89;17.08.2011;2011;08;09;Keskiviikko;59;139;198;19;21;40
89;17.08.2011;2011;08;10;Keskiviikko;64;107;171;21;12;33
89;17.08.2011;2011;08;11;Keskiviikko;85;77;162;18;25;43
89;17.08.2011;2011;08;12;Keskiviikko;91;94;185;27;25;52
89;17.08.2011;2011;08;13;Keskiviikko;95;65;160;25;30;55
89;17.08.2011;2011;08;14;Keskiviikko;160;84;244;24;20;44
89;17.08.2011;2011;08;15;Keskiviikko;213;124;337;24;22;46
89;17.08.2011;2011;08;16;Keskiviikko;294;107;401;20;11;31
89;17.08.2011;2011;08;17;Keskiviikko;158;110;268;19;36;55
89;17.08.2011;2011;08;18;Keskiviikko;115;99;214;23;17;40
89;17.08.2011;2011;08;19;Keskiviikko;80;52;132;23;30;53
89;17.08.2011;2011;08;20;Keskiviikko;83;51;134;24;14;38
89;17.08.2011;2011;08;21;Keskiviikko;63;28;91;17;7;24
89;17.08.2011;2011;08;22;Keskiviikko;35;19;54;7;11;18
89;17.08.2011;2011;08;23;Keskiviikko;8;8;16;9;2;11
89;18.08.2011;2011;08;00;Torstai;12;8;20;1;0;1
89;18.08.2011;2011;08;01;Torstai;8;5;13;1;1;2
89;18.08.2011;2011;08;02;Torstai;9;2;11;2;1;3
89;18.08.2011;2011;08;03;Torstai;6;3;9;0;1;1
89;18.08.2011;2011;08;04;Torstai;3;9;12;1;0;1
89;18.08.2011;2011;08;05;Torstai;3;18;21;0;0;0
89;18.08.2011;2011;08;06;Torstai;43;74;117;6;2;8
89;18.08.2011;2011;08;07;Torstai;70;234;304;4;17;21
89;18.08.2011;2011;08;08;Torstai;80;240;320;13;39;52
89;18.08.2011;2011;08;09;Torstai;44;127;171;9;31;40
89;18.08.2011;2011;08;10;Torstai;46;63;109;14;13;27
89;18.08.2011;2011;08;11;Torstai;43;53;96;18;14;32
89;18.08.2011;2011;08;12;Torstai;69;80;149;14;12;26
89;18.08.2011;2011;08;13;Torstai;88;84;172;14;21;35
89;18.08.2011;2011;08;14;Torstai;116;88;204;14;10;24
89;18.08.2011;2011;08;15;Torstai;194;106;300;19;18;37
89;18.08.2011;2011;08;16;Torstai;254;114;368;16;15;31
89;18.08.2011;2011;08;17;Torstai;134;135;269;22;25;47
89;18.08.2011;2011;08;18;Torstai;99;116;215;25;35;60
89;18.08.2011;2011;08;19;Torstai;96;99;195;30;28;58
89;18.08.2011;2011;08;20;Torstai;119;63;182;26;20;46
89;18.08.2011;2011;08;21;Torstai;119;31;150;19;8;27
89;18.08.2011;2011;08;22;Torstai;51;23;74;7;4;11
89;18.08.2011;2011;08;23;Torstai;41;2;43;10;1;11
89;19.08.2011;2011;08;00;Perjantai;11;4;15;1;0;1
89;19.08.2011;2011;08;01;Perjantai;6;2;8;3;1;4
89;19.08.2011;2011;08;02;Perjantai;10;0;10;2;2;4
89;19.08.2011;2011;08;03;Perjantai;7;1;8;0;1;1
89;19.08.2011;2011;08;04;Perjantai;3;4;7;2;0;2
89;19.08.2011;2011;08;05;Perjantai;4;9;13;1;1;2
89;19.08.2011;2011;08;06;Perjantai;33;48;81;4;5;9
89;19.08.2011;2011;08;07;Perjantai;71;185;256;4;14;18
89;19.08.2011;2011;08;08;Perjantai;57;164;221;7;16;23
89;19.08.2011;2011;08;09;Perjantai;42;111;153;9;15;24
89;19.08.2011;2011;08;10;Perjantai;49;73;122;11;24;35
89;19.08.2011;2011;08;11;Perjantai;82;99;181;15;37;52
89;19.08.2011;2011;08;12;Perjantai;81;112;193;19;29;48
89;19.08.2011;2011;08;13;Perjantai;155;96;251;24;19;43
89;19.08.2011;2011;08;14;Perjantai;186;92;278;24;25;49
89;19.08.2011;2011;08;15;Perjantai;164;100;264;17;30;47
89;19.08.2011;2011;08;16;Perjantai;200;81;281;19;13;32
89;19.08.2011;2011;08;17;Perjantai;113;46;159;17;17;34
89;19.08.2011;2011;08;18;Perjantai;67;64;131;14;11;25
89;19.08.2011;2011;08;19;Perjantai;53;45;98;15;15;30
89;19.08.2011;2011;08;20;Perjantai;48;32;80;13;9;22
89;19.08.2011;2011;08;21;Perjantai;44;38;82;10;9;19
89;19.08.2011;2011;08;22;Perjantai;27;41;68;5;4;9
89;19.08.2011;2011;08;23;Perjantai;27;24;51;6;8;14
89;20.08.2011;2011;08;00;Lauantai;55;15;70;6;0;6
89;20.08.2011;2011;08;01;Lauantai;18;12;30;6;6;12
89;20.08.2011;2011;08;02;Lauantai;22;4;26;3;4;7
89;20.08.2011;2011;08;03;Lauantai;20;5;25;4;0;4
89;20.08.2011;2011;08;04;Lauantai;10;7;17;3;2;5
89;20.08.2011;2011;08;05;Lauantai;13;3;16;0;3;3
89;20.08.2011;2011;08;06;Lauantai;11;23;34;3;4;7
89;20.08.2011;2011;08;07;Lauantai;9;12;21;4;6;10
89;20.08.2011;2011;08;08;Lauantai;10;22;32;9;9;18
89;20.08.2011;2011;08;09;Lauantai;24;72;96;8;10;18
89;20.08.2011;2011;08;10;Lauantai;40;67;107;18;34;52
89;20.08.2011;2011;08;11;Lauantai;62;89;151;24;33;57
89;20.08.2011;2011;08;12;Lauantai;74;110;184;14;35;49
89;20.08.2011;2011;08;13;Lauantai;104;94;198;18;34;52
89;20.08.2011;2011;08;14;Lauantai;97;96;193;31;32;63
89;20.08.2011;2011;08;15;Lauantai;126;85;211;30;16;46
89;20.08.2011;2011;08;16;Lauantai;115;80;195;20;28;48
89;20.08.2011;2011;08;17;Lauantai;102;85;187;18;21;39
89;20.08.2011;2011;08;18;Lauantai;92;100;192;23;31;54
89;20.08.2011;2011;08;19;Lauantai;77;74;151;18;21;39
89;20.08.2011;2011;08;20;Lauantai;49;55;104;16;25;41
89;20.08.2011;2011;08;21;Lauantai;51;66;117;13;10;23
89;20.08.2011;2011;08;22;Lauantai;24;52;76;5;7;12
89;20.08.2011;2011;08;23;Lauantai;34;33;67;6;9;15
89;21.08.2011;2011;08;00;Sunnuntai;44;25;69;1;4;5
89;21.08.2011;2011;08;01;Sunnuntai;35;15;50;4;3;7
89;21.08.2011;2011;08;02;Sunnuntai;33;6;39;14;9;23
89;21.08.2011;2011;08;03;Sunnuntai;36;8;44;2;0;2
89;21.08.2011;2011;08;04;Sunnuntai;31;1;32;4;0;4
89;21.08.2011;2011;08;05;Sunnuntai;13;0;13;0;1;1
89;21.08.2011;2011;08;06;Sunnuntai;6;13;19;2;3;5
89;21.08.2011;2011;08;07;Sunnuntai;5;12;17;5;8;13
89;21.08.2011;2011;08;08;Sunnuntai;9;9;18;9;4;13
89;21.08.2011;2011;08;09;Sunnuntai;18;33;51;11;26;37
89;21.08.2011;2011;08;10;Sunnuntai;31;74;105;26;35;61
89;21.08.2011;2011;08;11;Sunnuntai;68;111;179;44;55;99
89;21.08.2011;2011;08;12;Sunnuntai;69;113;182;40;139;179
89;21.08.2011;2011;08;13;Sunnuntai;134;132;266;25;31;56
89;21.08.2011;2011;08;14;Sunnuntai;115;108;223;32;39;71
89;21.08.2011;2011;08;15;Sunnuntai;103;84;187;22;34;56
89;21.08.2011;2011;08;16;Sunnuntai;98;85;183;29;23;52
89;21.08.2011;2011;08;17;Sunnuntai;109;101;210;39;45;84
89;21.08.2011;2011;08;18;Sunnuntai;95;99;194;35;40;75
89;21.08.2011;2011;08;19;Sunnuntai;73;59;132;39;40;79
89;21.08.2011;2011;08;20;Sunnuntai;94;45;139;27;25;52
89;21.08.2011;2011;08;21;Sunnuntai;56;19;75;5;18;23
89;21.08.2011;2011;08;22;Sunnuntai;20;11;31;2;3;5
89;21.08.2011;2011;08;23;Sunnuntai;8;8;16;3;4;7
89;22.08.2011;2011;08;00;Maanantai;5;6;11;1;3;4
89;22.08.2011;2011;08;01;Maanantai;2;2;4;1;1;2
89;22.08.2011;2011;08;02;Maanantai;2;4;6;3;0;3
89;22.08.2011;2011;08;03;Maanantai;4;1;5;1;0;1
89;22.08.2011;2011;08;04;Maanantai;7;6;13;1;1;2
89;22.08.2011;2011;08;05;Maanantai;5;14;19;0;0;0
89;22.08.2011;2011;08;06;Maanantai;40;85;125;1;4;5
89;22.08.2011;2011;08;07;Maanantai;77;246;323;5;22;27
89;22.08.2011;2011;08;08;Maanantai;90;266;356;10;30;40
89;22.08.2011;2011;08;09;Maanantai;76;167;243;11;25;36
89;22.08.2011;2011;08;10;Maanantai;64;133;197;11;28;39
89;22.08.2011;2011;08;11;Maanantai;95;109;204;15;20;35
89;22.08.2011;2011;08;12;Maanantai;106;114;220;9;24;33
89;22.08.2011;2011;08;13;Maanantai;125;99;224;37;11;48
89;22.08.2011;2011;08;14;Maanantai;169;103;272;18;14;32
89;22.08.2011;2011;08;15;Maanantai;227;84;311;12;10;22
89;22.08.2011;2011;08;16;Maanantai;282;62;344;14;6;20
89;22.08.2011;2011;08;17;Maanantai;159;82;241;17;19;36
89;22.08.2011;2011;08;18;Maanantai;119;77;196;33;29;62
89;22.08.2011;2011;08;19;Maanantai;107;82;189;27;26;53
89;22.08.2011;2011;08;20;Maanantai;96;45;141;28;25;53
89;22.08.2011;2011;08;21;Maanantai;69;31;100;12;7;19
89;22.08.2011;2011;08;22;Maanantai;14;9;23;13;6;19
89;22.08.2011;2011;08;23;Maanantai;8;1;9;3;2;5
89;23.08.2011;2011;08;00;Tiistai;6;1;7;2;1;3
89;23.08.2011;2011;08;01;Tiistai;2;1;3;0;0;0
89;23.08.2011;2011;08;02;Tiistai;4;0;4;3;2;5
89;23.08.2011;2011;08;03;Tiistai;3;1;4;0;0;0
89;23.08.2011;2011;08;04;Tiistai;4;2;6;1;1;2
89;23.08.2011;2011;08;05;Tiistai;7;18;25;2;3;5
89;23.08.2011;2011;08;06;Tiistai;35;77;112;2;10;12
89;23.08.2011;2011;08;07;Tiistai;74;211;285;6;16;22
89;23.08.2011;2011;08;08;Tiistai;79;219;298;19;41;60
89;23.08.2011;2011;08;09;Tiistai;55;138;193;17;37;54
89;23.08.2011;2011;08;10;Tiistai;62;73;135;21;15;36
89;23.08.2011;2011;08;11;Tiistai;65;56;121;23;26;49
89;23.08.2011;2011;08;12;Tiistai;60;59;119;17;26;43
89;23.08.2011;2011;08;13;Tiistai;98;56;154;15;27;42
89;23.08.2011;2011;08;14;Tiistai;97;98;195;31;32;63
89;23.08.2011;2011;08;15;Tiistai;204;114;318;35;33;68
89;23.08.2011;2011;08;16;Tiistai;249;130;379;36;23;59
89;23.08.2011;2011;08;17;Tiistai;179;97;276;34;33;67
89;23.08.2011;2011;08;18;Tiistai;144;87;231;28;30;58
89;23.08.2011;2011;08;19;Tiistai;135;99;234;33;31;64
89;23.08.2011;2011;08;20;Tiistai;108;43;151;29;30;59
89;23.08.2011;2011;08;21;Tiistai;46;40;86;10;22;32
89;23.08.2011;2011;08;22;Tiistai;31;18;49;4;3;7
89;23.08.2011;2011;08;23;Tiistai;13;8;21;3;4;7
89;24.08.2011;2011;08;00;Keskiviikko;6;1;7;1;0;1
89;24.08.2011;2011;08;01;Keskiviikko;4;3;7;0;0;0
89;24.08.2011;2011;08;02;Keskiviikko;3;2;5;1;1;2
89;24.08.2011;2011;08;03;Keskiviikko;3;5;8;0;0;0
89;24.08.2011;2011;08;04;Keskiviikko;2;4;6;0;0;0
89;24.08.2011;2011;08;05;Keskiviikko;6;21;27;1;1;2
89;24.08.2011;2011;08;06;Keskiviikko;45;74;119;1;5;6
89;24.08.2011;2011;08;07;Keskiviikko;89;250;339;8;40;48
89;24.08.2011;2011;08;08;Keskiviikko;101;248;349;15;26;41
89;24.08.2011;2011;08;09;Keskiviikko;61;144;205;15;14;29
89;24.08.2011;2011;08;10;Keskiviikko;81;123;204;24;36;60
89;24.08.2011;2011;08;11;Keskiviikko;92;114;206;22;30;52
89;24.08.2011;2011;08;12;Keskiviikko;144;141;285;17;28;45
89;24.08.2011;2011;08;13;Keskiviikko;120;137;257;24;26;50
89;24.08.2011;2011;08;14;Keskiviikko;221;203;424;29;31;60
89;24.08.2011;2011;08;15;Keskiviikko;264;154;418;21;42;63
89;24.08.2011;2011;08;16;Keskiviikko;328;147;475;41;27;68
89;24.08.2011;2011;08;17;Keskiviikko;229;189;418;34;30;64
89;24.08.2011;2011;08;18;Keskiviikko;167;113;280;31;46;77
89;24.08.2011;2011;08;19;Keskiviikko;157;86;243;50;52;102
89;24.08.2011;2011;08;20;Keskiviikko;158;80;238;24;28;52
89;24.08.2011;2011;08;21;Keskiviikko;75;54;129;21;8;29
89;24.08.2011;2011;08;22;Keskiviikko;34;19;53;4;6;10
89;24.08.2011;2011;08;23;Keskiviikko;14;10;24;4;6;10
89;25.08.2011;2011;08;00;Torstai;14;5;19;2;1;3
89;25.08.2011;2011;08;01;Torstai;9;1;10;2;1;3
89;25.08.2011;2011;08;02;Torstai;8;5;13;3;0;3
89;25.08.2011;2011;08;03;Torstai;7;2;9;0;1;1
89;25.08.2011;2011;08;04;Torstai;5;5;10;1;0;1
89;25.08.2011;2011;08;05;Torstai;5;17;22;1;1;2
89;25.08.2011;2011;08;06;Torstai;32;90;122;2;3;5
89;25.08.2011;2011;08;07;Torstai;77;256;333;2;31;33
89;25.08.2011;2011;08;08;Torstai;95;280;375;10;29;39
89;25.08.2011;2011;08;09;Torstai;52;133;185;12;16;28
89;25.08.2011;2011;08;10;Torstai;65;120;185;19;20;39
89;25.08.2011;2011;08;11;Torstai;78;124;202;20;27;47
89;25.08.2011;2011;08;12;Torstai;102;150;252;24;51;75
89;25.08.2011;2011;08;13;Torstai;144;143;287;27;36;63
89;25.08.2011;2011;08;14;Torstai;182;154;336;30;46;76
89;25.08.2011;2011;08;15;Torstai;273;160;433;35;31;66
89;25.08.2011;2011;08;16;Torstai;303;215;518;24;24;48
89;25.08.2011;2011;08;17;Torstai;249;209;458;24;41;65
89;25.08.2011;2011;08;18;Torstai;179;154;333;31;31;62
89;25.08.2011;2011;08;19;Torstai;186;143;329;39;32;71
89;25.08.2011;2011;08;20;Torstai;149;108;257;25;38;63
89;25.08.2011;2011;08;21;Torstai;121;68;189;20;16;36
89;25.08.2011;2011;08;22;Torstai;89;29;118;12;5;17
89;25.08.2011;2011;08;23;Torstai;52;17;69;12;3;15
89;26.08.2011;2011;08;00;Perjantai;41;9;50;6;3;9
89;26.08.2011;2011;08;01;Perjantai;20;3;23;5;1;6
89;26.08.2011;2011;08;02;Perjantai;12;5;17;5;0;5
89;26.08.2011;2011;08;03;Perjantai;17;0;17;2;0;2
89;26.08.2011;2011;08;04;Perjantai;11;2;13;5;1;6
89;26.08.2011;2011;08;05;Perjantai;7;14;21;2;1;3
89;26.08.2011;2011;08;06;Perjantai;41;74;115;2;4;6
89;26.08.2011;2011;08;07;Perjantai;72;231;303;6;23;29
89;26.08.2011;2011;08;08;Perjantai;86;241;327;8;20;28
89;26.08.2011;2011;08;09;Perjantai;77;145;222;12;28;40
89;26.08.2011;2011;08;10;Perjantai;74;96;170;8;15;23
89;26.08.2011;2011;08;11;Perjantai;95;106;201;24;21;45
89;26.08.2011;2011;08;12;Perjantai;112;117;229;23;38;61
89;26.08.2011;2011;08;13;Perjantai;197;143;340;22;35;57
89;26.08.2011;2011;08;14;Perjantai;239;98;337;23;25;48
89;26.08.2011;2011;08;15;Perjantai;214;125;339;21;21;42
89;26.08.2011;2011;08;16;Perjantai;206;121;327;17;10;27
89;26.08.2011;2011;08;17;Perjantai;115;76;191;10;19;29
89;26.08.2011;2011;08;18;Perjantai;81;91;172;8;14;22
89;26.08.2011;2011;08;19;Perjantai;67;87;154;15;19;34
89;26.08.2011;2011;08;20;Perjantai;53;76;129;13;15;28
89;26.08.2011;2011;08;21;Perjantai;73;53;126;14;12;26
89;26.08.2011;2011;08;22;Perjantai;22;31;53;7;2;9
89;26.08.2011;2011;08;23;Perjantai;70;21;91;8;1;9
89;27.08.2011;2011;08;00;Lauantai;22;9;31;4;7;11
89;27.08.2011;2011;08;01;Lauantai;27;16;43;2;4;6
89;27.08.2011;2011;08;02;Lauantai;21;2;23;5;0;5
89;27.08.2011;2011;08;03;Lauantai;17;6;23;7;2;9
89;27.08.2011;2011;08;04;Lauantai;19;1;20;6;4;10
89;27.08.2011;2011;08;05;Lauantai;8;3;11;3;0;3
89;27.08.2011;2011;08;06;Lauantai;13;12;25;4;2;6
89;27.08.2011;2011;08;07;Lauantai;14;21;35;4;8;12
89;27.08.2011;2011;08;08;Lauantai;14;21;35;7;5;12
89;27.08.2011;2011;08;09;Lauantai;25;46;71;9;17;26
89;27.08.2011;2011;08;10;Lauantai;41;72;113;11;24;35
89;27.08.2011;2011;08;11;Lauantai;57;98;155;12;19;31
89;27.08.2011;2011;08;12;Lauantai;85;90;175;23;8;31
89;27.08.2011;2011;08;13;Lauantai;84;109;193;9;6;15
89;27.08.2011;2011;08;14;Lauantai;92;77;169;24;16;40
89;27.08.2011;2011;08;15;Lauantai;104;76;180;17;19;36
89;27.08.2011;2011;08;16;Lauantai;80;55;135;12;13;25
89;27.08.2011;2011;08;17;Lauantai;101;76;177;25;16;41
89;27.08.2011;2011;08;18;Lauantai;101;77;178;35;18;53
89;27.08.2011;2011;08;19;Lauantai;79;65;144;28;14;42
89;27.08.2011;2011;08;20;Lauantai;59;71;130;18;40;58
89;27.08.2011;2011;08;21;Lauantai;47;52;99;4;42;46
89;27.08.2011;2011;08;22;Lauantai;37;56;93;6;14;20
89;27.08.2011;2011;08;23;Lauantai;45;47;92;12;10;22
89;28.08.2011;2011;08;00;Sunnuntai;39;28;67;0;3;3
89;28.08.2011;2011;08;01;Sunnuntai;34;17;51;9;0;9
89;28.08.2011;2011;08;02;Sunnuntai;39;6;45;8;0;8
89;28.08.2011;2011;08;03;Sunnuntai;36;5;41;6;0;6
89;28.08.2011;2011;08;04;Sunnuntai;30;6;36;6;0;6
89;28.08.2011;2011;08;05;Sunnuntai;18;2;20;3;3;6
89;28.08.2011;2011;08;06;Sunnuntai;12;14;26;6;0;6
89;28.08.2011;2011;08;07;Sunnuntai;10;10;20;3;0;3
89;28.08.2011;2011;08;08;Sunnuntai;14;15;29;15;9;24
89;28.08.2011;2011;08;09;Sunnuntai;29;34;63;9;6;15
89;28.08.2011;2011;08;10;Sunnuntai;28;74;102;12;18;30
89;28.08.2011;2011;08;11;Sunnuntai;74;120;194;14;30;44
89;28.08.2011;2011;08;12;Sunnuntai;127;160;287;11;50;61
89;28.08.2011;2011;08;13;Sunnuntai;109;177;286;3;30;33
89;28.08.2011;2011;08;14;Sunnuntai;177;185;362;17;24;41
89;28.08.2011;2011;08;15;Sunnuntai;185;171;356;28;21;49
89;28.08.2011;2011;08;16;Sunnuntai;176;142;318;21;37;58
89;28.08.2011;2011;08;17;Sunnuntai;141;129;270;61;30;91
89;28.08.2011;2011;08;18;Sunnuntai;164;86;250;31;39;70
89;28.08.2011;2011;08;19;Sunnuntai;110;72;182;31;46;77
89;28.08.2011;2011;08;20;Sunnuntai;85;43;128;12;21;33
89;28.08.2011;2011;08;21;Sunnuntai;30;10;40;6;28;34
89;28.08.2011;2011;08;22;Sunnuntai;12;8;20;3;3;6
89;28.08.2011;2011;08;23;Sunnuntai;7;0;7;3;0;3
89;29.08.2011;2011;08;00;Maanantai;12;7;19;2;0;2
89;29.08.2011;2011;08;01;Maanantai;1;5;6;2;0;2
89;29.08.2011;2011;08;02;Maanantai;2;3;5;2;0;2
89;29.08.2011;2011;08;03;Maanantai;2;2;4;0;0;0
89;29.08.2011;2011;08;04;Maanantai;4;6;10;0;0;0
89;29.08.2011;2011;08;05;Maanantai;5;10;15;0;2;2
89;29.08.2011;2011;08;06;Maanantai;33;73;106;8;6;14
89;29.08.2011;2011;08;07;Maanantai;84;282;366;37;20;57
89;29.08.2011;2011;08;08;Maanantai;99;272;371;27;18;45
89;29.08.2011;2011;08;09;Maanantai;78;184;262;23;24;47
89;29.08.2011;2011;08;10;Maanantai;77;123;200;29;19;48
89;29.08.2011;2011;08;11;Maanantai;99;121;220;14;26;40
89;29.08.2011;2011;08;12;Maanantai;133;102;235;19;17;36
89;29.08.2011;2011;08;13;Maanantai;164;95;259;16;13;29
89;29.08.2011;2011;08;14;Maanantai;186;122;308;18;25;43
89;29.08.2011;2011;08;15;Maanantai;274;136;410;12;53;65
89;29.08.2011;2011;08;16;Maanantai;314;150;464;10;42;52
89;29.08.2011;2011;08;17;Maanantai;186;144;330;50;30;80
89;29.08.2011;2011;08;18;Maanantai;135;93;228;37;25;62
89;29.08.2011;2011;08;19;Maanantai;139;56;195;40;23;63
89;29.08.2011;2011;08;20;Maanantai;108;53;161;25;24;49
89;29.08.2011;2011;08;21;Maanantai;48;37;85;8;19;27
89;29.08.2011;2011;08;22;Maanantai;18;17;35;6;0;6
89;29.08.2011;2011;08;23;Maanantai;11;5;16;0;0;0
89;30.08.2011;2011;08;00;Tiistai;8;7;15;0;2;2
89;30.08.2011;2011;08;01;Tiistai;1;2;3;0;0;0
89;30.08.2011;2011;08;02;Tiistai;3;1;4;0;0;0
89;30.08.2011;2011;08;03;Tiistai;4;4;8;0;0;0
89;30.08.2011;2011;08;04;Tiistai;6;6;12;0;0;0
89;30.08.2011;2011;08;05;Tiistai;2;11;13;0;0;0
89;30.08.2011;2011;08;06;Tiistai;34;84;118;15;2;17
89;30.08.2011;2011;08;07;Tiistai;86;329;415;40;24;64
89;30.08.2011;2011;08;08;Tiistai;87;294;381;38;24;62
89;30.08.2011;2011;08;09;Tiistai;85;151;236;23;26;49
89;30.08.2011;2011;08;10;Tiistai;79;117;196;9;16;25
89;30.08.2011;2011;08;11;Tiistai;86;129;215;21;7;28
89;30.08.2011;2011;08;12;Tiistai;135;176;311;19;51;70
89;30.08.2011;2011;08;13;Tiistai;156;118;274;47;11;58
89;30.08.2011;2011;08;14;Tiistai;192;113;305;8;44;52
89;30.08.2011;2011;08;15;Tiistai;314;165;479;19;56;75
89;30.08.2011;2011;08;16;Tiistai;298;173;471;24;64;88
89;30.08.2011;2011;08;17;Tiistai;185;111;296;29;39;68
89;30.08.2011;2011;08;18;Tiistai;159;100;259;27;39;66
89;30.08.2011;2011;08;19;Tiistai;119;71;190;28;39;67
89;30.08.2011;2011;08;20;Tiistai;85;50;135;34;41;75
89;30.08.2011;2011;08;21;Tiistai;42;23;65;4;18;22
89;30.08.2011;2011;08;22;Tiistai;22;17;39;10;0;10
89;30.08.2011;2011;08;23;Tiistai;8;3;11;0;0;0
89;31.08.2011;2011;08;00;Keskiviikko;6;2;8;0;0;0
89;31.08.2011;2011;08;01;Keskiviikko;8;1;9;0;0;0
89;31.08.2011;2011;08;02;Keskiviikko;6;5;11;0;0;0
89;31.08.2011;2011;08;03;Keskiviikko;1;3;4;0;0;0
89;31.08.2011;2011;08;04;Keskiviikko;1;3;4;0;0;0
89;31.08.2011;2011;08;05;Keskiviikko;9;10;19;0;0;0
89;31.08.2011;2011;08;06;Keskiviikko;39;85;124;6;2;8
89;31.08.2011;2011;08;07;Keskiviikko;78;310;388;29;24;53
89;31.08.2011;2011;08;08;Keskiviikko;70;190;260;25;15;40
89;31.08.2011;2011;08;09;Keskiviikko;53;157;210;15;8;23
89;31.08.2011;2011;08;10;Keskiviikko;76;94;170;10;13;23
89;31.08.2011;2011;08;11;Keskiviikko;94;118;212;14;17;31
89;31.08.2011;2011;08;12;Keskiviikko;119;126;245;19;20;39
89;31.08.2011;2011;08;13;Keskiviikko;124;129;253;8;24;32
89;31.08.2011;2011;08;14;Keskiviikko;215;108;323;8;33;41
89;31.08.2011;2011;08;15;Keskiviikko;222;104;326;10;40;50
89;31.08.2011;2011;08;16;Keskiviikko;222;90;312;0;19;19
89;31.08.2011;2011;08;17;Keskiviikko;124;89;213;16;19;35
89;31.08.2011;2011;08;18;Keskiviikko;96;63;159;24;15;39
89;31.08.2011;2011;08;19;Keskiviikko;75;46;121;18;24;42
89;31.08.2011;2011;08;20;Keskiviikko;72;44;116;25;13;38
89;31.08.2011;2011;08;21;Keskiviikko;36;25;61;12;15;27
89;31.08.2011;2011;08;22;Keskiviikko;20;17;37;6;13;19
89;31.08.2011;2011;08;23;Keskiviikko;9;6;15;2;0;2
89;01.09.2011;2011;09;00;Torstai;6;4;10;0;0;0
89;01.09.2011;2011;09;01;Torstai;3;2;5;0;0;0
89;01.09.2011;2011;09;02;Torstai;5;2;7;0;0;0
89;01.09.2011;2011;09;03;Torstai;5;1;6;0;0;0
89;01.09.2011;2011;09;04;Torstai;1;2;3;0;0;0
89;01.09.2011;2011;09;05;Torstai;4;12;16;0;5;5
89;01.09.2011;2011;09;06;Torstai;43;92;135;17;2;19
89;01.09.2011;2011;09;07;Torstai;82;329;411;43;14;57
89;01.09.2011;2011;09;08;Torstai;79;218;297;21;21;42
89;01.09.2011;2011;09;09;Torstai;72;143;215;23;21;44
89;01.09.2011;2011;09;10;Torstai;66;90;156;6;9;15
89;01.09.2011;2011;09;11;Torstai;84;104;188;6;13;19
89;01.09.2011;2011;09;12;Torstai;103;129;232;10;11;21
89;01.09.2011;2011;09;13;Torstai;112;102;214;6;13;19
89;01.09.2011;2011;09;14;Torstai;183;120;303;8;17;25
89;01.09.2011;2011;09;15;Torstai;294;115;409;15;73;88
89;01.09.2011;2011;09;16;Torstai;234;101;335;6;36;42
89;01.09.2011;2011;09;17;Torstai;162;96;258;12;16;28
89;01.09.2011;2011;09;18;Torstai;98;81;179;28;28;56
89;01.09.2011;2011;09;19;Torstai;94;79;173;23;21;44
89;01.09.2011;2011;09;20;Torstai;81;44;125;26;24;50
89;01.09.2011;2011;09;21;Torstai;36;25;61;12;14;26
89;01.09.2011;2011;09;22;Torstai;23;11;34;0;14;14
89;01.09.2011;2011;09;23;Torstai;11;8;19;2;0;2
89;02.09.2011;2011;09;00;Perjantai;12;1;13;3;0;3
89;02.09.2011;2011;09;01;Perjantai;7;2;9;0;2;2
89;02.09.2011;2011;09;02;Perjantai;6;5;11;0;0;0
89;02.09.2011;2011;09;03;Perjantai;4;3;7;0;0;0
89;02.09.2011;2011;09;04;Perjantai;8;3;11;0;0;0
89;02.09.2011;2011;09;05;Perjantai;4;14;18;3;2;5
89;02.09.2011;2011;09;06;Perjantai;46;79;125;10;4;14
89;02.09.2011;2011;09;07;Perjantai;100;276;376;31;18;49
89;02.09.2011;2011;09;08;Perjantai;66;196;262;39;23;62
89;02.09.2011;2011;09;09;Perjantai;53;162;215;16;15;31
89;02.09.2011;2011;09;10;Perjantai;95;98;193;8;16;24
89;02.09.2011;2011;09;11;Perjantai;89;109;198;11;12;23
89;02.09.2011;2011;09;12;Perjantai;130;115;245;6;14;20
89;02.09.2011;2011;09;13;Perjantai;177;112;289;16;21;37
89;02.09.2011;2011;09;14;Perjantai;183;113;296;16;31;47
89;02.09.2011;2011;09;15;Perjantai;247;131;378;16;33;49
89;02.09.2011;2011;09;16;Perjantai;196;126;322;44;7;51
89;02.09.2011;2011;09;17;Perjantai;121;105;226;19;16;35
89;02.09.2011;2011;09;18;Perjantai;83;97;180;13;16;29
89;02.09.2011;2011;09;19;Perjantai;93;58;151;29;23;52
89;02.09.2011;2011;09;20;Perjantai;70;61;131;29;13;42
89;02.09.2011;2011;09;21;Perjantai;48;45;93;3;14;17
89;02.09.2011;2011;09;22;Perjantai;23;52;75;3;2;5
89;02.09.2011;2011;09;23;Perjantai;33;34;67;3;0;3
89;03.09.2011;2011;09;00;Lauantai;19;22;41;0;10;10
89;03.09.2011;2011;09;01;Lauantai;29;18;47;2;3;5
89;03.09.2011;2011;09;02;Lauantai;35;2;37;5;0;5
89;03.09.2011;2011;09;03;Lauantai;44;5;49;7;0;7
89;03.09.2011;2011;09;04;Lauantai;24;3;27;2;0;2
89;03.09.2011;2011;09;05;Lauantai;5;3;8;0;3;3
89;03.09.2011;2011;09;06;Lauantai;10;20;30;0;0;0
89;03.09.2011;2011;09;07;Lauantai;9;24;33;6;0;6
89;03.09.2011;2011;09;08;Lauantai;17;55;72;4;6;10
89;03.09.2011;2011;09;09;Lauantai;53;105;158;7;24;31
89;03.09.2011;2011;09;10;Lauantai;72;209;281;54;6;60
89;03.09.2011;2011;09;11;Lauantai;88;200;288;9;40;49
89;03.09.2011;2011;09;12;Lauantai;116;164;280;75;57;132
89;03.09.2011;2011;09;13;Lauantai;125;145;270;75;51;126
89;03.09.2011;2011;09;14;Lauantai;179;104;283;132;38;170
89;03.09.2011;2011;09;15;Lauantai;136;120;256;23;8;31
89;03.09.2011;2011;09;16;Lauantai;150;103;253;14;11;25
89;03.09.2011;2011;09;17;Lauantai;114;75;189;26;14;40
89;03.09.2011;2011;09;18;Lauantai;78;84;162;57;22;79
89;03.09.2011;2011;09;19;Lauantai;81;55;136;10;38;48
89;03.09.2011;2011;09;20;Lauantai;73;88;161;7;14;21
89;03.09.2011;2011;09;21;Lauantai;48;35;83;0;22;22
89;03.09.2011;2011;09;22;Lauantai;61;33;94;7;6;13
89;03.09.2011;2011;09;23;Lauantai;20;29;49;4;0;4
89;04.09.2011;2011;09;00;Sunnuntai;19;21;40;3;0;3
89;04.09.2011;2011;09;01;Sunnuntai;16;11;27;0;0;0
89;04.09.2011;2011;09;02;Sunnuntai;28;6;34;3;0;3
89;04.09.2011;2011;09;03;Sunnuntai;35;5;40;9;0;9
89;04.09.2011;2011;09;04;Sunnuntai;19;0;19;3;0;3
89;04.09.2011;2011;09;05;Sunnuntai;3;1;4;3;0;3
89;04.09.2011;2011;09;06;Sunnuntai;7;12;19;9;0;9
89;04.09.2011;2011;09;07;Sunnuntai;11;13;24;6;9;15
89;04.09.2011;2011;09;08;Sunnuntai;15;11;26;12;9;21
89;04.09.2011;2011;09;09;Sunnuntai;24;40;64;15;30;45
89;04.09.2011;2011;09;10;Sunnuntai;47;103;150;18;18;36
89;04.09.2011;2011;09;11;Sunnuntai;77;133;210;18;24;42
89;04.09.2011;2011;09;12;Sunnuntai;124;165;289;20;24;44
89;04.09.2011;2011;09;13;Sunnuntai;157;193;350;6;31;37
89;04.09.2011;2011;09;14;Sunnuntai;145;175;320;9;30;39
89;04.09.2011;2011;09;15;Sunnuntai;185;137;322;28;46;74
89;04.09.2011;2011;09;16;Sunnuntai;140;119;259;25;36;61
89;04.09.2011;2011;09;17;Sunnuntai;123;117;240;47;12;59
89;04.09.2011;2011;09;18;Sunnuntai;122;77;199;71;39;110
89;04.09.2011;2011;09;19;Sunnuntai;72;47;119;26;78;104
89;04.09.2011;2011;09;20;Sunnuntai;46;41;87;30;27;57
89;04.09.2011;2011;09;21;Sunnuntai;29;26;55;20;18;38
89;04.09.2011;2011;09;22;Sunnuntai;18;13;31;3;9;12
89;04.09.2011;2011;09;23;Sunnuntai;12;7;19;3;0;3
89;05.09.2011;2011;09;00;Maanantai;7;7;14;2;0;2
89;05.09.2011;2011;09;01;Maanantai;4;2;6;0;0;0
89;05.09.2011;2011;09;02;Maanantai;2;1;3;0;0;0
89;05.09.2011;2011;09;03;Maanantai;4;1;5;2;0;2
89;05.09.2011;2011;09;04;Maanantai;2;4;6;4;0;4
89;05.09.2011;2011;09;05;Maanantai;10;18;28;2;0;2
89;05.09.2011;2011;09;06;Maanantai;42;92;134;8;6;14
89;05.09.2011;2011;09;07;Maanantai;94;356;450;47;12;59
89;05.09.2011;2011;09;08;Maanantai;85;234;319;27;20;47
89;05.09.2011;2011;09;09;Maanantai;85;166;251;14;24;38
89;05.09.2011;2011;09;10;Maanantai;77;112;189;28;17;45
89;05.09.2011;2011;09;11;Maanantai;97;129;226;12;20;32
89;05.09.2011;2011;09;12;Maanantai;136;147;283;12;21;33
89;05.09.2011;2011;09;13;Maanantai;147;127;274;12;4;16
89;05.09.2011;2011;09;14;Maanantai;225;149;374;14;33;47
89;05.09.2011;2011;09;15;Maanantai;333;175;508;12;51;63
89;05.09.2011;2011;09;16;Maanantai;293;157;450;8;56;64
89;05.09.2011;2011;09;17;Maanantai;208;139;347;25;34;59
89;05.09.2011;2011;09;18;Maanantai;189;95;284;40;48;88
89;05.09.2011;2011;09;19;Maanantai;130;65;195;42;46;88
89;05.09.2011;2011;09;20;Maanantai;98;61;159;22;29;51
89;05.09.2011;2011;09;21;Maanantai;49;34;83;22;35;57
89;05.09.2011;2011;09;22;Maanantai;21;23;44;2;6;8
89;05.09.2011;2011;09;23;Maanantai;12;9;21;2;0;2
89;06.09.2011;2011;09;00;Tiistai;7;4;11;0;0;0
89;06.09.2011;2011;09;01;Tiistai;12;0;12;0;0;0
89;06.09.2011;2011;09;02;Tiistai;5;1;6;0;0;0
89;06.09.2011;2011;09;03;Tiistai;8;0;8;0;0;0
89;06.09.2011;2011;09;04;Tiistai;1;4;5;4;0;4
89;06.09.2011;2011;09;05;Tiistai;8;25;33;0;0;0
89;06.09.2011;2011;09;06;Tiistai;52;81;133;5;7;12
89;06.09.2011;2011;09;07;Tiistai;123;391;514;45;19;64
89;06.09.2011;2011;09;08;Tiistai;73;192;265;23;23;46
89;06.09.2011;2011;09;09;Tiistai;83;144;227;25;6;31
89;06.09.2011;2011;09;10;Tiistai;83;94;177;23;23;46
89;06.09.2011;2011;09;11;Tiistai;101;104;205;9;16;25
89;06.09.2011;2011;09;12;Tiistai;92;125;217;23;27;50
89;06.09.2011;2011;09;13;Tiistai;126;124;250;10;17;27
89;06.09.2011;2011;09;14;Tiistai;184;155;339;21;24;45
89;06.09.2011;2011;09;15;Tiistai;343;139;482;17;54;71
89;06.09.2011;2011;09;16;Tiistai;290;175;465;11;64;75
89;06.09.2011;2011;09;17;Tiistai;212;123;335;9;39;48
89;06.09.2011;2011;09;18;Tiistai;124;44;168;14;19;33
89;06.09.2011;2011;09;19;Tiistai;82;45;127;30;20;50
89;06.09.2011;2011;09;20;Tiistai;65;52;117;19;14;33
89;06.09.2011;2011;09;21;Tiistai;37;24;61;16;17;33
89;06.09.2011;2011;09;22;Tiistai;11;13;24;2;6;8
89;06.09.2011;2011;09;23;Tiistai;8;13;21;0;2;2
89;07.09.2011;2011;09;00;Keskiviikko;10;1;11;0;0;0
89;07.09.2011;2011;09;01;Keskiviikko;6;4;10;0;0;0
89;07.09.2011;2011;09;02;Keskiviikko;4;0;4;2;0;2
89;07.09.2011;2011;09;03;Keskiviikko;1;1;2;2;0;2
89;07.09.2011;2011;09;04;Keskiviikko;4;2;6;0;0;0
89;07.09.2011;2011;09;05;Keskiviikko;6;14;20;0;0;0
89;07.09.2011;2011;09;06;Keskiviikko;40;107;147;11;6;17
89;07.09.2011;2011;09;07;Keskiviikko;93;337;430;38;10;48
89;07.09.2011;2011;09;08;Keskiviikko;75;222;297;37;15;52
89;07.09.2011;2011;09;09;Keskiviikko;62;142;204;24;28;52
89;07.09.2011;2011;09;10;Keskiviikko;65;96;161;21;8;29
89;07.09.2011;2011;09;11;Keskiviikko;108;110;218;4;8;12
89;07.09.2011;2011;09;12;Keskiviikko;117;126;243;16;22;38
89;07.09.2011;2011;09;13;Keskiviikko;111;102;213;8;17;25
89;07.09.2011;2011;09;14;Keskiviikko;220;131;351;8;42;50
89;07.09.2011;2011;09;15;Keskiviikko;304;156;460;14;53;67
89;07.09.2011;2011;09;16;Keskiviikko;277;143;420;18;51;69
89;07.09.2011;2011;09;17;Keskiviikko;196;166;362;10;34;44
89;07.09.2011;2011;09;18;Keskiviikko;153;135;288;49;22;71
89;07.09.2011;2011;09;19;Keskiviikko;128;78;206;33;30;63
89;07.09.2011;2011;09;20;Keskiviikko;89;72;161;24;30;54
89;07.09.2011;2011;09;21;Keskiviikko;47;40;87;8;8;16
89;07.09.2011;2011;09;22;Keskiviikko;21;16;37;2;2;4
89;07.09.2011;2011;09;23;Keskiviikko;24;6;30;4;0;4
89;08.09.2011;2011;09;00;Torstai;14;0;14;0;0;0
89;08.09.2011;2011;09;01;Torstai;19;5;24;2;0;2
89;08.09.2011;2011;09;02;Torstai;10;3;13;0;0;0
89;08.09.2011;2011;09;03;Torstai;13;2;15;2;0;2
89;08.09.2011;2011;09;04;Torstai;6;4;10;0;0;0
89;08.09.2011;2011;09;05;Torstai;5;15;20;2;0;2
89;08.09.2011;2011;09;06;Torstai;50;82;132;17;2;19
89;08.09.2011;2011;09;07;Torstai;101;308;409;42;29;71
89;08.09.2011;2011;09;08;Torstai;82;185;267;97;89;186
89;08.09.2011;2011;09;09;Torstai;81;158;239;23;12;35
89;08.09.2011;2011;09;10;Torstai;76;85;161;20;28;48
89;08.09.2011;2011;09;11;Torstai;111;115;226;8;9;17
89;08.09.2011;2011;09;12;Torstai;102;115;217;8;11;19
89;08.09.2011;2011;09;13;Torstai;116;95;211;8;19;27
89;08.09.2011;2011;09;14;Torstai;181;128;309;10;24;34
89;08.09.2011;2011;09;15;Torstai;314;152;466;6;59;65
89;08.09.2011;2011;09;16;Torstai;236;182;418;17;57;74
89;08.09.2011;2011;09;17;Torstai;223;132;355;47;29;76
89;08.09.2011;2011;09;18;Torstai;161;104;265;16;37;53
89;08.09.2011;2011;09;19;Torstai;142;73;215;25;33;58
89;08.09.2011;2011;09;20;Torstai;102;49;151;15;27;42
89;08.09.2011;2011;09;21;Torstai;42;18;60;4;17;21
89;08.09.2011;2011;09;22;Torstai;19;11;30;0;2;2
89;08.09.2011;2011;09;23;Torstai;13;8;21;2;0;2
89;09.09.2011;2011;09;00;Perjantai;11;10;21;3;0;3
89;09.09.2011;2011;09;01;Perjantai;7;1;8;0;2;2
89;09.09.2011;2011;09;02;Perjantai;10;2;12;0;0;0
89;09.09.2011;2011;09;03;Perjantai;3;2;5;0;0;0
89;09.09.2011;2011;09;04;Perjantai;7;4;11;0;0;0
89;09.09.2011;2011;09;05;Perjantai;8;11;19;3;0;3
89;09.09.2011;2011;09;06;Perjantai;46;73;119;15;5;20
89;09.09.2011;2011;09;07;Perjantai;90;297;387;34;12;46
89;09.09.2011;2011;09;08;Perjantai;74;155;229;24;9;33
89;09.09.2011;2011;09;09;Perjantai;78;152;230;14;23;37
89;09.09.2011;2011;09;10;Perjantai;76;90;166;13;11;24
89;09.09.2011;2011;09;11;Perjantai;104;126;230;23;13;36
89;09.09.2011;2011;09;12;Perjantai;101;122;223;8;18;26
89;09.09.2011;2011;09;13;Perjantai;206;155;361;18;16;34
89;09.09.2011;2011;09;14;Perjantai;216;140;356;6;35;41
89;09.09.2011;2011;09;15;Perjantai;253;121;374;13;41;54
89;09.09.2011;2011;09;16;Perjantai;204;118;322;19;38;57
89;09.09.2011;2011;09;17;Perjantai;130;123;253;38;17;55
89;09.09.2011;2011;09;18;Perjantai;113;123;236;22;17;39
89;09.09.2011;2011;09;19;Perjantai;126;89;215;28;14;42
89;09.09.2011;2011;09;20;Perjantai;79;63;142;6;18;24
89;09.09.2011;2011;09;21;Perjantai;57;60;117;5;5;10
89;09.09.2011;2011;09;22;Perjantai;53;39;92;0;2;2
89;09.09.2011;2011;09;23;Perjantai;31;28;59;5;2;7
89;10.09.2011;2011;09;00;Lauantai;19;19;38;2;0;2
89;10.09.2011;2011;09;01;Lauantai;19;8;27;2;0;2
89;10.09.2011;2011;09;02;Lauantai;26;3;29;2;0;2
89;10.09.2011;2011;09;03;Lauantai;25;2;27;4;3;7
89;10.09.2011;2011;09;04;Lauantai;22;7;29;9;3;12
89;10.09.2011;2011;09;05;Lauantai;5;2;7;7;0;7
89;10.09.2011;2011;09;06;Lauantai;7;17;24;9;0;9
89;10.09.2011;2011;09;07;Lauantai;10;25;35;9;3;12
89;10.09.2011;2011;09;08;Lauantai;12;34;46;9;6;15
89;10.09.2011;2011;09;09;Lauantai;38;80;118;12;3;15
89;10.09.2011;2011;09;10;Lauantai;73;136;209;7;23;30
89;10.09.2011;2011;09;11;Lauantai;79;113;192;11;32;43
89;10.09.2011;2011;09;12;Lauantai;107;160;267;16;21;37
89;10.09.2011;2011;09;13;Lauantai;107;116;223;5;24;29
89;10.09.2011;2011;09;14;Lauantai;104;82;186;28;22;50
89;10.09.2011;2011;09;15;Lauantai;133;71;204;16;45;61
89;10.09.2011;2011;09;16;Lauantai;105;71;176;19;24;43
89;10.09.2011;2011;09;17;Lauantai;90;71;161;37;32;69
89;10.09.2011;2011;09;18;Lauantai;94;106;200;47;19;66
89;10.09.2011;2011;09;19;Lauantai;81;68;149;17;16;33
89;10.09.2011;2011;09;20;Lauantai;64;55;119;6;13;19
89;10.09.2011;2011;09;21;Lauantai;42;45;87;12;16;28
89;10.09.2011;2011;09;22;Lauantai;24;43;67;2;6;8
89;10.09.2011;2011;09;23;Lauantai;24;43;67;0;6;6
89;11.09.2011;2011;09;00;Sunnuntai;26;24;50;0;0;0
89;11.09.2011;2011;09;01;Sunnuntai;28;16;44;3;0;3
89;11.09.2011;2011;09;02;Sunnuntai;38;3;41;0;0;0
89;11.09.2011;2011;09;03;Sunnuntai;38;3;41;3;0;3
89;11.09.2011;2011;09;04;Sunnuntai;23;2;25;0;3;3
89;11.09.2011;2011;09;05;Sunnuntai;4;1;5;0;0;0
89;11.09.2011;2011;09;06;Sunnuntai;2;8;10;3;3;6
89;11.09.2011;2011;09;07;Sunnuntai;7;13;20;3;3;6
89;11.09.2011;2011;09;08;Sunnuntai;6;12;18;6;3;9
89;11.09.2011;2011;09;09;Sunnuntai;24;32;56;9;12;21
89;11.09.2011;2011;09;10;Sunnuntai;41;68;109;6;18;24
89;11.09.2011;2011;09;11;Sunnuntai;59;71;130;18;30;48
89;11.09.2011;2011;09;12;Sunnuntai;70;117;187;14;36;50
89;11.09.2011;2011;09;13;Sunnuntai;88;92;180;33;49;82
89;11.09.2011;2011;09;14;Sunnuntai;80;93;173;25;69;94
89;11.09.2011;2011;09;15;Sunnuntai;96;83;179;6;27;33
89;11.09.2011;2011;09;16;Sunnuntai;101;87;188;75;9;84
89;11.09.2011;2011;09;17;Sunnuntai;104;75;179;40;36;76
89;11.09.2011;2011;09;18;Sunnuntai;109;69;178;33;67;100
89;11.09.2011;2011;09;19;Sunnuntai;72;50;122;20;31;51
89;11.09.2011;2011;09;20;Sunnuntai;43;32;75;23;72;95
89;11.09.2011;2011;09;21;Sunnuntai;25;17;42;12;27;39
89;11.09.2011;2011;09;22;Sunnuntai;13;4;17;6;3;9
89;11.09.2011;2011;09;23;Sunnuntai;9;9;18;6;0;6
89;12.09.2011;2011;09;00;Maanantai;6;3;9;2;0;2
89;12.09.2011;2011;09;01;Maanantai;8;4;12;2;0;2
89;12.09.2011;2011;09;02;Maanantai;0;1;1;0;0;0
89;12.09.2011;2011;09;03;Maanantai;1;2;3;0;0;0
89;12.09.2011;2011;09;04;Maanantai;3;5;8;0;0;0
89;12.09.2011;2011;09;05;Maanantai;10;8;18;4;0;4
89;12.09.2011;2011;09;06;Maanantai;33;92;125;8;6;14
89;12.09.2011;2011;09;07;Maanantai;122;312;434;27;17;44
89;12.09.2011;2011;09;08;Maanantai;82;197;279;27;12;39
89;12.09.2011;2011;09;09;Maanantai;92;185;277;16;35;51
89;12.09.2011;2011;09;10;Maanantai;89;106;195;14;17;31
89;12.09.2011;2011;09;11;Maanantai;108;88;196;19;17;36
89;12.09.2011;2011;09;12;Maanantai;104;82;186;8;18;26
89;12.09.2011;2011;09;13;Maanantai;130;84;214;18;8;26
89;12.09.2011;2011;09;14;Maanantai;170;104;274;6;20;26
89;12.09.2011;2011;09;15;Maanantai;274;113;387;12;40;52
89;12.09.2011;2011;09;16;Maanantai;247;111;358;16;37;53
89;12.09.2011;2011;09;17;Maanantai;138;75;213;10;13;23
89;12.09.2011;2011;09;18;Maanantai;112;51;163;27;22;49
89;12.09.2011;2011;09;19;Maanantai;89;49;138;28;27;55
89;12.09.2011;2011;09;20;Maanantai;58;38;96;23;30;53
89;12.09.2011;2011;09;21;Maanantai;35;17;52;8;11;19
89;12.09.2011;2011;09;22;Maanantai;6;11;17;0;6;6
89;12.09.2011;2011;09;23;Maanantai;4;4;8;0;0;0
89;13.09.2011;2011;09;00;Tiistai;3;1;4;0;0;0
89;13.09.2011;2011;09;01;Tiistai;2;1;3;0;0;0
89;13.09.2011;2011;09;02;Tiistai;1;1;2;0;0;0
89;13.09.2011;2011;09;03;Tiistai;0;2;2;0;0;0
89;13.09.2011;2011;09;04;Tiistai;2;2;4;0;0;0
89;13.09.2011;2011;09;05;Tiistai;7;18;25;4;0;4
89;13.09.2011;2011;09;06;Tiistai;33;74;107;13;0;13
89;13.09.2011;2011;09;07;Tiistai;100;282;382;38;19;57
89;13.09.2011;2011;09;08;Tiistai;78;157;235;25;17;42
89;13.09.2011;2011;09;09;Tiistai;70;158;228;27;16;43
89;13.09.2011;2011;09;10;Tiistai;88;110;198;23;30;53
89;13.09.2011;2011;09;11;Tiistai;87;92;179;12;24;36
89;13.09.2011;2011;09;12;Tiistai;111;151;262;25;6;31
89;13.09.2011;2011;09;13;Tiistai;156;112;268;11;27;38
89;13.09.2011;2011;09;14;Tiistai;166;104;270;14;31;45
89;13.09.2011;2011;09;15;Tiistai;277;129;406;21;63;84
89;13.09.2011;2011;09;16;Tiistai;257;153;410;30;54;84
89;13.09.2011;2011;09;17;Tiistai;181;88;269;23;26;49
89;13.09.2011;2011;09;18;Tiistai;147;86;233;48;49;97
89;13.09.2011;2011;09;19;Tiistai;112;45;157;21;24;45
89;13.09.2011;2011;09;20;Tiistai;79;56;135;21;19;40
89;13.09.2011;2011;09;21;Tiistai;35;11;46;12;9;21
89;13.09.2011;2011;09;22;Tiistai;16;1;17;0;9;9
89;13.09.2011;2011;09;23;Tiistai;9;7;16;0;0;0
89;14.09.2011;2011;09;00;Keskiviikko;4;6;10;0;2;2
89;14.09.2011;2011;09;01;Keskiviikko;1;1;2;0;0;0
89;14.09.2011;2011;09;02;Keskiviikko;1;0;1;0;0;0
89;14.09.2011;2011;09;03;Keskiviikko;1;1;2;0;0;0
89;14.09.2011;2011;09;04;Keskiviikko;6;3;9;0;0;0
89;14.09.2011;2011;09;05;Keskiviikko;5;7;12;0;0;0
89;14.09.2011;2011;09;06;Keskiviikko;40;63;103;11;6;17
89;14.09.2011;2011;09;07;Keskiviikko;129;240;369;45;13;58
89;14.09.2011;2011;09;08;Keskiviikko;66;163;229;23;26;49
89;14.09.2011;2011;09;09;Keskiviikko;64;135;199;12;8;20
89;14.09.2011;2011;09;10;Keskiviikko;75;100;175;14;20;34
89;14.09.2011;2011;09;11;Keskiviikko;75;78;153;6;17;23
89;14.09.2011;2011;09;12;Keskiviikko;96;113;209;12;19;31
89;14.09.2011;2011;09;13;Keskiviikko;138;96;234;6;11;17
89;14.09.2011;2011;09;14;Keskiviikko;181;117;298;8;22;30
89;14.09.2011;2011;09;15;Keskiviikko;258;118;376;19;47;66
89;14.09.2011;2011;09;16;Keskiviikko;228;104;332;28;64;92
89;14.09.2011;2011;09;17;Keskiviikko;129;116;245;15;31;46
89;14.09.2011;2011;09;18;Keskiviikko;132;101;233;25;43;68
89;14.09.2011;2011;09;19;Keskiviikko;128;64;192;23;24;47
89;14.09.2011;2011;09;20;Keskiviikko;82;51;133;28;52;80
89;14.09.2011;2011;09;21;Keskiviikko;58;26;84;10;22;32
89;14.09.2011;2011;09;22;Keskiviikko;41;12;53;2;17;19
89;14.09.2011;2011;09;23;Keskiviikko;16;11;27;0;0;0
89;15.09.2011;2011;09;00;Torstai;15;0;15;0;2;2
89;15.09.2011;2011;09;01;Torstai;9;3;12;0;0;0
89;15.09.2011;2011;09;02;Torstai;12;4;16;0;0;0
89;15.09.2011;2011;09;03;Torstai;12;3;15;0;0;0
89;15.09.2011;2011;09;04;Torstai;4;3;7;2;2;4
89;15.09.2011;2011;09;05;Torstai;6;12;18;2;0;2
89;15.09.2011;2011;09;06;Torstai;33;83;116;4;0;4
89;15.09.2011;2011;09;07;Torstai;114;322;436;41;7;48
89;15.09.2011;2011;09;08;Torstai;72;169;241;25;18;43
89;15.09.2011;2011;09;09;Torstai;65;147;212;17;6;23
89;15.09.2011;2011;09;10;Torstai;64;92;156;13;25;38
89;15.09.2011;2011;09;11;Torstai;84;98;182;10;13;23
89;15.09.2011;2011;09;12;Torstai;116;97;213;8;9;17
89;15.09.2011;2011;09;13;Torstai;122;120;242;12;24;36
89;15.09.2011;2011;09;14;Torstai;172;120;292;26;65;91
89;15.09.2011;2011;09;15;Torstai;310;131;441;25;46;71
89;15.09.2011;2011;09;16;Torstai;216;146;362;10;52;62
89;15.09.2011;2011;09;17;Torstai;165;129;294;25;23;48
89;15.09.2011;2011;09;18;Torstai;129;110;239;23;37;60
89;15.09.2011;2011;09;19;Torstai;113;75;188;39;20;59
89;15.09.2011;2011;09;20;Torstai;89;51;140;12;32;44
89;15.09.2011;2011;09;21;Torstai;56;23;79;14;14;28
89;15.09.2011;2011;09;22;Torstai;20;26;46;8;6;14
89;15.09.2011;2011;09;23;Torstai;14;4;18;4;0;4
89;16.09.2011;2011;09;00;Perjantai;11;6;17;3;4;7
89;16.09.2011;2011;09;01;Perjantai;10;2;12;6;0;6
89;16.09.2011;2011;09;02;Perjantai;11;1;12;3;0;3
89;16.09.2011;2011;09;03;Perjantai;15;4;19;0;0;0
89;16.09.2011;2011;09;04;Perjantai;6;5;11;0;0;0
89;16.09.2011;2011;09;05;Perjantai;5;12;17;3;0;3
89;16.09.2011;2011;09;06;Perjantai;34;79;113;8;10;18
89;16.09.2011;2011;09;07;Perjantai;97;307;404;38;18;56
89;16.09.2011;2011;09;08;Perjantai;71;179;250;51;47;98
89;16.09.2011;2011;09;09;Perjantai;66;155;221;13;35;48
89;16.09.2011;2011;09;10;Perjantai;67;90;157;13;23;36
89;16.09.2011;2011;09;11;Perjantai;105;118;223;8;14;22
89;16.09.2011;2011;09;12;Perjantai;114;145;259;18;24;42
89;16.09.2011;2011;09;13;Perjantai;195;139;334;37;56;93
89;16.09.2011;2011;09;14;Perjantai;229;127;356;18;30;48
89;16.09.2011;2011;09;15;Perjantai;257;123;380;8;33;41
89;16.09.2011;2011;09;16;Perjantai;196;131;327;23;23;46
89;16.09.2011;2011;09;17;Perjantai;146;119;265;34;21;55
89;16.09.2011;2011;09;18;Perjantai;108;87;195;39;12;51
89;16.09.2011;2011;09;19;Perjantai;94;66;160;11;19;30
89;16.09.2011;2011;09;20;Perjantai;67;46;113;26;16;42
89;16.09.2011;2011;09;21;Perjantai;43;46;89;5;18;23
89;16.09.2011;2011;09;22;Perjantai;25;43;68;3;0;3
89;16.09.2011;2011;09;23;Perjantai;40;33;73;0;7;7
89;17.09.2011;2011;09;00;Lauantai;21;29;50;0;0;0
89;17.09.2011;2011;09;01;Lauantai;33;14;47;2;0;2
89;17.09.2011;2011;09;02;Lauantai;38;5;43;2;0;2
89;17.09.2011;2011;09;03;Lauantai;32;3;35;0;0;0
89;17.09.2011;2011;09;04;Lauantai;23;4;27;2;0;2
89;17.09.2011;2011;09;05;Lauantai;5;0;5;0;0;0
89;17.09.2011;2011;09;06;Lauantai;8;16;24;9;0;9
89;17.09.2011;2011;09;07;Lauantai;10;18;28;2;3;5
89;17.09.2011;2011;09;08;Lauantai;21;38;59;18;9;27
89;17.09.2011;2011;09;09;Lauantai;22;101;123;9;59;68
89;17.09.2011;2011;09;10;Lauantai;50;103;153;12;31;43
89;17.09.2011;2011;09;11;Lauantai;77;111;188;15;24;39
89;17.09.2011;2011;09;12;Lauantai;109;125;234;36;31;67
89;17.09.2011;2011;09;13;Lauantai;118;140;258;24;41;65
89;17.09.2011;2011;09;14;Lauantai;146;114;260;34;38;72
89;17.09.2011;2011;09;15;Lauantai;140;80;220;38;19;57
89;17.09.2011;2011;09;16;Lauantai;110;83;193;19;59;78
89;17.09.2011;2011;09;17;Lauantai;110;91;201;19;20;39
89;17.09.2011;2011;09;18;Lauantai;66;74;140;33;13;46
89;17.09.2011;2011;09;19;Lauantai;67;60;127;42;50;92
89;17.09.2011;2011;09;20;Lauantai;44;27;71;13;23;36
89;17.09.2011;2011;09;21;Lauantai;24;52;76;2;22;24
89;17.09.2011;2011;09;22;Lauantai;25;25;50;2;3;5
89;17.09.2011;2011;09;23;Lauantai;17;33;50;2;0;2
89;18.09.2011;2011;09;00;Sunnuntai;14;24;38;3;0;3
89;18.09.2011;2011;09;01;Sunnuntai;29;8;37;0;0;0
89;18.09.2011;2011;09;02;Sunnuntai;32;5;37;3;0;3
89;18.09.2011;2011;09;03;Sunnuntai;34;5;39;6;0;6
89;18.09.2011;2011;09;04;Sunnuntai;16;2;18;12;0;12
89;18.09.2011;2011;09;05;Sunnuntai;12;0;12;0;0;0
89;18.09.2011;2011;09;06;Sunnuntai;6;16;22;9;0;9
89;18.09.2011;2011;09;07;Sunnuntai;13;16;29;3;3;6
89;18.09.2011;2011;09;08;Sunnuntai;16;14;30;12;6;18
89;18.09.2011;2011;09;09;Sunnuntai;15;39;54;18;3;21
89;18.09.2011;2011;09;10;Sunnuntai;25;76;101;20;43;63
89;18.09.2011;2011;09;11;Sunnuntai;57;102;159;18;34;52
89;18.09.2011;2011;09;12;Sunnuntai;82;123;205;58;66;124
89;18.09.2011;2011;09;13;Sunnuntai;97;114;211;42;62;104
89;18.09.2011;2011;09;14;Sunnuntai;122;124;246;37;65;102
89;18.09.2011;2011;09;15;Sunnuntai;112;88;200;49;59;108
89;18.09.2011;2011;09;16;Sunnuntai;126;98;224;42;34;76
89;18.09.2011;2011;09;17;Sunnuntai;102;77;179;78;44;122
89;18.09.2011;2011;09;18;Sunnuntai;94;78;172;36;30;66
89;18.09.2011;2011;09;19;Sunnuntai;71;46;117;39;47;86
89;18.09.2011;2011;09;20;Sunnuntai;42;16;58;17;40;57
89;18.09.2011;2011;09;21;Sunnuntai;26;13;39;12;12;24
89;18.09.2011;2011;09;22;Sunnuntai;15;6;21;3;6;9
89;18.09.2011;2011;09;23;Sunnuntai;13;6;19;0;3;3
89;19.09.2011;2011;09;00;Maanantai;2;3;5;0;0;0
89;19.09.2011;2011;09;01;Maanantai;2;2;4;0;0;0
89;19.09.2011;2011;09;02;Maanantai;2;2;4;0;0;0
89;19.09.2011;2011;09;03;Maanantai;1;2;3;0;0;0
89;19.09.2011;2011;09;04;Maanantai;2;4;6;0;2;2
89;19.09.2011;2011;09;05;Maanantai;3;13;16;2;0;2
89;19.09.2011;2011;09;06;Maanantai;38;76;114;8;8;16
89;19.09.2011;2011;09;07;Maanantai;91;320;411;42;20;62
89;19.09.2011;2011;09;08;Maanantai;73;243;316;30;17;47
89;19.09.2011;2011;09;09;Maanantai;77;171;248;14;11;25
89;19.09.2011;2011;09;10;Maanantai;67;97;164;19;6;25
89;19.09.2011;2011;09;11;Maanantai;94;114;208;14;18;32
89;19.09.2011;2011;09;12;Maanantai;86;113;199;12;23;35
89;19.09.2011;2011;09;13;Maanantai;136;131;267;16;14;30
89;19.09.2011;2011;09;14;Maanantai;205;143;348;8;24;32
89;19.09.2011;2011;09;15;Maanantai;299;144;443;12;55;67
89;19.09.2011;2011;09;16;Maanantai;263;168;431;23;59;82
89;19.09.2011;2011;09;17;Maanantai;194;123;317;29;22;51
89;19.09.2011;2011;09;18;Maanantai;139;113;252;22;59;81
89;19.09.2011;2011;09;19;Maanantai;118;76;194;31;40;71
89;19.09.2011;2011;09;20;Maanantai;83;45;128;22;31;53
89;19.09.2011;2011;09;21;Maanantai;53;17;70;16;11;27
89;19.09.2011;2011;09;22;Maanantai;5;8;13;0;4;4
89;19.09.2011;2011;09;23;Maanantai;12;5;17;0;2;2
89;20.09.2011;2011;09;00;Tiistai;5;3;8;0;0;0
89;20.09.2011;2011;09;01;Tiistai;0;2;2;0;2;2
89;20.09.2011;2011;09;02;Tiistai;2;1;3;0;0;0
89;20.09.2011;2011;09;03;Tiistai;0;3;3;0;0;0
89;20.09.2011;2011;09;04;Tiistai;2;3;5;0;0;0
89;20.09.2011;2011;09;05;Tiistai;5;15;20;5;0;5
89;20.09.2011;2011;09;06;Tiistai;43;77;120;12;5;17
89;20.09.2011;2011;09;07;Tiistai;95;260;355;41;29;70
89;20.09.2011;2011;09;08;Tiistai;60;118;178;23;11;34
89;20.09.2011;2011;09;09;Tiistai;56;84;140;14;7;21
89;20.09.2011;2011;09;10;Tiistai;29;41;70;9;0;9
89;20.09.2011;2011;09;11;Tiistai;47;40;87;18;6;24
89;20.09.2011;2011;09;12;Tiistai;51;57;108;23;19;42
89;20.09.2011;2011;09;13;Tiistai;91;69;160;4;11;15
89;20.09.2011;2011;09;14;Tiistai;137;101;238;6;21;27
89;20.09.2011;2011;09;15;Tiistai;222;95;317;22;56;78
89;20.09.2011;2011;09;16;Tiistai;201;96;297;21;44;65
89;20.09.2011;2011;09;17;Tiistai;117;76;193;32;29;61
89;20.09.2011;2011;09;18;Tiistai;88;82;170;19;42;61
89;20.09.2011;2011;09;19;Tiistai;82;36;118;36;19;55
89;20.09.2011;2011;09;20;Tiistai;78;29;107;36;21;57
89;20.09.2011;2011;09;21;Tiistai;40;27;67;11;7;18
89;20.09.2011;2011;09;22;Tiistai;10;5;15;2;9;11
89;20.09.2011;2011;09;23;Tiistai;8;5;13;4;2;6
89;21.09.2011;2011;09;00;Keskiviikko;2;0;2;2;0;2
89;21.09.2011;2011;09;01;Keskiviikko;4;1;5;0;0;0
89;21.09.2011;2011;09;02;Keskiviikko;0;2;2;0;0;0
89;21.09.2011;2011;09;03;Keskiviikko;2;1;3;0;0;0
89;21.09.2011;2011;09;04;Keskiviikko;3;3;6;0;0;0
89;21.09.2011;2011;09;05;Keskiviikko;4;13;17;0;0;0
89;21.09.2011;2011;09;06;Keskiviikko;42;76;118;6;4;10
89;21.09.2011;2011;09;07;Keskiviikko;105;301;406;40;15;55
89;21.09.2011;2011;09;08;Keskiviikko;80;193;273;32;6;38
89;21.09.2011;2011;09;09;Keskiviikko;57;134;191;8;21;29
89;21.09.2011;2011;09;10;Keskiviikko;63;101;164;6;17;23
89;21.09.2011;2011;09;11;Keskiviikko;71;78;149;10;11;21
89;21.09.2011;2011;09;12;Keskiviikko;85;98;183;14;13;27
89;21.09.2011;2011;09;13;Keskiviikko;143;91;234;6;11;17
89;21.09.2011;2011;09;14;Keskiviikko;171;123;294;23;55;78
89;21.09.2011;2011;09;15;Keskiviikko;243;134;377;25;42;67
89;21.09.2011;2011;09;16;Keskiviikko;273;126;399;29;50;79
89;21.09.2011;2011;09;17;Keskiviikko;139;83;222;12;15;27
89;21.09.2011;2011;09;18;Keskiviikko;105;71;176;22;26;48
89;21.09.2011;2011;09;19;Keskiviikko;86;41;127;36;29;65
89;21.09.2011;2011;09;20;Keskiviikko;82;46;128;13;23;36
89;21.09.2011;2011;09;21;Keskiviikko;32;16;48;11;19;30
89;21.09.2011;2011;09;22;Keskiviikko;10;16;26;0;6;6
89;21.09.2011;2011;09;23;Keskiviikko;14;3;17;0;0;0
89;22.09.2011;2011;09;00;Torstai;11;4;15;0;0;0
89;22.09.2011;2011;09;01;Torstai;13;2;15;4;0;4
89;22.09.2011;2011;09;02;Torstai;1;1;2;0;0;0
89;22.09.2011;2011;09;03;Torstai;7;2;9;0;0;0
89;22.09.2011;2011;09;04;Torstai;4;4;8;2;0;2
89;22.09.2011;2011;09;05;Torstai;6;10;16;2;0;2
89;22.09.2011;2011;09;06;Torstai;35;80;115;6;6;12
89;22.09.2011;2011;09;07;Torstai;84;275;359;38;13;51
89;22.09.2011;2011;09;08;Torstai;66;132;198;38;21;59
89;22.09.2011;2011;09;09;Torstai;57;86;143;10;4;14
89;22.09.2011;2011;09;10;Torstai;43;45;88;15;13;28
89;22.09.2011;2011;09;11;Torstai;65;58;123;12;25;37
89;22.09.2011;2011;09;12;Torstai;64;81;145;10;12;22
89;22.09.2011;2011;09;13;Torstai;83;75;158;8;25;33
89;22.09.2011;2011;09;14;Torstai;149;90;239;2;41;43
89;22.09.2011;2011;09;15;Torstai;223;78;301;8;39;47
89;22.09.2011;2011;09;16;Torstai;162;76;238;21;48;69
89;22.09.2011;2011;09;17;Torstai;106;81;187;17;9;26
89;22.09.2011;2011;09;18;Torstai;79;55;134;6;21;27
89;22.09.2011;2011;09;19;Torstai;65;36;101;21;17;38
89;22.09.2011;2011;09;20;Torstai;62;38;100;10;19;29
89;22.09.2011;2011;09;21;Torstai;35;19;54;4;16;20
89;22.09.2011;2011;09;22;Torstai;14;8;22;0;0;0
89;22.09.2011;2011;09;23;Torstai;10;6;16;0;2;2
89;23.09.2011;2011;09;00;Perjantai;8;8;16;0;0;0
89;23.09.2011;2011;09;01;Perjantai;2;3;5;3;0;3
89;23.09.2011;2011;09;02;Perjantai;1;1;2;0;0;0
89;23.09.2011;2011;09;03;Perjantai;0;3;3;0;0;0
89;23.09.2011;2011;09;04;Perjantai;2;4;6;0;2;2
89;23.09.2011;2011;09;05;Perjantai;3;14;17;6;0;6
89;23.09.2011;2011;09;06;Perjantai;31;70;101;8;5;13
89;23.09.2011;2011;09;07;Perjantai;83;252;335;38;19;57
89;23.09.2011;2011;09;08;Perjantai;67;176;243;22;14;36
89;23.09.2011;2011;09;09;Perjantai;58;122;180;21;5;26
89;23.09.2011;2011;09;10;Perjantai;64;58;122;6;30;36
89;23.09.2011;2011;09;11;Perjantai;50;74;124;21;13;34
89;23.09.2011;2011;09;12;Perjantai;94;101;195;16;14;30
89;23.09.2011;2011;09;13;Perjantai;147;98;245;21;9;30
89;23.09.2011;2011;09;14;Perjantai;196;79;275;14;18;32
89;23.09.2011;2011;09;15;Perjantai;188;64;252;13;33;46
89;23.09.2011;2011;09;16;Perjantai;155;87;242;18;23;41
89;23.09.2011;2011;09;17;Perjantai;86;70;156;28;18;46
89;23.09.2011;2011;09;18;Perjantai;80;55;135;38;30;68
89;23.09.2011;2011;09;19;Perjantai;52;42;94;17;26;43
89;23.09.2011;2011;09;20;Perjantai;40;38;78;11;4;15
89;23.09.2011;2011;09;21;Perjantai;30;29;59;32;13;45
89;23.09.2011;2011;09;22;Perjantai;22;23;45;3;7;10
89;23.09.2011;2011;09;23;Perjantai;21;18;39;8;4;12
89;24.09.2011;2011;09;00;Lauantai;17;27;44;5;5;10
89;24.09.2011;2011;09;01;Lauantai;12;8;20;0;0;0
89;24.09.2011;2011;09;02;Lauantai;22;8;30;7;0;7
89;24.09.2011;2011;09;03;Lauantai;33;6;39;0;0;0
89;24.09.2011;2011;09;04;Lauantai;13;2;15;2;0;2
89;24.09.2011;2011;09;05;Lauantai;7;5;12;0;0;0
89;24.09.2011;2011;09;06;Lauantai;5;12;17;5;0;5
89;24.09.2011;2011;09;07;Lauantai;7;22;29;2;3;5
89;24.09.2011;2011;09;08;Lauantai;10;31;41;6;17;23
89;24.09.2011;2011;09;09;Lauantai;21;70;91;7;6;13
89;24.09.2011;2011;09;10;Lauantai;42;79;121;9;14;23
89;24.09.2011;2011;09;11;Lauantai;52;98;150;12;12;24
89;24.09.2011;2011;09;12;Lauantai;70;93;163;14;24;38
89;24.09.2011;2011;09;13;Lauantai;91;83;174;16;24;40
89;24.09.2011;2011;09;14;Lauantai;104;93;197;19;11;30
89;24.09.2011;2011;09;15;Lauantai;79;59;138;14;21;35
89;24.09.2011;2011;09;16;Lauantai;77;65;142;9;40;49
89;24.09.2011;2011;09;17;Lauantai;88;55;143;14;8;22
89;24.09.2011;2011;09;18;Lauantai;64;45;109;30;30;60
89;24.09.2011;2011;09;19;Lauantai;39;41;80;28;16;44
89;24.09.2011;2011;09;20;Lauantai;47;33;80;7;8;15
89;24.09.2011;2011;09;21;Lauantai;26;33;59;4;22;26
89;24.09.2011;2011;09;22;Lauantai;14;44;58;4;27;31
89;24.09.2011;2011;09;23;Lauantai;24;36;60;2;0;2
89;25.09.2011;2011;09;00;Sunnuntai;15;20;35;0;6;6
89;25.09.2011;2011;09;01;Sunnuntai;24;21;45;0;0;0
89;25.09.2011;2011;09;02;Sunnuntai;27;0;27;3;0;3
89;25.09.2011;2011;09;03;Sunnuntai;30;7;37;20;0;20
89;25.09.2011;2011;09;04;Sunnuntai;14;0;14;15;0;15
89;25.09.2011;2011;09;05;Sunnuntai;7;5;12;0;0;0
89;25.09.2011;2011;09;06;Sunnuntai;8;7;15;8;0;8
89;25.09.2011;2011;09;07;Sunnuntai;9;13;22;3;6;9
89;25.09.2011;2011;09;08;Sunnuntai;12;13;25;6;0;6
89;25.09.2011;2011;09;09;Sunnuntai;13;31;44;9;12;21
89;25.09.2011;2011;09;10;Sunnuntai;46;64;110;14;15;29
89;25.09.2011;2011;09;11;Sunnuntai;46;82;128;22;37;59
89;25.09.2011;2011;09;12;Sunnuntai;88;118;206;14;40;54
89;25.09.2011;2011;09;13;Sunnuntai;112;119;231;28;30;58
89;25.09.2011;2011;09;14;Sunnuntai;104;109;213;38;15;53
89;25.09.2011;2011;09;15;Sunnuntai;92;68;160;17;42;59
89;25.09.2011;2011;09;16;Sunnuntai;71;81;152;61;28;89
89;25.09.2011;2011;09;17;Sunnuntai;77;66;143;28;46;74
89;25.09.2011;2011;09;18;Sunnuntai;83;61;144;45;40;85
89;25.09.2011;2011;09;19;Sunnuntai;67;25;92;15;37;52
89;25.09.2011;2011;09;20;Sunnuntai;38;17;55;31;31;62
89;25.09.2011;2011;09;21;Sunnuntai;19;7;26;14;12;26
89;25.09.2011;2011;09;22;Sunnuntai;18;12;30;12;9;21
89;25.09.2011;2011;09;23;Sunnuntai;12;3;15;3;3;6
89;26.09.2011;2011;09;00;Maanantai;1;2;3;2;0;2
89;26.09.2011;2011;09;01;Maanantai;3;1;4;0;0;0
89;26.09.2011;2011;09;02;Maanantai;0;0;0;0;0;0
89;26.09.2011;2011;09;03;Maanantai;4;2;6;0;0;0
89;26.09.2011;2011;09;04;Maanantai;1;5;6;0;0;0
89;26.09.2011;2011;09;05;Maanantai;5;7;12;0;2;2
89;26.09.2011;2011;09;06;Maanantai;38;72;110;17;0;17
89;26.09.2011;2011;09;07;Maanantai;93;274;367;35;28;63
89;26.09.2011;2011;09;08;Maanantai;87;221;308;20;25;45
89;26.09.2011;2011;09;09;Maanantai;86;174;260;6;20;26
89;26.09.2011;2011;09;10;Maanantai;61;93;154;17;10;27
89;26.09.2011;2011;09;11;Maanantai;98;108;206;18;24;42
89;26.09.2011;2011;09;12;Maanantai;96;134;230;10;8;18
89;26.09.2011;2011;09;13;Maanantai;142;134;276;11;11;22
89;26.09.2011;2011;09;14;Maanantai;175;150;325;8;31;39
89;26.09.2011;2011;09;15;Maanantai;331;147;478;31;50;81
89;26.09.2011;2011;09;16;Maanantai;244;147;391;20;46;66
89;26.09.2011;2011;09;17;Maanantai;171;134;305;29;48;77
89;26.09.2011;2011;09;18;Maanantai;123;116;239;41;28;69
89;26.09.2011;2011;09;19;Maanantai;124;54;178;27;44;71
89;26.09.2011;2011;09;20;Maanantai;70;36;106;52;46;98
89;26.09.2011;2011;09;21;Maanantai;41;20;61;14;22;36
89;26.09.2011;2011;09;22;Maanantai;17;8;25;2;2;4
89;26.09.2011;2011;09;23;Maanantai;6;5;11;2;2;4
89;27.09.2011;2011;09;00;Tiistai;5;1;6;2;0;2
89;27.09.2011;2011;09;01;Tiistai;1;2;3;0;0;0
89;27.09.2011;2011;09;02;Tiistai;3;1;4;0;0;0
89;27.09.2011;2011;09;03;Tiistai;0;4;4;0;0;0
89;27.09.2011;2011;09;04;Tiistai;3;8;11;2;0;2
89;27.09.2011;2011;09;05;Tiistai;8;12;20;2;0;2
89;27.09.2011;2011;09;06;Tiistai;43;47;90;14;12;26
89;27.09.2011;2011;09;07;Tiistai;110;170;280;43;14;57
89;27.09.2011;2011;09;08;Tiistai;82;120;202;29;9;38
89;27.09.2011;2011;09;09;Tiistai;48;90;138;20;13;33
89;27.09.2011;2011;09;10;Tiistai;52;55;107;2;16;18
89;27.09.2011;2011;09;11;Tiistai;53;59;112;14;6;20
89;27.09.2011;2011;09;12;Tiistai;58;65;123;14;17;31
89;27.09.2011;2011;09;13;Tiistai;71;45;116;10;11;21
89;27.09.2011;2011;09;14;Tiistai;114;48;162;2;9;11
89;27.09.2011;2011;09;15;Tiistai;164;60;224;10;41;51
89;27.09.2011;2011;09;16;Tiistai;146;65;211;16;44;60
89;27.09.2011;2011;09;17;Tiistai;84;43;127;9;19;28
89;27.09.2011;2011;09;18;Tiistai;62;32;94;19;22;41
89;27.09.2011;2011;09;19;Tiistai;46;19;65;17;7;24
89;27.09.2011;2011;09;20;Tiistai;38;15;53;10;14;24
89;27.09.2011;2011;09;21;Tiistai;29;14;43;5;2;7
89;27.09.2011;2011;09;22;Tiistai;6;4;10;2;2;4
89;27.09.2011;2011;09;23;Tiistai;8;1;9;2;2;4
89;28.09.2011;2011;09;00;Keskiviikko;0;1;1;0;0;0
89;28.09.2011;2011;09;01;Keskiviikko;0;2;2;0;0;0
89;28.09.2011;2011;09;02;Keskiviikko;1;1;2;0;0;0
89;28.09.2011;2011;09;03;Keskiviikko;4;3;7;0;0;0
89;28.09.2011;2011;09;04;Keskiviikko;9;6;15;0;0;0
89;28.09.2011;2011;09;05;Keskiviikko;7;13;20;2;0;2
89;28.09.2011;2011;09;06;Keskiviikko;28;85;113;8;2;10
89;28.09.2011;2011;09;07;Keskiviikko;102;274;376;34;28;62
89;28.09.2011;2011;09;08;Keskiviikko;95;241;336;35;12;47
89;28.09.2011;2011;09;09;Keskiviikko;77;111;188;14;17;31
89;28.09.2011;2011;09;10;Keskiviikko;64;114;178;10;24;34
89;28.09.2011;2011;09;11;Keskiviikko;91;122;213;8;18;26
89;28.09.2011;2011;09;12;Keskiviikko;108;100;208;40;26;66
89;28.09.2011;2011;09;13;Keskiviikko;144;105;249;21;29;50
89;28.09.2011;2011;09;14;Keskiviikko;178;121;299;12;22;34
89;28.09.2011;2011;09;15;Keskiviikko;270;150;420;25;44;69
89;28.09.2011;2011;09;16;Keskiviikko;245;125;370;8;57;65
89;28.09.2011;2011;09;17;Keskiviikko;138;86;224;19;11;30
89;28.09.2011;2011;09;18;Keskiviikko;101;69;170;19;22;41
89;28.09.2011;2011;09;19;Keskiviikko;80;33;113;24;22;46
89;28.09.2011;2011;09;20;Keskiviikko;79;41;120;33;26;59
89;28.09.2011;2011;09;21;Keskiviikko;36;22;58;25;31;56
89;28.09.2011;2011;09;22;Keskiviikko;11;18;29;2;6;8
89;28.09.2011;2011;09;23;Keskiviikko;17;17;34;0;0;0
89;29.09.2011;2011;09;00;Torstai;6;2;8;0;0;0
89;29.09.2011;2011;09;01;Torstai;8;10;18;2;0;2
89;29.09.2011;2011;09;02;Torstai;6;5;11;2;0;2
89;29.09.2011;2011;09;03;Torstai;13;1;14;0;0;0
89;29.09.2011;2011;09;04;Torstai;8;6;14;0;0;0
89;29.09.2011;2011;09;05;Torstai;4;14;18;2;0;2
89;29.09.2011;2011;09;06;Torstai;30;68;98;6;2;8
89;29.09.2011;2011;09;07;Torstai;69;310;379;43;9;52
89;29.09.2011;2011;09;08;Torstai;52;192;244;29;23;52
89;29.09.2011;2011;09;09;Torstai;61;134;195;16;9;25
89;29.09.2011;2011;09;10;Torstai;59;80;139;14;14;28
89;29.09.2011;2011;09;11;Torstai;95;120;215;6;12;18
89;29.09.2011;2011;09;12;Torstai;100;98;198;14;16;30
89;29.09.2011;2011;09;13;Torstai;126;57;183;18;7;25
89;29.09.2011;2011;09;14;Torstai;170;90;260;16;5;21
89;29.09.2011;2011;09;15;Torstai;246;97;343;18;46;64
89;29.09.2011;2011;09;16;Torstai;213;120;333;11;43;54
89;29.09.2011;2011;09;17;Torstai;159;97;256;36;16;52
89;29.09.2011;2011;09;18;Torstai;103;74;177;18;29;47
89;29.09.2011;2011;09;19;Torstai;80;51;131;21;28;49
89;29.09.2011;2011;09;20;Torstai;71;35;106;8;27;35
89;29.09.2011;2011;09;21;Torstai;41;26;67;4;11;15
89;29.09.2011;2011;09;22;Torstai;17;12;29;2;2;4
89;29.09.2011;2011;09;23;Torstai;12;13;25;0;0;0
89;30.09.2011;2011;09;00;Perjantai;4;2;6;0;0;0
89;30.09.2011;2011;09;01;Perjantai;8;3;11;3;0;3
89;30.09.2011;2011;09;02;Perjantai;9;2;11;0;0;0
89;30.09.2011;2011;09;03;Perjantai;8;2;10;0;2;2
89;30.09.2011;2011;09;04;Perjantai;5;8;13;6;0;6
89;30.09.2011;2011;09;05;Perjantai;6;10;16;3;0;3
89;30.09.2011;2011;09;06;Perjantai;42;66;108;28;0;28
89;30.09.2011;2011;09;07;Perjantai;103;237;340;54;11;65
89;30.09.2011;2011;09;08;Perjantai;71;170;241;19;7;26
89;30.09.2011;2011;09;09;Perjantai;74;117;191;8;12;20
89;30.09.2011;2011;09;10;Perjantai;103;90;193;15;9;24
89;30.09.2011;2011;09;11;Perjantai;115;104;219;14;22;36
89;30.09.2011;2011;09;12;Perjantai;118;143;261;16;31;47
89;30.09.2011;2011;09;13;Perjantai;174;142;316;19;24;43
89;30.09.2011;2011;09;14;Perjantai;219;167;386;19;44;63
89;30.09.2011;2011;09;15;Perjantai;230;119;349;21;58;79
89;30.09.2011;2011;09;16;Perjantai;173;117;290;31;51;82
89;30.09.2011;2011;09;17;Perjantai;138;131;269;15;19;34
89;30.09.2011;2011;09;18;Perjantai;105;86;191;19;34;53
89;30.09.2011;2011;09;19;Perjantai;81;69;150;18;16;34
89;30.09.2011;2011;09;20;Perjantai;77;36;113;16;17;33
89;30.09.2011;2011;09;21;Perjantai;36;30;66;31;14;45
89;30.09.2011;2011;09;22;Perjantai;51;41;92;3;5;8
89;30.09.2011;2011;09;23;Perjantai;30;38;68;3;0;3
89;01.10.2011;2011;10;00;Lauantai;25;14;39;4;6;10
89;01.10.2011;2011;10;01;Lauantai;21;6;27;4;0;4
89;01.10.2011;2011;10;02;Lauantai;28;3;31;6;6;12
89;01.10.2011;2011;10;03;Lauantai;28;2;30;2;0;2
89;01.10.2011;2011;10;04;Lauantai;23;0;23;4;3;7
89;01.10.2011;2011;10;05;Lauantai;3;3;6;0;0;0
89;01.10.2011;2011;10;06;Lauantai;5;9;14;9;0;9
89;01.10.2011;2011;10;07;Lauantai;9;25;34;0;6;6
89;01.10.2011;2011;10;08;Lauantai;12;40;52;0;8;8
89;01.10.2011;2011;10;09;Lauantai;27;73;100;9;14;23
89;01.10.2011;2011;10;10;Lauantai;38;94;132;14;27;41
89;01.10.2011;2011;10;11;Lauantai;72;102;174;19;34;53
89;01.10.2011;2011;10;12;Lauantai;100;130;230;25;22;47
89;01.10.2011;2011;10;13;Lauantai;107;127;234;38;24;62
89;01.10.2011;2011;10;14;Lauantai;120;77;197;11;29;40
89;01.10.2011;2011;10;15;Lauantai;122;86;208;35;26;61
89;01.10.2011;2011;10;16;Lauantai;108;67;175;19;70;89
89;01.10.2011;2011;10;17;Lauantai;70;71;141;107;38;145
89;01.10.2011;2011;10;18;Lauantai;62;70;132;31;21;52
89;01.10.2011;2011;10;19;Lauantai;40;46;86;27;13;40
89;01.10.2011;2011;10;20;Lauantai;32;37;69;31;30;61
89;01.10.2011;2011;10;21;Lauantai;28;32;60;14;56;70
89;01.10.2011;2011;10;22;Lauantai;11;32;43;7;62;69
89;01.10.2011;2011;10;23;Lauantai;13;28;41;0;11;11
89;02.10.2011;2011;10;00;Sunnuntai;25;29;54;14;0;14
89;02.10.2011;2011;10;01;Sunnuntai;23;13;36;9;0;9
89;02.10.2011;2011;10;02;Sunnuntai;43;6;49;0;9;9
89;02.10.2011;2011;10;03;Sunnuntai;24;2;26;6;0;6
89;02.10.2011;2011;10;04;Sunnuntai;22;1;23;3;0;3
89;02.10.2011;2011;10;05;Sunnuntai;3;1;4;0;0;0
89;02.10.2011;2011;10;06;Sunnuntai;6;5;11;3;3;6
89;02.10.2011;2011;10;07;Sunnuntai;9;7;16;0;6;6
89;02.10.2011;2011;10;08;Sunnuntai;9;11;20;17;6;23
89;02.10.2011;2011;10;09;Sunnuntai;27;26;53;20;28;48
89;02.10.2011;2011;10;10;Sunnuntai;34;54;88;17;21;38
89;02.10.2011;2011;10;11;Sunnuntai;45;53;98;23;12;35
89;02.10.2011;2011;10;12;Sunnuntai;57;77;134;32;40;72
89;02.10.2011;2011;10;13;Sunnuntai;67;59;126;26;15;41
89;02.10.2011;2011;10;14;Sunnuntai;58;71;129;17;24;41
89;02.10.2011;2011;10;15;Sunnuntai;63;70;133;19;18;37
89;02.10.2011;2011;10;16;Sunnuntai;63;26;89;26;57;83
89;02.10.2011;2011;10;17;Sunnuntai;47;23;70;38;30;68
89;02.10.2011;2011;10;18;Sunnuntai;39;22;61;17;21;38
89;02.10.2011;2011;10;19;Sunnuntai;18;16;34;19;55;74
89;02.10.2011;2011;10;20;Sunnuntai;25;9;34;20;12;32
89;02.10.2011;2011;10;21;Sunnuntai;25;11;36;12;41;53
89;02.10.2011;2011;10;22;Sunnuntai;10;12;22;0;3;3
89;02.10.2011;2011;10;23;Sunnuntai;6;10;16;0;3;3
89;03.10.2011;2011;10;00;Maanantai;5;3;8;8;0;8
89;03.10.2011;2011;10;01;Maanantai;3;1;4;2;0;2
89;03.10.2011;2011;10;02;Maanantai;3;0;3;0;0;0
89;03.10.2011;2011;10;03;Maanantai;1;3;4;0;0;0
89;03.10.2011;2011;10;04;Maanantai;3;3;6;0;0;0
89;03.10.2011;2011;10;05;Maanantai;4;23;27;0;0;0
89;03.10.2011;2011;10;06;Maanantai;39;79;118;10;2;12
89;03.10.2011;2011;10;07;Maanantai;93;256;349;46;13;59
89;03.10.2011;2011;10;08;Maanantai;82;216;298;29;13;42
89;03.10.2011;2011;10;09;Maanantai;67;143;210;27;13;40
89;03.10.2011;2011;10;10;Maanantai;62;99;161;21;22;43
89;03.10.2011;2011;10;11;Maanantai;107;100;207;10;21;31
89;03.10.2011;2011;10;12;Maanantai;111;135;246;6;4;10
89;03.10.2011;2011;10;13;Maanantai;125;109;234;10;25;35
89;03.10.2011;2011;10;14;Maanantai;183;134;317;6;62;68
89;03.10.2011;2011;10;15;Maanantai;297;132;429;18;48;66
89;03.10.2011;2011;10;16;Maanantai;251;136;387;27;50;77
89;03.10.2011;2011;10;17;Maanantai;184;96;280;38;27;65
89;03.10.2011;2011;10;18;Maanantai;136;109;245;36;39;75
89;03.10.2011;2011;10;19;Maanantai;105;56;161;38;36;74
89;03.10.2011;2011;10;20;Maanantai;82;29;111;16;40;56
89;03.10.2011;2011;10;21;Maanantai;49;25;74;16;15;31
89;03.10.2011;2011;10;22;Maanantai;11;5;16;4;4;8
89;03.10.2011;2011;10;23;Maanantai;10;7;17;0;2;2
89;04.10.2011;2011;10;00;Tiistai;5;3;8;2;0;2
89;04.10.2011;2011;10;01;Tiistai;6;0;6;0;0;0
89;04.10.2011;2011;10;02;Tiistai;1;1;2;0;0;0
89;04.10.2011;2011;10;03;Tiistai;2;2;4;2;0;2
89;04.10.2011;2011;10;04;Tiistai;3;4;7;0;0;0
89;04.10.2011;2011;10;05;Tiistai;5;19;24;2;0;2
89;04.10.2011;2011;10;06;Tiistai;29;85;114;14;4;18
89;04.10.2011;2011;10;07;Tiistai;108;301;409;46;27;73
89;04.10.2011;2011;10;08;Tiistai;67;174;241;15;25;40
89;04.10.2011;2011;10;09;Tiistai;73;108;181;18;24;42
89;04.10.2011;2011;10;10;Tiistai;48;85;133;26;11;37
89;04.10.2011;2011;10;11;Tiistai;95;73;168;14;16;30
89;04.10.2011;2011;10;12;Tiistai;99;73;172;25;44;69
89;04.10.2011;2011;10;13;Tiistai;102;68;170;35;14;49
89;04.10.2011;2011;10;14;Tiistai;131;85;216;2;11;13
89;04.10.2011;2011;10;15;Tiistai;237;102;339;12;41;53
89;04.10.2011;2011;10;16;Tiistai;182;74;256;29;56;85
89;04.10.2011;2011;10;17;Tiistai;107;78;185;11;9;20
89;04.10.2011;2011;10;18;Tiistai;100;39;139;26;24;50
89;04.10.2011;2011;10;19;Tiistai;68;41;109;32;29;61
89;04.10.2011;2011;10;20;Tiistai;52;27;79;27;21;48
89;04.10.2011;2011;10;21;Tiistai;48;16;64;9;15;24
89;04.10.2011;2011;10;22;Tiistai;16;7;23;0;2;2
89;04.10.2011;2011;10;23;Tiistai;12;7;19;0;0;0
89;05.10.2011;2011;10;00;Keskiviikko;5;0;5;0;2;2
89;05.10.2011;2011;10;01;Keskiviikko;3;1;4;0;0;0
89;05.10.2011;2011;10;02;Keskiviikko;5;2;7;0;0;0
89;05.10.2011;2011;10;03;Keskiviikko;0;0;0;0;0;0
89;05.10.2011;2011;10;04;Keskiviikko;0;5;5;0;0;0
89;05.10.2011;2011;10;05;Keskiviikko;4;15;19;0;0;0
89;05.10.2011;2011;10;06;Keskiviikko;30;79;109;6;4;10
89;05.10.2011;2011;10;07;Keskiviikko;97;323;420;45;15;60
89;05.10.2011;2011;10;08;Keskiviikko;92;226;318;12;12;24
89;05.10.2011;2011;10;09;Keskiviikko;83;160;243;14;49;63
89;05.10.2011;2011;10;10;Keskiviikko;58;105;163;19;6;25
89;05.10.2011;2011;10;11;Keskiviikko;106;119;225;8;13;21
89;05.10.2011;2011;10;12;Keskiviikko;123;129;252;14;19;33
89;05.10.2011;2011;10;13;Keskiviikko;126;141;267;27;17;44
89;05.10.2011;2011;10;14;Keskiviikko;192;154;346;21;42;63
89;05.10.2011;2011;10;15;Keskiviikko;264;148;412;25;50;75
89;05.10.2011;2011;10;16;Keskiviikko;249;143;392;6;54;60
89;05.10.2011;2011;10;17;Keskiviikko;201;128;329;30;26;56
89;05.10.2011;2011;10;18;Keskiviikko;161;90;251;40;18;58
89;05.10.2011;2011;10;19;Keskiviikko;142;56;198;28;32;60
89;05.10.2011;2011;10;20;Keskiviikko;103;35;138;44;21;65
89;05.10.2011;2011;10;21;Keskiviikko;49;23;72;19;11;30
89;05.10.2011;2011;10;22;Keskiviikko;20;10;30;6;4;10
89;05.10.2011;2011;10;23;Keskiviikko;16;12;28;2;2;4
89;06.10.2011;2011;10;00;Torstai;9;13;22;2;2;4
89;06.10.2011;2011;10;01;Torstai;4;3;7;0;0;0
89;06.10.2011;2011;10;02;Torstai;7;0;7;2;0;2
89;06.10.2011;2011;10;03;Torstai;7;5;12;2;0;2
89;06.10.2011;2011;10;04;Torstai;10;5;15;0;0;0
89;06.10.2011;2011;10;05;Torstai;7;18;25;2;0;2
89;06.10.2011;2011;10;06;Torstai;28;93;121;15;0;15
89;06.10.2011;2011;10;07;Torstai;77;304;381;36;16;52
89;06.10.2011;2011;10;08;Torstai;68;184;252;23;13;36
89;06.10.2011;2011;10;09;Torstai;90;163;253;14;18;32
89;06.10.2011;2011;10;10;Torstai;73;115;188;6;7;13
89;06.10.2011;2011;10;11;Torstai;103;122;225;18;23;41
89;06.10.2011;2011;10;12;Torstai;115;99;214;8;20;28
89;06.10.2011;2011;10;13;Torstai;139;92;231;16;21;37
89;06.10.2011;2011;10;14;Torstai;148;96;244;0;36;36
89;06.10.2011;2011;10;15;Torstai;240;74;314;8;46;54
89;06.10.2011;2011;10;16;Torstai;195;59;254;10;46;56
89;06.10.2011;2011;10;17;Torstai;121;66;187;6;17;23
89;06.10.2011;2011;10;18;Torstai;89;43;132;4;34;38
89;06.10.2011;2011;10;19;Torstai;64;39;103;8;30;38
89;06.10.2011;2011;10;20;Torstai;61;25;86;26;15;41
89;06.10.2011;2011;10;21;Torstai;39;14;53;12;18;30
89;06.10.2011;2011;10;22;Torstai;13;12;25;2;2;4
89;06.10.2011;2011;10;23;Torstai;11;10;21;2;0;2
89;07.10.2011;2011;10;00;Perjantai;10;3;13;0;0;0
89;07.10.2011;2011;10;01;Perjantai;7;0;7;0;0;0
89;07.10.2011;2011;10;02;Perjantai;9;0;9;0;0;0
89;07.10.2011;2011;10;03;Perjantai;14;2;16;3;0;3
89;07.10.2011;2011;10;04;Perjantai;5;3;8;0;2;2
89;07.10.2011;2011;10;05;Perjantai;7;14;21;3;0;3
89;07.10.2011;2011;10;06;Perjantai;33;53;86;13;4;17
89;07.10.2011;2011;10;07;Perjantai;69;199;268;47;11;58
89;07.10.2011;2011;10;08;Perjantai;61;125;186;21;19;40
89;07.10.2011;2011;10;09;Perjantai;46;128;174;8;14;22
89;07.10.2011;2011;10;10;Perjantai;55;76;131;6;4;10
89;07.10.2011;2011;10;11;Perjantai;74;66;140;13;5;18
89;07.10.2011;2011;10;12;Perjantai;86;58;144;8;9;17
89;07.10.2011;2011;10;13;Perjantai;88;38;126;11;7;18
89;07.10.2011;2011;10;14;Perjantai;129;50;179;6;4;10
89;07.10.2011;2011;10;15;Perjantai;116;53;169;15;24;39
89;07.10.2011;2011;10;16;Perjantai;114;37;151;8;30;38
89;07.10.2011;2011;10;17;Perjantai;59;24;83;13;4;17
89;07.10.2011;2011;10;18;Perjantai;53;23;76;3;7;10
89;07.10.2011;2011;10;19;Perjantai;36;12;48;18;12;30
89;07.10.2011;2011;10;20;Perjantai;23;25;48;5;7;12
89;07.10.2011;2011;10;21;Perjantai;20;21;41;13;12;25
89;07.10.2011;2011;10;22;Perjantai;11;13;24;6;7;13
89;07.10.2011;2011;10;23;Perjantai;9;11;20;0;2;2
89;08.10.2011;2011;10;00;Lauantai;13;9;22;0;0;0
89;08.10.2011;2011;10;01;Lauantai;13;5;18;6;3;9
89;08.10.2011;2011;10;02;Lauantai;14;2;16;6;3;9
89;08.10.2011;2011;10;03;Lauantai;13;7;20;5;0;5
89;08.10.2011;2011;10;04;Lauantai;2;3;5;4;0;4
89;08.10.2011;2011;10;05;Lauantai;5;5;10;0;0;0
89;08.10.2011;2011;10;06;Lauantai;6;13;19;0;3;3
89;08.10.2011;2011;10;07;Lauantai;14;25;39;4;13;17
89;08.10.2011;2011;10;08;Lauantai;17;32;49;0;6;6
89;08.10.2011;2011;10;09;Lauantai;24;70;94;6;14;20
89;08.10.2011;2011;10;10;Lauantai;36;101;137;11;80;91
89;08.10.2011;2011;10;11;Lauantai;78;143;221;31;90;121
89;08.10.2011;2011;10;12;Lauantai;111;132;243;49;72;121
89;08.10.2011;2011;10;13;Lauantai;110;109;219;76;35;111
89;08.10.2011;2011;10;14;Lauantai;97;114;211;67;35;102
89;08.10.2011;2011;10;15;Lauantai;129;78;207;66;36;102
89;08.10.2011;2011;10;16;Lauantai;108;89;197;35;29;64
89;08.10.2011;2011;10;17;Lauantai;111;60;171;9;16;25
89;08.10.2011;2011;10;18;Lauantai;70;52;122;40;24;64
89;08.10.2011;2011;10;19;Lauantai;57;44;101;16;20;36
89;08.10.2011;2011;10;20;Lauantai;28;38;66;12;30;42
89;08.10.2011;2011;10;21;Lauantai;34;24;58;12;16;28
89;08.10.2011;2011;10;22;Lauantai;26;30;56;2;5;7
89;08.10.2011;2011;10;23;Lauantai;21;26;47;14;8;22
89;09.10.2011;2011;10;00;Sunnuntai;13;17;30;0;0;0
89;09.10.2011;2011;10;01;Sunnuntai;21;6;27;3;0;3
89;09.10.2011;2011;10;02;Sunnuntai;23;2;25;0;0;0
89;09.10.2011;2011;10;03;Sunnuntai;30;1;31;0;0;0
89;09.10.2011;2011;10;04;Sunnuntai;17;1;18;3;0;3
89;09.10.2011;2011;10;05;Sunnuntai;3;2;5;0;3;3
89;09.10.2011;2011;10;06;Sunnuntai;10;11;21;15;3;18
89;09.10.2011;2011;10;07;Sunnuntai;6;9;15;0;9;9
89;09.10.2011;2011;10;08;Sunnuntai;10;20;30;6;3;9
89;09.10.2011;2011;10;09;Sunnuntai;17;41;58;3;3;6
89;09.10.2011;2011;10;10;Sunnuntai;21;48;69;28;21;49
89;09.10.2011;2011;10;11;Sunnuntai;54;101;155;17;52;69
89;09.10.2011;2011;10;12;Sunnuntai;70;95;165;31;50;81
89;09.10.2011;2011;10;13;Sunnuntai;93;107;200;47;59;106
89;09.10.2011;2011;10;14;Sunnuntai;130;100;230;34;50;84
89;09.10.2011;2011;10;15;Sunnuntai;121;101;222;53;27;80
89;09.10.2011;2011;10;16;Sunnuntai;80;74;154;78;24;102
89;09.10.2011;2011;10;17;Sunnuntai;93;57;150;24;36;60
89;09.10.2011;2011;10;18;Sunnuntai;63;33;96;25;36;61
89;09.10.2011;2011;10;19;Sunnuntai;39;23;62;28;34;62
89;09.10.2011;2011;10;20;Sunnuntai;29;18;47;18;30;48
89;09.10.2011;2011;10;21;Sunnuntai;12;11;23;9;15;24
89;09.10.2011;2011;10;22;Sunnuntai;9;6;15;0;0;0
89;09.10.2011;2011;10;23;Sunnuntai;6;7;13;0;3;3
89;10.10.2011;2011;10;00;Maanantai;4;2;6;0;0;0
89;10.10.2011;2011;10;01;Maanantai;2;1;3;0;0;0
89;10.10.2011;2011;10;02;Maanantai;1;1;2;0;0;0
89;10.10.2011;2011;10;03;Maanantai;3;2;5;0;0;0
89;10.10.2011;2011;10;04;Maanantai;2;4;6;0;0;0
89;10.10.2011;2011;10;05;Maanantai;4;8;12;0;2;2
89;10.10.2011;2011;10;06;Maanantai;25;61;86;10;4;14
89;10.10.2011;2011;10;07;Maanantai;79;241;320;33;17;50
89;10.10.2011;2011;10;08;Maanantai;66;132;198;10;20;30
89;10.10.2011;2011;10;09;Maanantai;52;90;142;12;7;19
89;10.10.2011;2011;10;10;Maanantai;36;50;86;16;24;40
89;10.10.2011;2011;10;11;Maanantai;62;72;134;14;17;31
89;10.10.2011;2011;10;12;Maanantai;53;71;124;10;10;20
89;10.10.2011;2011;10;13;Maanantai;86;47;133;14;16;30
89;10.10.2011;2011;10;14;Maanantai;121;77;198;23;22;45
89;10.10.2011;2011;10;15;Maanantai;224;78;302;12;61;73
89;10.10.2011;2011;10;16;Maanantai;185;85;270;16;50;66
89;10.10.2011;2011;10;17;Maanantai;117;76;193;12;33;45
89;10.10.2011;2011;10;18;Maanantai;110;69;179;39;20;59
89;10.10.2011;2011;10;19;Maanantai;85;40;125;25;36;61
89;10.10.2011;2011;10;20;Maanantai;66;36;102;14;27;41
89;10.10.2011;2011;10;21;Maanantai;28;11;39;10;10;20
89;10.10.2011;2011;10;22;Maanantai;14;8;22;2;19;21
89;10.10.2011;2011;10;23;Maanantai;6;2;8;2;0;2
89;11.10.2011;2011;10;00;Tiistai;1;1;2;0;0;0
89;11.10.2011;2011;10;01;Tiistai;1;3;4;0;0;0
89;11.10.2011;2011;10;02;Tiistai;1;2;3;2;0;2
89;11.10.2011;2011;10;03;Tiistai;0;1;1;0;2;2
89;11.10.2011;2011;10;04;Tiistai;3;5;8;0;0;0
89;11.10.2011;2011;10;05;Tiistai;4;6;10;2;0;2
89;11.10.2011;2011;10;06;Tiistai;38;77;115;7;7;14
89;11.10.2011;2011;10;07;Tiistai;78;278;356;48;9;57
89;11.10.2011;2011;10;08;Tiistai;71;154;225;21;12;33
89;11.10.2011;2011;10;09;Tiistai;69;110;179;34;17;51
89;11.10.2011;2011;10;10;Tiistai;55;101;156;14;22;36
89;11.10.2011;2011;10;11;Tiistai;75;95;170;16;23;39
89;11.10.2011;2011;10;12;Tiistai;83;91;174;19;41;60
89;11.10.2011;2011;10;13;Tiistai;122;84;206;22;27;49
89;11.10.2011;2011;10;14;Tiistai;164;107;271;23;27;50
89;11.10.2011;2011;10;15;Tiistai;209;103;312;11;68;79
89;11.10.2011;2011;10;16;Tiistai;207;118;325;30;51;81
89;11.10.2011;2011;10;17;Tiistai;161;99;260;52;60;112
89;11.10.2011;2011;10;18;Tiistai;81;84;165;43;55;98
89;11.10.2011;2011;10;19;Tiistai;64;36;100;37;46;83
89;11.10.2011;2011;10;20;Tiistai;110;33;143;41;34;75
89;11.10.2011;2011;10;21;Tiistai;40;23;63;27;37;64
89;11.10.2011;2011;10;22;Tiistai;14;8;22;2;9;11
89;11.10.2011;2011;10;23;Tiistai;6;3;9;0;0;0
89;12.10.2011;2011;10;00;Keskiviikko;7;4;11;0;0;0
89;12.10.2011;2011;10;01;Keskiviikko;2;3;5;0;0;0
89;12.10.2011;2011;10;02;Keskiviikko;1;2;3;0;0;0
89;12.10.2011;2011;10;03;Keskiviikko;4;3;7;0;0;0
89;12.10.2011;2011;10;04;Keskiviikko;3;5;8;0;0;0
89;12.10.2011;2011;10;05;Keskiviikko;7;13;20;2;0;2
89;12.10.2011;2011;10;06;Keskiviikko;25;83;108;8;2;10
89;12.10.2011;2011;10;07;Keskiviikko;87;250;337;53;9;62
89;12.10.2011;2011;10;08;Keskiviikko;68;169;237;29;19;48
89;12.10.2011;2011;10;09;Keskiviikko;60;109;169;19;6;25
89;12.10.2011;2011;10;10;Keskiviikko;51;63;114;8;19;27
89;12.10.2011;2011;10;11;Keskiviikko;64;73;137;12;33;45
89;12.10.2011;2011;10;12;Keskiviikko;70;83;153;19;13;32
89;12.10.2011;2011;10;13;Keskiviikko;110;80;190;35;13;48
89;12.10.2011;2011;10;14;Keskiviikko;136;80;216;18;38;56
89;12.10.2011;2011;10;15;Keskiviikko;179;87;266;23;66;89
89;12.10.2011;2011;10;16;Keskiviikko;203;108;311;16;78;94
89;12.10.2011;2011;10;17;Keskiviikko;123;90;213;10;34;44
89;12.10.2011;2011;10;18;Keskiviikko;103;61;164;44;22;66
89;12.10.2011;2011;10;19;Keskiviikko;86;34;120;23;44;67
89;12.10.2011;2011;10;20;Keskiviikko;76;31;107;25;27;52
89;12.10.2011;2011;10;21;Keskiviikko;44;22;66;12;11;23
89;12.10.2011;2011;10;22;Keskiviikko;14;16;30;8;8;16
89;12.10.2011;2011;10;23;Keskiviikko;10;17;27;2;0;2
89;13.10.2011;2011;10;00;Torstai;9;13;22;0;0;0
89;13.10.2011;2011;10;01;Torstai;4;3;7;0;0;0
89;13.10.2011;2011;10;02;Torstai;7;0;7;0;0;0
89;13.10.2011;2011;10;03;Torstai;7;5;12;0;0;0
89;13.10.2011;2011;10;04;Torstai;10;5;15;2;0;2
89;13.10.2011;2011;10;05;Torstai;7;18;25;2;0;2
89;13.10.2011;2011;10;06;Torstai;28;93;121;4;4;8
89;13.10.2011;2011;10;07;Torstai;77;304;381;56;27;83
89;13.10.2011;2011;10;08;Torstai;68;184;252;30;9;39
89;13.10.2011;2011;10;09;Torstai;90;163;253;13;18;31
89;13.10.2011;2011;10;10;Torstai;73;115;188;17;46;63
89;13.10.2011;2011;10;11;Torstai;103;122;225;28;32;60
89;13.10.2011;2011;10;12;Torstai;115;99;214;28;41;69
89;13.10.2011;2011;10;13;Torstai;139;92;231;16;38;54
89;13.10.2011;2011;10;14;Torstai;148;96;244;30;14;44
89;13.10.2011;2011;10;15;Torstai;240;74;314;18;44;62
89;13.10.2011;2011;10;16;Torstai;195;59;254;21;57;78
89;13.10.2011;2011;10;17;Torstai;121;66;187;20;30;50
89;13.10.2011;2011;10;18;Torstai;89;43;132;21;43;64
89;13.10.2011;2011;10;19;Torstai;64;39;103;22;19;41
89;13.10.2011;2011;10;20;Torstai;61;25;86;33;21;54
89;13.10.2011;2011;10;21;Torstai;39;14;53;4;21;25
89;13.10.2011;2011;10;22;Torstai;13;12;25;0;0;0
89;13.10.2011;2011;10;23;Torstai;11;10;21;0;2;2
89;14.10.2011;2011;10;00;Perjantai;0;0;0;3;2;5
89;14.10.2011;2011;10;01;Perjantai;0;0;0;0;0;0
89;14.10.2011;2011;10;02;Perjantai;0;0;0;0;0;0
89;14.10.2011;2011;10;03;Perjantai;0;0;0;0;0;0
89;14.10.2011;2011;10;04;Perjantai;0;0;0;3;0;3
89;14.10.2011;2011;10;05;Perjantai;4;10;14;1;1;2
89;14.10.2011;2011;10;06;Perjantai;21;65;86;3;6;9
89;14.10.2011;2011;10;07;Perjantai;49;218;267;1;31;32
89;14.10.2011;2011;10;08;Perjantai;77;206;283;16;31;47
89;14.10.2011;2011;10;09;Perjantai;48;134;182;9;25;34
89;14.10.2011;2011;10;10;Perjantai;31;80;111;8;37;45
89;14.10.2011;2011;10;11;Perjantai;77;85;162;14;31;45
89;14.10.2011;2011;10;12;Perjantai;94;99;193;22;30;52
89;14.10.2011;2011;10;13;Perjantai;102;126;228;28;34;62
89;14.10.2011;2011;10;14;Perjantai;185;117;302;23;31;54
89;14.10.2011;2011;10;15;Perjantai;186;99;285;27;20;47
89;14.10.2011;2011;10;16;Perjantai;173;105;278;33;39;72
89;14.10.2011;2011;10;17;Perjantai;124;87;211;27;44;71
89;14.10.2011;2011;10;18;Perjantai;78;82;160;21;20;41
89;14.10.2011;2011;10;19;Perjantai;53;40;93;18;13;31
89;14.10.2011;2011;10;20;Perjantai;61;44;105;8;15;23
89;14.10.2011;2011;10;21;Perjantai;31;19;50;14;18;32
89;14.10.2011;2011;10;22;Perjantai;23;20;43;7;9;16
89;14.10.2011;2011;10;23;Perjantai;21;28;49;5;9;14
89;15.10.2011;2011;10;00;Lauantai;19;15;34;2;3;5
89;15.10.2011;2011;10;01;Lauantai;18;6;24;5;3;8
89;15.10.2011;2011;10;02;Lauantai;15;19;34;4;1;5
89;15.10.2011;2011;10;03;Lauantai;12;3;15;6;0;6
89;15.10.2011;2011;10;04;Lauantai;21;4;25;7;0;7
89;15.10.2011;2011;10;05;Lauantai;3;5;8;0;2;2
89;15.10.2011;2011;10;06;Lauantai;3;8;11;1;1;2
89;15.10.2011;2011;10;07;Lauantai;10;26;36;4;8;12
89;15.10.2011;2011;10;08;Lauantai;24;40;64;7;16;23
89;15.10.2011;2011;10;09;Lauantai;23;59;82;27;37;64
89;15.10.2011;2011;10;10;Lauantai;21;61;82;17;42;59
89;15.10.2011;2011;10;11;Lauantai;48;93;141;20;35;55
89;15.10.2011;2011;10;12;Lauantai;75;110;185;27;51;78
89;15.10.2011;2011;10;13;Lauantai;97;104;201;43;49;92
89;15.10.2011;2011;10;14;Lauantai;100;72;172;38;54;92
89;15.10.2011;2011;10;15;Lauantai;101;69;170;29;27;56
89;15.10.2011;2011;10;16;Lauantai;97;64;161;34;44;78
89;15.10.2011;2011;10;17;Lauantai;75;64;139;40;27;67
89;15.10.2011;2011;10;18;Lauantai;66;54;120;24;21;45
89;15.10.2011;2011;10;19;Lauantai;35;47;82;19;14;33
89;15.10.2011;2011;10;20;Lauantai;39;37;76;7;17;24
89;15.10.2011;2011;10;21;Lauantai;39;24;63;5;6;11
89;15.10.2011;2011;10;22;Lauantai;21;48;69;6;5;11
89;15.10.2011;2011;10;23;Lauantai;22;22;44;8;8;16
89;16.10.2011;2011;10;00;Sunnuntai;10;25;35;6;6;12
89;16.10.2011;2011;10;01;Sunnuntai;24;11;35;9;4;13
89;16.10.2011;2011;10;02;Sunnuntai;22;9;31;10;2;12
89;16.10.2011;2011;10;03;Sunnuntai;37;6;43;7;1;8
89;16.10.2011;2011;10;04;Sunnuntai;22;2;24;12;0;12
89;16.10.2011;2011;10;05;Sunnuntai;6;4;10;1;1;2
89;16.10.2011;2011;10;06;Sunnuntai;1;6;7;1;2;3
89;16.10.2011;2011;10;07;Sunnuntai;6;6;12;1;3;4
89;16.10.2011;2011;10;08;Sunnuntai;11;14;25;9;9;18
89;16.10.2011;2011;10;09;Sunnuntai;17;28;45;26;37;63
89;16.10.2011;2011;10;10;Sunnuntai;22;77;99;24;55;79
89;16.10.2011;2011;10;11;Sunnuntai;42;71;113;44;66;110
89;16.10.2011;2011;10;12;Sunnuntai;79;103;182;54;70;124
89;16.10.2011;2011;10;13;Sunnuntai;86;95;181;47;51;98
89;16.10.2011;2011;10;14;Sunnuntai;107;92;199;35;42;77
89;16.10.2011;2011;10;15;Sunnuntai;78;90;168;39;55;94
89;16.10.2011;2011;10;16;Sunnuntai;96;95;191;50;57;107
89;16.10.2011;2011;10;17;Sunnuntai;97;64;161;44;64;108
89;16.10.2011;2011;10;18;Sunnuntai;77;32;109;26;33;59
89;16.10.2011;2011;10;19;Sunnuntai;38;32;70;22;25;47
89;16.10.2011;2011;10;20;Sunnuntai;27;34;61;21;16;37
89;16.10.2011;2011;10;21;Sunnuntai;32;17;49;6;10;16
89;16.10.2011;2011;10;22;Sunnuntai;17;11;28;1;0;1
89;16.10.2011;2011;10;23;Sunnuntai;13;8;21;1;1;2
89;17.10.2011;2011;10;00;Maanantai;5;4;9;1;0;1
89;17.10.2011;2011;10;01;Maanantai;1;3;4;2;1;3
89;17.10.2011;2011;10;02;Maanantai;1;2;3;1;1;2
89;17.10.2011;2011;10;03;Maanantai;4;2;6;0;0;0
89;17.10.2011;2011;10;04;Maanantai;3;4;7;2;0;2
89;17.10.2011;2011;10;05;Maanantai;0;13;13;0;1;1
89;17.10.2011;2011;10;06;Maanantai;22;64;86;1;5;6
89;17.10.2011;2011;10;07;Maanantai;63;218;281;5;22;27
89;17.10.2011;2011;10;08;Maanantai;88;226;314;17;49;66
89;17.10.2011;2011;10;09;Maanantai;48;147;195;14;25;39
89;17.10.2011;2011;10;10;Maanantai;65;87;152;15;31;46
89;17.10.2011;2011;10;11;Maanantai;77;101;178;20;33;53
89;17.10.2011;2011;10;12;Maanantai;85;85;170;24;25;49
89;17.10.2011;2011;10;13;Maanantai;115;100;215;23;46;69
89;17.10.2011;2011;10;14;Maanantai;167;108;275;22;24;46
89;17.10.2011;2011;10;15;Maanantai;205;110;315;46;19;65
89;17.10.2011;2011;10;16;Maanantai;254;126;380;42;20;62
89;17.10.2011;2011;10;17;Maanantai;152;100;252;32;32;64
89;17.10.2011;2011;10;18;Maanantai;108;84;192;37;34;71
89;17.10.2011;2011;10;19;Maanantai;86;51;137;31;36;67
89;17.10.2011;2011;10;20;Maanantai;64;26;90;28;18;46
89;17.10.2011;2011;10;21;Maanantai;38;21;59;11;17;28
89;17.10.2011;2011;10;22;Maanantai;17;10;27;1;4;5
89;17.10.2011;2011;10;23;Maanantai;6;4;10;2;3;5
89;18.10.2011;2011;10;00;Tiistai;1;4;5;2;3;5
89;18.10.2011;2011;10;01;Tiistai;1;0;1;0;1;1
89;18.10.2011;2011;10;02;Tiistai;2;0;2;1;0;1
89;18.10.2011;2011;10;03;Tiistai;0;0;0;0;1;1
89;18.10.2011;2011;10;04;Tiistai;4;7;11;0;0;0
89;18.10.2011;2011;10;05;Tiistai;5;11;16;1;1;2
89;18.10.2011;2011;10;06;Tiistai;25;71;96;4;9;13
89;18.10.2011;2011;10;07;Tiistai;52;249;301;2;31;33
89;18.10.2011;2011;10;08;Tiistai;87;219;306;20;41;61
89;18.10.2011;2011;10;09;Tiistai;63;127;190;10;28;38
89;18.10.2011;2011;10;10;Tiistai;65;85;150;19;36;55
89;18.10.2011;2011;10;11;Tiistai;83;86;169;14;22;36
89;18.10.2011;2011;10;12;Tiistai;94;104;198;20;25;45
89;18.10.2011;2011;10;13;Tiistai;92;94;186;25;19;44
89;18.10.2011;2011;10;14;Tiistai;137;118;255;21;19;40
89;18.10.2011;2011;10;15;Tiistai;253;113;366;32;17;49
89;18.10.2011;2011;10;16;Tiistai;246;131;377;24;24;48
89;18.10.2011;2011;10;17;Tiistai;142;113;255;27;34;61
89;18.10.2011;2011;10;18;Tiistai;87;89;176;45;29;74
89;18.10.2011;2011;10;19;Tiistai;84;37;121;28;35;63
89;18.10.2011;2011;10;20;Tiistai;72;38;110;29;23;52
89;18.10.2011;2011;10;21;Tiistai;65;22;87;16;10;26
89;18.10.2011;2011;10;22;Tiistai;17;10;27;2;3;5
89;18.10.2011;2011;10;23;Tiistai;12;10;22;2;3;5
89;19.10.2011;2011;10;00;Keskiviikko;5;2;7;1;0;1
89;19.10.2011;2011;10;01;Keskiviikko;8;3;11;2;0;2
89;19.10.2011;2011;10;02;Keskiviikko;1;2;3;0;0;0
89;19.10.2011;2011;10;03;Keskiviikko;0;1;1;0;1;1
89;19.10.2011;2011;10;04;Keskiviikko;1;3;4;1;0;1
89;19.10.2011;2011;10;05;Keskiviikko;1;7;8;1;2;3
89;19.10.2011;2011;10;06;Keskiviikko;21;58;79;3;2;5
89;19.10.2011;2011;10;07;Keskiviikko;42;196;238;4;24;28
89;19.10.2011;2011;10;08;Keskiviikko;70;212;282;12;39;51
89;19.10.2011;2011;10;09;Keskiviikko;39;90;129;9;26;35
89;19.10.2011;2011;10;10;Keskiviikko;46;86;132;11;17;28
89;19.10.2011;2011;10;11;Keskiviikko;71;84;155;21;25;46
89;19.10.2011;2011;10;12;Keskiviikko;57;105;162;26;31;57
89;19.10.2011;2011;10;13;Keskiviikko;92;67;159;34;34;68
89;19.10.2011;2011;10;14;Keskiviikko;133;91;224;34;21;55
89;19.10.2011;2011;10;15;Keskiviikko;145;121;266;42;29;71
89;19.10.2011;2011;10;16;Keskiviikko;195;115;310;31;19;50
89;19.10.2011;2011;10;17;Keskiviikko;139;99;238;26;30;56
89;19.10.2011;2011;10;18;Keskiviikko;110;68;178;41;20;61
89;19.10.2011;2011;10;19;Keskiviikko;87;44;131;23;30;53
89;19.10.2011;2011;10;20;Keskiviikko;76;43;119;16;25;41
89;19.10.2011;2011;10;21;Keskiviikko;51;29;80;7;8;15
89;19.10.2011;2011;10;22;Keskiviikko;21;17;38;4;4;8
89;19.10.2011;2011;10;23;Keskiviikko;10;5;15;0;1;1
89;20.10.2011;2011;10;00;Torstai;6;3;9;0;0;0
89;20.10.2011;2011;10;01;Torstai;9;1;10;2;1;3
89;20.10.2011;2011;10;02;Torstai;0;4;4;1;0;1
89;20.10.2011;2011;10;03;Torstai;6;3;9;2;0;2
89;20.10.2011;2011;10;04;Torstai;6;4;10;1;0;1
89;20.10.2011;2011;10;05;Torstai;4;10;14;0;1;1
89;20.10.2011;2011;10;06;Torstai;22;50;72;3;7;10
89;20.10.2011;2011;10;07;Torstai;55;207;262;3;26;29
89;20.10.2011;2011;10;08;Torstai;81;187;268;8;33;41
89;20.10.2011;2011;10;09;Torstai;52;114;166;20;32;52
89;20.10.2011;2011;10;10;Torstai;41;101;142;14;18;32
89;20.10.2011;2011;10;11;Torstai;70;91;161;22;33;55
89;20.10.2011;2011;10;12;Torstai;83;79;162;20;25;45
89;20.10.2011;2011;10;13;Torstai;101;93;194;13;17;30
89;20.10.2011;2011;10;14;Torstai;119;86;205;25;19;44
89;20.10.2011;2011;10;15;Torstai;195;115;310;24;19;43
89;20.10.2011;2011;10;16;Torstai;206;100;306;30;28;58
89;20.10.2011;2011;10;17;Torstai;116;118;234;41;36;77
89;20.10.2011;2011;10;18;Torstai;112;85;197;23;18;41
89;20.10.2011;2011;10;19;Torstai;88;56;144;28;25;53
89;20.10.2011;2011;10;20;Torstai;101;39;140;9;10;19
89;20.10.2011;2011;10;21;Torstai;50;26;76;6;20;26
89;20.10.2011;2011;10;22;Torstai;23;11;34;6;1;7
89;20.10.2011;2011;10;23;Torstai;12;5;17;3;0;3
89;21.10.2011;2011;10;00;Perjantai;5;4;9;2;0;2
89;21.10.2011;2011;10;01;Perjantai;8;0;8;0;0;0
89;21.10.2011;2011;10;02;Perjantai;9;2;11;0;0;0
89;21.10.2011;2011;10;03;Perjantai;3;7;10;0;0;0
89;21.10.2011;2011;10;04;Perjantai;5;3;8;1;2;3
89;21.10.2011;2011;10;05;Perjantai;4;14;18;1;0;1
89;21.10.2011;2011;10;06;Perjantai;27;64;91;2;5;7
89;21.10.2011;2011;10;07;Perjantai;45;196;241;3;32;35
89;21.10.2011;2011;10;08;Perjantai;69;184;253;6;21;27
89;21.10.2011;2011;10;09;Perjantai;53;129;182;16;15;31
89;21.10.2011;2011;10;10;Perjantai;49;80;129;14;26;40
89;21.10.2011;2011;10;11;Perjantai;67;109;176;16;31;47
89;21.10.2011;2011;10;12;Perjantai;99;97;196;25;38;63
89;21.10.2011;2011;10;13;Perjantai;133;111;244;26;27;53
89;21.10.2011;2011;10;14;Perjantai;154;139;293;20;16;36
89;21.10.2011;2011;10;15;Perjantai;196;107;303;29;27;56
89;21.10.2011;2011;10;16;Perjantai;184;86;270;33;33;66
89;21.10.2011;2011;10;17;Perjantai;127;101;228;28;19;47
89;21.10.2011;2011;10;18;Perjantai;81;75;156;15;27;42
89;21.10.2011;2011;10;19;Perjantai;59;43;102;22;24;46
89;21.10.2011;2011;10;20;Perjantai;58;48;106;11;18;29
89;21.10.2011;2011;10;21;Perjantai;49;26;75;8;8;16
89;21.10.2011;2011;10;22;Perjantai;34;28;62;5;8;13
89;21.10.2011;2011;10;23;Perjantai;25;40;65;9;7;16
89;22.10.2011;2011;10;00;Lauantai;13;13;26;8;5;13
89;22.10.2011;2011;10;01;Lauantai;16;14;30;3;3;6
89;22.10.2011;2011;10;02;Lauantai;16;3;19;5;2;7
89;22.10.2011;2011;10;03;Lauantai;20;6;26;7;0;7
89;22.10.2011;2011;10;04;Lauantai;25;4;29;12;3;15
89;22.10.2011;2011;10;05;Lauantai;4;7;11;3;0;3
89;22.10.2011;2011;10;06;Lauantai;6;19;25;4;3;7
89;22.10.2011;2011;10;07;Lauantai;6;9;15;1;4;5
89;22.10.2011;2011;10;08;Lauantai;3;39;42;9;15;24
89;22.10.2011;2011;10;09;Lauantai;14;50;64;7;22;29
89;22.10.2011;2011;10;10;Lauantai;29;76;105;21;45;66
89;22.10.2011;2011;10;11;Lauantai;40;75;115;20;42;62
89;22.10.2011;2011;10;12;Lauantai;56;85;141;25;37;62
89;22.10.2011;2011;10;13;Lauantai;103;58;161;32;37;69
89;22.10.2011;2011;10;14;Lauantai;65;62;127;23;27;50
89;22.10.2011;2011;10;15;Lauantai;79;47;126;9;18;27
89;22.10.2011;2011;10;16;Lauantai;51;42;93;14;13;27
89;22.10.2011;2011;10;17;Lauantai;64;62;126;19;17;36
89;22.10.2011;2011;10;18;Lauantai;57;47;104;25;25;50
89;22.10.2011;2011;10;19;Lauantai;35;26;61;19;18;37
89;22.10.2011;2011;10;20;Lauantai;22;43;65;6;8;14
89;22.10.2011;2011;10;21;Lauantai;21;25;46;7;1;8
89;22.10.2011;2011;10;22;Lauantai;17;22;39;5;7;12
89;22.10.2011;2011;10;23;Lauantai;20;20;40;5;5;10
89;23.10.2011;2011;10;00;Sunnuntai;14;6;20;2;1;3
89;23.10.2011;2011;10;01;Sunnuntai;19;15;34;4;3;7
89;23.10.2011;2011;10;02;Sunnuntai;23;3;26;5;2;7
89;23.10.2011;2011;10;03;Sunnuntai;16;1;17;10;2;12
89;23.10.2011;2011;10;04;Sunnuntai;13;1;14;11;0;11
89;23.10.2011;2011;10;05;Sunnuntai;3;0;3;5;1;6
89;23.10.2011;2011;10;06;Sunnuntai;2;10;12;2;2;4
89;23.10.2011;2011;10;07;Sunnuntai;6;8;14;2;3;5
89;23.10.2011;2011;10;08;Sunnuntai;3;30;33;9;5;14
89;23.10.2011;2011;10;09;Sunnuntai;9;15;24;19;27;46
89;23.10.2011;2011;10;10;Sunnuntai;9;35;44;27;39;66
89;23.10.2011;2011;10;11;Sunnuntai;16;45;61;37;63;100
89;23.10.2011;2011;10;12;Sunnuntai;34;52;86;46;57;103
89;23.10.2011;2011;10;13;Sunnuntai;32;60;92;32;53;85
89;23.10.2011;2011;10;14;Sunnuntai;68;41;109;47;33;80
89;23.10.2011;2011;10;15;Sunnuntai;45;46;91;32;39;71
89;23.10.2011;2011;10;16;Sunnuntai;54;47;101;34;34;68
89;23.10.2011;2011;10;17;Sunnuntai;53;47;100;26;21;47
89;23.10.2011;2011;10;18;Sunnuntai;54;30;84;32;23;55
89;23.10.2011;2011;10;19;Sunnuntai;28;22;50;22;25;47
89;23.10.2011;2011;10;20;Sunnuntai;28;26;54;9;11;20
89;23.10.2011;2011;10;21;Sunnuntai;26;10;36;6;3;9
89;23.10.2011;2011;10;22;Sunnuntai;8;11;19;1;1;2
89;23.10.2011;2011;10;23;Sunnuntai;7;4;11;1;1;2
89;24.10.2011;2011;10;00;Maanantai;4;2;6;2;1;3
89;24.10.2011;2011;10;01;Maanantai;2;3;5;0;0;0
89;24.10.2011;2011;10;02;Maanantai;3;2;5;1;2;3
89;24.10.2011;2011;10;03;Maanantai;4;3;7;2;0;2
89;24.10.2011;2011;10;04;Maanantai;0;4;4;1;0;1
89;24.10.2011;2011;10;05;Maanantai;3;15;18;0;1;1
89;24.10.2011;2011;10;06;Maanantai;14;55;69;3;7;10
89;24.10.2011;2011;10;07;Maanantai;38;130;168;2;16;18
89;24.10.2011;2011;10;08;Maanantai;44;139;183;8;21;29
89;24.10.2011;2011;10;09;Maanantai;37;85;122;10;27;37
89;24.10.2011;2011;10;10;Maanantai;29;77;106;15;21;36
89;24.10.2011;2011;10;11;Maanantai;68;72;140;11;29;40
89;24.10.2011;2011;10;12;Maanantai;59;84;143;23;27;50
89;24.10.2011;2011;10;13;Maanantai;75;71;146;25;30;55
89;24.10.2011;2011;10;14;Maanantai;99;98;197;28;22;50
89;24.10.2011;2011;10;15;Maanantai;159;83;242;30;23;53
89;24.10.2011;2011;10;16;Maanantai;182;88;270;39;19;58
89;24.10.2011;2011;10;17;Maanantai;122;67;189;28;33;61
89;24.10.2011;2011;10;18;Maanantai;82;56;138;29;40;69
89;24.10.2011;2011;10;19;Maanantai;49;30;79;30;26;56
89;24.10.2011;2011;10;20;Maanantai;40;22;62;18;21;39
89;24.10.2011;2011;10;21;Maanantai;33;22;55;7;9;16
89;24.10.2011;2011;10;22;Maanantai;16;11;27;6;5;11
89;24.10.2011;2011;10;23;Maanantai;5;5;10;3;4;7
89;25.10.2011;2011;10;00;Tiistai;3;5;8;3;0;3
89;25.10.2011;2011;10;01;Tiistai;4;0;4;0;0;0
89;25.10.2011;2011;10;02;Tiistai;3;1;4;0;0;0
89;25.10.2011;2011;10;03;Tiistai;1;2;3;2;0;2
89;25.10.2011;2011;10;04;Tiistai;3;6;9;1;0;1
89;25.10.2011;2011;10;05;Tiistai;1;12;13;2;0;2
89;25.10.2011;2011;10;06;Tiistai;17;57;74;4;4;8
89;25.10.2011;2011;10;07;Tiistai;44;148;192;2;26;28
89;25.10.2011;2011;10;08;Tiistai;38;147;185;12;21;33
89;25.10.2011;2011;10;09;Tiistai;28;78;106;16;26;42
89;25.10.2011;2011;10;10;Tiistai;40;87;127;17;27;44
89;25.10.2011;2011;10;11;Tiistai;58;86;144;18;29;47
89;25.10.2011;2011;10;12;Tiistai;59;102;161;21;27;48
89;25.10.2011;2011;10;13;Tiistai;71;80;151;17;27;44
89;25.10.2011;2011;10;14;Tiistai;104;83;187;23;22;45
89;25.10.2011;2011;10;15;Tiistai;159;74;233;37;12;49
89;25.10.2011;2011;10;16;Tiistai;166;92;258;27;27;54
89;25.10.2011;2011;10;17;Tiistai;118;82;200;31;33;64
89;25.10.2011;2011;10;18;Tiistai;72;65;137;22;31;53
89;25.10.2011;2011;10;19;Tiistai;59;40;99;29;31;60
89;25.10.2011;2011;10;20;Tiistai;63;20;83;23;22;45
89;25.10.2011;2011;10;21;Tiistai;41;18;59;12;7;19
89;25.10.2011;2011;10;22;Tiistai;19;13;32;6;6;12
89;25.10.2011;2011;10;23;Tiistai;10;2;12;2;2;4
89;26.10.2011;2011;10;00;Keskiviikko;5;4;9;0;1;1
89;26.10.2011;2011;10;01;Keskiviikko;9;0;9;2;1;3
89;26.10.2011;2011;10;02;Keskiviikko;1;2;3;0;0;0
89;26.10.2011;2011;10;03;Keskiviikko;7;3;10;1;0;1
89;26.10.2011;2011;10;04;Keskiviikko;4;6;10;0;0;0
89;26.10.2011;2011;10;05;Keskiviikko;5;13;18;0;1;1
89;26.10.2011;2011;10;06;Keskiviikko;13;52;65;3;6;9
89;26.10.2011;2011;10;07;Keskiviikko;33;141;174;4;11;15
89;26.10.2011;2011;10;08;Keskiviikko;36;143;179;7;18;25
89;26.10.2011;2011;10;09;Keskiviikko;36;80;116;14;42;56
89;26.10.2011;2011;10;10;Keskiviikko;27;77;104;16;28;44
89;26.10.2011;2011;10;11;Keskiviikko;69;86;155;43;36;79
89;26.10.2011;2011;10;12;Keskiviikko;67;103;170;21;37;58
89;26.10.2011;2011;10;13;Keskiviikko;82;66;148;19;20;39
89;26.10.2011;2011;10;14;Keskiviikko;90;72;162;21;22;43
89;26.10.2011;2011;10;15;Keskiviikko;145;75;220;28;14;42
89;26.10.2011;2011;10;16;Keskiviikko;196;84;280;25;17;42
89;26.10.2011;2011;10;17;Keskiviikko;115;71;186;20;14;34
89;26.10.2011;2011;10;18;Keskiviikko;77;46;123;23;22;45
89;26.10.2011;2011;10;19;Keskiviikko;62;47;109;13;27;40
89;26.10.2011;2011;10;20;Keskiviikko;54;36;90;24;18;42
89;26.10.2011;2011;10;21;Keskiviikko;38;23;61;19;13;32
89;26.10.2011;2011;10;22;Keskiviikko;22;15;37;3;5;8
89;26.10.2011;2011;10;23;Keskiviikko;12;20;32;1;3;4
89;27.10.2011;2011;10;00;Torstai;2;6;8;0;4;4
89;27.10.2011;2011;10;01;Torstai;14;4;18;2;1;3
89;27.10.2011;2011;10;02;Torstai;4;2;6;1;0;1
89;27.10.2011;2011;10;03;Torstai;5;4;9;2;0;2
89;27.10.2011;2011;10;04;Torstai;2;2;4;1;0;1
89;27.10.2011;2011;10;05;Torstai;1;11;12;0;0;0
89;27.10.2011;2011;10;06;Torstai;18;49;67;2;7;9
89;27.10.2011;2011;10;07;Torstai;37;126;163;3;18;21
89;27.10.2011;2011;10;08;Torstai;34;135;169;9;25;34
89;27.10.2011;2011;10;09;Torstai;41;82;123;10;28;38
89;27.10.2011;2011;10;10;Torstai;37;60;97;12;24;36
89;27.10.2011;2011;10;11;Torstai;54;83;137;24;30;54
89;27.10.2011;2011;10;12;Torstai;55;69;124;17;22;39
89;27.10.2011;2011;10;13;Torstai;92;86;178;14;29;43
89;27.10.2011;2011;10;14;Torstai;92;85;177;16;18;34
89;27.10.2011;2011;10;15;Torstai;149;85;234;28;18;46
89;27.10.2011;2011;10;16;Torstai;153;79;232;33;23;56
89;27.10.2011;2011;10;17;Torstai;124;79;203;19;27;46
89;27.10.2011;2011;10;18;Torstai;69;68;137;31;39;70
89;27.10.2011;2011;10;19;Torstai;61;48;109;27;24;51
89;27.10.2011;2011;10;20;Torstai;68;40;108;16;18;34
89;27.10.2011;2011;10;21;Torstai;38;17;55;14;5;19
89;27.10.2011;2011;10;22;Torstai;25;15;40;2;5;7
89;27.10.2011;2011;10;23;Torstai;13;12;25;3;6;9
89;28.10.2011;2011;10;00;Perjantai;18;5;23;3;2;5
89;28.10.2011;2011;10;01;Perjantai;8;9;17;0;0;0
89;28.10.2011;2011;10;02;Perjantai;6;1;7;2;1;3
89;28.10.2011;2011;10;03;Perjantai;7;5;12;2;0;2
89;28.10.2011;2011;10;04;Perjantai;3;3;6;0;1;1
89;28.10.2011;2011;10;05;Perjantai;2;12;14;0;2;2
89;28.10.2011;2011;10;06;Perjantai;17;50;67;4;4;8
89;28.10.2011;2011;10;07;Perjantai;32;115;147;5;19;24
89;28.10.2011;2011;10;08;Perjantai;31;123;154;5;25;30
89;28.10.2011;2011;10;09;Perjantai;34;68;102;16;24;40
89;28.10.2011;2011;10;10;Perjantai;42;66;108;19;26;45
89;28.10.2011;2011;10;11;Perjantai;61;99;160;21;20;41
89;28.10.2011;2011;10;12;Perjantai;62;96;158;11;39;50
89;28.10.2011;2011;10;13;Perjantai;92;89;181;31;16;47
89;28.10.2011;2011;10;14;Perjantai;103;73;176;25;19;44
89;28.10.2011;2011;10;15;Perjantai;140;67;207;21;24;45
89;28.10.2011;2011;10;16;Perjantai;108;79;187;29;24;53
89;28.10.2011;2011;10;17;Perjantai;100;71;171;29;22;51
89;28.10.2011;2011;10;18;Perjantai;54;41;95;16;19;35
89;28.10.2011;2011;10;19;Perjantai;39;24;63;12;11;23
89;28.10.2011;2011;10;20;Perjantai;37;32;69;5;7;12
89;28.10.2011;2011;10;21;Perjantai;32;23;55;5;6;11
89;28.10.2011;2011;10;22;Perjantai;20;10;30;3;10;13
89;28.10.2011;2011;10;23;Perjantai;11;19;30;3;7;10
89;29.10.2011;2011;10;00;Lauantai;7;15;22;5;2;7
89;29.10.2011;2011;10;01;Lauantai;14;6;20;2;0;2
89;29.10.2011;2011;10;02;Lauantai;19;4;23;8;1;9
89;29.10.2011;2011;10;03;Lauantai;13;2;15;2;0;2
89;29.10.2011;2011;10;04;Lauantai;13;1;14;3;1;4
89;29.10.2011;2011;10;05;Lauantai;0;9;9;0;1;1
89;29.10.2011;2011;10;06;Lauantai;6;12;18;3;3;6
89;29.10.2011;2011;10;07;Lauantai;5;18;23;3;6;9
89;29.10.2011;2011;10;08;Lauantai;8;23;31;6;9;15
89;29.10.2011;2011;10;09;Lauantai;20;44;64;16;30;46
89;29.10.2011;2011;10;10;Lauantai;27;75;102;18;36;54
89;29.10.2011;2011;10;11;Lauantai;51;79;130;20;28;48
89;29.10.2011;2011;10;12;Lauantai;55;77;132;30;51;81
89;29.10.2011;2011;10;13;Lauantai;60;67;127;33;45;78
89;29.10.2011;2011;10;14;Lauantai;86;82;168;27;37;64
89;29.10.2011;2011;10;15;Lauantai;91;57;148;25;37;62
89;29.10.2011;2011;10;16;Lauantai;88;50;138;32;27;59
89;29.10.2011;2011;10;17;Lauantai;72;49;121;25;22;47
89;29.10.2011;2011;10;18;Lauantai;47;45;92;25;20;45
89;29.10.2011;2011;10;19;Lauantai;33;31;64;9;19;28
89;29.10.2011;2011;10;20;Lauantai;32;40;72;15;19;34
89;29.10.2011;2011;10;21;Lauantai;20;23;43;6;6;12
89;29.10.2011;2011;10;22;Lauantai;18;27;45;4;13;17
89;29.10.2011;2011;10;23;Lauantai;14;42;56;6;7;13
89;30.10.2011;2011;10;00;Sunnuntai;13;7;20;1;3;4
89;30.10.2011;2011;10;01;Sunnuntai;18;9;27;8;6;14
89;30.10.2011;2011;10;02;Sunnuntai;22;7;29;2;2;4
89;30.10.2011;2011;10;03;Sunnuntai;32;8;40;6;2;8
89;30.10.2011;2011;10;04;Sunnuntai;7;2;9;1;1;2
89;30.10.2011;2011;10;05;Sunnuntai;2;1;3;1;1;2
89;30.10.2011;2011;10;06;Sunnuntai;3;6;9;2;2;4
89;30.10.2011;2011;10;07;Sunnuntai;4;8;12;5;8;13
89;30.10.2011;2011;10;08;Sunnuntai;9;10;19;12;16;28
89;30.10.2011;2011;10;09;Sunnuntai;16;24;40;27;28;55
89;30.10.2011;2011;10;10;Sunnuntai;26;43;69;35;43;78
89;30.10.2011;2011;10;11;Sunnuntai;30;70;100;30;50;80
89;30.10.2011;2011;10;12;Sunnuntai;52;69;121;42;59;101
89;30.10.2011;2011;10;13;Sunnuntai;55;53;108;34;47;81
89;30.10.2011;2011;10;14;Sunnuntai;58;64;122;36;37;73
89;30.10.2011;2011;10;15;Sunnuntai;56;59;115;36;42;78
89;30.10.2011;2011;10;16;Sunnuntai;53;45;98;23;28;51
89;30.10.2011;2011;10;17;Sunnuntai;48;31;79;22;25;47
89;30.10.2011;2011;10;18;Sunnuntai;47;35;82;25;17;42
89;30.10.2011;2011;10;19;Sunnuntai;35;26;61;21;20;41
89;30.10.2011;2011;10;20;Sunnuntai;32;13;45;14;8;22
89;30.10.2011;2011;10;21;Sunnuntai;30;9;39;3;1;4
89;30.10.2011;2011;10;22;Sunnuntai;13;6;19;2;12;14
89;30.10.2011;2011;10;23;Sunnuntai;8;3;11;1;1;2
89;31.10.2011;2011;10;00;Maanantai;3;3;6;2;0;2
89;31.10.2011;2011;10;01;Maanantai;3;2;5;0;0;0
89;31.10.2011;2011;10;02;Maanantai;2;2;4;0;0;0
89;31.10.2011;2011;10;03;Maanantai;2;1;3;1;0;1
89;31.10.2011;2011;10;04;Maanantai;1;3;4;0;0;0
89;31.10.2011;2011;10;05;Maanantai;4;13;17;0;4;4
89;31.10.2011;2011;10;06;Maanantai;18;65;83;6;14;20
89;31.10.2011;2011;10;07;Maanantai;61;211;272;5;24;29
89;31.10.2011;2011;10;08;Maanantai;71;223;294;7;47;54
89;31.10.2011;2011;10;09;Maanantai;57;147;204;16;31;47
89;31.10.2011;2011;10;10;Maanantai;40;85;125;21;34;55
89;31.10.2011;2011;10;11;Maanantai;71;113;184;12;27;39
89;31.10.2011;2011;10;12;Maanantai;70;94;164;18;27;45
89;31.10.2011;2011;10;13;Maanantai;107;77;184;18;26;44
89;31.10.2011;2011;10;14;Maanantai;153;98;251;23;23;46
89;31.10.2011;2011;10;15;Maanantai;178;101;279;40;20;60
89;31.10.2011;2011;10;16;Maanantai;246;114;360;30;25;55
89;31.10.2011;2011;10;17;Maanantai;142;67;209;36;25;61
89;31.10.2011;2011;10;18;Maanantai;73;74;147;27;29;56
89;31.10.2011;2011;10;19;Maanantai;66;40;106;35;29;64
89;31.10.2011;2011;10;20;Maanantai;71;23;94;17;19;36
89;31.10.2011;2011;10;21;Maanantai;52;21;73;10;11;21
89;31.10.2011;2011;10;22;Maanantai;16;15;31;5;6;11
89;31.10.2011;2011;10;23;Maanantai;6;4;10;3;1;4
89;01.11.2011;2011;11;00;Tiistai;4;0;4;0;0;0
89;01.11.2011;2011;11;01;Tiistai;1;1;2;2;0;2
89;01.11.2011;2011;11;02;Tiistai;1;1;2;0;1;1
89;01.11.2011;2011;11;03;Tiistai;0;2;2;0;0;0
89;01.11.2011;2011;11;04;Tiistai;1;4;5;0;0;0
89;01.11.2011;2011;11;05;Tiistai;2;9;11;2;0;2
89;01.11.2011;2011;11;06;Tiistai;25;63;88;3;4;7
89;01.11.2011;2011;11;07;Tiistai;47;243;290;6;27;33
89;01.11.2011;2011;11;08;Tiistai;65;234;299;16;31;47
89;01.11.2011;2011;11;09;Tiistai;59;128;187;8;27;35
89;01.11.2011;2011;11;10;Tiistai;51;74;125;21;29;50
89;01.11.2011;2011;11;11;Tiistai;61;87;148;16;23;39
89;01.11.2011;2011;11;12;Tiistai;83;73;156;34;31;65
89;01.11.2011;2011;11;13;Tiistai;104;103;207;24;32;56
89;01.11.2011;2011;11;14;Tiistai;139;107;246;34;24;58
89;01.11.2011;2011;11;15;Tiistai;235;106;341;31;19;50
89;01.11.2011;2011;11;16;Tiistai;208;123;331;47;26;73
89;01.11.2011;2011;11;17;Tiistai;140;79;219;38;26;64
89;01.11.2011;2011;11;18;Tiistai;91;76;167;25;17;42
89;01.11.2011;2011;11;19;Tiistai;62;60;122;28;28;56
89;01.11.2011;2011;11;20;Tiistai;73;34;107;15;17;32
89;01.11.2011;2011;11;21;Tiistai;47;23;70;9;9;18
89;01.11.2011;2011;11;22;Tiistai;29;12;41;3;7;10
89;01.11.2011;2011;11;23;Tiistai;4;11;15;1;0;1
89;02.11.2011;2011;11;00;Keskiviikko;8;1;9;0;1;1
89;02.11.2011;2011;11;01;Keskiviikko;6;5;11;1;1;2
89;02.11.2011;2011;11;02;Keskiviikko;1;1;2;1;1;2
89;02.11.2011;2011;11;03;Keskiviikko;4;3;7;2;0;2
89;02.11.2011;2011;11;04;Keskiviikko;4;5;9;3;0;3
89;02.11.2011;2011;11;05;Keskiviikko;6;11;17;1;1;2
89;02.11.2011;2011;11;06;Keskiviikko;16;58;74;3;9;12
89;02.11.2011;2011;11;07;Keskiviikko;65;251;316;3;38;41
89;02.11.2011;2011;11;08;Keskiviikko;70;253;323;9;25;34
89;02.11.2011;2011;11;09;Keskiviikko;52;123;175;15;15;30
89;02.11.2011;2011;11;10;Keskiviikko;65;104;169;24;25;49
89;02.11.2011;2011;11;11;Keskiviikko;81;104;185;20;33;53
89;02.11.2011;2011;11;12;Keskiviikko;70;90;160;22;26;48
89;02.11.2011;2011;11;13;Keskiviikko;119;81;200;20;23;43
89;02.11.2011;2011;11;14;Keskiviikko;167;107;274;16;32;48
89;02.11.2011;2011;11;15;Keskiviikko;179;108;287;28;22;50
89;02.11.2011;2011;11;16;Keskiviikko;247;136;383;36;26;62
89;02.11.2011;2011;11;17;Keskiviikko;140;69;209;32;25;57
89;02.11.2011;2011;11;18;Keskiviikko;93;70;163;23;24;47
89;02.11.2011;2011;11;19;Keskiviikko;79;56;135;32;28;60
89;02.11.2011;2011;11;20;Keskiviikko;76;43;119;21;15;36
89;02.11.2011;2011;11;21;Keskiviikko;49;19;68;8;10;18
89;02.11.2011;2011;11;22;Keskiviikko;21;16;37;3;7;10
89;02.11.2011;2011;11;23;Keskiviikko;8;4;12;3;2;5
89;03.11.2011;2011;11;00;Torstai;6;4;10;0;1;1
89;03.11.2011;2011;11;01;Torstai;11;3;14;2;0;2
89;03.11.2011;2011;11;02;Torstai;4;1;5;2;1;3
89;03.11.2011;2011;11;03;Torstai;9;4;13;2;0;2
89;03.11.2011;2011;11;04;Torstai;1;3;4;1;0;1
89;03.11.2011;2011;11;05;Torstai;2;9;11;3;1;4
89;03.11.2011;2011;11;06;Torstai;22;70;92;1;4;5
89;03.11.2011;2011;11;07;Torstai;56;235;291;6;22;28
89;03.11.2011;2011;11;08;Torstai;65;221;286;9;36;45
89;03.11.2011;2011;11;09;Torstai;64;132;196;14;32;46
89;03.11.2011;2011;11;10;Torstai;47;100;147;26;20;46
89;03.11.2011;2011;11;11;Torstai;71;88;159;15;31;46
89;03.11.2011;2011;11;12;Torstai;80;96;176;17;24;41
89;03.11.2011;2011;11;13;Torstai;98;102;200;14;18;32
89;03.11.2011;2011;11;14;Torstai;144;84;228;18;20;38
89;03.11.2011;2011;11;15;Torstai;219;95;314;29;25;54
89;03.11.2011;2011;11;16;Torstai;223;95;318;28;19;47
89;03.11.2011;2011;11;17;Torstai;143;106;249;22;22;44
89;03.11.2011;2011;11;18;Torstai;88;81;169;31;40;71
89;03.11.2011;2011;11;19;Torstai;84;51;135;33;14;47
89;03.11.2011;2011;11;20;Torstai;68;34;102;15;15;30
89;03.11.2011;2011;11;21;Torstai;63;29;92;10;9;19
89;03.11.2011;2011;11;22;Torstai;26;28;54;6;1;7
89;03.11.2011;2011;11;23;Torstai;14;16;30;5;2;7
89;04.11.2011;2011;11;00;Perjantai;8;4;12;4;0;4
89;04.11.2011;2011;11;01;Perjantai;7;3;10;1;0;1
89;04.11.2011;2011;11;02;Perjantai;8;2;10;1;1;2
89;04.11.2011;2011;11;03;Perjantai;2;2;4;0;0;0
89;04.11.2011;2011;11;04;Perjantai;6;6;12;2;0;2
89;04.11.2011;2011;11;05;Perjantai;1;17;18;3;1;4
89;04.11.2011;2011;11;06;Perjantai;22;65;87;6;13;19
89;04.11.2011;2011;11;07;Perjantai;41;193;234;5;26;31
89;04.11.2011;2011;11;08;Perjantai;82;192;274;16;41;57
89;04.11.2011;2011;11;09;Perjantai;47;97;144;14;23;37
89;04.11.2011;2011;11;10;Perjantai;52;104;156;10;33;43
89;04.11.2011;2011;11;11;Perjantai;53;93;146;16;31;47
89;04.11.2011;2011;11;12;Perjantai;64;115;179;21;23;44
89;04.11.2011;2011;11;13;Perjantai;124;103;227;24;24;48
89;04.11.2011;2011;11;14;Perjantai;180;102;282;16;23;39
89;04.11.2011;2011;11;15;Perjantai;184;104;288;10;17;27
89;04.11.2011;2011;11;16;Perjantai;142;78;220;29;8;37
89;04.11.2011;2011;11;17;Perjantai;91;72;163;17;22;39
89;04.11.2011;2011;11;18;Perjantai;69;62;131;9;13;22
89;04.11.2011;2011;11;19;Perjantai;42;40;82;16;9;25
89;04.11.2011;2011;11;20;Perjantai;55;48;103;15;9;24
89;04.11.2011;2011;11;21;Perjantai;33;28;61;7;7;14
89;04.11.2011;2011;11;22;Perjantai;30;25;55;2;10;12
89;04.11.2011;2011;11;23;Perjantai;16;33;49;8;8;16
89;05.11.2011;2011;11;00;Lauantai;17;33;50;3;4;7
89;05.11.2011;2011;11;01;Lauantai;30;9;39;6;3;9
89;05.11.2011;2011;11;02;Lauantai;34;7;41;6;1;7
89;05.11.2011;2011;11;03;Lauantai;21;3;24;6;0;6
89;05.11.2011;2011;11;04;Lauantai;19;1;20;8;1;9
89;05.11.2011;2011;11;05;Lauantai;3;3;6;3;0;3
89;05.11.2011;2011;11;06;Lauantai;5;9;14;1;2;3
89;05.11.2011;2011;11;07;Lauantai;6;10;16;3;3;6
89;05.11.2011;2011;11;08;Lauantai;9;18;27;7;16;23
89;05.11.2011;2011;11;09;Lauantai;25;48;73;30;42;72
89;05.11.2011;2011;11;10;Lauantai;25;55;80;22;37;59
89;05.11.2011;2011;11;11;Lauantai;46;60;106;30;30;60
89;05.11.2011;2011;11;12;Lauantai;54;62;116;43;63;106
89;05.11.2011;2011;11;13;Lauantai;52;59;111;20;52;72
89;05.11.2011;2011;11;14;Lauantai;63;49;112;36;30;66
89;05.11.2011;2011;11;15;Lauantai;61;54;115;25;26;51
89;05.11.2011;2011;11;16;Lauantai;43;56;99;19;29;48
89;05.11.2011;2011;11;17;Lauantai;45;45;90;14;23;37
89;05.11.2011;2011;11;18;Lauantai;36;37;73;18;12;30
89;05.11.2011;2011;11;19;Lauantai;41;38;79;20;4;24
89;05.11.2011;2011;11;20;Lauantai;29;37;66;15;9;24
89;05.11.2011;2011;11;21;Lauantai;31;25;56;5;7;12
89;05.11.2011;2011;11;22;Lauantai;15;32;47;6;7;13
89;05.11.2011;2011;11;23;Lauantai;15;18;33;6;10;16
89;06.11.2011;2011;11;00;Sunnuntai;16;21;37;4;5;9
89;06.11.2011;2011;11;01;Sunnuntai;18;7;25;2;4;6
89;06.11.2011;2011;11;02;Sunnuntai;20;7;27;8;1;9
89;06.11.2011;2011;11;03;Sunnuntai;18;3;21;9;1;10
89;06.11.2011;2011;11;04;Sunnuntai;17;0;17;7;0;7
89;06.11.2011;2011;11;05;Sunnuntai;7;4;11;1;1;2
89;06.11.2011;2011;11;06;Sunnuntai;2;8;10;2;1;3
89;06.11.2011;2011;11;07;Sunnuntai;5;9;14;0;5;5
89;06.11.2011;2011;11;08;Sunnuntai;9;16;25;3;13;16
89;06.11.2011;2011;11;09;Sunnuntai;14;24;38;20;35;55
89;06.11.2011;2011;11;10;Sunnuntai;26;39;65;46;34;80
89;06.11.2011;2011;11;11;Sunnuntai;29;54;83;44;51;95
89;06.11.2011;2011;11;12;Sunnuntai;48;92;140;24;54;78
89;06.11.2011;2011;11;13;Sunnuntai;50;65;115;39;36;75
89;06.11.2011;2011;11;14;Sunnuntai;70;45;115;44;24;68
89;06.11.2011;2011;11;15;Sunnuntai;49;51;100;22;39;61
89;06.11.2011;2011;11;16;Sunnuntai;43;40;83;21;34;55
89;06.11.2011;2011;11;17;Sunnuntai;43;36;79;20;26;46
89;06.11.2011;2011;11;18;Sunnuntai;47;32;79;11;29;40
89;06.11.2011;2011;11;19;Sunnuntai;30;21;51;16;16;32
89;06.11.2011;2011;11;20;Sunnuntai;39;16;55;9;9;18
89;06.11.2011;2011;11;21;Sunnuntai;22;7;29;3;4;7
89;06.11.2011;2011;11;22;Sunnuntai;8;9;17;2;2;4
89;06.11.2011;2011;11;23;Sunnuntai;9;4;13;5;2;7
89;07.11.2011;2011;11;00;Maanantai;3;1;4;0;1;1
89;07.11.2011;2011;11;01;Maanantai;4;1;5;1;0;1
89;07.11.2011;2011;11;02;Maanantai;7;0;7;0;0;0
89;07.11.2011;2011;11;03;Maanantai;2;3;5;1;0;1
89;07.11.2011;2011;11;04;Maanantai;1;5;6;0;1;1
89;07.11.2011;2011;11;05;Maanantai;3;14;17;0;0;0
89;07.11.2011;2011;11;06;Maanantai;19;53;72;3;7;10
89;07.11.2011;2011;11;07;Maanantai;55;178;233;2;22;24
89;07.11.2011;2011;11;08;Maanantai;65;209;274;13;34;47
89;07.11.2011;2011;11;09;Maanantai;60;154;214;12;21;33
89;07.11.2011;2011;11;10;Maanantai;51;82;133;25;25;50
89;07.11.2011;2011;11;11;Maanantai;72;95;167;17;35;52
89;07.11.2011;2011;11;12;Maanantai;64;92;156;25;27;52
89;07.11.2011;2011;11;13;Maanantai;102;87;189;19;34;53
89;07.11.2011;2011;11;14;Maanantai;142;99;241;28;18;46
89;07.11.2011;2011;11;15;Maanantai;173;85;258;28;30;58
89;07.11.2011;2011;11;16;Maanantai;252;105;357;36;22;58
89;07.11.2011;2011;11;17;Maanantai;128;75;203;24;40;64
89;07.11.2011;2011;11;18;Maanantai;100;71;171;36;24;60
89;07.11.2011;2011;11;19;Maanantai;56;36;92;18;33;51
89;07.11.2011;2011;11;20;Maanantai;62;32;94;19;23;42
89;07.11.2011;2011;11;21;Maanantai;35;24;59;11;6;17
89;07.11.2011;2011;11;22;Maanantai;14;15;29;0;4;4
89;07.11.2011;2011;11;23;Maanantai;5;4;9;0;2;2
89;08.11.2011;2011;11;00;Tiistai;1;3;4;1;0;1
89;08.11.2011;2011;11;01;Tiistai;3;6;9;0;1;1
89;08.11.2011;2011;11;02;Tiistai;3;0;3;0;0;0
89;08.11.2011;2011;11;03;Tiistai;4;3;7;2;0;2
89;08.11.2011;2011;11;04;Tiistai;2;7;9;0;1;1
89;08.11.2011;2011;11;05;Tiistai;5;14;19;1;2;3
89;08.11.2011;2011;11;06;Tiistai;20;65;85;7;9;16
89;08.11.2011;2011;11;07;Tiistai;55;222;277;5;25;30
89;08.11.2011;2011;11;08;Tiistai;68;225;293;19;61;80
89;08.11.2011;2011;11;09;Tiistai;65;120;185;18;26;44
89;08.11.2011;2011;11;10;Tiistai;37;108;145;19;24;43
89;08.11.2011;2011;11;11;Tiistai;70;85;155;22;13;35
89;08.11.2011;2011;11;12;Tiistai;80;87;167;21;40;61
89;08.11.2011;2011;11;13;Tiistai;110;70;180;27;14;41
89;08.11.2011;2011;11;14;Tiistai;151;101;252;30;23;53
89;08.11.2011;2011;11;15;Tiistai;223;122;345;33;26;59
89;08.11.2011;2011;11;16;Tiistai;222;136;358;27;28;55
89;08.11.2011;2011;11;17;Tiistai;137;101;238;31;36;67
89;08.11.2011;2011;11;18;Tiistai;100;85;185;29;31;60
89;08.11.2011;2011;11;19;Tiistai;80;36;116;35;21;56
89;08.11.2011;2011;11;20;Tiistai;79;30;109;20;23;43
89;08.11.2011;2011;11;21;Tiistai;47;17;64;14;10;24
89;08.11.2011;2011;11;22;Tiistai;26;10;36;3;7;10
89;08.11.2011;2011;11;23;Tiistai;12;2;14;1;0;1
89;09.11.2011;2011;11;00;Keskiviikko;7;3;10;1;1;2
89;09.11.2011;2011;11;01;Keskiviikko;5;0;5;0;1;1
89;09.11.2011;2011;11;02;Keskiviikko;7;0;7;1;0;1
89;09.11.2011;2011;11;03;Keskiviikko;2;2;4;1;0;1
89;09.11.2011;2011;11;04;Keskiviikko;2;8;10;0;0;0
89;09.11.2011;2011;11;05;Keskiviikko;2;13;15;1;1;2
89;09.11.2011;2011;11;06;Keskiviikko;17;66;83;4;12;16
89;09.11.2011;2011;11;07;Keskiviikko;48;197;245;5;20;25
89;09.11.2011;2011;11;08;Keskiviikko;74;229;303;14;50;64
89;09.11.2011;2011;11;09;Keskiviikko;69;125;194;12;37;49
89;09.11.2011;2011;11;10;Keskiviikko;47;80;127;22;27;49
89;09.11.2011;2011;11;11;Keskiviikko;46;98;144;40;31;71
89;09.11.2011;2011;11;12;Keskiviikko;80;83;163;23;51;74
89;09.11.2011;2011;11;13;Keskiviikko;97;69;166;35;52;87
89;09.11.2011;2011;11;14;Keskiviikko;126;90;216;32;38;70
89;09.11.2011;2011;11;15;Keskiviikko;165;110;275;32;20;52
89;09.11.2011;2011;11;16;Keskiviikko;177;117;294;29;29;58
89;09.11.2011;2011;11;17;Keskiviikko;135;81;216;29;29;58
89;09.11.2011;2011;11;18;Keskiviikko;91;63;154;32;26;58
89;09.11.2011;2011;11;19;Keskiviikko;77;52;129;27;27;54
89;09.11.2011;2011;11;20;Keskiviikko;75;48;123;16;21;37
89;09.11.2011;2011;11;21;Keskiviikko;53;17;70;11;5;16
89;09.11.2011;2011;11;22;Keskiviikko;21;10;31;6;8;14
89;09.11.2011;2011;11;23;Keskiviikko;17;4;21;1;3;4
89;10.11.2011;2011;11;00;Torstai;4;5;9;3;0;3
89;10.11.2011;2011;11;01;Torstai;6;3;9;1;0;1
89;10.11.2011;2011;11;02;Torstai;3;2;5;1;2;3
89;10.11.2011;2011;11;03;Torstai;3;4;7;0;1;1
89;10.11.2011;2011;11;04;Torstai;4;4;8;2;0;2
89;10.11.2011;2011;11;05;Torstai;3;13;16;0;0;0
89;10.11.2011;2011;11;06;Torstai;14;59;73;5;8;13
89;10.11.2011;2011;11;07;Torstai;55;196;251;10;26;36
89;10.11.2011;2011;11;08;Torstai;70;225;295;16;25;41
89;10.11.2011;2011;11;09;Torstai;53;114;167;10;26;36
89;10.11.2011;2011;11;10;Torstai;46;84;130;9;16;25
89;10.11.2011;2011;11;11;Torstai;55;71;126;18;20;38
89;10.11.2011;2011;11;12;Torstai;72;69;141;15;19;34
89;10.11.2011;2011;11;13;Torstai;92;70;162;21;16;37
89;10.11.2011;2011;11;14;Torstai;114;82;196;23;24;47
89;10.11.2011;2011;11;15;Torstai;172;94;266;34;26;60
89;10.11.2011;2011;11;16;Torstai;197;107;304;25;21;46
89;10.11.2011;2011;11;17;Torstai;130;100;230;28;24;52
89;10.11.2011;2011;11;18;Torstai;75;65;140;39;32;71
89;10.11.2011;2011;11;19;Torstai;57;59;116;23;25;48
89;10.11.2011;2011;11;20;Torstai;71;41;112;10;16;26
89;10.11.2011;2011;11;21;Torstai;43;18;61;5;14;19
89;10.11.2011;2011;11;22;Torstai;24;19;43;13;11;24
89;10.11.2011;2011;11;23;Torstai;13;9;22;1;2;3
89;11.11.2011;2011;11;00;Perjantai;6;6;12;1;1;2
89;11.11.2011;2011;11;01;Perjantai;10;0;10;1;0;1
89;11.11.2011;2011;11;02;Perjantai;7;2;9;1;2;3
89;11.11.2011;2011;11;03;Perjantai;9;6;15;1;1;2
89;11.11.2011;2011;11;04;Perjantai;5;6;11;2;1;3
89;11.11.2011;2011;11;05;Perjantai;6;13;19;0;0;0
89;11.11.2011;2011;11;06;Perjantai;15;58;73;4;8;12
89;11.11.2011;2011;11;07;Perjantai;47;179;226;8;28;36
89;11.11.2011;2011;11;08;Perjantai;74;187;261;4;37;41
89;11.11.2011;2011;11;09;Perjantai;42;113;155;15;21;36
89;11.11.2011;2011;11;10;Perjantai;41;81;122;14;20;34
89;11.11.2011;2011;11;11;Perjantai;60;94;154;17;23;40
89;11.11.2011;2011;11;12;Perjantai;60;91;151;25;24;49
89;11.11.2011;2011;11;13;Perjantai;120;87;207;21;23;44
89;11.11.2011;2011;11;14;Perjantai;139;89;228;27;16;43
89;11.11.2011;2011;11;15;Perjantai;206;83;289;23;12;35
89;11.11.2011;2011;11;16;Perjantai;143;95;238;32;24;56
89;11.11.2011;2011;11;17;Perjantai;84;69;153;27;24;51
89;11.11.2011;2011;11;18;Perjantai;70;69;139;14;25;39
89;11.11.2011;2011;11;19;Perjantai;41;50;91;19;12;31
89;11.11.2011;2011;11;20;Perjantai;40;34;74;15;15;30
89;11.11.2011;2011;11;21;Perjantai;45;28;73;6;9;15
89;11.11.2011;2011;11;22;Perjantai;34;25;59;8;10;18
89;11.11.2011;2011;11;23;Perjantai;17;19;36;10;7;17
89;12.11.2011;2011;11;00;Lauantai;17;23;40;7;5;12
89;12.11.2011;2011;11;01;Lauantai;21;9;30;3;2;5
89;12.11.2011;2011;11;02;Lauantai;14;5;19;10;0;10
89;12.11.2011;2011;11;03;Lauantai;22;0;22;10;0;10
89;12.11.2011;2011;11;04;Lauantai;11;1;12;2;3;5
89;12.11.2011;2011;11;05;Lauantai;3;5;8;0;1;1
89;12.11.2011;2011;11;06;Lauantai;6;12;18;0;1;1
89;12.11.2011;2011;11;07;Lauantai;6;18;24;3;4;7
89;12.11.2011;2011;11;08;Lauantai;7;32;39;5;14;19
89;12.11.2011;2011;11;09;Lauantai;12;66;78;15;28;43
89;12.11.2011;2011;11;10;Lauantai;29;51;80;17;21;38
89;12.11.2011;2011;11;11;Lauantai;53;72;125;13;31;44
89;12.11.2011;2011;11;12;Lauantai;53;72;125;32;42;74
89;12.11.2011;2011;11;13;Lauantai;83;74;157;18;30;48
89;12.11.2011;2011;11;14;Lauantai;81;57;138;30;31;61
89;12.11.2011;2011;11;15;Lauantai;65;66;131;34;23;57
89;12.11.2011;2011;11;16;Lauantai;50;40;90;25;27;52
89;12.11.2011;2011;11;17;Lauantai;37;49;86;16;21;37
89;12.11.2011;2011;11;18;Lauantai;44;22;66;19;24;43
89;12.11.2011;2011;11;19;Lauantai;47;29;76;9;16;25
89;12.11.2011;2011;11;20;Lauantai;47;16;63;11;10;21
89;12.11.2011;2011;11;21;Lauantai;17;18;35;4;6;10
89;12.11.2011;2011;11;22;Lauantai;13;31;44;4;8;12
89;12.11.2011;2011;11;23;Lauantai;14;24;38;5;4;9
89;13.11.2011;2011;11;00;Sunnuntai;11;6;17;0;3;3
89;13.11.2011;2011;11;01;Sunnuntai;18;17;35;4;4;8
89;13.11.2011;2011;11;02;Sunnuntai;15;1;16;5;2;7
89;13.11.2011;2011;11;03;Sunnuntai;29;7;36;9;0;9
89;13.11.2011;2011;11;04;Sunnuntai;16;3;19;7;0;7
89;13.11.2011;2011;11;05;Sunnuntai;4;1;5;0;0;0
89;13.11.2011;2011;11;06;Sunnuntai;4;4;8;1;4;5
89;13.11.2011;2011;11;07;Sunnuntai;6;8;14;3;6;9
89;13.11.2011;2011;11;08;Sunnuntai;9;11;20;10;8;18
89;13.11.2011;2011;11;09;Sunnuntai;6;25;31;25;27;52
89;13.11.2011;2011;11;10;Sunnuntai;21;38;59;26;36;62
89;13.11.2011;2011;11;11;Sunnuntai;34;47;81;46;39;85
89;13.11.2011;2011;11;12;Sunnuntai;50;53;103;29;49;78
89;13.11.2011;2011;11;13;Sunnuntai;48;46;94;50;44;94
89;13.11.2011;2011;11;14;Sunnuntai;33;45;78;31;39;70
89;13.11.2011;2011;11;15;Sunnuntai;55;45;100;27;33;60
89;13.11.2011;2011;11;16;Sunnuntai;39;40;79;26;22;48
89;13.11.2011;2011;11;17;Sunnuntai;25;40;65;29;24;53
89;13.11.2011;2011;11;18;Sunnuntai;46;29;75;17;29;46
89;13.11.2011;2011;11;19;Sunnuntai;25;20;45;20;13;33
89;13.11.2011;2011;11;20;Sunnuntai;37;26;63;6;9;15
89;13.11.2011;2011;11;21;Sunnuntai;18;13;31;3;3;6
89;13.11.2011;2011;11;22;Sunnuntai;10;8;18;4;4;8
89;13.11.2011;2011;11;23;Sunnuntai;5;3;8;4;1;5
89;14.11.2011;2011;11;00;Maanantai;4;1;5;0;0;0
89;14.11.2011;2011;11;01;Maanantai;1;1;2;2;1;3
89;14.11.2011;2011;11;02;Maanantai;5;0;5;2;0;2
89;14.11.2011;2011;11;03;Maanantai;2;2;4;0;0;0
89;14.11.2011;2011;11;04;Maanantai;0;6;6;3;0;3
89;14.11.2011;2011;11;05;Maanantai;6;16;22;1;3;4
89;14.11.2011;2011;11;06;Maanantai;26;62;88;1;7;8
89;14.11.2011;2011;11;07;Maanantai;44;188;232;2;23;25
89;14.11.2011;2011;11;08;Maanantai;66;220;286;9;33;42
89;14.11.2011;2011;11;09;Maanantai;46;120;166;15;25;40
89;14.11.2011;2011;11;10;Maanantai;47;84;131;16;23;39
89;14.11.2011;2011;11;11;Maanantai;76;79;155;19;17;36
89;14.11.2011;2011;11;12;Maanantai;80;94;174;17;26;43
89;14.11.2011;2011;11;13;Maanantai;92;94;186;31;46;77
89;14.11.2011;2011;11;14;Maanantai;147;85;232;16;26;42
89;14.11.2011;2011;11;15;Maanantai;171;87;258;33;20;53
89;14.11.2011;2011;11;16;Maanantai;215;115;330;19;26;45
89;14.11.2011;2011;11;17;Maanantai;130;75;205;35;23;58
89;14.11.2011;2011;11;18;Maanantai;85;61;146;29;24;53
89;14.11.2011;2011;11;19;Maanantai;60;34;94;25;23;48
89;14.11.2011;2011;11;20;Maanantai;56;19;75;17;18;35
89;14.11.2011;2011;11;21;Maanantai;49;17;66;8;9;17
89;14.11.2011;2011;11;22;Maanantai;10;9;19;2;2;4
89;14.11.2011;2011;11;23;Maanantai;6;3;9;0;3;3
89;15.11.2011;2011;11;00;Tiistai;3;2;5;1;1;2
89;15.11.2011;2011;11;01;Tiistai;2;1;3;0;1;1
89;15.11.2011;2011;11;02;Tiistai;3;0;3;0;1;1
89;15.11.2011;2011;11;03;Tiistai;1;2;3;0;0;0
89;15.11.2011;2011;11;04;Tiistai;1;1;2;1;1;2
89;15.11.2011;2011;11;05;Tiistai;2;17;19;1;2;3
89;15.11.2011;2011;11;06;Tiistai;25;59;84;3;10;13
89;15.11.2011;2011;11;07;Tiistai;56;189;245;5;31;36
89;15.11.2011;2011;11;08;Tiistai;59;238;297;7;56;63
89;15.11.2011;2011;11;09;Tiistai;61;95;156;27;27;54
89;15.11.2011;2011;11;10;Tiistai;44;62;106;24;34;58
89;15.11.2011;2011;11;11;Tiistai;59;107;166;21;51;72
89;15.11.2011;2011;11;12;Tiistai;69;80;149;28;49;77
89;15.11.2011;2011;11;13;Tiistai;92;61;153;29;35;64
89;15.11.2011;2011;11;14;Tiistai;120;82;202;21;27;48
89;15.11.2011;2011;11;15;Tiistai;200;102;302;33;18;51
89;15.11.2011;2011;11;16;Tiistai;197;126;323;31;33;64
89;15.11.2011;2011;11;17;Tiistai;114;85;199;26;31;57
89;15.11.2011;2011;11;18;Tiistai;96;60;156;32;28;60
89;15.11.2011;2011;11;19;Tiistai;79;45;124;35;24;59
89;15.11.2011;2011;11;20;Tiistai;77;42;119;27;18;45
89;15.11.2011;2011;11;21;Tiistai;58;20;78;10;11;21
89;15.11.2011;2011;11;22;Tiistai;22;4;26;3;1;4
89;15.11.2011;2011;11;23;Tiistai;7;6;13;4;2;6
89;16.11.2011;2011;11;00;Keskiviikko;6;4;10;0;0;0
89;16.11.2011;2011;11;01;Keskiviikko;6;3;9;1;0;1
89;16.11.2011;2011;11;02;Keskiviikko;2;2;4;4;5;9
89;16.11.2011;2011;11;03;Keskiviikko;5;1;6;2;1;3
89;16.11.2011;2011;11;04;Keskiviikko;1;7;8;2;0;2
89;16.11.2011;2011;11;05;Keskiviikko;7;12;19;1;1;2
89;16.11.2011;2011;11;06;Keskiviikko;21;66;87;2;11;13
89;16.11.2011;2011;11;07;Keskiviikko;57;194;251;6;34;40
89;16.11.2011;2011;11;08;Keskiviikko;70;227;297;12;31;43
89;16.11.2011;2011;11;09;Keskiviikko;50;94;144;11;29;40
89;16.11.2011;2011;11;10;Keskiviikko;41;77;118;14;11;25
89;16.11.2011;2011;11;11;Keskiviikko;66;61;127;12;28;40
89;16.11.2011;2011;11;12;Keskiviikko;65;78;143;20;20;40
89;16.11.2011;2011;11;13;Keskiviikko;79;64;143;21;29;50
89;16.11.2011;2011;11;14;Keskiviikko;132;94;226;30;21;51
89;16.11.2011;2011;11;15;Keskiviikko;157;99;256;35;29;64
89;16.11.2011;2011;11;16;Keskiviikko;191;106;297;31;27;58
89;16.11.2011;2011;11;17;Keskiviikko;141;72;213;26;20;46
89;16.11.2011;2011;11;18;Keskiviikko;89;82;171;24;23;47
89;16.11.2011;2011;11;19;Keskiviikko;80;45;125;32;23;55
89;16.11.2011;2011;11;20;Keskiviikko;49;32;81;19;27;46
89;16.11.2011;2011;11;21;Keskiviikko;60;26;86;11;11;22
89;16.11.2011;2011;11;22;Keskiviikko;15;19;34;2;6;8
89;16.11.2011;2011;11;23;Keskiviikko;5;5;10;2;4;6
89;17.11.2011;2011;11;00;Torstai;9;4;13;2;5;7
89;17.11.2011;2011;11;01;Torstai;13;3;16;2;2;4
89;17.11.2011;2011;11;02;Torstai;5;2;7;2;1;3
89;17.11.2011;2011;11;03;Torstai;9;5;14;0;0;0
89;17.11.2011;2011;11;04;Torstai;7;2;9;2;0;2
89;17.11.2011;2011;11;05;Torstai;6;12;18;1;2;3
89;17.11.2011;2011;11;06;Torstai;21;64;85;4;6;10
89;17.11.2011;2011;11;07;Torstai;51;200;251;5;32;37
89;17.11.2011;2011;11;08;Torstai;55;228;283;16;33;49
89;17.11.2011;2011;11;09;Torstai;61;112;173;11;22;33
89;17.11.2011;2011;11;10;Torstai;42;96;138;20;30;50
89;17.11.2011;2011;11;11;Torstai;68;96;164;19;59;78
89;17.11.2011;2011;11;12;Torstai;67;80;147;24;39;63
89;17.11.2011;2011;11;13;Torstai;89;98;187;26;28;54
89;17.11.2011;2011;11;14;Torstai;124;84;208;44;40;84
89;17.11.2011;2011;11;15;Torstai;179;76;255;25;30;55
89;17.11.2011;2011;11;16;Torstai;227;87;314;36;18;54
89;17.11.2011;2011;11;17;Torstai;122;78;200;26;17;43
89;17.11.2011;2011;11;18;Torstai;74;67;141;24;16;40
89;17.11.2011;2011;11;19;Torstai;62;40;102;26;23;49
89;17.11.2011;2011;11;20;Torstai;53;42;95;23;21;44
89;17.11.2011;2011;11;21;Torstai;72;31;103;7;7;14
89;17.11.2011;2011;11;22;Torstai;15;19;34;6;3;9
89;17.11.2011;2011;11;23;Torstai;9;17;26;1;5;6
89;18.11.2011;2011;11;00;Perjantai;5;2;7;1;1;2
89;18.11.2011;2011;11;01;Perjantai;3;0;3;0;2;2
89;18.11.2011;2011;11;02;Perjantai;9;2;11;0;0;0
89;18.11.2011;2011;11;03;Perjantai;5;2;7;0;0;0
89;18.11.2011;2011;11;04;Perjantai;7;6;13;2;0;2
89;18.11.2011;2011;11;05;Perjantai;2;16;18;0;1;1
89;18.11.2011;2011;11;06;Perjantai;19;62;81;3;7;10
89;18.11.2011;2011;11;07;Perjantai;32;177;209;6;34;40
89;18.11.2011;2011;11;08;Perjantai;65;186;251;11;33;44
89;18.11.2011;2011;11;09;Perjantai;36;98;134;18;40;58
89;18.11.2011;2011;11;10;Perjantai;40;85;125;14;24;38
89;18.11.2011;2011;11;11;Perjantai;60;68;128;12;29;41
89;18.11.2011;2011;11;12;Perjantai;56;85;141;29;21;50
89;18.11.2011;2011;11;13;Perjantai;103;83;186;37;28;65
89;18.11.2011;2011;11;14;Perjantai;129;76;205;19;23;42
89;18.11.2011;2011;11;15;Perjantai;165;80;245;20;24;44
89;18.11.2011;2011;11;16;Perjantai;103;68;171;25;24;49
89;18.11.2011;2011;11;17;Perjantai;88;57;145;36;26;62
89;18.11.2011;2011;11;18;Perjantai;57;55;112;33;22;55
89;18.11.2011;2011;11;19;Perjantai;44;47;91;21;15;36
89;18.11.2011;2011;11;20;Perjantai;37;37;74;13;17;30
89;18.11.2011;2011;11;21;Perjantai;38;30;68;4;10;14
89;18.11.2011;2011;11;22;Perjantai;32;32;64;7;11;18
89;18.11.2011;2011;11;23;Perjantai;13;16;29;1;5;6
89;19.11.2011;2011;11;00;Lauantai;19;13;32;1;3;4
89;19.11.2011;2011;11;01;Lauantai;18;8;26;4;5;9
89;19.11.2011;2011;11;02;Lauantai;12;4;16;8;2;10
89;19.11.2011;2011;11;03;Lauantai;12;1;13;14;1;15
89;19.11.2011;2011;11;04;Lauantai;11;4;15;8;0;8
89;19.11.2011;2011;11;05;Lauantai;4;3;7;1;1;2
89;19.11.2011;2011;11;06;Lauantai;7;15;22;2;2;4
89;19.11.2011;2011;11;07;Lauantai;5;21;26;3;2;5
89;19.11.2011;2011;11;08;Lauantai;14;26;40;5;14;19
89;19.11.2011;2011;11;09;Lauantai;19;43;62;10;28;38
89;19.11.2011;2011;11;10;Lauantai;30;61;91;21;30;51
89;19.11.2011;2011;11;11;Lauantai;40;71;111;27;28;55
89;19.11.2011;2011;11;12;Lauantai;32;76;108;24;47;71
89;19.11.2011;2011;11;13;Lauantai;60;51;111;29;43;72
89;19.11.2011;2011;11;14;Lauantai;57;62;119;29;33;62
89;19.11.2011;2011;11;15;Lauantai;64;46;110;33;36;69
89;19.11.2011;2011;11;16;Lauantai;57;39;96;20;30;50
89;19.11.2011;2011;11;17;Lauantai;62;34;96;18;20;38
89;19.11.2011;2011;11;18;Lauantai;21;37;58;16;21;37
89;19.11.2011;2011;11;19;Lauantai;42;22;64;8;11;19
89;19.11.2011;2011;11;20;Lauantai;25;21;46;9;11;20
89;19.11.2011;2011;11;21;Lauantai;20;18;38;3;6;9
89;19.11.2011;2011;11;22;Lauantai;14;18;32;3;3;6
89;19.11.2011;2011;11;23;Lauantai;13;22;35;3;6;9
89;20.11.2011;2011;11;00;Sunnuntai;11;17;28;1;6;7
89;20.11.2011;2011;11;01;Sunnuntai;12;12;24;2;0;2
89;20.11.2011;2011;11;02;Sunnuntai;21;3;24;6;0;6
89;20.11.2011;2011;11;03;Sunnuntai;17;3;20;10;0;10
89;20.11.2011;2011;11;04;Sunnuntai;14;0;14;12;0;12
89;20.11.2011;2011;11;05;Sunnuntai;5;0;5;0;0;0
89;20.11.2011;2011;11;06;Sunnuntai;8;8;16;2;2;4
89;20.11.2011;2011;11;07;Sunnuntai;5;8;13;2;2;4
89;20.11.2011;2011;11;08;Sunnuntai;6;8;14;9;6;15
89;20.11.2011;2011;11;09;Sunnuntai;11;23;34;24;21;45
89;20.11.2011;2011;11;10;Sunnuntai;19;22;41;19;31;50
89;20.11.2011;2011;11;11;Sunnuntai;19;40;59;27;46;73
89;20.11.2011;2011;11;12;Sunnuntai;34;58;92;36;47;83
89;20.11.2011;2011;11;13;Sunnuntai;40;43;83;34;46;80
89;20.11.2011;2011;11;14;Sunnuntai;46;40;86;38;44;82
89;20.11.2011;2011;11;15;Sunnuntai;57;39;96;24;32;56
89;20.11.2011;2011;11;16;Sunnuntai;27;32;59;22;22;44
89;20.11.2011;2011;11;17;Sunnuntai;23;30;53;29;30;59
89;20.11.2011;2011;11;18;Sunnuntai;31;24;55;27;24;51
89;20.11.2011;2011;11;19;Sunnuntai;31;19;50;16;19;35
89;20.11.2011;2011;11;20;Sunnuntai;29;16;45;17;17;34
89;20.11.2011;2011;11;21;Sunnuntai;18;14;32;8;9;17
89;20.11.2011;2011;11;22;Sunnuntai;15;7;22;3;3;6
89;20.11.2011;2011;11;23;Sunnuntai;6;2;8;2;0;2
89;21.11.2011;2011;11;00;Maanantai;5;0;5;3;0;3
89;21.11.2011;2011;11;01;Maanantai;1;0;1;0;0;0
89;21.11.2011;2011;11;02;Maanantai;0;0;0;0;1;1
89;21.11.2011;2011;11;03;Maanantai;1;3;4;0;0;0
89;21.11.2011;2011;11;04;Maanantai;1;6;7;0;0;0
89;21.11.2011;2011;11;05;Maanantai;1;11;12;1;2;3
89;21.11.2011;2011;11;06;Maanantai;14;47;61;4;11;15
89;21.11.2011;2011;11;07;Maanantai;33;163;196;11;21;32
89;21.11.2011;2011;11;08;Maanantai;68;207;275;11;44;55
89;21.11.2011;2011;11;09;Maanantai;45;127;172;14;33;47
89;21.11.2011;2011;11;10;Maanantai;40;60;100;25;42;67
89;21.11.2011;2011;11;11;Maanantai;49;68;117;26;53;79
89;21.11.2011;2011;11;12;Maanantai;52;78;130;22;27;49
89;21.11.2011;2011;11;13;Maanantai;69;59;128;27;23;50
89;21.11.2011;2011;11;14;Maanantai;96;65;161;34;25;59
89;21.11.2011;2011;11;15;Maanantai;136;65;201;48;20;68
89;21.11.2011;2011;11;16;Maanantai;179;77;256;41;25;66
89;21.11.2011;2011;11;17;Maanantai;108;57;165;35;29;64
89;21.11.2011;2011;11;18;Maanantai;75;55;130;34;25;59
89;21.11.2011;2011;11;19;Maanantai;53;45;98;29;23;52
89;21.11.2011;2011;11;20;Maanantai;43;31;74;26;32;58
89;21.11.2011;2011;11;21;Maanantai;42;13;55;7;6;13
89;21.11.2011;2011;11;22;Maanantai;15;4;19;2;4;6
89;21.11.2011;2011;11;23;Maanantai;7;2;9;2;0;2
89;22.11.2011;2011;11;00;Tiistai;3;3;6;1;0;1
89;22.11.2011;2011;11;01;Tiistai;2;0;2;1;1;2
89;22.11.2011;2011;11;02;Tiistai;2;0;2;0;0;0
89;22.11.2011;2011;11;03;Tiistai;0;3;3;0;0;0
89;22.11.2011;2011;11;04;Tiistai;1;7;8;1;1;2
89;22.11.2011;2011;11;05;Tiistai;6;7;13;3;5;8
89;22.11.2011;2011;11;06;Tiistai;14;59;73;4;10;14
89;22.11.2011;2011;11;07;Tiistai;38;180;218;9;34;43
89;22.11.2011;2011;11;08;Tiistai;55;188;243;19;54;73
89;22.11.2011;2011;11;09;Tiistai;41;102;143;16;30;46
89;22.11.2011;2011;11;10;Tiistai;40;57;97;16;34;50
89;22.11.2011;2011;11;11;Tiistai;62;70;132;33;34;67
89;22.11.2011;2011;11;12;Tiistai;50;76;126;23;21;44
89;22.11.2011;2011;11;13;Tiistai;60;66;126;31;26;57
89;22.11.2011;2011;11;14;Tiistai;121;82;203;27;27;54
89;22.11.2011;2011;11;15;Tiistai;156;79;235;34;28;62
89;22.11.2011;2011;11;16;Tiistai;178;84;262;37;27;64
89;22.11.2011;2011;11;17;Tiistai;110;54;164;30;17;47
89;22.11.2011;2011;11;18;Tiistai;63;52;115;23;26;49
89;22.11.2011;2011;11;19;Tiistai;60;48;108;30;23;53
89;22.11.2011;2011;11;20;Tiistai;68;32;100;24;22;46
89;22.11.2011;2011;11;21;Tiistai;40;12;52;7;6;13
89;22.11.2011;2011;11;22;Tiistai;17;5;22;6;3;9
89;22.11.2011;2011;11;23;Tiistai;14;4;18;3;3;6
89;23.11.2011;2011;11;00;Keskiviikko;6;3;9;1;0;1
89;23.11.2011;2011;11;01;Keskiviikko;2;1;3;0;3;3
89;23.11.2011;2011;11;02;Keskiviikko;1;2;3;0;1;1
89;23.11.2011;2011;11;03;Keskiviikko;1;3;4;0;1;1
89;23.11.2011;2011;11;04;Keskiviikko;1;5;6;1;0;1
89;23.11.2011;2011;11;05;Keskiviikko;3;7;10;1;1;2
89;23.11.2011;2011;11;06;Keskiviikko;16;56;72;2;11;13
89;23.11.2011;2011;11;07;Keskiviikko;35;166;201;6;35;41
89;23.11.2011;2011;11;08;Keskiviikko;46;206;252;19;52;71
89;23.11.2011;2011;11;09;Keskiviikko;46;102;148;13;28;41
89;23.11.2011;2011;11;10;Keskiviikko;46;81;127;14;40;54
89;23.11.2011;2011;11;11;Keskiviikko;67;54;121;36;42;78
89;23.11.2011;2011;11;12;Keskiviikko;62;77;139;40;39;79
89;23.11.2011;2011;11;13;Keskiviikko;89;66;155;50;27;77
89;23.11.2011;2011;11;14;Keskiviikko;109;56;165;26;31;57
89;23.11.2011;2011;11;15;Keskiviikko;137;66;203;34;17;51
89;23.11.2011;2011;11;16;Keskiviikko;156;94;250;42;21;63
89;23.11.2011;2011;11;17;Keskiviikko;101;79;180;33;27;60
89;23.11.2011;2011;11;18;Keskiviikko;75;52;127;23;26;49
89;23.11.2011;2011;11;19;Keskiviikko;65;50;115;27;21;48
89;23.11.2011;2011;11;20;Keskiviikko;55;40;95;25;26;51
89;23.11.2011;2011;11;21;Keskiviikko;43;19;62;6;4;10
89;23.11.2011;2011;11;22;Keskiviikko;25;9;34;5;3;8
89;23.11.2011;2011;11;23;Keskiviikko;8;12;20;1;2;3
89;24.11.2011;2011;11;00;Torstai;9;3;12;1;3;4
89;24.11.2011;2011;11;01;Torstai;2;2;4;1;2;3
89;24.11.2011;2011;11;02;Torstai;2;2;4;2;0;2
89;24.11.2011;2011;11;03;Torstai;4;4;8;1;0;1
89;24.11.2011;2011;11;04;Torstai;0;4;4;2;0;2
89;24.11.2011;2011;11;05;Torstai;4;10;14;0;0;0
89;24.11.2011;2011;11;06;Torstai;13;45;58;4;3;7
89;24.11.2011;2011;11;07;Torstai;28;112;140;3;26;29
89;24.11.2011;2011;11;08;Torstai;47;155;202;13;35;48
89;24.11.2011;2011;11;09;Torstai;37;69;106;5;21;26
89;24.11.2011;2011;11;10;Torstai;29;38;67;14;20;34
89;24.11.2011;2011;11;11;Torstai;58;70;128;22;17;39
89;24.11.2011;2011;11;12;Torstai;55;71;126;22;51;73
89;24.11.2011;2011;11;13;Torstai;71;106;177;28;28;56
89;24.11.2011;2011;11;14;Torstai;108;72;180;36;32;68
89;24.11.2011;2011;11;15;Torstai;137;70;207;23;27;50
89;24.11.2011;2011;11;16;Torstai;148;66;214;36;30;66
89;24.11.2011;2011;11;17;Torstai;84;73;157;32;28;60
89;24.11.2011;2011;11;18;Torstai;70;43;113;26;29;55
89;24.11.2011;2011;11;19;Torstai;57;33;90;15;15;30
89;24.11.2011;2011;11;20;Torstai;48;45;93;27;18;45
89;24.11.2011;2011;11;21;Torstai;42;27;69;6;12;18
89;24.11.2011;2011;11;22;Torstai;19;9;28;4;3;7
89;24.11.2011;2011;11;23;Torstai;11;28;39;1;11;12
89;25.11.2011;2011;11;00;Perjantai;8;6;14;1;1;2
89;25.11.2011;2011;11;01;Perjantai;10;0;10;2;1;3
89;25.11.2011;2011;11;02;Perjantai;6;0;6;0;0;0
89;25.11.2011;2011;11;03;Perjantai;6;3;9;3;2;5
89;25.11.2011;2011;11;04;Perjantai;2;4;6;2;2;4
89;25.11.2011;2011;11;05;Perjantai;4;9;13;0;1;1
89;25.11.2011;2011;11;06;Perjantai;19;49;68;5;5;10
89;25.11.2011;2011;11;07;Perjantai;36;139;175;7;33;40
89;25.11.2011;2011;11;08;Perjantai;51;154;205;9;30;39
89;25.11.2011;2011;11;09;Perjantai;29;86;115;13;18;31
89;25.11.2011;2011;11;10;Perjantai;42;77;119;15;19;34
89;25.11.2011;2011;11;11;Perjantai;62;68;130;31;27;58
89;25.11.2011;2011;11;12;Perjantai;65;72;137;23;27;50
89;25.11.2011;2011;11;13;Perjantai;90;74;164;29;16;45
89;25.11.2011;2011;11;14;Perjantai;113;81;194;16;17;33
89;25.11.2011;2011;11;15;Perjantai;126;65;191;40;41;81
89;25.11.2011;2011;11;16;Perjantai;115;45;160;23;15;38
89;25.11.2011;2011;11;17;Perjantai;56;54;110;15;18;33
89;25.11.2011;2011;11;18;Perjantai;36;45;81;14;17;31
89;25.11.2011;2011;11;19;Perjantai;34;24;58;12;8;20
89;25.11.2011;2011;11;20;Perjantai;30;20;50;9;3;12
89;25.11.2011;2011;11;21;Perjantai;31;11;42;3;5;8
89;25.11.2011;2011;11;22;Perjantai;13;17;30;2;0;2
89;25.11.2011;2011;11;23;Perjantai;16;15;31;8;14;22
89;26.11.2011;2011;11;00;Lauantai;13;10;23;1;9;10
89;26.11.2011;2011;11;01;Lauantai;18;7;25;3;1;4
89;26.11.2011;2011;11;02;Lauantai;24;2;26;11;4;15
89;26.11.2011;2011;11;03;Lauantai;19;4;23;14;0;14
89;26.11.2011;2011;11;04;Lauantai;14;1;15;8;2;10
89;26.11.2011;2011;11;05;Lauantai;1;5;6;0;1;1
89;26.11.2011;2011;11;06;Lauantai;8;14;22;2;5;7
89;26.11.2011;2011;11;07;Lauantai;7;11;18;1;1;2
89;26.11.2011;2011;11;08;Lauantai;7;13;20;3;7;10
89;26.11.2011;2011;11;09;Lauantai;5;31;36;13;21;34
89;26.11.2011;2011;11;10;Lauantai;5;30;35;8;21;29
89;26.11.2011;2011;11;11;Lauantai;17;37;54;9;24;33
89;26.11.2011;2011;11;12;Lauantai;25;38;63;22;21;43
89;26.11.2011;2011;11;13;Lauantai;37;27;64;17;29;46
89;26.11.2011;2011;11;14;Lauantai;39;32;71;28;15;43
89;26.11.2011;2011;11;15;Lauantai;32;19;51;20;23;43
89;26.11.2011;2011;11;16;Lauantai;38;26;64;15;17;32
89;26.11.2011;2011;11;17;Lauantai;17;31;48;14;17;31
89;26.11.2011;2011;11;18;Lauantai;18;20;38;11;13;24
89;26.11.2011;2011;11;19;Lauantai;21;11;32;10;8;18
89;26.11.2011;2011;11;20;Lauantai;12;13;25;7;7;14
89;26.11.2011;2011;11;21;Lauantai;18;16;34;1;2;3
89;26.11.2011;2011;11;22;Lauantai;12;6;18;0;3;3
89;26.11.2011;2011;11;23;Lauantai;8;10;18;5;4;9
89;27.11.2011;2011;11;00;Sunnuntai;12;11;23;2;4;6
89;27.11.2011;2011;11;01;Sunnuntai;13;7;20;7;3;10
89;27.11.2011;2011;11;02;Sunnuntai;9;0;9;8;1;9
89;27.11.2011;2011;11;03;Sunnuntai;15;3;18;6;1;7
89;27.11.2011;2011;11;04;Sunnuntai;10;1;11;7;1;8
89;27.11.2011;2011;11;05;Sunnuntai;1;0;1;2;1;3
89;27.11.2011;2011;11;06;Sunnuntai;3;8;11;2;2;4
89;27.11.2011;2011;11;07;Sunnuntai;2;4;6;3;3;6
89;27.11.2011;2011;11;08;Sunnuntai;7;15;22;8;6;14
89;27.11.2011;2011;11;09;Sunnuntai;7;21;28;15;29;44
89;27.11.2011;2011;11;10;Sunnuntai;16;17;33;22;37;59
89;27.11.2011;2011;11;11;Sunnuntai;17;45;62;40;37;77
89;27.11.2011;2011;11;12;Sunnuntai;28;55;83;42;57;99
89;27.11.2011;2011;11;13;Sunnuntai;36;48;84;44;59;103
89;27.11.2011;2011;11;14;Sunnuntai;49;49;98;49;47;96
89;27.11.2011;2011;11;15;Sunnuntai;44;41;85;33;30;63
89;27.11.2011;2011;11;16;Sunnuntai;35;32;67;35;21;56
89;27.11.2011;2011;11;17;Sunnuntai;31;25;56;28;23;51
89;27.11.2011;2011;11;18;Sunnuntai;28;29;57;26;32;58
89;27.11.2011;2011;11;19;Sunnuntai;23;15;38;9;25;34
89;27.11.2011;2011;11;20;Sunnuntai;26;6;32;12;11;23
89;27.11.2011;2011;11;21;Sunnuntai;17;12;29;12;6;18
89;27.11.2011;2011;11;22;Sunnuntai;11;9;20;8;4;12
89;27.11.2011;2011;11;23;Sunnuntai;6;3;9;1;3;4
89;28.11.2011;2011;11;00;Maanantai;4;2;6;1;1;2
89;28.11.2011;2011;11;01;Maanantai;3;0;3;1;0;1
89;28.11.2011;2011;11;02;Maanantai;3;1;4;0;1;1
89;28.11.2011;2011;11;03;Maanantai;1;2;3;2;1;3
89;28.11.2011;2011;11;04;Maanantai;0;7;7;1;0;1
89;28.11.2011;2011;11;05;Maanantai;6;8;14;1;2;3
89;28.11.2011;2011;11;06;Maanantai;17;59;76;2;8;10
89;28.11.2011;2011;11;07;Maanantai;35;121;156;6;29;35
89;28.11.2011;2011;11;08;Maanantai;49;177;226;11;38;49
89;28.11.2011;2011;11;09;Maanantai;52;105;157;9;44;53
89;28.11.2011;2011;11;10;Maanantai;40;56;96;14;30;44
89;28.11.2011;2011;11;11;Maanantai;49;84;133;24;30;54
89;28.11.2011;2011;11;12;Maanantai;60;69;129;26;36;62
89;28.11.2011;2011;11;13;Maanantai;76;69;145;18;30;48
89;28.11.2011;2011;11;14;Maanantai;91;80;171;39;22;61
89;28.11.2011;2011;11;15;Maanantai;141;74;215;49;51;100
89;28.11.2011;2011;11;16;Maanantai;169;80;249;35;29;64
89;28.11.2011;2011;11;17;Maanantai;88;50;138;35;19;54
89;28.11.2011;2011;11;18;Maanantai;68;51;119;40;33;73
89;28.11.2011;2011;11;19;Maanantai;60;35;95;25;19;44
89;28.11.2011;2011;11;20;Maanantai;51;15;66;28;24;52
89;28.11.2011;2011;11;21;Maanantai;42;18;60;9;8;17
89;28.11.2011;2011;11;22;Maanantai;12;8;20;5;6;11
89;28.11.2011;2011;11;23;Maanantai;7;3;10;3;2;5
89;29.11.2011;2011;11;00;Tiistai;2;3;5;1;0;1
89;29.11.2011;2011;11;01;Tiistai;0;2;2;0;0;0
89;29.11.2011;2011;11;02;Tiistai;2;0;2;3;0;3
89;29.11.2011;2011;11;03;Tiistai;0;1;1;0;1;1
89;29.11.2011;2011;11;04;Tiistai;1;4;5;0;1;1
89;29.11.2011;2011;11;05;Tiistai;5;12;17;0;1;1
89;29.11.2011;2011;11;06;Tiistai;15;60;75;7;9;16
89;29.11.2011;2011;11;07;Tiistai;58;162;220;4;37;41
89;29.11.2011;2011;11;08;Tiistai;45;162;207;14;53;67
89;29.11.2011;2011;11;09;Tiistai;37;93;130;15;23;38
89;29.11.2011;2011;11;10;Tiistai;52;58;110;19;37;56
89;29.11.2011;2011;11;11;Tiistai;61;66;127;30;31;61
89;29.11.2011;2011;11;12;Tiistai;55;55;110;26;32;58
89;29.11.2011;2011;11;13;Tiistai;68;65;133;22;36;58
89;29.11.2011;2011;11;14;Tiistai;103;48;151;34;37;71
89;29.11.2011;2011;11;15;Tiistai;138;72;210;25;28;53
89;29.11.2011;2011;11;16;Tiistai;141;77;218;46;15;61
89;29.11.2011;2011;11;17;Tiistai;84;51;135;35;17;52
89;29.11.2011;2011;11;18;Tiistai;65;44;109;35;22;57
89;29.11.2011;2011;11;19;Tiistai;48;39;87;30;30;60
89;29.11.2011;2011;11;20;Tiistai;55;25;80;16;21;37
89;29.11.2011;2011;11;21;Tiistai;39;21;60;11;5;16
89;29.11.2011;2011;11;22;Tiistai;18;4;22;4;4;8
89;29.11.2011;2011;11;23;Tiistai;8;4;12;2;3;5
89;30.11.2011;2011;11;00;Keskiviikko;5;1;6;1;1;2
89;30.11.2011;2011;11;01;Keskiviikko;3;2;5;0;0;0
89;30.11.2011;2011;11;02;Keskiviikko;1;1;2;0;1;1
89;30.11.2011;2011;11;03;Keskiviikko;0;3;3;0;0;0
89;30.11.2011;2011;11;04;Keskiviikko;1;5;6;0;1;1
89;30.11.2011;2011;11;05;Keskiviikko;3;12;15;0;2;2
89;30.11.2011;2011;11;06;Keskiviikko;11;62;73;3;10;13
89;30.11.2011;2011;11;07;Keskiviikko;33;141;174;5;37;42
89;30.11.2011;2011;11;08;Keskiviikko;38;167;205;17;40;57
89;30.11.2011;2011;11;09;Keskiviikko;41;77;118;12;36;48
89;30.11.2011;2011;11;10;Keskiviikko;43;59;102;17;27;44
89;30.11.2011;2011;11;11;Keskiviikko;49;65;114;26;19;45
89;30.11.2011;2011;11;12;Keskiviikko;55;65;120;17;21;38
89;30.11.2011;2011;11;13;Keskiviikko;65;58;123;16;22;38
89;30.11.2011;2011;11;14;Keskiviikko;86;61;147;25;19;44
89;30.11.2011;2011;11;15;Keskiviikko;141;79;220;24;17;41
89;30.11.2011;2011;11;16;Keskiviikko;130;76;206;29;12;41
89;30.11.2011;2011;11;17;Keskiviikko;68;65;133;35;21;56
89;30.11.2011;2011;11;18;Keskiviikko;62;36;98;21;13;34
89;30.11.2011;2011;11;19;Keskiviikko;52;32;84;27;20;47
89;30.11.2011;2011;11;20;Keskiviikko;62;34;96;21;19;40
89;30.11.2011;2011;11;21;Keskiviikko;33;16;49;9;5;14
89;30.11.2011;2011;11;22;Keskiviikko;12;17;29;8;3;11
89;30.11.2011;2011;11;23;Keskiviikko;10;6;16;2;2;4
89;01.12.2011;2011;12;00;Torstai;6;1;7;3;4;7
89;01.12.2011;2011;12;01;Torstai;6;0;6;2;1;3
89;01.12.2011;2011;12;02;Torstai;3;2;5;0;1;1
89;01.12.2011;2011;12;03;Torstai;2;1;3;1;0;1
89;01.12.2011;2011;12;04;Torstai;2;7;9;3;0;3
89;01.12.2011;2011;12;05;Torstai;5;6;11;1;2;3
89;01.12.2011;2011;12;06;Torstai;12;52;64;4;7;11
89;01.12.2011;2011;12;07;Torstai;40;145;185;4;32;36
89;01.12.2011;2011;12;08;Torstai;51;167;218;18;35;53
89;01.12.2011;2011;12;09;Torstai;38;112;150;17;37;54
89;01.12.2011;2011;12;10;Torstai;35;71;106;17;41;58
89;01.12.2011;2011;12;11;Torstai;52;71;123;19;24;43
89;01.12.2011;2011;12;12;Torstai;65;67;132;26;25;51
89;01.12.2011;2011;12;13;Torstai;63;62;125;16;29;45
89;01.12.2011;2011;12;14;Torstai;100;69;169;25;23;48
89;01.12.2011;2011;12;15;Torstai;134;65;199;34;20;54
89;01.12.2011;2011;12;16;Torstai;181;74;255;46;31;77
89;01.12.2011;2011;12;17;Torstai;103;63;166;30;29;59
89;01.12.2011;2011;12;18;Torstai;68;42;110;34;23;57
89;01.12.2011;2011;12;19;Torstai;53;32;85;31;18;49
89;01.12.2011;2011;12;20;Torstai;51;34;85;26;20;46
89;01.12.2011;2011;12;21;Torstai;39;17;56;6;10;16
89;01.12.2011;2011;12;22;Torstai;18;8;26;4;5;9
89;01.12.2011;2011;12;23;Torstai;9;4;13;6;1;7
89;02.12.2011;2011;12;00;Perjantai;5;3;8;2;0;2
89;02.12.2011;2011;12;01;Perjantai;3;1;4;4;1;5
89;02.12.2011;2011;12;02;Perjantai;1;1;2;2;1;3
89;02.12.2011;2011;12;03;Perjantai;2;4;6;2;0;2
89;02.12.2011;2011;12;04;Perjantai;3;4;7;1;0;1
89;02.12.2011;2011;12;05;Perjantai;3;9;12;1;0;1
89;02.12.2011;2011;12;06;Perjantai;17;59;76;4;5;9
89;02.12.2011;2011;12;07;Perjantai;40;130;170;7;39;46
89;02.12.2011;2011;12;08;Perjantai;40;139;179;10;38;48
89;02.12.2011;2011;12;09;Perjantai;24;86;110;8;24;32
89;02.12.2011;2011;12;10;Perjantai;31;69;100;18;19;37
89;02.12.2011;2011;12;11;Perjantai;47;69;116;16;27;43
89;02.12.2011;2011;12;12;Perjantai;75;102;177;21;43;64
89;02.12.2011;2011;12;13;Perjantai;85;73;158;26;26;52
89;02.12.2011;2011;12;14;Perjantai;141;75;216;23;33;56
89;02.12.2011;2011;12;15;Perjantai;140;53;193;36;30;66
89;02.12.2011;2011;12;16;Perjantai;109;79;188;32;21;53
89;02.12.2011;2011;12;17;Perjantai;60;59;119;22;13;35
89;02.12.2011;2011;12;18;Perjantai;56;38;94;18;18;36
89;02.12.2011;2011;12;19;Perjantai;46;47;93;10;9;19
89;02.12.2011;2011;12;20;Perjantai;26;34;60;13;13;26
89;02.12.2011;2011;12;21;Perjantai;38;15;53;16;12;28
89;02.12.2011;2011;12;22;Perjantai;16;21;37;5;4;9
89;02.12.2011;2011;12;23;Perjantai;22;11;33;4;4;8
89;03.12.2011;2011;12;00;Lauantai;18;13;31;4;2;6
89;03.12.2011;2011;12;01;Lauantai;17;4;21;6;2;8
89;03.12.2011;2011;12;02;Lauantai;15;5;20;11;1;12
89;03.12.2011;2011;12;03;Lauantai;8;4;12;11;1;12
89;03.12.2011;2011;12;04;Lauantai;10;2;12;13;0;13
89;03.12.2011;2011;12;05;Lauantai;4;6;10;2;1;3
89;03.12.2011;2011;12;06;Lauantai;4;17;21;1;5;6
89;03.12.2011;2011;12;07;Lauantai;10;17;27;5;6;11
89;03.12.2011;2011;12;08;Lauantai;13;19;32;7;13;20
89;03.12.2011;2011;12;09;Lauantai;11;46;57;14;41;55
89;03.12.2011;2011;12;10;Lauantai;23;58;81;21;31;52
89;03.12.2011;2011;12;11;Lauantai;37;84;121;20;68;88
89;03.12.2011;2011;12;12;Lauantai;48;82;130;38;39;77
89;03.12.2011;2011;12;13;Lauantai;77;56;133;30;41;71
89;03.12.2011;2011;12;14;Lauantai;68;40;108;35;27;62
89;03.12.2011;2011;12;15;Lauantai;57;43;100;35;15;50
89;03.12.2011;2011;12;16;Lauantai;51;40;91;27;17;44
89;03.12.2011;2011;12;17;Lauantai;33;28;61;21;16;37
89;03.12.2011;2011;12;18;Lauantai;34;18;52;11;21;32
89;03.12.2011;2011;12;19;Lauantai;26;23;49;6;8;14
89;03.12.2011;2011;12;20;Lauantai;18;23;41;10;11;21
89;03.12.2011;2011;12;21;Lauantai;31;11;42;2;8;10
89;03.12.2011;2011;12;22;Lauantai;8;15;23;3;4;7
89;03.12.2011;2011;12;23;Lauantai;7;24;31;5;5;10
89;04.12.2011;2011;12;00;Sunnuntai;7;9;16;4;2;6
89;04.12.2011;2011;12;01;Sunnuntai;13;10;23;9;1;10
89;04.12.2011;2011;12;02;Sunnuntai;12;3;15;11;2;13
89;04.12.2011;2011;12;03;Sunnuntai;14;2;16;25;2;27
89;04.12.2011;2011;12;04;Sunnuntai;16;0;16;7;2;9
89;04.12.2011;2011;12;05;Sunnuntai;2;4;6;0;1;1
89;04.12.2011;2011;12;06;Sunnuntai;3;4;7;1;3;4
89;04.12.2011;2011;12;07;Sunnuntai;5;7;12;2;2;4
89;04.12.2011;2011;12;08;Sunnuntai;3;6;9;5;1;6
89;04.12.2011;2011;12;09;Sunnuntai;7;12;19;9;13;22
89;04.12.2011;2011;12;10;Sunnuntai;8;30;38;11;17;28
89;04.12.2011;2011;12;11;Sunnuntai;11;37;48;17;37;54
89;04.12.2011;2011;12;12;Sunnuntai;27;28;55;20;28;48
89;04.12.2011;2011;12;13;Sunnuntai;29;49;78;23;30;53
89;04.12.2011;2011;12;14;Sunnuntai;29;30;59;23;28;51
89;04.12.2011;2011;12;15;Sunnuntai;34;29;63;25;13;38
89;04.12.2011;2011;12;16;Sunnuntai;30;22;52;24;22;46
89;04.12.2011;2011;12;17;Sunnuntai;30;23;53;22;12;34
89;04.12.2011;2011;12;18;Sunnuntai;29;17;46;23;16;39
89;04.12.2011;2011;12;19;Sunnuntai;32;11;43;17;12;29
89;04.12.2011;2011;12;20;Sunnuntai;12;16;28;11;10;21
89;04.12.2011;2011;12;21;Sunnuntai;12;11;23;5;5;10
89;04.12.2011;2011;12;22;Sunnuntai;11;9;20;3;3;6
89;04.12.2011;2011;12;23;Sunnuntai;8;5;13;1;0;1
89;05.12.2011;2011;12;00;Maanantai;5;8;13;1;3;4
89;05.12.2011;2011;12;01;Maanantai;4;1;5;0;0;0
89;05.12.2011;2011;12;02;Maanantai;4;2;6;0;0;0
89;05.12.2011;2011;12;03;Maanantai;6;2;8;1;0;1
89;05.12.2011;2011;12;04;Maanantai;2;5;7;0;1;1
89;05.12.2011;2011;12;05;Maanantai;2;12;14;1;3;4
89;05.12.2011;2011;12;06;Maanantai;7;28;35;2;5;7
89;05.12.2011;2011;12;07;Maanantai;19;57;76;9;19;28
89;05.12.2011;2011;12;08;Maanantai;17;87;104;5;21;26
89;05.12.2011;2011;12;09;Maanantai;29;54;83;15;29;44
89;05.12.2011;2011;12;10;Maanantai;19;44;63;11;30;41
89;05.12.2011;2011;12;11;Maanantai;22;45;67;22;29;51
89;05.12.2011;2011;12;12;Maanantai;32;60;92;15;26;41
89;05.12.2011;2011;12;13;Maanantai;37;39;76;18;26;44
89;05.12.2011;2011;12;14;Maanantai;60;42;102;25;19;44
89;05.12.2011;2011;12;15;Maanantai;78;48;126;38;25;63
89;05.12.2011;2011;12;16;Maanantai;79;40;119;33;17;50
89;05.12.2011;2011;12;17;Maanantai;59;47;106;24;14;38
89;05.12.2011;2011;12;18;Maanantai;46;33;79;27;26;53
89;05.12.2011;2011;12;19;Maanantai;32;17;49;18;18;36
89;05.12.2011;2011;12;20;Maanantai;30;19;49;19;12;31
89;05.12.2011;2011;12;21;Maanantai;30;11;41;9;8;17
89;05.12.2011;2011;12;22;Maanantai;16;10;26;5;7;12
89;05.12.2011;2011;12;23;Maanantai;9;11;20;4;5;9
89;06.12.2011;2011;12;00;Tiistai;11;13;24;0;3;3
89;06.12.2011;2011;12;01;Tiistai;5;10;15;3;4;7
89;06.12.2011;2011;12;02;Tiistai;10;3;13;8;0;8
89;06.12.2011;2011;12;03;Tiistai;15;1;16;9;1;10
89;06.12.2011;2011;12;04;Tiistai;11;4;15;5;1;6
89;06.12.2011;2011;12;05;Tiistai;4;0;4;2;0;2
89;06.12.2011;2011;12;06;Tiistai;4;3;7;2;2;4
89;06.12.2011;2011;12;07;Tiistai;5;10;15;6;4;10
89;06.12.2011;2011;12;08;Tiistai;1;11;12;8;10;18
89;06.12.2011;2011;12;09;Tiistai;8;15;23;23;12;35
89;06.12.2011;2011;12;10;Tiistai;7;21;28;33;40;73
89;06.12.2011;2011;12;11;Tiistai;21;24;45;37;51;88
89;06.12.2011;2011;12;12;Tiistai;17;30;47;53;44;97
89;06.12.2011;2011;12;13;Tiistai;26;26;52;46;45;91
89;06.12.2011;2011;12;14;Tiistai;27;22;49;57;63;120
89;06.12.2011;2011;12;15;Tiistai;21;12;33;45;36;81
89;06.12.2011;2011;12;16;Tiistai;21;26;47;30;55;85
89;06.12.2011;2011;12;17;Tiistai;16;26;42;23;34;57
89;06.12.2011;2011;12;18;Tiistai;20;16;36;27;29;56
89;06.12.2011;2011;12;19;Tiistai;14;13;27;12;9;21
89;06.12.2011;2011;12;20;Tiistai;19;11;30;9;12;21
89;06.12.2011;2011;12;21;Tiistai;19;4;23;9;5;14
89;06.12.2011;2011;12;22;Tiistai;10;9;19;2;3;5
89;06.12.2011;2011;12;23;Tiistai;4;2;6;2;1;3
89;07.12.2011;2011;12;00;Keskiviikko;3;0;3;4;0;4
89;07.12.2011;2011;12;01;Keskiviikko;0;0;0;0;1;1
89;07.12.2011;2011;12;02;Keskiviikko;1;0;1;0;0;0
89;07.12.2011;2011;12;03;Keskiviikko;0;4;4;0;0;0
89;07.12.2011;2011;12;04;Keskiviikko;1;6;7;1;1;2
89;07.12.2011;2011;12;05;Keskiviikko;2;8;10;1;2;3
89;07.12.2011;2011;12;06;Keskiviikko;13;48;61;3;8;11
89;07.12.2011;2011;12;07;Keskiviikko;34;145;179;4;47;51
89;07.12.2011;2011;12;08;Keskiviikko;62;155;217;15;41;56
89;07.12.2011;2011;12;09;Keskiviikko;31;74;105;9;38;47
89;07.12.2011;2011;12;10;Keskiviikko;35;89;124;22;32;54
89;07.12.2011;2011;12;11;Keskiviikko;45;60;105;25;39;64
89;07.12.2011;2011;12;12;Keskiviikko;56;71;127;34;39;73
89;07.12.2011;2011;12;13;Keskiviikko;62;54;116;42;23;65
89;07.12.2011;2011;12;14;Keskiviikko;88;67;155;30;24;54
89;07.12.2011;2011;12;15;Keskiviikko;127;70;197;35;25;60
89;07.12.2011;2011;12;16;Keskiviikko;173;80;253;51;26;77
89;07.12.2011;2011;12;17;Keskiviikko;97;59;156;37;28;65
89;07.12.2011;2011;12;18;Keskiviikko;71;35;106;31;28;59
89;07.12.2011;2011;12;19;Keskiviikko;64;39;103;31;30;61
89;07.12.2011;2011;12;20;Keskiviikko;44;28;72;12;17;29
89;07.12.2011;2011;12;21;Keskiviikko;47;16;63;17;13;30
89;07.12.2011;2011;12;22;Keskiviikko;12;14;26;6;5;11
89;07.12.2011;2011;12;23;Keskiviikko;7;7;14;0;4;4
89;08.12.2011;2011;12;00;Torstai;5;2;7;2;0;2
89;08.12.2011;2011;12;01;Torstai;5;7;12;2;3;5
89;08.12.2011;2011;12;02;Torstai;7;0;7;3;0;3
89;08.12.2011;2011;12;03;Torstai;4;2;6;0;0;0
89;08.12.2011;2011;12;04;Torstai;5;6;11;1;0;1
89;08.12.2011;2011;12;05;Torstai;1;8;9;2;0;2
89;08.12.2011;2011;12;06;Torstai;12;51;63;4;15;19
89;08.12.2011;2011;12;07;Torstai;37;125;162;3;41;44
89;08.12.2011;2011;12;08;Torstai;49;151;200;15;52;67
89;08.12.2011;2011;12;09;Torstai;44;78;122;18;42;60
89;08.12.2011;2011;12;10;Torstai;24;52;76;17;27;44
89;08.12.2011;2011;12;11;Torstai;40;48;88;30;32;62
89;08.12.2011;2011;12;12;Torstai;31;45;76;36;22;58
89;08.12.2011;2011;12;13;Torstai;52;60;112;31;30;61
89;08.12.2011;2011;12;14;Torstai;98;56;154;30;28;58
89;08.12.2011;2011;12;15;Torstai;130;67;197;41;28;69
89;08.12.2011;2011;12;16;Torstai;134;68;202;47;22;69
89;08.12.2011;2011;12;17;Torstai;91;73;164;25;25;50
89;08.12.2011;2011;12;18;Torstai;70;39;109;29;28;57
89;08.12.2011;2011;12;19;Torstai;56;25;81;33;20;53
89;08.12.2011;2011;12;20;Torstai;45;27;72;27;17;44
89;08.12.2011;2011;12;21;Torstai;32;15;47;15;8;23
89;08.12.2011;2011;12;22;Torstai;17;14;31;10;16;26
89;08.12.2011;2011;12;23;Torstai;10;4;14;1;1;2
89;09.12.2011;2011;12;00;Perjantai;8;2;10;2;0;2
89;09.12.2011;2011;12;01;Perjantai;4;2;6;2;0;2
89;09.12.2011;2011;12;02;Perjantai;1;1;2;1;1;2
89;09.12.2011;2011;12;03;Perjantai;10;3;13;1;0;1
89;09.12.2011;2011;12;04;Perjantai;1;7;8;0;0;0
89;09.12.2011;2011;12;05;Perjantai;2;12;14;1;2;3
89;09.12.2011;2011;12;06;Perjantai;21;53;74;4;13;17
89;09.12.2011;2011;12;07;Perjantai;30;137;167;4;43;47
89;09.12.2011;2011;12;08;Perjantai;48;134;182;14;43;57
89;09.12.2011;2011;12;09;Perjantai;28;81;109;14;42;56
89;09.12.2011;2011;12;10;Perjantai;29;56;85;23;31;54
89;09.12.2011;2011;12;11;Perjantai;46;71;117;25;35;60
89;09.12.2011;2011;12;12;Perjantai;50;66;116;27;32;59
89;09.12.2011;2011;12;13;Perjantai;72;66;138;22;30;52
89;09.12.2011;2011;12;14;Perjantai;119;73;192;33;25;58
89;09.12.2011;2011;12;15;Perjantai;127;65;192;30;20;50
89;09.12.2011;2011;12;16;Perjantai;113;71;184;28;15;43
89;09.12.2011;2011;12;17;Perjantai;80;70;150;28;25;53
89;09.12.2011;2011;12;18;Perjantai;45;60;105;23;22;45
89;09.12.2011;2011;12;19;Perjantai;45;28;73;21;16;37
89;09.12.2011;2011;12;20;Perjantai;39;24;63;6;8;14
89;09.12.2011;2011;12;21;Perjantai;40;20;60;12;13;25
89;09.12.2011;2011;12;22;Perjantai;26;13;39;12;2;14
89;09.12.2011;2011;12;23;Perjantai;17;10;27;0;0;0
89;10.12.2011;2011;12;00;Lauantai;11;10;21;4;2;6
89;10.12.2011;2011;12;01;Lauantai;10;8;18;6;2;8
89;10.12.2011;2011;12;02;Lauantai;7;5;12;11;1;12
89;10.12.2011;2011;12;03;Lauantai;8;7;15;11;1;12
89;10.12.2011;2011;12;04;Lauantai;5;4;9;13;0;13
89;10.12.2011;2011;12;05;Lauantai;5;4;9;2;1;3
89;10.12.2011;2011;12;06;Lauantai;11;8;19;1;5;6
89;10.12.2011;2011;12;07;Lauantai;6;4;10;5;6;11
89;10.12.2011;2011;12;08;Lauantai;14;10;24;7;13;20
89;10.12.2011;2011;12;09;Lauantai;26;23;49;14;41;55
89;10.12.2011;2011;12;10;Lauantai;23;21;44;21;31;52
89;10.12.2011;2011;12;11;Lauantai;35;34;69;20;68;88
89;10.12.2011;2011;12;12;Lauantai;37;35;72;38;39;77
89;10.12.2011;2011;12;13;Lauantai;34;31;65;30;41;71
89;10.12.2011;2011;12;14;Lauantai;38;36;74;35;27;62
89;10.12.2011;2011;12;15;Lauantai;42;40;82;35;15;50
89;10.12.2011;2011;12;16;Lauantai;32;28;60;27;17;44
89;10.12.2011;2011;12;17;Lauantai;40;38;78;21;16;37
89;10.12.2011;2011;12;18;Lauantai;29;26;55;11;21;32
89;10.12.2011;2011;12;19;Lauantai;24;22;46;6;8;14
89;10.12.2011;2011;12;20;Lauantai;26;23;49;10;11;21
89;10.12.2011;2011;12;21;Lauantai;21;17;38;2;8;10
89;10.12.2011;2011;12;22;Lauantai;8;7;15;3;4;7
89;10.12.2011;2011;12;23;Lauantai;14;13;27;5;5;10
89;11.12.2011;2011;12;00;Sunnuntai;15;12;27;4;2;6
89;11.12.2011;2011;12;01;Sunnuntai;11;8;19;9;1;10
89;11.12.2011;2011;12;02;Sunnuntai;15;13;28;11;2;13
89;11.12.2011;2011;12;03;Sunnuntai;12;12;24;25;2;27
89;11.12.2011;2011;12;04;Sunnuntai;9;7;16;7;2;9
89;11.12.2011;2011;12;05;Sunnuntai;4;1;5;0;1;1
89;11.12.2011;2011;12;06;Sunnuntai;6;3;9;1;3;4
89;11.12.2011;2011;12;07;Sunnuntai;4;3;7;2;2;4
89;11.12.2011;2011;12;08;Sunnuntai;7;5;12;5;1;6
89;11.12.2011;2011;12;09;Sunnuntai;8;6;14;9;13;22
89;11.12.2011;2011;12;10;Sunnuntai;11;9;20;11;17;28
89;11.12.2011;2011;12;11;Sunnuntai;18;17;35;17;37;54
89;11.12.2011;2011;12;12;Sunnuntai;25;24;49;20;28;48
89;11.12.2011;2011;12;13;Sunnuntai;27;24;51;23;30;53
89;11.12.2011;2011;12;14;Sunnuntai;38;35;73;23;28;51
89;11.12.2011;2011;12;15;Sunnuntai;32;30;62;25;13;38
89;11.12.2011;2011;12;16;Sunnuntai;34;31;65;24;22;46
89;11.12.2011;2011;12;17;Sunnuntai;22;21;43;22;12;34
89;11.12.2011;2011;12;18;Sunnuntai;32;32;64;23;16;39
89;11.12.2011;2011;12;19;Sunnuntai;16;14;30;17;12;29
89;11.12.2011;2011;12;20;Sunnuntai;20;18;38;11;10;21
89;11.12.2011;2011;12;21;Sunnuntai;21;18;39;5;5;10
89;11.12.2011;2011;12;22;Sunnuntai;7;5;12;3;3;6
89;11.12.2011;2011;12;23;Sunnuntai;10;7;17;1;0;1
89;12.12.2011;2011;12;00;Maanantai;3;1;4;1;3;4
89;12.12.2011;2011;12;01;Maanantai;0;0;0;0;0;0
89;12.12.2011;2011;12;02;Maanantai;2;1;3;0;0;0
89;12.12.2011;2011;12;03;Maanantai;3;1;4;1;0;1
89;12.12.2011;2011;12;04;Maanantai;4;2;6;0;1;1
89;12.12.2011;2011;12;05;Maanantai;8;6;14;1;3;4
89;12.12.2011;2011;12;06;Maanantai;38;37;75;2;5;7
89;12.12.2011;2011;12;07;Maanantai;80;79;159;9;19;28
89;12.12.2011;2011;12;08;Maanantai;106;103;209;5;21;26
89;12.12.2011;2011;12;09;Maanantai;67;64;131;15;29;44
89;12.12.2011;2011;12;10;Maanantai;41;38;79;11;30;41
89;12.12.2011;2011;12;11;Maanantai;55;53;108;22;29;51
89;12.12.2011;2011;12;12;Maanantai;45;42;87;15;26;41
89;12.12.2011;2011;12;13;Maanantai;59;57;116;18;26;44
89;12.12.2011;2011;12;14;Maanantai;82;79;161;25;19;44
89;12.12.2011;2011;12;15;Maanantai;88;87;175;38;25;63
89;12.12.2011;2011;12;16;Maanantai;128;126;254;33;17;50
89;12.12.2011;2011;12;17;Maanantai;73;69;142;24;14;38
89;12.12.2011;2011;12;18;Maanantai;50;49;99;27;26;53
89;12.12.2011;2011;12;19;Maanantai;35;33;68;18;18;36
89;12.12.2011;2011;12;20;Maanantai;38;37;75;19;12;31
89;12.12.2011;2011;12;21;Maanantai;16;16;32;9;8;17
89;12.12.2011;2011;12;22;Maanantai;10;8;18;5;7;12
89;12.12.2011;2011;12;23;Maanantai;5;4;9;4;5;9
89;13.12.2011;2011;12;00;Tiistai;4;0;4;0;3;3
89;13.12.2011;2011;12;01;Tiistai;2;1;3;3;4;7
89;13.12.2011;2011;12;02;Tiistai;1;1;2;8;0;8
89;13.12.2011;2011;12;03;Tiistai;5;2;7;9;1;10
89;13.12.2011;2011;12;04;Tiistai;3;2;5;5;1;6
89;13.12.2011;2011;12;05;Tiistai;7;6;13;2;0;2
89;13.12.2011;2011;12;06;Tiistai;31;30;61;2;2;4
89;13.12.2011;2011;12;07;Tiistai;90;86;176;6;4;10
89;13.12.2011;2011;12;08;Tiistai;101;97;198;8;10;18
89;13.12.2011;2011;12;09;Tiistai;62;59;121;23;12;35
89;13.12.2011;2011;12;10;Tiistai;48;47;95;33;40;73
89;13.12.2011;2011;12;11;Tiistai;52;51;103;37;51;88
89;13.12.2011;2011;12;12;Tiistai;44;42;86;53;44;97
89;13.12.2011;2011;12;13;Tiistai;51;49;100;46;45;91
89;13.12.2011;2011;12;14;Tiistai;64;61;125;57;63;120
89;13.12.2011;2011;12;15;Tiistai;86;83;169;45;36;81
89;13.12.2011;2011;12;16;Tiistai;138;106;244;30;55;85
89;13.12.2011;2011;12;17;Tiistai;103;21;124;23;34;57
89;13.12.2011;2011;12;18;Tiistai;109;2;111;27;29;56
89;13.12.2011;2011;12;19;Tiistai;79;0;79;12;9;21
89;13.12.2011;2011;12;20;Tiistai;59;13;72;9;12;21
89;13.12.2011;2011;12;21;Tiistai;35;12;47;9;5;14
89;13.12.2011;2011;12;22;Tiistai;11;7;18;2;3;5
89;13.12.2011;2011;12;23;Tiistai;9;4;13;2;1;3
89;14.12.2011;2011;12;00;Keskiviikko;4;2;6;2;1;3
89;14.12.2011;2011;12;01;Keskiviikko;1;1;2;0;2;2
89;14.12.2011;2011;12;02;Keskiviikko;2;1;3;0;1;1
89;14.12.2011;2011;12;03;Keskiviikko;0;4;4;0;0;0
89;14.12.2011;2011;12;04;Keskiviikko;1;4;5;0;1;1
89;14.12.2011;2011;12;05;Keskiviikko;2;6;8;3;3;6
89;14.12.2011;2011;12;06;Keskiviikko;14;46;60;3;8;11
89;14.12.2011;2011;12;07;Keskiviikko;29;116;145;5;46;51
89;14.12.2011;2011;12;08;Keskiviikko;43;139;182;14;35;49
89;14.12.2011;2011;12;09;Keskiviikko;22;81;103;9;24;33
89;14.12.2011;2011;12;10;Keskiviikko;19;69;88;14;21;35
89;14.12.2011;2011;12;11;Keskiviikko;28;36;64;16;20;36
89;14.12.2011;2011;12;12;Keskiviikko;37;43;80;27;26;53
89;14.12.2011;2011;12;13;Keskiviikko;49;45;94;19;31;50
89;14.12.2011;2011;12;14;Keskiviikko;66;53;119;32;42;74
89;14.12.2011;2011;12;15;Keskiviikko;82;52;134;40;27;67
89;14.12.2011;2011;12;16;Keskiviikko;100;47;147;36;25;61
89;14.12.2011;2011;12;17;Keskiviikko;67;45;112;41;30;71
89;14.12.2011;2011;12;18;Keskiviikko;54;21;75;25;22;47
89;14.12.2011;2011;12;19;Keskiviikko;41;14;55;26;21;47
89;14.12.2011;2011;12;20;Keskiviikko;39;8;47;25;11;36
89;14.12.2011;2011;12;21;Keskiviikko;23;10;33;12;8;20
89;14.12.2011;2011;12;22;Keskiviikko;5;3;8;4;1;5
89;14.12.2011;2011;12;23;Keskiviikko;10;2;12;3;5;8
89;15.12.2011;2011;12;00;Torstai;3;2;5;1;3;4
89;15.12.2011;2011;12;01;Torstai;2;1;3;2;3;5
89;15.12.2011;2011;12;02;Torstai;1;1;2;4;0;4
89;15.12.2011;2011;12;03;Torstai;2;1;3;1;0;1
89;15.12.2011;2011;12;04;Torstai;5;4;9;1;5;6
89;15.12.2011;2011;12;05;Torstai;5;8;13;5;3;8
89;15.12.2011;2011;12;06;Torstai;9;35;44;0;15;15
89;15.12.2011;2011;12;07;Torstai;25;95;120;6;35;41
89;15.12.2011;2011;12;08;Torstai;45;125;170;19;43;62
89;15.12.2011;2011;12;09;Torstai;19;77;96;7;40;47
89;15.12.2011;2011;12;10;Torstai;21;32;53;16;30;46
89;15.12.2011;2011;12;11;Torstai;34;55;89;18;23;41
89;15.12.2011;2011;12;12;Torstai;28;43;71;27;32;59
89;15.12.2011;2011;12;13;Torstai;46;41;87;24;30;54
89;15.12.2011;2011;12;14;Torstai;74;51;125;44;27;71
89;15.12.2011;2011;12;15;Torstai;88;53;141;29;18;47
89;15.12.2011;2011;12;16;Torstai;107;29;136;45;26;71
89;15.12.2011;2011;12;17;Torstai;77;38;115;30;19;49
89;15.12.2011;2011;12;18;Torstai;47;21;68;26;16;42
89;15.12.2011;2011;12;19;Torstai;53;26;79;30;17;47
89;15.12.2011;2011;12;20;Torstai;40;16;56;23;8;31
89;15.12.2011;2011;12;21;Torstai;21;22;43;6;5;11
89;15.12.2011;2011;12;22;Torstai;13;6;19;5;6;11
89;15.12.2011;2011;12;23;Torstai;5;1;6;4;1;5
89;16.12.2011;2011;12;00;Perjantai;3;4;7;0;2;2
89;16.12.2011;2011;12;01;Perjantai;2;0;2;3;1;4
89;16.12.2011;2011;12;02;Perjantai;4;0;4;2;0;2
89;16.12.2011;2011;12;03;Perjantai;2;5;7;1;0;1
89;16.12.2011;2011;12;04;Perjantai;3;4;7;4;1;5
89;16.12.2011;2011;12;05;Perjantai;3;7;10;4;4;8
89;16.12.2011;2011;12;06;Perjantai;16;34;50;4;11;15
89;16.12.2011;2011;12;07;Perjantai;17;77;94;4;32;36
89;16.12.2011;2011;12;08;Perjantai;37;111;148;13;39;52
89;16.12.2011;2011;12;09;Perjantai;22;68;90;10;39;49
89;16.12.2011;2011;12;10;Perjantai;30;56;86;20;29;49
89;16.12.2011;2011;12;11;Perjantai;24;60;84;25;27;52
89;16.12.2011;2011;12;12;Perjantai;46;51;97;19;36;55
89;16.12.2011;2011;12;13;Perjantai;73;57;130;37;32;69
89;16.12.2011;2011;12;14;Perjantai;87;63;150;36;25;61
89;16.12.2011;2011;12;15;Perjantai;92;43;135;40;34;74
89;16.12.2011;2011;12;16;Perjantai;75;52;127;30;15;45
89;16.12.2011;2011;12;17;Perjantai;58;39;97;39;24;63
89;16.12.2011;2011;12;18;Perjantai;40;27;67;29;20;49
89;16.12.2011;2011;12;19;Perjantai;49;29;78;28;10;38
89;16.12.2011;2011;12;20;Perjantai;41;15;56;8;10;18
89;16.12.2011;2011;12;21;Perjantai;36;15;51;11;7;18
89;16.12.2011;2011;12;22;Perjantai;10;23;33;5;9;14
89;16.12.2011;2011;12;23;Perjantai;8;16;24;4;6;10
89;17.12.2011;2011;12;00;Lauantai;3;15;18;4;8;12
89;17.12.2011;2011;12;01;Lauantai;12;5;17;5;4;9
89;17.12.2011;2011;12;02;Lauantai;7;1;8;11;4;15
89;17.12.2011;2011;12;03;Lauantai;12;0;12;12;2;14
89;17.12.2011;2011;12;04;Lauantai;11;3;14;15;0;15
89;17.12.2011;2011;12;05;Lauantai;3;4;7;0;3;3
89;17.12.2011;2011;12;06;Lauantai;5;9;14;3;2;5
89;17.12.2011;2011;12;07;Lauantai;2;8;10;1;8;9
89;17.12.2011;2011;12;08;Lauantai;8;25;33;7;14;21
89;17.12.2011;2011;12;09;Lauantai;7;40;47;10;30;40
89;17.12.2011;2011;12;10;Lauantai;20;41;61;14;37;51
89;17.12.2011;2011;12;11;Lauantai;30;56;86;29;32;61
89;17.12.2011;2011;12;12;Lauantai;33;49;82;16;34;50
89;17.12.2011;2011;12;13;Lauantai;42;48;90;26;31;57
89;17.12.2011;2011;12;14;Lauantai;49;42;91;43;56;99
89;17.12.2011;2011;12;15;Lauantai;52;41;93;38;36;74
89;17.12.2011;2011;12;16;Lauantai;33;14;47;35;23;58
89;17.12.2011;2011;12;17;Lauantai;35;25;60;27;21;48
89;17.12.2011;2011;12;18;Lauantai;28;21;49;18;25;43
89;17.12.2011;2011;12;19;Lauantai;12;16;28;14;17;31
89;17.12.2011;2011;12;20;Lauantai;10;20;30;17;9;26
89;17.12.2011;2011;12;21;Lauantai;15;12;27;2;5;7
89;17.12.2011;2011;12;22;Lauantai;7;15;22;4;1;5
89;17.12.2011;2011;12;23;Lauantai;10;20;30;3;10;13
89;18.12.2011;2011;12;00;Sunnuntai;9;8;17;1;5;6
89;18.12.2011;2011;12;01;Sunnuntai;10;9;19;7;4;11
89;18.12.2011;2011;12;02;Sunnuntai;16;4;20;9;0;9
89;18.12.2011;2011;12;03;Sunnuntai;22;1;23;14;0;14
89;18.12.2011;2011;12;04;Sunnuntai;20;1;21;8;0;8
89;18.12.2011;2011;12;05;Sunnuntai;5;0;5;3;0;3
89;18.12.2011;2011;12;06;Sunnuntai;7;0;7;1;0;1
89;18.12.2011;2011;12;07;Sunnuntai;7;0;7;4;0;4
89;18.12.2011;2011;12;08;Sunnuntai;16;0;16;26;0;26
89;18.12.2011;2011;12;09;Sunnuntai;16;0;16;38;0;38
89;18.12.2011;2011;12;10;Sunnuntai;13;15;28;27;18;45
89;18.12.2011;2011;12;11;Sunnuntai;8;19;27;25;28;53
89;18.12.2011;2011;12;12;Sunnuntai;12;22;34;22;41;63
89;18.12.2011;2011;12;13;Sunnuntai;26;28;54;22;22;44
89;18.12.2011;2011;12;14;Sunnuntai;23;30;53;22;35;57
89;18.12.2011;2011;12;15;Sunnuntai;20;17;37;15;21;36
89;18.12.2011;2011;12;16;Sunnuntai;35;36;71;24;37;61
89;18.12.2011;2011;12;17;Sunnuntai;23;27;50;15;14;29
89;18.12.2011;2011;12;18;Sunnuntai;37;20;57;28;16;44
89;18.12.2011;2011;12;19;Sunnuntai;18;9;27;18;11;29
89;18.12.2011;2011;12;20;Sunnuntai;20;15;35;11;5;16
89;18.12.2011;2011;12;21;Sunnuntai;15;12;27;11;7;18
89;18.12.2011;2011;12;22;Sunnuntai;6;11;17;0;1;1
89;18.12.2011;2011;12;23;Sunnuntai;3;5;8;7;3;10
89;19.12.2011;2011;12;00;Maanantai;2;1;3;2;2;4
89;19.12.2011;2011;12;01;Maanantai;0;0;0;1;2;3
89;19.12.2011;2011;12;02;Maanantai;1;1;2;0;1;1
89;19.12.2011;2011;12;03;Maanantai;2;2;4;2;1;3
89;19.12.2011;2011;12;04;Maanantai;0;6;6;1;1;2
89;19.12.2011;2011;12;05;Maanantai;2;11;13;1;0;1
89;19.12.2011;2011;12;06;Maanantai;12;39;51;4;10;14
89;19.12.2011;2011;12;07;Maanantai;22;94;116;8;35;43
89;19.12.2011;2011;12;08;Maanantai;39;123;162;15;42;57
89;19.12.2011;2011;12;09;Maanantai;26;83;109;10;46;56
89;19.12.2011;2011;12;10;Maanantai;35;56;91;17;28;45
89;19.12.2011;2011;12;11;Maanantai;28;51;79;24;37;61
89;19.12.2011;2011;12;12;Maanantai;44;60;104;28;36;64
89;19.12.2011;2011;12;13;Maanantai;64;58;122;27;27;54
89;19.12.2011;2011;12;14;Maanantai;88;66;154;46;43;89
89;19.12.2011;2011;12;15;Maanantai;121;67;188;43;22;65
89;19.12.2011;2011;12;16;Maanantai;119;58;177;37;21;58
89;19.12.2011;2011;12;17;Maanantai;71;43;114;31;21;52
89;19.12.2011;2011;12;18;Maanantai;55;29;84;20;23;43
89;19.12.2011;2011;12;19;Maanantai;48;28;76;19;19;38
89;19.12.2011;2011;12;20;Maanantai;37;13;50;27;12;39
89;19.12.2011;2011;12;21;Maanantai;26;23;49;11;10;21
89;19.12.2011;2011;12;22;Maanantai;9;1;10;9;4;13
89;19.12.2011;2011;12;23;Maanantai;10;9;19;5;1;6
89;20.12.2011;2011;12;00;Tiistai;5;2;7;0;1;1
89;20.12.2011;2011;12;01;Tiistai;3;1;4;4;2;6
89;20.12.2011;2011;12;02;Tiistai;1;1;2;2;3;5
89;20.12.2011;2011;12;03;Tiistai;9;11;20;3;2;5
89;20.12.2011;2011;12;04;Tiistai;1;3;4;2;0;2
89;20.12.2011;2011;12;05;Tiistai;1;9;10;1;1;2
89;20.12.2011;2011;12;06;Tiistai;11;43;54;5;10;15
89;20.12.2011;2011;12;07;Tiistai;33;101;134;7;39;46
89;20.12.2011;2011;12;08;Tiistai;40;115;155;5;47;52
89;20.12.2011;2011;12;09;Tiistai;23;88;111;11;41;52
89;20.12.2011;2011;12;10;Tiistai;37;53;90;19;24;43
89;20.12.2011;2011;12;11;Tiistai;47;56;103;31;40;71
89;20.12.2011;2011;12;12;Tiistai;47;78;125;19;30;49
89;20.12.2011;2011;12;13;Tiistai;71;72;143;49;39;88
89;20.12.2011;2011;12;14;Tiistai;87;49;136;44;29;73
89;20.12.2011;2011;12;15;Tiistai;101;48;149;33;27;60
89;20.12.2011;2011;12;16;Tiistai;135;58;193;37;16;53
89;20.12.2011;2011;12;17;Tiistai;85;54;139;40;19;59
89;20.12.2011;2011;12;18;Tiistai;55;25;80;29;15;44
89;20.12.2011;2011;12;19;Tiistai;53;26;79;27;21;48
89;20.12.2011;2011;12;20;Tiistai;40;18;58;18;12;30
89;20.12.2011;2011;12;21;Tiistai;22;8;30;10;8;18
89;20.12.2011;2011;12;22;Tiistai;13;8;21;9;1;10
89;20.12.2011;2011;12;23;Tiistai;7;3;10;1;3;4
89;21.12.2011;2011;12;00;Keskiviikko;3;4;7;1;1;2
89;21.12.2011;2011;12;01;Keskiviikko;3;5;8;2;1;3
89;21.12.2011;2011;12;02;Keskiviikko;2;2;4;0;1;1
89;21.12.2011;2011;12;03;Keskiviikko;2;4;6;0;0;0
89;21.12.2011;2011;12;04;Keskiviikko;1;5;6;0;0;0
89;21.12.2011;2011;12;05;Keskiviikko;5;11;16;3;0;3
89;21.12.2011;2011;12;06;Keskiviikko;15;40;55;2;10;12
89;21.12.2011;2011;12;07;Keskiviikko;28;108;136;12;27;39
89;21.12.2011;2011;12;08;Keskiviikko;33;138;171;6;30;36
89;21.12.2011;2011;12;09;Keskiviikko;17;84;101;8;34;42
89;21.12.2011;2011;12;10;Keskiviikko;37;59;96;16;33;49
89;21.12.2011;2011;12;11;Keskiviikko;45;54;99;20;33;53
89;21.12.2011;2011;12;12;Keskiviikko;55;59;114;30;33;63
89;21.12.2011;2011;12;13;Keskiviikko;74;61;135;28;32;60
89;21.12.2011;2011;12;14;Keskiviikko;84;63;147;32;42;74
89;21.12.2011;2011;12;15;Keskiviikko;101;51;152;34;23;57
89;21.12.2011;2011;12;16;Keskiviikko;117;43;160;34;22;56
89;21.12.2011;2011;12;17;Keskiviikko;65;42;107;32;18;50
89;21.12.2011;2011;12;18;Keskiviikko;57;38;95;25;19;44
89;21.12.2011;2011;12;19;Keskiviikko;37;31;68;29;15;44
89;21.12.2011;2011;12;20;Keskiviikko;45;19;64;20;19;39
89;21.12.2011;2011;12;21;Keskiviikko;21;19;40;10;7;17
89;21.12.2011;2011;12;22;Keskiviikko;16;21;37;3;6;9
89;21.12.2011;2011;12;23;Keskiviikko;11;10;21;2;11;13
89;22.12.2011;2011;12;00;Torstai;19;10;29;6;4;10
89;22.12.2011;2011;12;01;Torstai;8;4;12;3;3;6
89;22.12.2011;2011;12;02;Torstai;4;4;8;4;1;5
89;22.12.2011;2011;12;03;Torstai;10;3;13;3;1;4
89;22.12.2011;2011;12;04;Torstai;7;2;9;2;0;2
89;22.12.2011;2011;12;05;Torstai;6;10;16;2;0;2
89;22.12.2011;2011;12;06;Torstai;17;37;54;3;4;7
89;22.12.2011;2011;12;07;Torstai;25;77;102;4;29;33
89;22.12.2011;2011;12;08;Torstai;29;104;133;13;33;46
89;22.12.2011;2011;12;09;Torstai;14;61;75;15;28;43
89;22.12.2011;2011;12;10;Torstai;28;50;78;14;30;44
89;22.12.2011;2011;12;11;Torstai;55;47;102;27;30;57
89;22.12.2011;2011;12;12;Torstai;42;39;81;20;29;49
89;22.12.2011;2011;12;13;Torstai;46;44;90;18;33;51
89;22.12.2011;2011;12;14;Torstai;55;43;98;22;34;56
89;22.12.2011;2011;12;15;Torstai;84;44;128;24;21;45
89;22.12.2011;2011;12;16;Torstai;117;45;162;32;19;51
89;22.12.2011;2011;12;17;Torstai;53;35;88;29;20;49
89;22.12.2011;2011;12;18;Torstai;45;33;78;20;12;32
89;22.12.2011;2011;12;19;Torstai;48;11;59;26;11;37
89;22.12.2011;2011;12;20;Torstai;28;20;48;12;13;25
89;22.12.2011;2011;12;21;Torstai;24;12;36;10;5;15
89;22.12.2011;2011;12;22;Torstai;15;5;20;4;4;8
89;22.12.2011;2011;12;23;Torstai;9;11;20;1;8;9
89;23.12.2011;2011;12;00;Perjantai;2;4;6;2;1;3
89;23.12.2011;2011;12;01;Perjantai;5;3;8;2;4;6
89;23.12.2011;2011;12;02;Perjantai;9;2;11;1;0;1
89;23.12.2011;2011;12;03;Perjantai;3;2;5;4;1;5
89;23.12.2011;2011;12;04;Perjantai;6;1;7;2;1;3
89;23.12.2011;2011;12;05;Perjantai;2;6;8;2;0;2
89;23.12.2011;2011;12;06;Perjantai;12;27;39;6;2;8
89;23.12.2011;2011;12;07;Perjantai;11;40;51;3;18;21
89;23.12.2011;2011;12;08;Perjantai;14;53;67;7;11;18
89;23.12.2011;2011;12;09;Perjantai;12;32;44;11;25;36
89;23.12.2011;2011;12;10;Perjantai;18;41;59;21;22;43
89;23.12.2011;2011;12;11;Perjantai;37;39;76;15;36;51
89;23.12.2011;2011;12;12;Perjantai;33;51;84;16;28;44
89;23.12.2011;2011;12;13;Perjantai;55;27;82;15;14;29
89;23.12.2011;2011;12;14;Perjantai;70;47;117;31;17;48
89;23.12.2011;2011;12;15;Perjantai;68;34;102;20;22;42
89;23.12.2011;2011;12;16;Perjantai;46;18;64;17;17;34
89;23.12.2011;2011;12;17;Perjantai;27;12;39;7;8;15
89;23.12.2011;2011;12;18;Perjantai;31;11;42;14;13;27
89;23.12.2011;2011;12;19;Perjantai;21;15;36;13;4;17
89;23.12.2011;2011;12;20;Perjantai;12;15;27;20;11;31
89;23.12.2011;2011;12;21;Perjantai;12;3;15;8;5;13
89;23.12.2011;2011;12;22;Perjantai;7;3;10;7;1;8
89;23.12.2011;2011;12;23;Perjantai;6;3;9;3;1;4
89;24.12.2011;2011;12;00;Lauantai;6;1;7;0;2;2
89;24.12.2011;2011;12;01;Lauantai;3;5;8;1;0;1
89;24.12.2011;2011;12;02;Lauantai;2;0;2;1;0;1
89;24.12.2011;2011;12;03;Lauantai;1;1;2;5;3;8
89;24.12.2011;2011;12;04;Lauantai;0;2;2;1;2;3
89;24.12.2011;2011;12;05;Lauantai;2;2;4;1;1;2
89;24.12.2011;2011;12;06;Lauantai;3;11;14;1;3;4
89;24.12.2011;2011;12;07;Lauantai;6;9;15;5;6;11
89;24.12.2011;2011;12;08;Lauantai;8;24;32;6;13;19
89;24.12.2011;2011;12;09;Lauantai;10;17;27;16;14;30
89;24.12.2011;2011;12;10;Lauantai;13;27;40;11;24;35
89;24.12.2011;2011;12;11;Lauantai;20;16;36;21;26;47
89;24.12.2011;2011;12;12;Lauantai;29;19;48;19;19;38
89;24.12.2011;2011;12;13;Lauantai;8;13;21;29;14;43
89;24.12.2011;2011;12;14;Lauantai;9;16;25;17;14;31
89;24.12.2011;2011;12;15;Lauantai;13;12;25;32;10;42
89;24.12.2011;2011;12;16;Lauantai;10;5;15;10;13;23
89;24.12.2011;2011;12;17;Lauantai;4;4;8;13;4;17
89;24.12.2011;2011;12;18;Lauantai;7;2;9;8;2;10
89;24.12.2011;2011;12;19;Lauantai;7;1;8;7;3;10
89;24.12.2011;2011;12;20;Lauantai;5;8;13;3;4;7
89;24.12.2011;2011;12;21;Lauantai;10;4;14;5;7;12
89;24.12.2011;2011;12;22;Lauantai;3;3;6;7;4;11
89;24.12.2011;2011;12;23;Lauantai;3;4;7;3;3;6
89;25.12.2011;2011;12;00;Sunnuntai;3;4;7;2;1;3
89;25.12.2011;2011;12;01;Sunnuntai;3;1;4;2;2;4
89;25.12.2011;2011;12;02;Sunnuntai;3;0;3;0;1;1
89;25.12.2011;2011;12;03;Sunnuntai;3;0;3;1;3;4
89;25.12.2011;2011;12;04;Sunnuntai;0;0;0;2;0;2
89;25.12.2011;2011;12;05;Sunnuntai;2;1;3;0;0;0
89;25.12.2011;2011;12;06;Sunnuntai;2;6;8;1;6;7
89;25.12.2011;2011;12;07;Sunnuntai;1;1;2;3;1;4
89;25.12.2011;2011;12;08;Sunnuntai;0;3;3;11;7;18
89;25.12.2011;2011;12;09;Sunnuntai;2;6;8;10;11;21
89;25.12.2011;2011;12;10;Sunnuntai;2;3;5;9;15;24
89;25.12.2011;2011;12;11;Sunnuntai;4;5;9;26;23;49
89;25.12.2011;2011;12;12;Sunnuntai;10;11;21;34;34;68
89;25.12.2011;2011;12;13;Sunnuntai;11;9;20;34;27;61
89;25.12.2011;2011;12;14;Sunnuntai;7;8;15;28;27;55
89;25.12.2011;2011;12;15;Sunnuntai;7;10;17;19;18;37
89;25.12.2011;2011;12;16;Sunnuntai;10;5;15;25;25;50
89;25.12.2011;2011;12;17;Sunnuntai;7;11;18;15;19;34
89;25.12.2011;2011;12;18;Sunnuntai;6;5;11;19;21;40
89;25.12.2011;2011;12;19;Sunnuntai;10;4;14;25;11;36
89;25.12.2011;2011;12;20;Sunnuntai;5;9;14;8;14;22
89;25.12.2011;2011;12;21;Sunnuntai;8;6;14;6;10;16
89;25.12.2011;2011;12;22;Sunnuntai;2;6;8;5;6;11
89;25.12.2011;2011;12;23;Sunnuntai;2;3;5;1;5;6
89;26.12.2011;2011;12;00;Maanantai;1;6;7;0;1;1
89;26.12.2011;2011;12;01;Maanantai;1;3;4;1;3;4
89;26.12.2011;2011;12;02;Maanantai;6;1;7;2;0;2
89;26.12.2011;2011;12;03;Maanantai;3;0;3;6;0;6
89;26.12.2011;2011;12;04;Maanantai;8;0;8;8;0;8
89;26.12.2011;2011;12;05;Maanantai;0;2;2;4;0;4
89;26.12.2011;2011;12;06;Maanantai;1;3;4;0;1;1
89;26.12.2011;2011;12;07;Maanantai;1;6;7;6;8;14
89;26.12.2011;2011;12;08;Maanantai;1;2;3;2;10;12
89;26.12.2011;2011;12;09;Maanantai;3;3;6;11;16;27
89;26.12.2011;2011;12;10;Maanantai;5;7;12;12;15;27
89;26.12.2011;2011;12;11;Maanantai;1;3;4;24;21;45
89;26.12.2011;2011;12;12;Maanantai;9;11;20;29;24;53
89;26.12.2011;2011;12;13;Maanantai;10;17;27;32;42;74
89;26.12.2011;2011;12;14;Maanantai;13;10;23;36;31;67
89;26.12.2011;2011;12;15;Maanantai;19;12;31;26;14;40
89;26.12.2011;2011;12;16;Maanantai;9;8;17;11;11;22
89;26.12.2011;2011;12;17;Maanantai;6;14;20;13;15;28
89;26.12.2011;2011;12;18;Maanantai;10;4;14;15;10;25
89;26.12.2011;2011;12;19;Maanantai;6;6;12;12;10;22
89;26.12.2011;2011;12;20;Maanantai;15;14;29;13;13;26
89;26.12.2011;2011;12;21;Maanantai;9;5;14;6;6;12
89;26.12.2011;2011;12;22;Maanantai;6;11;17;2;6;8
89;26.12.2011;2011;12;23;Maanantai;3;6;9;6;3;9
89;27.12.2011;2011;12;00;Tiistai;7;3;10;4;1;5
89;27.12.2011;2011;12;01;Tiistai;1;3;4;7;4;11
89;27.12.2011;2011;12;02;Tiistai;5;0;5;5;0;5
89;27.12.2011;2011;12;03;Tiistai;4;1;5;5;1;6
89;27.12.2011;2011;12;04;Tiistai;10;6;16;7;2;9
89;27.12.2011;2011;12;05;Tiistai;2;5;7;2;3;5
89;27.12.2011;2011;12;06;Tiistai;11;30;41;2;7;9
89;27.12.2011;2011;12;07;Tiistai;8;35;43;7;20;27
89;27.12.2011;2011;12;08;Tiistai;9;37;46;3;17;20
89;27.12.2011;2011;12;09;Tiistai;10;14;24;3;13;16
89;27.12.2011;2011;12;10;Tiistai;11;23;34;9;20;29
89;27.12.2011;2011;12;11;Tiistai;12;11;23;13;18;31
89;27.12.2011;2011;12;12;Tiistai;16;22;38;7;10;17
89;27.12.2011;2011;12;13;Tiistai;16;16;32;8;18;26
89;27.12.2011;2011;12;14;Tiistai;15;23;38;18;17;35
89;27.12.2011;2011;12;15;Tiistai;44;29;73;24;18;42
89;27.12.2011;2011;12;16;Tiistai;43;20;63;27;19;46
89;27.12.2011;2011;12;17;Tiistai;29;26;55;32;12;44
89;27.12.2011;2011;12;18;Tiistai;23;12;35;22;21;43
89;27.12.2011;2011;12;19;Tiistai;20;11;31;27;19;46
89;27.12.2011;2011;12;20;Tiistai;26;8;34;14;15;29
89;27.12.2011;2011;12;21;Tiistai;15;4;19;12;2;14
89;27.12.2011;2011;12;22;Tiistai;10;5;15;2;2;4
89;27.12.2011;2011;12;23;Tiistai;5;4;9;2;0;2
89;28.12.2011;2011;12;00;Keskiviikko;6;1;7;2;0;2
89;28.12.2011;2011;12;01;Keskiviikko;2;3;5;0;1;1
89;28.12.2011;2011;12;02;Keskiviikko;0;2;2;0;0;0
89;28.12.2011;2011;12;03;Keskiviikko;4;3;7;3;0;3
89;28.12.2011;2011;12;04;Keskiviikko;4;5;9;2;2;4
89;28.12.2011;2011;12;05;Keskiviikko;0;10;10;1;1;2
89;28.12.2011;2011;12;06;Keskiviikko;6;26;32;3;2;5
89;28.12.2011;2011;12;07;Keskiviikko;12;39;51;4;17;21
89;28.12.2011;2011;12;08;Keskiviikko;16;45;61;4;19;23
89;28.12.2011;2011;12;09;Keskiviikko;15;31;46;3;16;19
89;28.12.2011;2011;12;10;Keskiviikko;20;29;49;13;29;42
89;28.12.2011;2011;12;11;Keskiviikko;21;45;66;23;17;40
89;28.12.2011;2011;12;12;Keskiviikko;25;37;62;16;42;58
89;28.12.2011;2011;12;13;Keskiviikko;28;36;64;31;62;93
89;28.12.2011;2011;12;14;Keskiviikko;30;38;68;36;34;70
89;28.12.2011;2011;12;15;Keskiviikko;59;36;95;40;42;82
89;28.12.2011;2011;12;16;Keskiviikko;45;30;75;37;25;62
89;28.12.2011;2011;12;17;Keskiviikko;32;29;61;28;30;58
89;28.12.2011;2011;12;18;Keskiviikko;48;9;57;24;22;46
89;28.12.2011;2011;12;19;Keskiviikko;31;17;48;31;15;46
89;28.12.2011;2011;12;20;Keskiviikko;22;9;31;15;9;24
89;28.12.2011;2011;12;21;Keskiviikko;15;8;23;10;6;16
89;28.12.2011;2011;12;22;Keskiviikko;9;12;21;4;7;11
89;28.12.2011;2011;12;23;Keskiviikko;4;8;12;2;0;2
89;29.12.2011;2011;12;00;Torstai;4;3;7;4;2;6
89;29.12.2011;2011;12;01;Torstai;6;0;6;3;1;4
89;29.12.2011;2011;12;02;Torstai;1;1;2;5;4;9
89;29.12.2011;2011;12;03;Torstai;2;3;5;2;0;2
89;29.12.2011;2011;12;04;Torstai;3;4;7;5;1;6
89;29.12.2011;2011;12;05;Torstai;4;8;12;2;1;3
89;29.12.2011;2011;12;06;Torstai;31;4;35;9;0;9
89;29.12.2011;2011;12;07;Torstai;39;0;39;24;0;24
89;29.12.2011;2011;12;08;Torstai;58;0;58;36;0;36
89;29.12.2011;2011;12;09;Torstai;26;0;26;28;0;28
89;29.12.2011;2011;12;10;Torstai;33;0;33;42;0;42
89;29.12.2011;2011;12;11;Torstai;41;0;41;40;0;40
89;29.12.2011;2011;12;12;Torstai;43;0;43;53;0;53
89;29.12.2011;2011;12;13;Torstai;57;0;57;51;0;51
89;29.12.2011;2011;12;14;Torstai;63;0;63;70;0;70
89;29.12.2011;2011;12;15;Torstai;89;0;89;69;0;69
89;29.12.2011;2011;12;16;Torstai;83;0;83;71;0;71
89;29.12.2011;2011;12;17;Torstai;65;0;65;56;0;56
89;29.12.2011;2011;12;18;Torstai;62;0;62;62;0;62
89;29.12.2011;2011;12;19;Torstai;57;0;57;32;0;32
89;29.12.2011;2011;12;20;Torstai;40;0;40;40;0;40
89;29.12.2011;2011;12;21;Torstai;27;0;27;25;0;25
89;29.12.2011;2011;12;22;Torstai;18;0;18;11;0;11
89;29.12.2011;2011;12;23;Torstai;11;0;11;9;0;9
89;30.12.2011;2011;12;00;Perjantai;6;0;6;7;0;7
89;30.12.2011;2011;12;01;Perjantai;5;0;5;4;0;4
89;30.12.2011;2011;12;02;Perjantai;9;0;9;2;0;2
89;30.12.2011;2011;12;03;Perjantai;8;0;8;4;0;4
89;30.12.2011;2011;12;04;Perjantai;7;0;7;9;0;9
89;30.12.2011;2011;12;05;Perjantai;10;0;10;5;0;5
89;30.12.2011;2011;12;06;Perjantai;43;0;43;4;0;4
89;30.12.2011;2011;12;07;Perjantai;62;0;62;24;0;24
89;30.12.2011;2011;12;08;Perjantai;56;0;56;26;0;26
89;30.12.2011;2011;12;09;Perjantai;47;0;47;44;0;44
89;30.12.2011;2011;12;10;Perjantai;58;0;58;45;0;45
89;30.12.2011;2011;12;11;Perjantai;54;0;54;60;0;60
89;30.12.2011;2011;12;12;Perjantai;84;0;84;94;0;94
89;30.12.2011;2011;12;13;Perjantai;115;0;115;102;0;102
89;30.12.2011;2011;12;14;Perjantai;95;0;95;76;0;76
89;30.12.2011;2011;12;15;Perjantai;103;0;103;94;0;94
89;30.12.2011;2011;12;16;Perjantai;78;0;78;43;0;43
89;30.12.2011;2011;12;17;Perjantai;62;0;62;56;0;56
89;30.12.2011;2011;12;18;Perjantai;50;0;50;52;0;52
89;30.12.2011;2011;12;19;Perjantai;54;0;54;35;0;35
89;30.12.2011;2011;12;20;Perjantai;37;0;37;30;0;30
89;30.12.2011;2011;12;21;Perjantai;29;0;29;22;0;22
89;30.12.2011;2011;12;22;Perjantai;30;0;30;11;0;11
89;30.12.2011;2011;12;23;Perjantai;18;0;18;7;0;7
89;31.12.2011;2011;12;00;Lauantai;11;0;11;9;0;9
89;31.12.2011;2011;12;01;Lauantai;7;0;7;10;0;10
89;31.12.2011;2011;12;02;Lauantai;13;0;13;10;0;10
89;31.12.2011;2011;12;03;Lauantai;8;0;8;4;0;4
89;31.12.2011;2011;12;04;Lauantai;13;0;13;4;0;4
89;31.12.2011;2011;12;05;Lauantai;4;0;4;4;0;4
89;31.12.2011;2011;12;06;Lauantai;13;0;13;4;0;4
89;31.12.2011;2011;12;07;Lauantai;8;0;8;11;0;11
89;31.12.2011;2011;12;08;Lauantai;21;0;21;19;0;19
89;31.12.2011;2011;12;09;Lauantai;23;0;23;28;0;28
89;31.12.2011;2011;12;10;Lauantai;38;0;38;60;0;60
89;31.12.2011;2011;12;11;Lauantai;56;0;56;66;0;66
89;31.12.2011;2011;12;12;Lauantai;65;0;65;89;0;89
89;31.12.2011;2011;12;13;Lauantai;64;0;64;81;0;81
89;31.12.2011;2011;12;14;Lauantai;42;0;42;78;0;78
89;31.12.2011;2011;12;15;Lauantai;58;0;58;57;0;57
89;31.12.2011;2011;12;16;Lauantai;69;0;69;53;0;53
89;31.12.2011;2011;12;17;Lauantai;49;0;49;53;0;53
89;31.12.2011;2011;12;18;Lauantai;48;0;48;40;0;40
89;31.12.2011;2011;12;19;Lauantai;66;0;66;67;0;67
89;31.12.2011;2011;12;20;Lauantai;96;0;96;89;0;89
89;31.12.2011;2011;12;21;Lauantai;43;0;43;23;0;23
89;31.12.2011;2011;12;22;Lauantai;26;0;26;29;0;29
89;31.12.2011;2011;12;23;Lauantai;20;0;20;34;0;34
89;01.01.2012;2012;01;00;Sunnuntai;35;0;35;46;1;47
89;01.01.2012;2012;01;01;Sunnuntai;23;0;23;34;0;34
89;01.01.2012;2012;01;02;Sunnuntai;29;0;29;38;0;38
89;01.01.2012;2012;01;03;Sunnuntai;34;0;34;32;0;32
89;01.01.2012;2012;01;04;Sunnuntai;18;0;18;28;1;29
89;01.01.2012;2012;01;05;Sunnuntai;16;0;16;8;0;8
89;01.01.2012;2012;01;06;Sunnuntai;9;0;9;4;0;4
89;01.01.2012;2012;01;07;Sunnuntai;7;0;7;8;0;8
89;01.01.2012;2012;01;08;Sunnuntai;8;0;8;9;0;9
89;01.01.2012;2012;01;09;Sunnuntai;10;0;10;25;0;25
89;01.01.2012;2012;01;10;Sunnuntai;10;0;10;57;0;57
89;01.01.2012;2012;01;11;Sunnuntai;16;0;16;66;1;67
89;01.01.2012;2012;01;12;Sunnuntai;36;0;36;72;0;72
89;01.01.2012;2012;01;13;Sunnuntai;28;1;29;90;2;92
89;01.01.2012;2012;01;14;Sunnuntai;25;0;25;79;4;83
89;01.01.2012;2012;01;15;Sunnuntai;38;0;38;77;2;79
89;01.01.2012;2012;01;16;Sunnuntai;30;0;30;58;1;59
89;01.01.2012;2012;01;17;Sunnuntai;34;0;34;54;1;55
89;01.01.2012;2012;01;18;Sunnuntai;21;0;21;50;1;51
89;01.01.2012;2012;01;19;Sunnuntai;14;0;14;39;3;42
89;01.01.2012;2012;01;20;Sunnuntai;15;0;15;17;2;19
89;01.01.2012;2012;01;21;Sunnuntai;17;2;19;19;2;21
89;01.01.2012;2012;01;22;Sunnuntai;12;3;15;5;3;8
89;01.01.2012;2012;01;23;Sunnuntai;11;0;11;6;0;6
89;02.01.2012;2012;01;00;Maanantai;4;0;4;1;0;1
89;02.01.2012;2012;01;01;Maanantai;0;0;0;1;1;2
89;02.01.2012;2012;01;02;Maanantai;1;0;1;0;1;1
89;02.01.2012;2012;01;03;Maanantai;3;0;3;2;0;2
89;02.01.2012;2012;01;04;Maanantai;2;0;2;4;0;4
89;02.01.2012;2012;01;05;Maanantai;16;2;18;5;0;5
89;02.01.2012;2012;01;06;Maanantai;38;5;43;10;1;11
89;02.01.2012;2012;01;07;Maanantai;79;12;91;41;15;56
89;02.01.2012;2012;01;08;Maanantai;91;14;105;29;10;39
89;02.01.2012;2012;01;09;Maanantai;52;10;62;24;7;31
89;02.01.2012;2012;01;10;Maanantai;48;12;60;48;9;57
89;02.01.2012;2012;01;11;Maanantai;74;13;87;49;16;65
89;02.01.2012;2012;01;12;Maanantai;49;17;66;56;25;81
89;02.01.2012;2012;01;13;Maanantai;73;10;83;53;22;75
89;02.01.2012;2012;01;14;Maanantai;82;15;97;64;19;83
89;02.01.2012;2012;01;15;Maanantai;100;20;120;53;20;73
89;02.01.2012;2012;01;16;Maanantai;132;25;157;50;29;79
89;02.01.2012;2012;01;17;Maanantai;82;24;106;36;19;55
89;02.01.2012;2012;01;18;Maanantai;55;8;63;33;24;57
89;02.01.2012;2012;01;19;Maanantai;33;10;43;36;16;52
89;02.01.2012;2012;01;20;Maanantai;33;6;39;14;22;36
89;02.01.2012;2012;01;21;Maanantai;22;5;27;7;6;13
89;02.01.2012;2012;01;22;Maanantai;11;5;16;5;4;9
89;02.01.2012;2012;01;23;Maanantai;7;3;10;0;0;0
89;03.01.2012;2012;01;00;Tiistai;3;0;3;0;0;0
89;03.01.2012;2012;01;01;Tiistai;0;0;0;1;0;1
89;03.01.2012;2012;01;02;Tiistai;0;0;0;0;0;0
89;03.01.2012;2012;01;03;Tiistai;3;1;4;0;0;0
89;03.01.2012;2012;01;04;Tiistai;2;1;3;1;0;1
89;03.01.2012;2012;01;05;Tiistai;6;5;11;4;0;4
89;03.01.2012;2012;01;06;Tiistai;24;21;45;20;0;20
89;03.01.2012;2012;01;07;Tiistai;45;42;87;86;0;86
89;03.01.2012;2012;01;08;Tiistai;55;52;107;61;0;61
89;03.01.2012;2012;01;09;Tiistai;29;27;56;50;0;50
89;03.01.2012;2012;01;10;Tiistai;28;26;54;48;0;48
89;03.01.2012;2012;01;11;Tiistai;33;30;63;66;0;66
89;03.01.2012;2012;01;12;Tiistai;36;36;72;87;0;87
89;03.01.2012;2012;01;13;Tiistai;43;41;84;76;0;76
89;03.01.2012;2012;01;14;Tiistai;44;42;86;77;0;77
89;03.01.2012;2012;01;15;Tiistai;61;59;120;100;0;100
89;03.01.2012;2012;01;16;Tiistai;74;70;144;99;0;99
89;03.01.2012;2012;01;17;Tiistai;54;53;107;76;0;76
89;03.01.2012;2012;01;18;Tiistai;32;30;62;69;0;69
89;03.01.2012;2012;01;19;Tiistai;24;20;44;65;0;65
89;03.01.2012;2012;01;20;Tiistai;29;25;54;44;0;44
89;03.01.2012;2012;01;21;Tiistai;15;13;28;16;0;16
89;03.01.2012;2012;01;22;Tiistai;8;8;16;10;0;10
89;03.01.2012;2012;01;23;Tiistai;4;3;7;2;0;2
89;04.01.2012;2012;01;00;Keskiviikko;7;4;11;1;0;1
89;04.01.2012;2012;01;01;Keskiviikko;2;1;3;0;0;0
89;04.01.2012;2012;01;02;Keskiviikko;4;0;4;1;0;1
89;04.01.2012;2012;01;03;Keskiviikko;4;1;5;0;0;0
89;04.01.2012;2012;01;04;Keskiviikko;5;1;6;1;0;1
89;04.01.2012;2012;01;05;Keskiviikko;8;3;11;0;0;0
89;04.01.2012;2012;01;06;Keskiviikko;28;20;48;8;0;8
89;04.01.2012;2012;01;07;Keskiviikko;69;39;108;16;0;16
89;04.01.2012;2012;01;08;Keskiviikko;73;40;113;18;0;18
89;04.01.2012;2012;01;09;Keskiviikko;48;16;64;19;0;19
89;04.01.2012;2012;01;10;Keskiviikko;43;13;56;17;0;17
89;04.01.2012;2012;01;11;Keskiviikko;62;19;81;17;0;17
89;04.01.2012;2012;01;12;Keskiviikko;55;12;67;32;0;32
89;04.01.2012;2012;01;13;Keskiviikko;79;16;95;25;0;25
89;04.01.2012;2012;01;14;Keskiviikko;105;13;118;26;0;26
89;04.01.2012;2012;01;15;Keskiviikko;121;19;140;31;0;31
89;04.01.2012;2012;01;16;Keskiviikko;136;12;148;38;0;38
89;04.01.2012;2012;01;17;Keskiviikko;101;5;106;49;0;49
89;04.01.2012;2012;01;18;Keskiviikko;70;2;72;31;0;31
89;04.01.2012;2012;01;19;Keskiviikko;48;2;50;40;0;40
89;04.01.2012;2012;01;20;Keskiviikko;44;3;47;24;0;24
89;04.01.2012;2012;01;21;Keskiviikko;33;1;34;22;0;22
89;04.01.2012;2012;01;22;Keskiviikko;23;0;23;10;0;10
89;04.01.2012;2012;01;23;Keskiviikko;15;0;15;4;0;4
89;05.01.2012;2012;01;00;Torstai;6;0;6;0;0;0
89;05.01.2012;2012;01;01;Torstai;2;1;3;1;0;1
89;05.01.2012;2012;01;02;Torstai;3;3;6;1;0;1
89;05.01.2012;2012;01;03;Torstai;5;0;5;1;0;1
89;05.01.2012;2012;01;04;Torstai;6;0;6;2;0;2
89;05.01.2012;2012;01;05;Torstai;12;0;12;2;0;2
89;05.01.2012;2012;01;06;Torstai;33;7;40;11;0;11
89;05.01.2012;2012;01;07;Torstai;93;4;97;38;0;38
89;05.01.2012;2012;01;08;Torstai;112;7;119;41;0;41
89;05.01.2012;2012;01;09;Torstai;60;3;63;27;0;27
89;05.01.2012;2012;01;10;Torstai;59;2;61;48;0;48
89;05.01.2012;2012;01;11;Torstai;59;3;62;52;0;52
89;05.01.2012;2012;01;12;Torstai;74;5;79;52;0;52
89;05.01.2012;2012;01;13;Torstai;90;5;95;48;0;48
89;05.01.2012;2012;01;14;Torstai;94;9;103;52;0;52
89;05.01.2012;2012;01;15;Torstai;120;4;124;57;0;57
89;05.01.2012;2012;01;16;Torstai;126;8;134;41;0;41
89;05.01.2012;2012;01;17;Torstai;80;3;83;40;0;40
89;05.01.2012;2012;01;18;Torstai;59;1;60;45;0;45
89;05.01.2012;2012;01;19;Torstai;41;1;42;32;0;32
89;05.01.2012;2012;01;20;Torstai;49;2;51;25;0;25
89;05.01.2012;2012;01;21;Torstai;33;0;33;19;0;19
89;05.01.2012;2012;01;22;Torstai;20;0;20;10;0;10
89;05.01.2012;2012;01;23;Torstai;14;0;14;6;0;6
89;06.01.2012;2012;01;00;Perjantai;7;0;7;3;0;3
89;06.01.2012;2012;01;01;Perjantai;7;0;7;11;0;11
89;06.01.2012;2012;01;02;Perjantai;9;0;9;2;0;2
89;06.01.2012;2012;01;03;Perjantai;4;0;4;8;0;8
89;06.01.2012;2012;01;04;Perjantai;11;0;11;10;0;10
89;06.01.2012;2012;01;05;Perjantai;10;0;10;2;0;2
89;06.01.2012;2012;01;06;Perjantai;11;0;11;8;0;8
89;06.01.2012;2012;01;07;Perjantai;4;0;4;3;0;3
89;06.01.2012;2012;01;08;Perjantai;11;0;11;9;0;9
89;06.01.2012;2012;01;09;Perjantai;10;0;10;31;0;31
89;06.01.2012;2012;01;10;Perjantai;20;0;20;29;0;29
89;06.01.2012;2012;01;11;Perjantai;45;0;45;80;0;80
89;06.01.2012;2012;01;12;Perjantai;49;0;49;103;0;103
89;06.01.2012;2012;01;13;Perjantai;32;0;32;88;0;88
89;06.01.2012;2012;01;14;Perjantai;50;0;50;97;0;97
89;06.01.2012;2012;01;15;Perjantai;32;0;32;80;0;80
89;06.01.2012;2012;01;16;Perjantai;37;0;37;83;0;83
89;06.01.2012;2012;01;17;Perjantai;34;0;34;67;0;67
89;06.01.2012;2012;01;18;Perjantai;33;0;33;71;0;71
89;06.01.2012;2012;01;19;Perjantai;38;0;38;47;0;47
89;06.01.2012;2012;01;20;Perjantai;30;0;30;30;0;30
89;06.01.2012;2012;01;21;Perjantai;30;0;30;18;0;18
89;06.01.2012;2012;01;22;Perjantai;12;0;12;15;0;15
89;06.01.2012;2012;01;23;Perjantai;18;0;18;11;0;11
89;07.01.2012;2012;01;00;Lauantai;13;0;13;11;0;11
89;07.01.2012;2012;01;01;Lauantai;6;0;6;5;0;5
89;07.01.2012;2012;01;02;Lauantai;7;0;7;7;0;7
89;07.01.2012;2012;01;03;Lauantai;14;0;14;11;0;11
89;07.01.2012;2012;01;04;Lauantai;8;0;8;18;0;18
89;07.01.2012;2012;01;05;Lauantai;3;0;3;1;0;1
89;07.01.2012;2012;01;06;Lauantai;9;0;9;8;0;8
89;07.01.2012;2012;01;07;Lauantai;13;0;13;12;0;12
89;07.01.2012;2012;01;08;Lauantai;13;0;13;18;0;18
89;07.01.2012;2012;01;09;Lauantai;27;0;27;35;0;35
89;07.01.2012;2012;01;10;Lauantai;43;1;44;50;0;50
89;07.01.2012;2012;01;11;Lauantai;46;0;46;71;0;71
89;07.01.2012;2012;01;12;Lauantai;59;0;59;80;0;80
89;07.01.2012;2012;01;13;Lauantai;65;1;66;97;0;97
89;07.01.2012;2012;01;14;Lauantai;56;0;56;107;0;107
89;07.01.2012;2012;01;15;Lauantai;55;0;55;78;0;78
89;07.01.2012;2012;01;16;Lauantai;57;0;57;60;0;60
89;07.01.2012;2012;01;17;Lauantai;37;0;37;58;0;58
89;07.01.2012;2012;01;18;Lauantai;32;0;32;60;0;60
89;07.01.2012;2012;01;19;Lauantai;48;0;48;55;0;55
89;07.01.2012;2012;01;20;Lauantai;31;0;31;32;0;32
89;07.01.2012;2012;01;21;Lauantai;24;0;24;25;0;25
89;07.01.2012;2012;01;22;Lauantai;28;0;28;22;0;22
89;07.01.2012;2012;01;23;Lauantai;19;0;19;13;0;13
89;08.01.2012;2012;01;00;Sunnuntai;12;0;12;12;0;12
89;08.01.2012;2012;01;01;Sunnuntai;17;0;17;3;0;3
89;08.01.2012;2012;01;02;Sunnuntai;3;0;3;5;0;5
89;08.01.2012;2012;01;03;Sunnuntai;9;0;9;10;0;10
89;08.01.2012;2012;01;04;Sunnuntai;11;0;11;12;0;12
89;08.01.2012;2012;01;05;Sunnuntai;4;0;4;0;0;0
89;08.01.2012;2012;01;06;Sunnuntai;13;0;13;0;0;0
89;08.01.2012;2012;01;07;Sunnuntai;7;0;7;8;0;8
89;08.01.2012;2012;01;08;Sunnuntai;1;0;1;13;0;13
89;08.01.2012;2012;01;09;Sunnuntai;15;0;15;28;0;28
89;08.01.2012;2012;01;10;Sunnuntai;20;0;20;33;0;33
89;08.01.2012;2012;01;11;Sunnuntai;49;0;49;90;0;90
89;08.01.2012;2012;01;12;Sunnuntai;52;0;52;82;0;82
89;08.01.2012;2012;01;13;Sunnuntai;48;0;48;147;0;147
89;08.01.2012;2012;01;14;Sunnuntai;58;0;58;126;0;126
89;08.01.2012;2012;01;15;Sunnuntai;57;0;57;94;0;94
89;08.01.2012;2012;01;16;Sunnuntai;51;0;51;80;0;80
89;08.01.2012;2012;01;17;Sunnuntai;51;0;51;61;0;61
89;08.01.2012;2012;01;18;Sunnuntai;38;0;38;56;0;56
89;08.01.2012;2012;01;19;Sunnuntai;39;0;39;52;0;52
89;08.01.2012;2012;01;20;Sunnuntai;18;0;18;43;0;43
89;08.01.2012;2012;01;21;Sunnuntai;24;0;24;20;0;20
89;08.01.2012;2012;01;22;Sunnuntai;19;0;19;8;0;8
89;08.01.2012;2012;01;23;Sunnuntai;8;0;8;3;0;3
89;09.01.2012;2012;01;00;Maanantai;4;0;4;4;0;4
89;09.01.2012;2012;01;01;Maanantai;6;0;6;1;0;1
89;09.01.2012;2012;01;02;Maanantai;4;0;4;1;0;1
89;09.01.2012;2012;01;03;Maanantai;4;0;4;0;0;0
89;09.01.2012;2012;01;04;Maanantai;3;0;3;4;0;4
89;09.01.2012;2012;01;05;Maanantai;18;0;18;6;0;6
89;09.01.2012;2012;01;06;Maanantai;53;0;53;19;0;19
89;09.01.2012;2012;01;07;Maanantai;159;0;159;50;0;50
89;09.01.2012;2012;01;08;Maanantai;185;0;185;66;0;66
89;09.01.2012;2012;01;09;Maanantai;105;0;105;57;0;57
89;09.01.2012;2012;01;10;Maanantai;71;0;71;58;0;58
89;09.01.2012;2012;01;11;Maanantai;82;0;82;67;0;67
89;09.01.2012;2012;01;12;Maanantai;84;0;84;79;0;79
89;09.01.2012;2012;01;13;Maanantai;85;0;85;83;0;83
89;09.01.2012;2012;01;14;Maanantai;132;0;132;89;0;89
89;09.01.2012;2012;01;15;Maanantai;172;0;172;102;0;102
89;09.01.2012;2012;01;16;Maanantai;212;0;212;97;0;97
89;09.01.2012;2012;01;17;Maanantai;106;0;106;83;0;83
89;09.01.2012;2012;01;18;Maanantai;108;0;108;78;0;78
89;09.01.2012;2012;01;19;Maanantai;70;0;70;64;0;64
89;09.01.2012;2012;01;20;Maanantai;62;0;62;53;0;53
89;09.01.2012;2012;01;21;Maanantai;48;0;48;31;0;31
89;09.01.2012;2012;01;22;Maanantai;16;0;16;6;0;6
89;09.01.2012;2012;01;23;Maanantai;12;0;12;5;0;5
89;10.01.2012;2012;01;00;Tiistai;2;0;2;0;0;0
89;10.01.2012;2012;01;01;Tiistai;1;0;1;1;0;1
89;10.01.2012;2012;01;02;Tiistai;0;0;0;0;0;0
89;10.01.2012;2012;01;03;Tiistai;4;0;4;0;0;0
89;10.01.2012;2012;01;04;Tiistai;4;0;4;1;0;1
89;10.01.2012;2012;01;05;Tiistai;14;0;14;4;0;4
89;10.01.2012;2012;01;06;Tiistai;53;0;53;20;0;20
89;10.01.2012;2012;01;07;Tiistai;173;0;173;86;0;86
89;10.01.2012;2012;01;08;Tiistai;186;0;186;61;0;61
89;10.01.2012;2012;01;09;Tiistai;99;0;99;50;0;50
89;10.01.2012;2012;01;10;Tiistai;69;0;69;48;0;48
89;10.01.2012;2012;01;11;Tiistai;85;0;85;66;0;66
89;10.01.2012;2012;01;12;Tiistai;82;0;82;87;0;87
89;10.01.2012;2012;01;13;Tiistai;84;0;84;76;0;76
89;10.01.2012;2012;01;14;Tiistai;123;0;123;77;0;77
89;10.01.2012;2012;01;15;Tiistai;145;0;145;100;0;100
89;10.01.2012;2012;01;16;Tiistai;194;0;194;99;0;99
89;10.01.2012;2012;01;17;Tiistai;131;0;131;76;0;76
89;10.01.2012;2012;01;18;Tiistai;90;0;90;69;0;69
89;10.01.2012;2012;01;19;Tiistai;82;0;82;65;0;65
89;10.01.2012;2012;01;20;Tiistai;53;0;53;44;0;44
89;10.01.2012;2012;01;21;Tiistai;42;0;42;16;0;16
89;10.01.2012;2012;01;22;Tiistai;16;0;16;10;0;10
89;10.01.2012;2012;01;23;Tiistai;12;0;12;2;0;2
89;11.01.2012;2012;01;00;Keskiviikko;3;0;3;2;0;2
89;11.01.2012;2012;01;01;Keskiviikko;1;0;1;0;0;0
89;11.01.2012;2012;01;02;Keskiviikko;4;0;4;5;0;5
89;11.01.2012;2012;01;03;Keskiviikko;4;0;4;2;0;2
89;11.01.2012;2012;01;04;Keskiviikko;3;0;3;4;0;4
89;11.01.2012;2012;01;05;Keskiviikko;17;0;17;3;0;3
89;11.01.2012;2012;01;06;Keskiviikko;50;0;50;22;0;22
89;11.01.2012;2012;01;07;Keskiviikko;155;0;155;69;0;69
89;11.01.2012;2012;01;08;Keskiviikko;172;0;172;85;0;85
89;11.01.2012;2012;01;09;Keskiviikko;84;0;84;44;0;44
89;11.01.2012;2012;01;10;Keskiviikko;78;0;78;51;0;51
89;11.01.2012;2012;01;11;Keskiviikko;81;0;81;88;0;88
89;11.01.2012;2012;01;12;Keskiviikko;81;0;81;70;0;70
89;11.01.2012;2012;01;13;Keskiviikko;102;0;102;59;0;59
89;11.01.2012;2012;01;14;Keskiviikko;124;0;124;82;0;82
89;11.01.2012;2012;01;15;Keskiviikko;172;0;172;100;0;100
89;11.01.2012;2012;01;16;Keskiviikko;198;0;198;89;0;89
89;11.01.2012;2012;01;17;Keskiviikko;125;0;125;90;0;90
89;11.01.2012;2012;01;18;Keskiviikko;80;0;80;81;0;81
89;11.01.2012;2012;01;19;Keskiviikko;80;0;80;66;0;66
89;11.01.2012;2012;01;20;Keskiviikko;64;0;64;45;0;45
89;11.01.2012;2012;01;21;Keskiviikko;30;0;30;40;0;40
89;11.01.2012;2012;01;22;Keskiviikko;33;0;33;18;0;18
89;11.01.2012;2012;01;23;Keskiviikko;7;0;7;7;0;7
89;12.01.2012;2012;01;00;Torstai;11;0;11;3;0;3
89;12.01.2012;2012;01;01;Torstai;4;0;4;2;0;2
89;12.01.2012;2012;01;02;Torstai;9;0;9;3;0;3
89;12.01.2012;2012;01;03;Torstai;7;0;7;3;0;3
89;12.01.2012;2012;01;04;Torstai;3;0;3;3;0;3
89;12.01.2012;2012;01;05;Torstai;10;0;10;8;0;8
89;12.01.2012;2012;01;06;Torstai;57;0;57;15;0;15
89;12.01.2012;2012;01;07;Torstai;144;0;144;67;0;67
89;12.01.2012;2012;01;08;Torstai;169;0;169;93;0;93
89;12.01.2012;2012;01;09;Torstai;90;0;90;54;0;54
89;12.01.2012;2012;01;10;Torstai;70;0;70;63;0;63
89;12.01.2012;2012;01;11;Torstai;81;0;81;77;0;77
89;12.01.2012;2012;01;12;Torstai;93;0;93;79;0;79
89;12.01.2012;2012;01;13;Torstai;101;0;101;64;0;64
89;12.01.2012;2012;01;14;Torstai;120;0;120;77;0;77
89;12.01.2012;2012;01;15;Torstai;166;0;166;96;0;96
89;12.01.2012;2012;01;16;Torstai;201;0;201;78;0;78
89;12.01.2012;2012;01;17;Torstai;120;0;120;62;0;62
89;12.01.2012;2012;01;18;Torstai;81;0;81;64;0;64
89;12.01.2012;2012;01;19;Torstai;64;0;64;50;0;50
89;12.01.2012;2012;01;20;Torstai;58;0;58;34;0;34
89;12.01.2012;2012;01;21;Torstai;23;0;23;17;0;17
89;12.01.2012;2012;01;22;Torstai;13;1;14;6;0;6
89;12.01.2012;2012;01;23;Torstai;4;2;6;0;0;0
89;13.01.2012;2012;01;00;Perjantai;4;1;5;0;0;0
89;13.01.2012;2012;01;01;Perjantai;3;2;5;0;1;1
89;13.01.2012;2012;01;02;Perjantai;4;2;6;0;0;0
89;13.01.2012;2012;01;03;Perjantai;3;1;4;3;0;3
89;13.01.2012;2012;01;04;Perjantai;2;1;3;1;4;5
89;13.01.2012;2012;01;05;Perjantai;6;4;10;3;2;5
89;13.01.2012;2012;01;06;Perjantai;23;23;46;4;8;12
89;13.01.2012;2012;01;07;Perjantai;64;63;127;2;42;44
89;13.01.2012;2012;01;08;Perjantai;69;68;137;22;50;72
89;13.01.2012;2012;01;09;Perjantai;40;39;79;11;24;35
89;13.01.2012;2012;01;10;Perjantai;31;30;61;14;27;41
89;13.01.2012;2012;01;11;Perjantai;35;32;67;19;38;57
89;13.01.2012;2012;01;12;Perjantai;44;41;85;29;22;51
89;13.01.2012;2012;01;13;Perjantai;57;54;111;33;21;54
89;13.01.2012;2012;01;14;Perjantai;66;63;129;34;20;54
89;13.01.2012;2012;01;15;Perjantai;62;59;121;37;25;62
89;13.01.2012;2012;01;16;Perjantai;78;60;138;29;15;44
89;13.01.2012;2012;01;17;Perjantai;53;49;102;23;24;47
89;13.01.2012;2012;01;18;Perjantai;40;30;70;30;21;51
89;13.01.2012;2012;01;19;Perjantai;33;25;58;16;18;34
89;13.01.2012;2012;01;20;Perjantai;27;18;45;18;12;30
89;13.01.2012;2012;01;21;Perjantai;20;13;33;12;5;17
89;13.01.2012;2012;01;22;Perjantai;10;7;17;8;2;10
89;13.01.2012;2012;01;23;Perjantai;17;18;35;4;8;12
89;14.01.2012;2012;01;00;Lauantai;6;5;11;2;5;7
89;14.01.2012;2012;01;01;Lauantai;9;8;17;4;5;9
89;14.01.2012;2012;01;02;Lauantai;8;5;13;3;0;3
89;14.01.2012;2012;01;03;Lauantai;13;3;16;8;0;8
89;14.01.2012;2012;01;04;Lauantai;7;2;9;4;1;5
89;14.01.2012;2012;01;05;Lauantai;4;1;5;2;1;3
89;14.01.2012;2012;01;06;Lauantai;6;8;14;3;2;5
89;14.01.2012;2012;01;07;Lauantai;6;5;11;1;7;8
89;14.01.2012;2012;01;08;Lauantai;11;13;24;1;11;12
89;14.01.2012;2012;01;09;Lauantai;16;21;37;3;14;17
89;14.01.2012;2012;01;10;Lauantai;15;17;32;2;19;21
89;14.01.2012;2012;01;11;Lauantai;25;21;46;5;28;33
89;14.01.2012;2012;01;12;Lauantai;32;46;78;14;45;59
89;14.01.2012;2012;01;13;Lauantai;27;32;59;13;31;44
89;14.01.2012;2012;01;14;Lauantai;32;32;64;10;25;35
89;14.01.2012;2012;01;15;Lauantai;29;35;64;12;13;25
89;14.01.2012;2012;01;16;Lauantai;22;17;39;17;14;31
89;14.01.2012;2012;01;17;Lauantai;31;20;51;10;17;27
89;14.01.2012;2012;01;18;Lauantai;26;19;45;6;10;16
89;14.01.2012;2012;01;19;Lauantai;18;20;38;11;11;22
89;14.01.2012;2012;01;20;Lauantai;16;16;32;4;9;13
89;14.01.2012;2012;01;21;Lauantai;12;10;22;4;6;10
89;14.01.2012;2012;01;22;Lauantai;14;13;27;2;4;6
89;14.01.2012;2012;01;23;Lauantai;10;15;25;2;4;6
89;15.01.2012;2012;01;00;Sunnuntai;9;6;15;2;5;7
89;15.01.2012;2012;01;01;Sunnuntai;5;3;8;0;2;2
89;15.01.2012;2012;01;02;Sunnuntai;9;3;12;5;1;6
89;15.01.2012;2012;01;03;Sunnuntai;15;1;16;7;1;8
89;15.01.2012;2012;01;04;Sunnuntai;9;0;9;29;1;30
89;15.01.2012;2012;01;05;Sunnuntai;2;1;3;2;1;3
89;15.01.2012;2012;01;06;Sunnuntai;4;1;5;1;0;1
89;15.01.2012;2012;01;07;Sunnuntai;3;1;4;0;1;1
89;15.01.2012;2012;01;08;Sunnuntai;3;0;3;5;5;10
89;15.01.2012;2012;01;09;Sunnuntai;7;7;14;12;8;20
89;15.01.2012;2012;01;10;Sunnuntai;12;11;23;11;21;32
89;15.01.2012;2012;01;11;Sunnuntai;20;19;39;17;33;50
89;15.01.2012;2012;01;12;Sunnuntai;16;24;40;11;31;42
89;15.01.2012;2012;01;13;Sunnuntai;24;18;42;18;46;64
89;15.01.2012;2012;01;14;Sunnuntai;24;23;47;21;35;56
89;15.01.2012;2012;01;15;Sunnuntai;19;17;36;23;26;49
89;15.01.2012;2012;01;16;Sunnuntai;22;18;40;22;28;50
89;15.01.2012;2012;01;17;Sunnuntai;16;19;35;21;19;40
89;15.01.2012;2012;01;18;Sunnuntai;29;15;44;10;15;25
89;15.01.2012;2012;01;19;Sunnuntai;13;10;23;14;13;27
89;15.01.2012;2012;01;20;Sunnuntai;16;7;23;7;15;22
89;15.01.2012;2012;01;21;Sunnuntai;16;7;23;5;3;8
89;15.01.2012;2012;01;22;Sunnuntai;10;2;12;5;1;6
89;15.01.2012;2012;01;23;Sunnuntai;2;1;3;1;0;1
89;16.01.2012;2012;01;00;Maanantai;3;0;3;1;1;2
89;16.01.2012;2012;01;01;Maanantai;1;0;1;0;2;2
89;16.01.2012;2012;01;02;Maanantai;3;0;3;0;0;0
89;16.01.2012;2012;01;03;Maanantai;5;2;7;1;0;1
89;16.01.2012;2012;01;04;Maanantai;3;0;3;20;0;20
89;16.01.2012;2012;01;05;Maanantai;7;8;15;3;0;3
89;16.01.2012;2012;01;06;Maanantai;23;22;45;3;4;7
89;16.01.2012;2012;01;07;Maanantai;65;70;135;3;23;26
89;16.01.2012;2012;01;08;Maanantai;81;84;165;7;35;42
89;16.01.2012;2012;01;09;Maanantai;48;51;99;4;26;30
89;16.01.2012;2012;01;10;Maanantai;21;26;47;5;15;20
89;16.01.2012;2012;01;11;Maanantai;27;29;56;13;24;37
89;16.01.2012;2012;01;12;Maanantai;38;30;68;19;25;44
89;16.01.2012;2012;01;13;Maanantai;54;37;91;13;17;30
89;16.01.2012;2012;01;14;Maanantai;75;48;123;18;4;22
89;16.01.2012;2012;01;15;Maanantai;82;52;134;18;25;43
89;16.01.2012;2012;01;16;Maanantai;123;79;202;28;10;38
89;16.01.2012;2012;01;17;Maanantai;56;40;96;19;13;32
89;16.01.2012;2012;01;18;Maanantai;45;29;74;12;12;24
89;16.01.2012;2012;01;19;Maanantai;34;29;63;20;15;35
89;16.01.2012;2012;01;20;Maanantai;33;20;53;17;12;29
89;16.01.2012;2012;01;21;Maanantai;21;11;32;5;12;17
89;16.01.2012;2012;01;22;Maanantai;8;4;12;4;2;6
89;16.01.2012;2012;01;23;Maanantai;4;2;6;0;0;0
89;17.01.2012;2012;01;00;Tiistai;4;2;6;3;1;4
89;17.01.2012;2012;01;01;Tiistai;0;0;0;0;0;0
89;17.01.2012;2012;01;02;Tiistai;1;0;1;1;0;1
89;17.01.2012;2012;01;03;Tiistai;7;1;8;1;0;1
89;17.01.2012;2012;01;04;Tiistai;3;2;5;1;1;2
89;17.01.2012;2012;01;05;Tiistai;5;6;11;3;4;7
89;17.01.2012;2012;01;06;Tiistai;28;25;53;2;7;9
89;17.01.2012;2012;01;07;Tiistai;86;88;174;3;47;50
89;17.01.2012;2012;01;08;Tiistai;105;105;210;10;48;58
89;17.01.2012;2012;01;09;Tiistai;45;47;92;7;29;36
89;17.01.2012;2012;01;10;Tiistai;39;39;78;7;23;30
89;17.01.2012;2012;01;11;Tiistai;44;50;94;15;35;50
89;17.01.2012;2012;01;12;Tiistai;39;42;81;13;30;43
89;17.01.2012;2012;01;13;Tiistai;52;49;101;12;33;45
89;17.01.2012;2012;01;14;Tiistai;74;52;126;15;31;46
89;17.01.2012;2012;01;15;Tiistai;104;69;173;25;26;51
89;17.01.2012;2012;01;16;Tiistai;129;79;208;28;30;58
89;17.01.2012;2012;01;17;Tiistai;70;46;116;20;19;39
89;17.01.2012;2012;01;18;Tiistai;53;41;94;20;21;41
89;17.01.2012;2012;01;19;Tiistai;48;26;74;17;16;33
89;17.01.2012;2012;01;20;Tiistai;36;16;52;15;12;27
89;17.01.2012;2012;01;21;Tiistai;32;11;43;9;3;12
89;17.01.2012;2012;01;22;Tiistai;20;3;23;4;2;6
89;17.01.2012;2012;01;23;Tiistai;9;4;13;5;0;5
89;18.01.2012;2012;01;00;Keskiviikko;3;0;3;0;2;2
89;18.01.2012;2012;01;01;Keskiviikko;2;0;2;1;0;1
89;18.01.2012;2012;01;02;Keskiviikko;0;2;2;2;1;3
89;18.01.2012;2012;01;03;Keskiviikko;4;2;6;0;1;1
89;18.01.2012;2012;01;04;Keskiviikko;4;1;5;1;0;1
89;18.01.2012;2012;01;05;Keskiviikko;8;6;14;2;2;4
89;18.01.2012;2012;01;06;Keskiviikko;23;22;45;0;9;9
89;18.01.2012;2012;01;07;Keskiviikko;74;66;140;6;27;33
89;18.01.2012;2012;01;08;Keskiviikko;73;98;171;6;45;51
89;18.01.2012;2012;01;09;Keskiviikko;40;44;84;13;31;44
89;18.01.2012;2012;01;10;Keskiviikko;49;38;87;4;24;28
89;18.01.2012;2012;01;11;Keskiviikko;47;41;88;8;19;27
89;18.01.2012;2012;01;12;Keskiviikko;41;39;80;16;32;48
89;18.01.2012;2012;01;13;Keskiviikko;63;41;104;16;18;34
89;18.01.2012;2012;01;14;Keskiviikko;81;56;137;18;21;39
89;18.01.2012;2012;01;15;Keskiviikko;102;71;173;21;29;50
89;18.01.2012;2012;01;16;Keskiviikko;125;74;199;26;15;41
89;18.01.2012;2012;01;17;Keskiviikko;89;46;135;27;28;55
89;18.01.2012;2012;01;18;Keskiviikko;49;33;82;24;17;41
89;18.01.2012;2012;01;19;Keskiviikko;50;42;92;27;28;55
89;18.01.2012;2012;01;20;Keskiviikko;39;26;65;19;16;35
89;18.01.2012;2012;01;21;Keskiviikko;32;10;42;10;12;22
89;18.01.2012;2012;01;22;Keskiviikko;16;4;20;6;4;10
89;18.01.2012;2012;01;23;Keskiviikko;15;7;22;2;1;3
89;19.01.2012;2012;01;00;Torstai;2;1;3;1;2;3
89;19.01.2012;2012;01;01;Torstai;3;0;3;1;0;1
89;19.01.2012;2012;01;02;Torstai;2;1;3;1;1;2
89;19.01.2012;2012;01;03;Torstai;4;1;5;1;0;1
89;19.01.2012;2012;01;04;Torstai;5;3;8;2;2;4
89;19.01.2012;2012;01;05;Torstai;7;5;12;2;0;2
89;19.01.2012;2012;01;06;Torstai;22;16;38;0;6;6
89;19.01.2012;2012;01;07;Torstai;71;79;150;2;30;32
89;19.01.2012;2012;01;08;Torstai;85;84;169;7;47;54
89;19.01.2012;2012;01;09;Torstai;48;43;91;11;28;39
89;19.01.2012;2012;01;10;Torstai;34;30;64;6;28;34
89;19.01.2012;2012;01;11;Torstai;43;31;74;13;36;49
89;19.01.2012;2012;01;12;Torstai;57;48;105;18;23;41
89;19.01.2012;2012;01;13;Torstai;50;35;85;17;17;34
89;19.01.2012;2012;01;14;Torstai;78;32;110;23;25;48
89;19.01.2012;2012;01;15;Torstai;104;54;158;26;24;50
89;19.01.2012;2012;01;16;Torstai;121;51;172;24;23;47
89;19.01.2012;2012;01;17;Torstai;90;46;136;29;23;52
89;19.01.2012;2012;01;18;Torstai;59;34;93;25;22;47
89;19.01.2012;2012;01;19;Torstai;50;22;72;23;17;40
89;19.01.2012;2012;01;20;Torstai;48;18;66;10;15;25
89;19.01.2012;2012;01;21;Torstai;35;14;49;4;4;8
89;19.01.2012;2012;01;22;Torstai;25;6;31;6;5;11
89;19.01.2012;2012;01;23;Torstai;6;0;6;4;4;8
89;20.01.2012;2012;01;00;Perjantai;5;0;5;0;0;0
89;20.01.2012;2012;01;01;Perjantai;4;1;5;0;1;1
89;20.01.2012;2012;01;02;Perjantai;1;0;1;0;0;0
89;20.01.2012;2012;01;03;Perjantai;8;2;10;3;0;3
89;20.01.2012;2012;01;04;Perjantai;8;2;10;1;4;5
89;20.01.2012;2012;01;05;Perjantai;6;5;11;3;2;5
89;20.01.2012;2012;01;06;Perjantai;25;33;58;4;8;12
89;20.01.2012;2012;01;07;Perjantai;57;78;135;2;42;44
89;20.01.2012;2012;01;08;Perjantai;72;78;150;22;50;72
89;20.01.2012;2012;01;09;Perjantai;38;41;79;11;24;35
89;20.01.2012;2012;01;10;Perjantai;30;41;71;14;27;41
89;20.01.2012;2012;01;11;Perjantai;47;22;69;19;38;57
89;20.01.2012;2012;01;12;Perjantai;74;25;99;29;22;51
89;20.01.2012;2012;01;13;Perjantai;88;24;112;33;21;54
89;20.01.2012;2012;01;14;Perjantai;113;21;134;34;20;54
89;20.01.2012;2012;01;15;Perjantai;147;28;175;37;25;62
89;20.01.2012;2012;01;16;Perjantai;137;19;156;29;15;44
89;20.01.2012;2012;01;17;Perjantai;87;21;108;23;24;47
89;20.01.2012;2012;01;18;Perjantai;78;12;90;30;21;51
89;20.01.2012;2012;01;19;Perjantai;38;4;42;16;18;34
89;20.01.2012;2012;01;20;Perjantai;36;8;44;18;12;30
89;20.01.2012;2012;01;21;Perjantai;39;4;43;12;5;17
89;20.01.2012;2012;01;22;Perjantai;25;5;30;8;2;10
89;20.01.2012;2012;01;23;Perjantai;22;10;32;4;8;12
89;21.01.2012;2012;01;00;Lauantai;18;4;22;8;1;9
89;21.01.2012;2012;01;01;Lauantai;14;3;17;4;2;6
89;21.01.2012;2012;01;02;Lauantai;19;4;23;8;3;11
89;21.01.2012;2012;01;03;Lauantai;11;0;11;6;1;7
89;21.01.2012;2012;01;04;Lauantai;9;1;10;14;1;15
89;21.01.2012;2012;01;05;Lauantai;8;1;9;2;1;3
89;21.01.2012;2012;01;06;Lauantai;12;2;14;2;5;7
89;21.01.2012;2012;01;07;Lauantai;8;1;9;5;3;8
89;21.01.2012;2012;01;08;Lauantai;14;4;18;5;7;12
89;21.01.2012;2012;01;09;Lauantai;30;13;43;16;18;34
89;21.01.2012;2012;01;10;Lauantai;30;11;41;20;35;55
89;21.01.2012;2012;01;11;Lauantai;40;17;57;20;41;61
89;21.01.2012;2012;01;12;Lauantai;61;17;78;29;41;70
89;21.01.2012;2012;01;13;Lauantai;45;23;68;41;34;75
89;21.01.2012;2012;01;14;Lauantai;46;21;67;33;24;57
89;21.01.2012;2012;01;15;Lauantai;54;15;69;23;22;45
89;21.01.2012;2012;01;16;Lauantai;45;10;55;27;26;53
89;21.01.2012;2012;01;17;Lauantai;41;9;50;23;25;48
89;21.01.2012;2012;01;18;Lauantai;28;12;40;20;18;38
89;21.01.2012;2012;01;19;Lauantai;25;13;38;15;15;30
89;21.01.2012;2012;01;20;Lauantai;24;10;34;11;6;17
89;21.01.2012;2012;01;21;Lauantai;25;10;35;11;13;24
89;21.01.2012;2012;01;22;Lauantai;19;8;27;4;6;10
89;21.01.2012;2012;01;23;Lauantai;22;10;32;8;11;19
89;22.01.2012;2012;01;00;Sunnuntai;11;3;14;4;3;7
89;22.01.2012;2012;01;01;Sunnuntai;7;1;8;4;4;8
89;22.01.2012;2012;01;02;Sunnuntai;15;2;17;7;0;7
89;22.01.2012;2012;01;03;Sunnuntai;7;0;7;5;1;6
89;22.01.2012;2012;01;04;Sunnuntai;12;0;12;7;0;7
89;22.01.2012;2012;01;05;Sunnuntai;2;0;2;2;0;2
89;22.01.2012;2012;01;06;Sunnuntai;6;1;7;0;1;1
89;22.01.2012;2012;01;07;Sunnuntai;6;0;6;3;3;6
89;22.01.2012;2012;01;08;Sunnuntai;8;2;10;5;7;12
89;22.01.2012;2012;01;09;Sunnuntai;10;4;14;7;9;16
89;22.01.2012;2012;01;10;Sunnuntai;16;4;20;16;20;36
89;22.01.2012;2012;01;11;Sunnuntai;27;12;39;22;33;55
89;22.01.2012;2012;01;12;Sunnuntai;35;7;42;37;40;77
89;22.01.2012;2012;01;13;Sunnuntai;50;14;64;27;41;68
89;22.01.2012;2012;01;14;Sunnuntai;52;12;64;30;31;61
89;22.01.2012;2012;01;15;Sunnuntai;45;10;55;25;31;56
89;22.01.2012;2012;01;16;Sunnuntai;48;15;63;33;24;57
89;22.01.2012;2012;01;17;Sunnuntai;41;12;53;26;25;51
89;22.01.2012;2012;01;18;Sunnuntai;38;7;45;21;23;44
89;22.01.2012;2012;01;19;Sunnuntai;31;6;37;29;13;42
89;22.01.2012;2012;01;20;Sunnuntai;29;1;30;13;10;23
89;22.01.2012;2012;01;21;Sunnuntai;13;0;13;7;4;11
89;22.01.2012;2012;01;22;Sunnuntai;14;1;15;8;3;11
89;22.01.2012;2012;01;23;Sunnuntai;9;9;18;3;3;6
89;23.01.2012;2012;01;00;Maanantai;5;3;8;1;2;3
89;23.01.2012;2012;01;01;Maanantai;3;0;3;1;1;2
89;23.01.2012;2012;01;02;Maanantai;0;0;0;2;1;3
89;23.01.2012;2012;01;03;Maanantai;4;0;4;0;0;0
89;23.01.2012;2012;01;04;Maanantai;7;1;8;5;4;9
89;23.01.2012;2012;01;05;Maanantai;10;2;12;1;2;3
89;23.01.2012;2012;01;06;Maanantai;33;9;42;5;8;13
89;23.01.2012;2012;01;07;Maanantai;99;43;142;11;35;46
89;23.01.2012;2012;01;08;Maanantai;118;71;189;22;51;73
89;23.01.2012;2012;01;09;Maanantai;62;41;103;13;29;42
89;23.01.2012;2012;01;10;Maanantai;43;19;62;25;35;60
89;23.01.2012;2012;01;11;Maanantai;36;21;57;23;36;59
89;23.01.2012;2012;01;12;Maanantai;59;22;81;35;29;64
89;23.01.2012;2012;01;13;Maanantai;57;19;76;23;26;49
89;23.01.2012;2012;01;14;Maanantai;77;20;97;34;22;56
89;23.01.2012;2012;01;15;Maanantai;139;21;160;43;32;75
89;23.01.2012;2012;01;16;Maanantai;175;35;210;52;21;73
89;23.01.2012;2012;01;17;Maanantai;100;25;125;34;24;58
89;23.01.2012;2012;01;18;Maanantai;98;17;115;39;20;59
89;23.01.2012;2012;01;19;Maanantai;60;16;76;30;27;57
89;23.01.2012;2012;01;20;Maanantai;57;7;64;26;14;40
89;23.01.2012;2012;01;21;Maanantai;28;8;36;9;6;15
89;23.01.2012;2012;01;22;Maanantai;14;3;17;3;6;9
89;23.01.2012;2012;01;23;Maanantai;7;1;8;3;0;3
89;24.01.2012;2012;01;00;Tiistai;3;0;3;1;1;2
89;24.01.2012;2012;01;01;Tiistai;0;0;0;2;1;3
89;24.01.2012;2012;01;02;Tiistai;1;2;3;0;0;0
89;24.01.2012;2012;01;03;Tiistai;2;0;2;2;0;2
89;24.01.2012;2012;01;04;Tiistai;3;0;3;1;0;1
89;24.01.2012;2012;01;05;Tiistai;9;0;9;2;1;3
89;24.01.2012;2012;01;06;Tiistai;43;17;60;4;9;13
89;24.01.2012;2012;01;07;Tiistai;120;66;186;15;34;49
89;24.01.2012;2012;01;08;Tiistai;104;55;159;27;38;65
89;24.01.2012;2012;01;09;Tiistai;49;33;82;14;24;38
89;24.01.2012;2012;01;10;Tiistai;47;23;70;17;35;52
89;24.01.2012;2012;01;11;Tiistai;68;21;89;22;26;48
89;24.01.2012;2012;01;12;Tiistai;62;37;99;30;54;84
89;24.01.2012;2012;01;13;Tiistai;62;20;82;32;30;62
89;24.01.2012;2012;01;14;Tiistai;83;15;98;35;19;54
89;24.01.2012;2012;01;15;Tiistai;149;27;176;50;28;78
89;24.01.2012;2012;01;16;Tiistai;186;32;218;68;25;93
89;24.01.2012;2012;01;17;Tiistai;100;24;124;41;42;83
89;24.01.2012;2012;01;18;Tiistai;62;27;89;24;27;51
89;24.01.2012;2012;01;19;Tiistai;50;10;60;29;12;41
89;24.01.2012;2012;01;20;Tiistai;63;12;75;25;12;37
89;24.01.2012;2012;01;21;Tiistai;31;5;36;10;10;20
89;24.01.2012;2012;01;22;Tiistai;15;0;15;4;1;5
89;24.01.2012;2012;01;23;Tiistai;6;1;7;2;0;2
89;25.01.2012;2012;01;00;Keskiviikko;3;0;3;0;2;2
89;25.01.2012;2012;01;01;Keskiviikko;2;0;2;0;1;1
89;25.01.2012;2012;01;02;Keskiviikko;1;0;1;1;0;1
89;25.01.2012;2012;01;03;Keskiviikko;2;2;4;0;1;1
89;25.01.2012;2012;01;04;Keskiviikko;3;1;4;0;0;0
89;25.01.2012;2012;01;05;Keskiviikko;10;0;10;1;3;4
89;25.01.2012;2012;01;06;Keskiviikko;22;22;44;7;15;22
89;25.01.2012;2012;01;07;Keskiviikko;104;44;148;10;31;41
89;25.01.2012;2012;01;08;Keskiviikko;104;83;187;18;45;63
89;25.01.2012;2012;01;09;Keskiviikko;51;24;75;9;25;34
89;25.01.2012;2012;01;10;Keskiviikko;37;22;59;9;24;33
89;25.01.2012;2012;01;11;Keskiviikko;41;24;65;16;35;51
89;25.01.2012;2012;01;12;Keskiviikko;60;30;90;22;29;51
89;25.01.2012;2012;01;13;Keskiviikko;46;22;68;25;32;57
89;25.01.2012;2012;01;14;Keskiviikko;74;23;97;40;21;61
89;25.01.2012;2012;01;15;Keskiviikko;111;34;145;30;21;51
89;25.01.2012;2012;01;16;Keskiviikko;154;27;181;42;21;63
89;25.01.2012;2012;01;17;Keskiviikko;83;29;112;40;10;50
89;25.01.2012;2012;01;18;Keskiviikko;64;16;80;21;13;34
89;25.01.2012;2012;01;19;Keskiviikko;55;4;59;14;18;32
89;25.01.2012;2012;01;20;Keskiviikko;47;10;57;23;15;38
89;25.01.2012;2012;01;21;Keskiviikko;30;1;31;11;8;19
89;25.01.2012;2012;01;22;Keskiviikko;5;2;7;3;3;6
89;25.01.2012;2012;01;23;Keskiviikko;5;1;6;3;7;10
89;26.01.2012;2012;01;00;Torstai;2;0;2;2;1;3
89;26.01.2012;2012;01;01;Torstai;4;1;5;3;3;6
89;26.01.2012;2012;01;02;Torstai;3;1;4;0;0;0
89;26.01.2012;2012;01;03;Torstai;3;0;3;1;0;1
89;26.01.2012;2012;01;04;Torstai;4;0;4;3;0;3
89;26.01.2012;2012;01;05;Torstai;10;2;12;0;1;1
89;26.01.2012;2012;01;06;Torstai;32;17;49;7;13;20
89;26.01.2012;2012;01;07;Torstai;93;42;135;11;29;40
89;26.01.2012;2012;01;08;Torstai;86;64;150;10;36;46
89;26.01.2012;2012;01;09;Torstai;58;41;99;13;24;37
89;26.01.2012;2012;01;10;Torstai;43;16;59;16;29;45
89;26.01.2012;2012;01;11;Torstai;51;21;72;23;34;57
89;26.01.2012;2012;01;12;Torstai;54;38;92;25;36;61
89;26.01.2012;2012;01;13;Torstai;52;19;71;24;31;55
89;26.01.2012;2012;01;14;Torstai;70;30;100;30;31;61
89;26.01.2012;2012;01;15;Torstai;111;25;136;38;23;61
89;26.01.2012;2012;01;16;Torstai;165;24;189;44;21;65
89;26.01.2012;2012;01;17;Torstai;87;27;114;31;19;50
89;26.01.2012;2012;01;18;Torstai;58;20;78;40;17;57
89;26.01.2012;2012;01;19;Torstai;47;11;58;23;13;36
89;26.01.2012;2012;01;20;Torstai;48;12;60;17;11;28
89;26.01.2012;2012;01;21;Torstai;32;6;38;11;10;21
89;26.01.2012;2012;01;22;Torstai;18;5;23;5;3;8
89;26.01.2012;2012;01;23;Torstai;5;1;6;2;3;5
89;27.01.2012;2012;01;00;Perjantai;5;0;5;2;0;2
89;27.01.2012;2012;01;01;Perjantai;4;0;4;0;0;0
89;27.01.2012;2012;01;02;Perjantai;1;0;1;1;1;2
89;27.01.2012;2012;01;03;Perjantai;2;0;2;2;0;2
89;27.01.2012;2012;01;04;Perjantai;3;0;3;2;0;2
89;27.01.2012;2012;01;05;Perjantai;12;3;15;1;3;4
89;27.01.2012;2012;01;06;Perjantai;28;12;40;5;6;11
89;27.01.2012;2012;01;07;Perjantai;96;53;149;9;37;46
89;27.01.2012;2012;01;08;Perjantai;87;64;151;12;36;48
89;27.01.2012;2012;01;09;Perjantai;42;32;74;9;35;44
89;27.01.2012;2012;01;10;Perjantai;33;15;48;20;26;46
89;27.01.2012;2012;01;11;Perjantai;46;22;68;20;33;53
89;27.01.2012;2012;01;12;Perjantai;51;38;89;13;22;35
89;27.01.2012;2012;01;13;Perjantai;78;29;107;28;24;52
89;27.01.2012;2012;01;14;Perjantai;98;30;128;22;24;46
89;27.01.2012;2012;01;15;Perjantai;106;25;131;26;21;47
89;27.01.2012;2012;01;16;Perjantai;120;16;136;28;20;48
89;27.01.2012;2012;01;17;Perjantai;66;20;86;26;15;41
89;27.01.2012;2012;01;18;Perjantai;40;13;53;12;16;28
89;27.01.2012;2012;01;19;Perjantai;40;18;58;8;8;16
89;27.01.2012;2012;01;20;Perjantai;29;4;33;4;9;13
89;27.01.2012;2012;01;21;Perjantai;15;17;32;9;7;16
89;27.01.2012;2012;01;22;Perjantai;15;9;24;5;5;10
89;27.01.2012;2012;01;23;Perjantai;2;8;10;3;5;8
89;28.01.2012;2012;01;00;Lauantai;6;9;15;4;2;6
89;28.01.2012;2012;01;01;Lauantai;4;3;7;3;2;5
89;28.01.2012;2012;01;02;Lauantai;16;2;18;4;4;8
89;28.01.2012;2012;01;03;Lauantai;10;0;10;1;1;2
89;28.01.2012;2012;01;04;Lauantai;10;1;11;2;1;3
89;28.01.2012;2012;01;05;Lauantai;3;0;3;1;2;3
89;28.01.2012;2012;01;06;Lauantai;8;5;13;1;3;4
89;28.01.2012;2012;01;07;Lauantai;8;6;14;15;6;21
89;28.01.2012;2012;01;08;Lauantai;7;6;13;4;9;13
89;28.01.2012;2012;01;09;Lauantai;18;8;26;7;20;27
89;28.01.2012;2012;01;10;Lauantai;18;9;27;8;24;32
89;28.01.2012;2012;01;11;Lauantai;13;14;27;12;29;41
89;28.01.2012;2012;01;12;Lauantai;19;23;42;22;28;50
89;28.01.2012;2012;01;13;Lauantai;28;17;45;22;43;65
89;28.01.2012;2012;01;14;Lauantai;25;12;37;26;29;55
89;28.01.2012;2012;01;15;Lauantai;30;26;56;45;30;75
89;28.01.2012;2012;01;16;Lauantai;36;13;49;22;14;36
89;28.01.2012;2012;01;17;Lauantai;24;11;35;17;13;30
89;28.01.2012;2012;01;18;Lauantai;18;10;28;15;16;31
89;28.01.2012;2012;01;19;Lauantai;17;13;30;7;11;18
89;28.01.2012;2012;01;20;Lauantai;10;1;11;14;8;22
89;28.01.2012;2012;01;21;Lauantai;10;11;21;6;4;10
89;28.01.2012;2012;01;22;Lauantai;8;12;20;6;5;11
89;28.01.2012;2012;01;23;Lauantai;6;5;11;3;3;6
89;29.01.2012;2012;01;00;Sunnuntai;5;6;11;5;4;9
89;29.01.2012;2012;01;01;Sunnuntai;5;2;7;6;4;10
89;29.01.2012;2012;01;02;Sunnuntai;9;0;9;8;0;8
89;29.01.2012;2012;01;03;Sunnuntai;9;1;10;4;0;4
89;29.01.2012;2012;01;04;Sunnuntai;13;0;13;4;0;4
89;29.01.2012;2012;01;05;Sunnuntai;4;0;4;3;0;3
89;29.01.2012;2012;01;06;Sunnuntai;3;4;7;1;1;2
89;29.01.2012;2012;01;07;Sunnuntai;2;0;2;2;0;2
89;29.01.2012;2012;01;08;Sunnuntai;2;4;6;5;11;16
89;29.01.2012;2012;01;09;Sunnuntai;7;6;13;6;14;20
89;29.01.2012;2012;01;10;Sunnuntai;6;4;10;9;20;29
89;29.01.2012;2012;01;11;Sunnuntai;7;16;23;27;37;64
89;29.01.2012;2012;01;12;Sunnuntai;11;15;26;39;31;70
89;29.01.2012;2012;01;13;Sunnuntai;24;9;33;35;35;70
89;29.01.2012;2012;01;14;Sunnuntai;12;14;26;45;47;92
89;29.01.2012;2012;01;15;Sunnuntai;19;8;27;35;25;60
89;29.01.2012;2012;01;16;Sunnuntai;25;8;33;21;13;34
89;29.01.2012;2012;01;17;Sunnuntai;13;10;23;17;21;38
89;29.01.2012;2012;01;18;Sunnuntai;24;5;29;11;14;25
89;29.01.2012;2012;01;19;Sunnuntai;16;7;23;10;8;18
89;29.01.2012;2012;01;20;Sunnuntai;15;11;26;4;4;8
89;29.01.2012;2012;01;21;Sunnuntai;8;2;10;11;4;15
89;29.01.2012;2012;01;22;Sunnuntai;6;5;11;2;0;2
89;29.01.2012;2012;01;23;Sunnuntai;8;3;11;1;1;2
89;30.01.2012;2012;01;00;Maanantai;0;2;2;0;2;2
89;30.01.2012;2012;01;01;Maanantai;0;0;0;0;0;0
89;30.01.2012;2012;01;02;Maanantai;1;0;1;0;0;0
89;30.01.2012;2012;01;03;Maanantai;5;2;7;0;0;0
89;30.01.2012;2012;01;04;Maanantai;2;3;5;0;1;1
89;30.01.2012;2012;01;05;Maanantai;8;1;9;0;0;0
89;30.01.2012;2012;01;06;Maanantai;11;16;27;7;6;13
89;30.01.2012;2012;01;07;Maanantai;31;22;53;9;20;29
89;30.01.2012;2012;01;08;Maanantai;90;56;146;17;48;65
89;30.01.2012;2012;01;09;Maanantai;43;28;71;9;37;46
89;30.01.2012;2012;01;10;Maanantai;35;23;58;12;26;38
89;30.01.2012;2012;01;11;Maanantai;37;10;47;21;29;50
89;30.01.2012;2012;01;12;Maanantai;38;17;55;26;23;49
89;30.01.2012;2012;01;13;Maanantai;45;18;63;20;22;42
89;30.01.2012;2012;01;14;Maanantai;39;37;76;34;35;69
89;30.01.2012;2012;01;15;Maanantai;74;21;95;38;26;64
89;30.01.2012;2012;01;16;Maanantai;124;18;142;52;20;72
89;30.01.2012;2012;01;17;Maanantai;63;17;80;35;16;51
89;30.01.2012;2012;01;18;Maanantai;48;16;64;20;14;34
89;30.01.2012;2012;01;19;Maanantai;47;12;59;21;16;37
89;30.01.2012;2012;01;20;Maanantai;37;9;46;8;10;18
89;30.01.2012;2012;01;21;Maanantai;23;5;28;9;7;16
89;30.01.2012;2012;01;22;Maanantai;9;0;9;8;3;11
89;30.01.2012;2012;01;23;Maanantai;6;1;7;3;1;4
89;31.01.2012;2012;01;00;Tiistai;1;0;1;0;0;0
89;31.01.2012;2012;01;01;Tiistai;0;0;0;1;0;1
89;31.01.2012;2012;01;02;Tiistai;1;0;1;0;1;1
89;31.01.2012;2012;01;03;Tiistai;3;1;4;0;0;0
89;31.01.2012;2012;01;04;Tiistai;2;2;4;0;1;1
89;31.01.2012;2012;01;05;Tiistai;10;1;11;2;0;2
89;31.01.2012;2012;01;06;Tiistai;23;10;33;2;5;7
89;31.01.2012;2012;01;07;Tiistai;81;30;111;6;56;62
89;31.01.2012;2012;01;08;Tiistai;87;46;133;14;44;58
89;31.01.2012;2012;01;09;Tiistai;52;20;72;13;23;36
89;31.01.2012;2012;01;10;Tiistai;28;8;36;14;30;44
89;31.01.2012;2012;01;11;Tiistai;42;8;50;13;13;26
89;31.01.2012;2012;01;12;Tiistai;34;22;56;25;32;57
89;31.01.2012;2012;01;13;Tiistai;42;10;52;20;18;38
89;31.01.2012;2012;01;14;Tiistai;56;21;77;45;20;65
89;31.01.2012;2012;01;15;Tiistai;82;18;100;49;21;70
89;31.01.2012;2012;01;16;Tiistai;127;17;144;47;22;69
89;31.01.2012;2012;01;17;Tiistai;50;19;69;26;19;45
89;31.01.2012;2012;01;18;Tiistai;53;16;69;20;19;39
89;31.01.2012;2012;01;19;Tiistai;43;13;56;16;14;30
89;31.01.2012;2012;01;20;Tiistai;41;4;45;19;9;28
89;31.01.2012;2012;01;21;Tiistai;29;3;32;9;5;14
89;31.01.2012;2012;01;22;Tiistai;9;2;11;3;3;6
89;31.01.2012;2012;01;23;Tiistai;4;1;5;0;2;2
89;01.02.2012;2012;02;00;Keskiviikko;4;0;4;2;0;2
89;01.02.2012;2012;02;01;Keskiviikko;0;2;2;0;0;0
89;01.02.2012;2012;02;02;Keskiviikko;3;0;3;1;0;1
89;01.02.2012;2012;02;03;Keskiviikko;0;0;0;1;0;1
89;01.02.2012;2012;02;04;Keskiviikko;3;7;10;0;1;1
89;01.02.2012;2012;02;05;Keskiviikko;7;4;11;3;1;4
89;01.02.2012;2012;02;06;Keskiviikko;23;12;35;4;10;14
89;01.02.2012;2012;02;07;Keskiviikko;58;48;106;7;42;49
89;01.02.2012;2012;02;08;Keskiviikko;61;53;114;5;37;42
89;01.02.2012;2012;02;09;Keskiviikko;35;20;55;9;30;39
89;01.02.2012;2012;02;10;Keskiviikko;22;20;42;12;20;32
89;01.02.2012;2012;02;11;Keskiviikko;36;20;56;16;21;37
89;01.02.2012;2012;02;12;Keskiviikko;28;22;50;22;37;59
89;01.02.2012;2012;02;13;Keskiviikko;43;28;71;31;19;50
89;01.02.2012;2012;02;14;Keskiviikko;56;15;71;30;30;60
89;01.02.2012;2012;02;15;Keskiviikko;85;16;101;24;23;47
89;01.02.2012;2012;02;16;Keskiviikko;102;20;122;41;27;68
89;01.02.2012;2012;02;17;Keskiviikko;61;12;73;37;16;53
89;01.02.2012;2012;02;18;Keskiviikko;55;14;69;21;18;39
89;01.02.2012;2012;02;19;Keskiviikko;29;8;37;12;17;29
89;01.02.2012;2012;02;20;Keskiviikko;29;9;38;23;8;31
89;01.02.2012;2012;02;21;Keskiviikko;27;4;31;10;4;14
89;01.02.2012;2012;02;22;Keskiviikko;11;0;11;3;5;8
89;01.02.2012;2012;02;23;Keskiviikko;5;2;7;2;2;4
89;02.02.2012;2012;02;00;Torstai;1;0;1;1;1;2
89;02.02.2012;2012;02;01;Torstai;2;0;2;2;3;5
89;02.02.2012;2012;02;02;Torstai;3;0;3;0;0;0
89;02.02.2012;2012;02;03;Torstai;0;1;1;1;0;1
89;02.02.2012;2012;02;04;Torstai;7;2;9;1;1;2
89;02.02.2012;2012;02;05;Torstai;6;1;7;1;0;1
89;02.02.2012;2012;02;06;Torstai;22;5;27;7;5;12
89;02.02.2012;2012;02;07;Torstai;55;25;80;8;52;60
89;02.02.2012;2012;02;08;Torstai;54;47;101;8;35;43
89;02.02.2012;2012;02;09;Torstai;31;20;51;10;23;33
89;02.02.2012;2012;02;10;Torstai;19;11;30;11;26;37
89;02.02.2012;2012;02;11;Torstai;31;27;58;10;27;37
89;02.02.2012;2012;02;12;Torstai;22;25;47;23;32;55
89;02.02.2012;2012;02;13;Torstai;39;9;48;20;20;40
89;02.02.2012;2012;02;14;Torstai;52;14;66;25;19;44
89;02.02.2012;2012;02;15;Torstai;71;21;92;39;21;60
89;02.02.2012;2012;02;16;Torstai;91;20;111;46;24;70
89;02.02.2012;2012;02;17;Torstai;54;21;75;29;7;36
89;02.02.2012;2012;02;18;Torstai;43;4;47;16;6;22
89;02.02.2012;2012;02;19;Torstai;36;1;37;24;11;35
89;02.02.2012;2012;02;20;Torstai;36;0;36;19;0;19
89;02.02.2012;2012;02;21;Torstai;25;0;25;9;0;9
89;02.02.2012;2012;02;22;Torstai;15;0;15;8;0;8
89;02.02.2012;2012;02;23;Torstai;13;0;13;4;0;4
89;03.02.2012;2012;02;00;Perjantai;1;0;1;3;0;3
89;03.02.2012;2012;02;01;Perjantai;1;0;1;0;0;0
89;03.02.2012;2012;02;02;Perjantai;1;0;1;1;0;1
89;03.02.2012;2012;02;03;Perjantai;3;0;3;1;0;1
89;03.02.2012;2012;02;04;Perjantai;8;0;8;1;0;1
89;03.02.2012;2012;02;05;Perjantai;9;0;9;3;0;3
89;03.02.2012;2012;02;06;Perjantai;29;0;29;12;0;12
89;03.02.2012;2012;02;07;Perjantai;73;1;74;50;0;50
89;03.02.2012;2012;02;08;Perjantai;79;0;79;64;0;64
89;03.02.2012;2012;02;09;Perjantai;35;0;35;31;0;31
89;03.02.2012;2012;02;10;Perjantai;36;0;36;29;0;29
89;03.02.2012;2012;02;11;Perjantai;41;0;41;37;0;37
89;03.02.2012;2012;02;12;Perjantai;49;0;49;49;0;49
89;03.02.2012;2012;02;13;Perjantai;71;0;71;51;0;51
89;03.02.2012;2012;02;14;Perjantai;65;0;65;42;0;42
89;03.02.2012;2012;02;15;Perjantai;87;0;87;52;0;52
89;03.02.2012;2012;02;16;Perjantai;70;0;70;54;0;54
89;03.02.2012;2012;02;17;Perjantai;47;0;47;39;0;39
89;03.02.2012;2012;02;18;Perjantai;40;0;40;33;0;33
89;03.02.2012;2012;02;19;Perjantai;42;0;42;18;0;18
89;03.02.2012;2012;02;20;Perjantai;24;0;24;14;0;14
89;03.02.2012;2012;02;21;Perjantai;24;0;24;19;0;19
89;03.02.2012;2012;02;22;Perjantai;10;0;10;7;0;7
89;03.02.2012;2012;02;23;Perjantai;9;0;9;5;0;5
89;04.02.2012;2012;02;00;Lauantai;8;0;8;7;0;7
89;04.02.2012;2012;02;01;Lauantai;14;0;14;9;0;9
89;04.02.2012;2012;02;02;Lauantai;8;0;8;5;0;5
89;04.02.2012;2012;02;03;Lauantai;5;0;5;5;0;5
89;04.02.2012;2012;02;04;Lauantai;5;0;5;4;0;4
89;04.02.2012;2012;02;05;Lauantai;6;0;6;2;0;2
89;04.02.2012;2012;02;06;Lauantai;6;0;6;4;0;4
89;04.02.2012;2012;02;07;Lauantai;6;0;6;8;0;8
89;04.02.2012;2012;02;08;Lauantai;7;0;7;8;0;8
89;04.02.2012;2012;02;09;Lauantai;20;0;20;20;0;20
89;04.02.2012;2012;02;10;Lauantai;21;0;21;23;0;23
89;04.02.2012;2012;02;11;Lauantai;32;0;32;40;0;40
89;04.02.2012;2012;02;12;Lauantai;29;0;29;64;0;64
89;04.02.2012;2012;02;13;Lauantai;23;0;23;57;0;57
89;04.02.2012;2012;02;14;Lauantai;25;0;25;54;0;54
89;04.02.2012;2012;02;15;Lauantai;30;0;30;34;0;34
89;04.02.2012;2012;02;16;Lauantai;31;0;31;26;0;26
89;04.02.2012;2012;02;17;Lauantai;29;0;29;30;0;30
89;04.02.2012;2012;02;18;Lauantai;25;0;25;19;0;19
89;04.02.2012;2012;02;19;Lauantai;16;0;16;22;0;22
89;04.02.2012;2012;02;20;Lauantai;13;0;13;10;0;10
89;04.02.2012;2012;02;21;Lauantai;13;0;13;10;0;10
89;04.02.2012;2012;02;22;Lauantai;9;0;9;6;0;6
89;04.02.2012;2012;02;23;Lauantai;8;0;8;7;0;7
89;05.02.2012;2012;02;00;Sunnuntai;9;0;9;2;0;2
89;05.02.2012;2012;02;01;Sunnuntai;7;0;7;4;0;4
89;05.02.2012;2012;02;02;Sunnuntai;10;0;10;2;0;2
89;05.02.2012;2012;02;03;Sunnuntai;7;0;7;7;0;7
89;05.02.2012;2012;02;04;Sunnuntai;1;0;1;5;0;5
89;05.02.2012;2012;02;05;Sunnuntai;4;0;4;0;0;0
89;05.02.2012;2012;02;06;Sunnuntai;4;0;4;0;0;0
89;05.02.2012;2012;02;07;Sunnuntai;5;0;5;1;0;1
89;05.02.2012;2012;02;08;Sunnuntai;2;0;2;6;0;6
89;05.02.2012;2012;02;09;Sunnuntai;6;0;6;10;0;10
89;05.02.2012;2012;02;10;Sunnuntai;11;0;11;20;0;20
89;05.02.2012;2012;02;11;Sunnuntai;9;0;9;26;0;26
89;05.02.2012;2012;02;12;Sunnuntai;18;0;18;34;0;34
89;05.02.2012;2012;02;13;Sunnuntai;12;0;12;39;0;39
89;05.02.2012;2012;02;14;Sunnuntai;14;0;14;31;0;31
89;05.02.2012;2012;02;15;Sunnuntai;32;0;32;31;0;31
89;05.02.2012;2012;02;16;Sunnuntai;18;0;18;23;0;23
89;05.02.2012;2012;02;17;Sunnuntai;13;0;13;16;0;16
89;05.02.2012;2012;02;18;Sunnuntai;26;0;26;18;0;18
89;05.02.2012;2012;02;19;Sunnuntai;19;0;19;29;0;29
89;05.02.2012;2012;02;20;Sunnuntai;15;0;15;12;0;12
89;05.02.2012;2012;02;21;Sunnuntai;9;0;9;11;0;11
89;05.02.2012;2012;02;22;Sunnuntai;7;0;7;3;0;3
89;05.02.2012;2012;02;23;Sunnuntai;6;0;6;4;0;4
89;06.02.2012;2012;02;00;Maanantai;3;0;3;2;0;2
89;06.02.2012;2012;02;01;Maanantai;5;0;5;1;0;1
89;06.02.2012;2012;02;02;Maanantai;3;0;3;0;0;0
89;06.02.2012;2012;02;03;Maanantai;0;0;0;1;0;1
89;06.02.2012;2012;02;04;Maanantai;4;1;5;2;0;2
89;06.02.2012;2012;02;05;Maanantai;8;0;8;14;0;14
89;06.02.2012;2012;02;06;Maanantai;48;1;49;12;0;12
89;06.02.2012;2012;02;07;Maanantai;109;8;117;51;0;51
89;06.02.2012;2012;02;08;Maanantai;134;6;140;93;0;93
89;06.02.2012;2012;02;09;Maanantai;70;4;74;45;0;45
89;06.02.2012;2012;02;10;Maanantai;60;2;62;50;0;50
89;06.02.2012;2012;02;11;Maanantai;70;0;70;39;0;39
89;06.02.2012;2012;02;12;Maanantai;56;2;58;61;0;61
89;06.02.2012;2012;02;13;Maanantai;64;2;66;51;0;51
89;06.02.2012;2012;02;14;Maanantai;85;2;87;68;0;68
89;06.02.2012;2012;02;15;Maanantai;145;5;150;76;0;76
89;06.02.2012;2012;02;16;Maanantai;164;7;171;84;0;84
89;06.02.2012;2012;02;17;Maanantai;71;5;76;54;0;54
89;06.02.2012;2012;02;18;Maanantai;74;5;79;65;0;65
89;06.02.2012;2012;02;19;Maanantai;48;1;49;43;0;43
89;06.02.2012;2012;02;20;Maanantai;32;0;32;45;0;45
89;06.02.2012;2012;02;21;Maanantai;13;0;13;22;0;22
89;06.02.2012;2012;02;22;Maanantai;7;0;7;6;0;6
89;06.02.2012;2012;02;23;Maanantai;0;0;0;5;0;5
89;07.02.2012;2012;02;00;Tiistai;3;0;3;2;0;2
89;07.02.2012;2012;02;01;Tiistai;1;0;1;1;0;1
89;07.02.2012;2012;02;02;Tiistai;1;0;1;1;0;1
89;07.02.2012;2012;02;03;Tiistai;3;0;3;1;0;1
89;07.02.2012;2012;02;04;Tiistai;5;0;5;12;0;12
89;07.02.2012;2012;02;05;Tiistai;9;0;9;4;0;4
89;07.02.2012;2012;02;06;Tiistai;31;0;31;12;0;12
89;07.02.2012;2012;02;07;Tiistai;69;0;69;66;0;66
89;07.02.2012;2012;02;08;Tiistai;85;0;85;61;0;61
89;07.02.2012;2012;02;09;Tiistai;43;0;43;42;0;42
89;07.02.2012;2012;02;10;Tiistai;22;0;22;34;0;34
89;07.02.2012;2012;02;11;Tiistai;35;0;35;31;0;31
89;07.02.2012;2012;02;12;Tiistai;46;0;46;37;0;37
89;07.02.2012;2012;02;13;Tiistai;49;0;49;41;0;41
89;07.02.2012;2012;02;14;Tiistai;66;0;66;49;0;49
89;07.02.2012;2012;02;15;Tiistai;86;0;86;62;0;62
89;07.02.2012;2012;02;16;Tiistai;91;0;91;64;0;64
89;07.02.2012;2012;02;17;Tiistai;53;0;53;44;0;44
89;07.02.2012;2012;02;18;Tiistai;42;0;42;25;0;25
89;07.02.2012;2012;02;19;Tiistai;33;0;33;23;0;23
89;07.02.2012;2012;02;20;Tiistai;27;0;27;27;0;27
89;07.02.2012;2012;02;21;Tiistai;19;0;19;10;0;10
89;07.02.2012;2012;02;22;Tiistai;13;0;13;7;0;7
89;07.02.2012;2012;02;23;Tiistai;4;0;4;2;0;2
89;08.02.2012;2012;02;00;Keskiviikko;2;0;2;2;0;2
89;08.02.2012;2012;02;01;Keskiviikko;0;0;0;4;0;4
89;08.02.2012;2012;02;02;Keskiviikko;0;0;0;0;0;0
89;08.02.2012;2012;02;03;Keskiviikko;0;0;0;2;0;2
89;08.02.2012;2012;02;04;Keskiviikko;4;0;4;1;3;4
89;08.02.2012;2012;02;05;Keskiviikko;4;0;4;5;0;5
89;08.02.2012;2012;02;06;Keskiviikko;24;0;24;18;0;18
89;08.02.2012;2012;02;07;Keskiviikko;80;2;82;54;0;54
89;08.02.2012;2012;02;08;Keskiviikko;80;1;81;61;0;61
89;08.02.2012;2012;02;09;Keskiviikko;46;0;46;36;0;36
89;08.02.2012;2012;02;10;Keskiviikko;40;0;40;38;0;38
89;08.02.2012;2012;02;11;Keskiviikko;41;0;41;39;0;39
89;08.02.2012;2012;02;12;Keskiviikko;44;0;44;55;0;55
89;08.02.2012;2012;02;13;Keskiviikko;42;0;42;48;0;48
89;08.02.2012;2012;02;14;Keskiviikko;66;0;66;64;0;64
89;08.02.2012;2012;02;15;Keskiviikko;86;1;87;72;0;72
89;08.02.2012;2012;02;16;Keskiviikko;103;0;103;75;0;75
89;08.02.2012;2012;02;17;Keskiviikko;65;0;65;56;0;56
89;08.02.2012;2012;02;18;Keskiviikko;56;0;56;38;0;38
89;08.02.2012;2012;02;19;Keskiviikko;47;0;47;33;0;33
89;08.02.2012;2012;02;20;Keskiviikko;32;0;32;30;0;30
89;08.02.2012;2012;02;21;Keskiviikko;22;0;22;12;0;12
89;08.02.2012;2012;02;22;Keskiviikko;11;0;11;6;0;6
89;08.02.2012;2012;02;23;Keskiviikko;13;0;13;1;0;1
89;09.02.2012;2012;02;00;Torstai;5;0;5;4;0;4
89;09.02.2012;2012;02;01;Torstai;7;0;7;2;0;2
89;09.02.2012;2012;02;02;Torstai;1;0;1;3;0;3
89;09.02.2012;2012;02;03;Torstai;2;0;2;1;0;1
89;09.02.2012;2012;02;04;Torstai;6;0;6;0;0;0
89;09.02.2012;2012;02;05;Torstai;7;0;7;3;0;3
89;09.02.2012;2012;02;06;Torstai;40;0;40;20;0;20
89;09.02.2012;2012;02;07;Torstai;103;0;103;59;0;59
89;09.02.2012;2012;02;08;Torstai;94;0;94;69;0;69
89;09.02.2012;2012;02;09;Torstai;63;0;63;39;0;39
89;09.02.2012;2012;02;10;Torstai;38;0;38;34;0;34
89;09.02.2012;2012;02;11;Torstai;48;0;48;40;0;40
89;09.02.2012;2012;02;12;Torstai;51;0;51;52;0;52
89;09.02.2012;2012;02;13;Torstai;55;0;55;54;0;54
89;09.02.2012;2012;02;14;Torstai;53;0;53;66;0;66
89;09.02.2012;2012;02;15;Torstai;103;0;103;70;0;70
89;09.02.2012;2012;02;16;Torstai;110;0;110;79;0;79
89;09.02.2012;2012;02;17;Torstai;68;0;68;54;0;54
89;09.02.2012;2012;02;18;Torstai;59;0;59;41;0;41
89;09.02.2012;2012;02;19;Torstai;47;0;47;40;0;40
89;09.02.2012;2012;02;20;Torstai;58;0;58;25;0;25
89;09.02.2012;2012;02;21;Torstai;33;1;34;17;0;17
89;09.02.2012;2012;02;22;Torstai;19;0;19;4;0;4
89;09.02.2012;2012;02;23;Torstai;9;0;9;3;0;3
89;10.02.2012;2012;02;00;Perjantai;4;0;4;3;0;3
89;10.02.2012;2012;02;01;Perjantai;1;0;1;2;0;2
89;10.02.2012;2012;02;02;Perjantai;5;0;5;3;0;3
89;10.02.2012;2012;02;03;Perjantai;5;0;5;2;0;2
89;10.02.2012;2012;02;04;Perjantai;6;0;6;4;0;4
89;10.02.2012;2012;02;05;Perjantai;7;1;8;6;0;6
89;10.02.2012;2012;02;06;Perjantai;46;2;48;16;0;16
89;10.02.2012;2012;02;07;Perjantai;107;8;115;58;0;58
89;10.02.2012;2012;02;08;Perjantai;123;5;128;69;0;69
89;10.02.2012;2012;02;09;Perjantai;69;5;74;38;0;38
89;10.02.2012;2012;02;10;Perjantai;73;2;75;62;0;62
89;10.02.2012;2012;02;11;Perjantai;67;1;68;81;0;81
89;10.02.2012;2012;02;12;Perjantai;73;1;74;56;0;56
89;10.02.2012;2012;02;13;Perjantai;108;4;112;59;0;59
89;10.02.2012;2012;02;14;Perjantai;122;2;124;79;0;79
89;10.02.2012;2012;02;15;Perjantai;124;2;126;71;0;71
89;10.02.2012;2012;02;16;Perjantai;127;1;128;64;0;64
89;10.02.2012;2012;02;17;Perjantai;86;3;89;55;0;55
89;10.02.2012;2012;02;18;Perjantai;61;2;63;59;0;59
89;10.02.2012;2012;02;19;Perjantai;47;0;47;34;0;34
89;10.02.2012;2012;02;20;Perjantai;44;0;44;35;0;35
89;10.02.2012;2012;02;21;Perjantai;38;1;39;14;0;14
89;10.02.2012;2012;02;22;Perjantai;23;0;23;11;0;11
89;10.02.2012;2012;02;23;Perjantai;20;0;20;18;0;18
89;11.02.2012;2012;02;00;Lauantai;16;0;16;13;0;13
89;11.02.2012;2012;02;01;Lauantai;14;0;14;10;0;10
89;11.02.2012;2012;02;02;Lauantai;16;0;16;13;0;13
89;11.02.2012;2012;02;03;Lauantai;12;0;12;6;0;6
89;11.02.2012;2012;02;04;Lauantai;10;0;10;8;0;8
89;11.02.2012;2012;02;05;Lauantai;3;0;3;2;0;2
89;11.02.2012;2012;02;06;Lauantai;8;0;8;4;0;4
89;11.02.2012;2012;02;07;Lauantai;17;1;18;6;0;6
89;11.02.2012;2012;02;08;Lauantai;20;0;20;14;0;14
89;11.02.2012;2012;02;09;Lauantai;27;0;27;40;0;40
89;11.02.2012;2012;02;10;Lauantai;61;1;62;37;0;37
89;11.02.2012;2012;02;11;Lauantai;48;2;50;71;0;71
89;11.02.2012;2012;02;12;Lauantai;63;3;66;86;0;86
89;11.02.2012;2012;02;13;Lauantai;70;1;71;77;0;77
89;11.02.2012;2012;02;14;Lauantai;60;2;62;74;0;74
89;11.02.2012;2012;02;15;Lauantai;50;3;53;76;0;76
89;11.02.2012;2012;02;16;Lauantai;57;0;57;66;0;66
89;11.02.2012;2012;02;17;Lauantai;62;1;63;61;0;61
89;11.02.2012;2012;02;18;Lauantai;57;2;59;54;0;54
89;11.02.2012;2012;02;19;Lauantai;32;0;32;29;0;29
89;11.02.2012;2012;02;20;Lauantai;34;0;34;21;0;21
89;11.02.2012;2012;02;21;Lauantai;36;0;36;13;0;13
89;11.02.2012;2012;02;22;Lauantai;20;0;20;15;0;15
89;11.02.2012;2012;02;23;Lauantai;25;0;25;12;0;12
89;12.02.2012;2012;02;00;Sunnuntai;22;0;22;13;0;13
89;12.02.2012;2012;02;01;Sunnuntai;11;0;11;11;0;11
89;12.02.2012;2012;02;02;Sunnuntai;17;0;17;9;0;9
89;12.02.2012;2012;02;03;Sunnuntai;14;0;14;3;0;3
89;12.02.2012;2012;02;04;Sunnuntai;9;0;9;11;0;11
89;12.02.2012;2012;02;05;Sunnuntai;1;0;1;2;0;2
89;12.02.2012;2012;02;06;Sunnuntai;6;0;6;3;0;3
89;12.02.2012;2012;02;07;Sunnuntai;3;0;3;8;0;8
89;12.02.2012;2012;02;08;Sunnuntai;4;0;4;11;0;11
89;12.02.2012;2012;02;09;Sunnuntai;8;0;8;39;0;39
89;12.02.2012;2012;02;10;Sunnuntai;19;0;19;38;0;38
89;12.02.2012;2012;02;11;Sunnuntai;19;0;19;59;0;59
89;12.02.2012;2012;02;12;Sunnuntai;35;0;35;70;0;70
89;12.02.2012;2012;02;13;Sunnuntai;38;0;38;107;0;107
89;12.02.2012;2012;02;14;Sunnuntai;33;0;33;87;0;87
89;12.02.2012;2012;02;15;Sunnuntai;39;0;39;66;0;66
89;12.02.2012;2012;02;16;Sunnuntai;45;0;45;84;0;84
89;12.02.2012;2012;02;17;Sunnuntai;44;0;44;52;0;52
89;12.02.2012;2012;02;18;Sunnuntai;46;0;46;62;0;62
89;12.02.2012;2012;02;19;Sunnuntai;20;0;20;53;0;53
89;12.02.2012;2012;02;20;Sunnuntai;23;1;24;40;0;40
89;12.02.2012;2012;02;21;Sunnuntai;21;0;21;15;0;15
89;12.02.2012;2012;02;22;Sunnuntai;4;0;4;7;0;7
89;12.02.2012;2012;02;23;Sunnuntai;8;0;8;3;0;3
89;13.02.2012;2012;02;00;Maanantai;3;0;3;1;0;1
89;13.02.2012;2012;02;01;Maanantai;2;0;2;2;0;2
89;13.02.2012;2012;02;02;Maanantai;2;0;2;1;0;1
89;13.02.2012;2012;02;03;Maanantai;2;0;2;0;0;0
89;13.02.2012;2012;02;04;Maanantai;9;0;9;1;0;1
89;13.02.2012;2012;02;05;Maanantai;13;0;13;3;0;3
89;13.02.2012;2012;02;06;Maanantai;51;1;52;10;0;10
89;13.02.2012;2012;02;07;Maanantai;143;4;147;49;0;49
89;13.02.2012;2012;02;08;Maanantai;170;3;173;71;0;71
89;13.02.2012;2012;02;09;Maanantai;93;0;93;59;0;59
89;13.02.2012;2012;02;10;Maanantai;70;0;70;46;0;46
89;13.02.2012;2012;02;11;Maanantai;90;1;91;60;0;60
89;13.02.2012;2012;02;12;Maanantai;93;0;93;73;0;73
89;13.02.2012;2012;02;13;Maanantai;104;0;104;70;0;70
89;13.02.2012;2012;02;14;Maanantai;142;0;142;61;0;61
89;13.02.2012;2012;02;15;Maanantai;169;3;172;85;0;85
89;13.02.2012;2012;02;16;Maanantai;200;1;201;69;0;69
89;13.02.2012;2012;02;17;Maanantai;107;0;107;66;0;66
89;13.02.2012;2012;02;18;Maanantai;93;1;94;54;0;54
89;13.02.2012;2012;02;19;Maanantai;72;2;74;46;0;46
89;13.02.2012;2012;02;20;Maanantai;54;0;54;35;0;35
89;13.02.2012;2012;02;21;Maanantai;37;0;37;16;0;16
89;13.02.2012;2012;02;22;Maanantai;15;0;15;7;0;7
89;13.02.2012;2012;02;23;Maanantai;5;0;5;6;0;6
89;14.02.2012;2012;02;00;Tiistai;2;0;2;2;0;2
89;14.02.2012;2012;02;01;Tiistai;2;0;2;2;0;2
89;14.02.2012;2012;02;02;Tiistai;2;0;2;0;0;0
89;14.02.2012;2012;02;03;Tiistai;3;0;3;0;0;0
89;14.02.2012;2012;02;04;Tiistai;5;0;5;0;0;0
89;14.02.2012;2012;02;05;Tiistai;11;0;11;3;0;3
89;14.02.2012;2012;02;06;Tiistai;61;0;61;11;0;11
89;14.02.2012;2012;02;07;Tiistai;162;7;169;45;0;45
89;14.02.2012;2012;02;08;Tiistai;152;2;154;58;0;58
89;14.02.2012;2012;02;09;Tiistai;76;1;77;44;0;44
89;14.02.2012;2012;02;10;Tiistai;46;0;46;51;0;51
89;14.02.2012;2012;02;11;Tiistai;52;1;53;31;0;31
89;14.02.2012;2012;02;12;Tiistai;53;3;56;41;0;41
89;14.02.2012;2012;02;13;Tiistai;59;10;69;28;0;28
89;14.02.2012;2012;02;14;Tiistai;68;17;85;38;0;38
89;14.02.2012;2012;02;15;Tiistai;111;34;145;38;0;38
89;14.02.2012;2012;02;16;Tiistai;116;40;156;34;0;34
89;14.02.2012;2012;02;17;Tiistai;76;31;107;17;0;17
89;14.02.2012;2012;02;18;Tiistai;38;19;57;13;0;13
89;14.02.2012;2012;02;19;Tiistai;37;13;50;12;0;12
89;14.02.2012;2012;02;20;Tiistai;40;16;56;15;0;15
89;14.02.2012;2012;02;21;Tiistai;24;10;34;11;0;11
89;14.02.2012;2012;02;22;Tiistai;14;2;16;7;0;7
89;14.02.2012;2012;02;23;Tiistai;5;0;5;5;0;5
89;15.02.2012;2012;02;00;Keskiviikko;2;0;2;3;0;3
89;15.02.2012;2012;02;01;Keskiviikko;2;0;2;1;0;1
89;15.02.2012;2012;02;02;Keskiviikko;1;0;1;0;0;0
89;15.02.2012;2012;02;03;Keskiviikko;2;1;3;5;0;5
89;15.02.2012;2012;02;04;Keskiviikko;3;2;5;0;0;0
89;15.02.2012;2012;02;05;Keskiviikko;9;4;13;2;0;2
89;15.02.2012;2012;02;06;Keskiviikko;37;18;55;8;0;8
89;15.02.2012;2012;02;07;Keskiviikko;94;45;139;44;0;44
89;15.02.2012;2012;02;08;Keskiviikko;129;37;166;50;0;50
89;15.02.2012;2012;02;09;Keskiviikko;73;14;87;34;0;34
89;15.02.2012;2012;02;10;Keskiviikko;43;12;55;39;0;39
89;15.02.2012;2012;02;11;Keskiviikko;60;9;69;68;0;68
89;15.02.2012;2012;02;12;Keskiviikko;60;8;68;47;0;47
89;15.02.2012;2012;02;13;Keskiviikko;70;8;78;43;0;43
89;15.02.2012;2012;02;14;Keskiviikko;119;12;131;65;0;65
89;15.02.2012;2012;02;15;Keskiviikko;106;14;120;57;0;57
89;15.02.2012;2012;02;16;Keskiviikko;154;18;172;60;0;60
89;15.02.2012;2012;02;17;Keskiviikko;93;11;104;48;0;48
89;15.02.2012;2012;02;18;Keskiviikko;69;12;81;51;0;51
89;15.02.2012;2012;02;19;Keskiviikko;64;5;69;46;0;46
89;15.02.2012;2012;02;20;Keskiviikko;45;6;51;39;0;39
89;15.02.2012;2012;02;21;Keskiviikko;40;2;42;20;0;20
89;15.02.2012;2012;02;22;Keskiviikko;7;0;7;13;0;13
89;15.02.2012;2012;02;23;Keskiviikko;11;0;11;5;0;5
89;16.02.2012;2012;02;00;Torstai;13;0;13;1;0;1
89;16.02.2012;2012;02;01;Torstai;3;0;3;2;0;2
89;16.02.2012;2012;02;02;Torstai;2;0;2;3;0;3
89;16.02.2012;2012;02;03;Torstai;6;0;6;1;0;1
89;16.02.2012;2012;02;04;Torstai;5;0;5;1;0;1
89;16.02.2012;2012;02;05;Torstai;7;2;9;1;0;1
89;16.02.2012;2012;02;06;Torstai;45;7;52;18;0;18
89;16.02.2012;2012;02;07;Torstai;123;22;145;52;0;52
89;16.02.2012;2012;02;08;Torstai;136;21;157;53;0;53
89;16.02.2012;2012;02;09;Torstai;79;6;85;49;0;49
89;16.02.2012;2012;02;10;Torstai;56;6;62;43;0;43
89;16.02.2012;2012;02;11;Torstai;62;0;62;60;0;60
89;16.02.2012;2012;02;12;Torstai;65;0;65;84;0;84
89;16.02.2012;2012;02;13;Torstai;84;2;86;72;0;72
89;16.02.2012;2012;02;14;Torstai;118;3;121;68;0;68
89;16.02.2012;2012;02;15;Torstai;162;8;170;79;0;79
89;16.02.2012;2012;02;16;Torstai;165;0;165;79;0;79
89;16.02.2012;2012;02;17;Torstai;102;7;109;58;0;58
89;16.02.2012;2012;02;18;Torstai;80;5;85;45;0;45
89;16.02.2012;2012;02;19;Torstai;63;0;63;48;0;48
89;16.02.2012;2012;02;20;Torstai;56;2;58;32;0;32
89;16.02.2012;2012;02;21;Torstai;26;1;27;21;0;21
89;16.02.2012;2012;02;22;Torstai;17;0;17;8;0;8
89;16.02.2012;2012;02;23;Torstai;14;0;14;4;0;4
89;17.02.2012;2012;02;00;Perjantai;4;2;6;3;0;3
89;17.02.2012;2012;02;01;Perjantai;2;0;2;2;0;2
89;17.02.2012;2012;02;02;Perjantai;4;3;7;3;0;3
89;17.02.2012;2012;02;03;Perjantai;4;1;5;2;0;2
89;17.02.2012;2012;02;04;Perjantai;4;4;8;4;0;4
89;17.02.2012;2012;02;05;Perjantai;8;6;14;6;0;6
89;17.02.2012;2012;02;06;Perjantai;22;20;42;16;0;16
89;17.02.2012;2012;02;07;Perjantai;68;66;134;58;0;58
89;17.02.2012;2012;02;08;Perjantai;61;58;119;69;0;69
89;17.02.2012;2012;02;09;Perjantai;35;33;68;38;0;38
89;17.02.2012;2012;02;10;Perjantai;29;27;56;62;0;62
89;17.02.2012;2012;02;11;Perjantai;44;43;87;81;0;81
89;17.02.2012;2012;02;12;Perjantai;51;49;100;56;0;56
89;17.02.2012;2012;02;13;Perjantai;44;44;88;59;0;59
89;17.02.2012;2012;02;14;Perjantai;53;50;103;79;0;79
89;17.02.2012;2012;02;15;Perjantai;62;59;121;71;0;71
89;17.02.2012;2012;02;16;Perjantai;57;55;112;64;0;64
89;17.02.2012;2012;02;17;Perjantai;51;50;101;55;0;55
89;17.02.2012;2012;02;18;Perjantai;33;31;64;59;0;59
89;17.02.2012;2012;02;19;Perjantai;29;29;58;34;0;34
89;17.02.2012;2012;02;20;Perjantai;26;24;50;35;0;35
89;17.02.2012;2012;02;21;Perjantai;22;20;42;14;0;14
89;17.02.2012;2012;02;22;Perjantai;14;11;25;11;0;11
89;17.02.2012;2012;02;23;Perjantai;10;9;19;18;0;18
89;18.02.2012;2012;02;00;Lauantai;11;8;19;13;0;13
89;18.02.2012;2012;02;01;Lauantai;11;11;22;10;0;10
89;18.02.2012;2012;02;02;Lauantai;6;3;9;13;0;13
89;18.02.2012;2012;02;03;Lauantai;7;4;11;6;0;6
89;18.02.2012;2012;02;04;Lauantai;7;4;11;8;0;8
89;18.02.2012;2012;02;05;Lauantai;3;1;4;2;0;2
89;18.02.2012;2012;02;06;Lauantai;5;2;7;4;0;4
89;18.02.2012;2012;02;07;Lauantai;12;8;20;6;0;6
89;18.02.2012;2012;02;08;Lauantai;11;9;20;14;0;14
89;18.02.2012;2012;02;09;Lauantai;22;19;41;40;0;40
89;18.02.2012;2012;02;10;Lauantai;33;30;63;37;0;37
89;18.02.2012;2012;02;11;Lauantai;34;33;67;71;0;71
89;18.02.2012;2012;02;12;Lauantai;39;36;75;86;0;86
89;18.02.2012;2012;02;13;Lauantai;51;46;97;77;0;77
89;18.02.2012;2012;02;14;Lauantai;43;40;83;74;0;74
89;18.02.2012;2012;02;15;Lauantai;41;38;79;76;0;76
89;18.02.2012;2012;02;16;Lauantai;33;32;65;66;0;66
89;18.02.2012;2012;02;17;Lauantai;34;23;57;61;0;61
89;18.02.2012;2012;02;18;Lauantai;29;25;54;54;0;54
89;18.02.2012;2012;02;19;Lauantai;19;9;28;29;0;29
89;18.02.2012;2012;02;20;Lauantai;29;12;41;21;0;21
89;18.02.2012;2012;02;21;Lauantai;15;7;22;13;0;13
89;18.02.2012;2012;02;22;Lauantai;20;9;29;15;0;15
89;18.02.2012;2012;02;23;Lauantai;12;2;14;12;0;12
89;19.02.2012;2012;02;00;Sunnuntai;10;0;10;13;0;13
89;19.02.2012;2012;02;01;Sunnuntai;11;1;12;11;0;11
89;19.02.2012;2012;02;02;Sunnuntai;15;0;15;9;0;9
89;19.02.2012;2012;02;03;Sunnuntai;4;0;4;3;0;3
89;19.02.2012;2012;02;04;Sunnuntai;10;2;12;11;0;11
89;19.02.2012;2012;02;05;Sunnuntai;3;1;4;2;0;2
89;19.02.2012;2012;02;06;Sunnuntai;5;3;8;3;0;3
89;19.02.2012;2012;02;07;Sunnuntai;3;0;3;8;0;8
89;19.02.2012;2012;02;08;Sunnuntai;4;1;5;11;0;11
89;19.02.2012;2012;02;09;Sunnuntai;7;5;12;39;0;39
89;19.02.2012;2012;02;10;Sunnuntai;5;2;7;38;0;38
89;19.02.2012;2012;02;11;Sunnuntai;9;5;14;59;0;59
89;19.02.2012;2012;02;12;Sunnuntai;9;7;16;70;0;70
89;19.02.2012;2012;02;13;Sunnuntai;12;11;23;107;0;107
89;19.02.2012;2012;02;14;Sunnuntai;9;7;16;87;0;87
89;19.02.2012;2012;02;15;Sunnuntai;10;8;18;66;0;66
89;19.02.2012;2012;02;16;Sunnuntai;11;10;21;84;0;84
89;19.02.2012;2012;02;17;Sunnuntai;11;10;21;52;0;52
89;19.02.2012;2012;02;18;Sunnuntai;11;9;20;62;0;62
89;19.02.2012;2012;02;19;Sunnuntai;9;5;14;53;0;53
89;19.02.2012;2012;02;20;Sunnuntai;5;3;8;40;0;40
89;19.02.2012;2012;02;21;Sunnuntai;5;3;8;15;0;15
89;19.02.2012;2012;02;22;Sunnuntai;2;0;2;7;0;7
89;19.02.2012;2012;02;23;Sunnuntai;5;3;8;3;0;3
89;20.02.2012;2012;02;00;Maanantai;0;0;0;0;0;0
89;20.02.2012;2012;02;01;Maanantai;0;0;0;0;0;0
89;20.02.2012;2012;02;02;Maanantai;1;0;1;0;0;0
89;20.02.2012;2012;02;03;Maanantai;4;3;7;0;0;0
89;20.02.2012;2012;02;04;Maanantai;3;0;3;0;0;0
89;20.02.2012;2012;02;05;Maanantai;9;6;15;0;0;0
89;20.02.2012;2012;02;06;Maanantai;19;19;38;0;0;0
89;20.02.2012;2012;02;07;Maanantai;55;54;109;0;0;0
89;20.02.2012;2012;02;08;Maanantai;79;76;155;0;0;0
89;20.02.2012;2012;02;09;Maanantai;49;49;98;0;0;0
89;20.02.2012;2012;02;10;Maanantai;37;35;72;0;0;0
89;20.02.2012;2012;02;11;Maanantai;35;33;68;0;0;0
89;20.02.2012;2012;02;12;Maanantai;38;37;75;0;0;0
89;20.02.2012;2012;02;13;Maanantai;43;42;85;0;0;0
89;20.02.2012;2012;02;14;Maanantai;46;45;91;0;0;0
89;20.02.2012;2012;02;15;Maanantai;65;64;129;0;0;0
89;20.02.2012;2012;02;16;Maanantai;94;91;185;0;0;0
89;20.02.2012;2012;02;17;Maanantai;52;52;104;0;0;0
89;20.02.2012;2012;02;18;Maanantai;43;40;83;0;0;0
89;20.02.2012;2012;02;19;Maanantai;33;30;63;0;0;0
89;20.02.2012;2012;02;20;Maanantai;35;31;66;0;0;0
89;20.02.2012;2012;02;21;Maanantai;14;13;27;0;0;0
89;20.02.2012;2012;02;22;Maanantai;4;2;6;0;0;0
89;20.02.2012;2012;02;23;Maanantai;6;3;9;0;0;0
89;21.02.2012;2012;02;00;Tiistai;2;1;3;0;0;0
89;21.02.2012;2012;02;01;Tiistai;0;0;0;0;0;0
89;21.02.2012;2012;02;02;Tiistai;2;0;2;0;0;0
89;21.02.2012;2012;02;03;Tiistai;2;1;3;0;0;0
89;21.02.2012;2012;02;04;Tiistai;5;3;8;0;0;0
89;21.02.2012;2012;02;05;Tiistai;7;5;12;0;0;0
89;21.02.2012;2012;02;06;Tiistai;20;18;38;0;0;0
89;21.02.2012;2012;02;07;Tiistai;78;78;156;0;0;0
89;21.02.2012;2012;02;08;Tiistai;89;85;174;0;0;0
89;21.02.2012;2012;02;09;Tiistai;33;31;64;0;0;0
89;21.02.2012;2012;02;10;Tiistai;23;21;44;0;0;0
89;21.02.2012;2012;02;11;Tiistai;33;32;65;0;0;0
89;21.02.2012;2012;02;12;Tiistai;30;29;59;0;0;0
89;21.02.2012;2012;02;13;Tiistai;30;29;59;0;0;0
89;21.02.2012;2012;02;14;Tiistai;58;54;112;0;0;0
89;21.02.2012;2012;02;15;Tiistai;61;60;121;0;0;0
89;21.02.2012;2012;02;16;Tiistai;90;88;178;0;0;0
89;21.02.2012;2012;02;17;Tiistai;55;52;107;0;0;0
89;21.02.2012;2012;02;18;Tiistai;40;38;78;0;0;0
89;21.02.2012;2012;02;19;Tiistai;38;35;73;0;0;0
89;21.02.2012;2012;02;20;Tiistai;26;24;50;0;0;0
89;21.02.2012;2012;02;21;Tiistai;16;14;30;0;0;0
89;21.02.2012;2012;02;22;Tiistai;19;17;36;0;0;0
89;21.02.2012;2012;02;23;Tiistai;11;8;19;0;0;0
89;22.02.2012;2012;02;00;Keskiviikko;6;4;10;0;0;0
89;22.02.2012;2012;02;01;Keskiviikko;4;1;5;0;0;0
89;22.02.2012;2012;02;02;Keskiviikko;3;2;5;0;0;0
89;22.02.2012;2012;02;03;Keskiviikko;4;1;5;0;0;0
89;22.02.2012;2012;02;04;Keskiviikko;3;1;4;0;0;0
89;22.02.2012;2012;02;05;Keskiviikko;7;6;13;0;0;0
89;22.02.2012;2012;02;06;Keskiviikko;26;24;50;0;0;0
89;22.02.2012;2012;02;07;Keskiviikko;79;77;156;0;0;0
89;22.02.2012;2012;02;08;Keskiviikko;85;82;167;0;0;0
89;22.02.2012;2012;02;09;Keskiviikko;54;53;107;0;0;0
89;22.02.2012;2012;02;10;Keskiviikko;41;38;79;0;0;0
89;22.02.2012;2012;02;11;Keskiviikko;55;54;109;0;0;0
89;22.02.2012;2012;02;12;Keskiviikko;45;44;89;0;0;0
89;22.02.2012;2012;02;13;Keskiviikko;43;41;84;0;0;0
89;22.02.2012;2012;02;14;Keskiviikko;69;66;135;0;0;0
89;22.02.2012;2012;02;15;Keskiviikko;74;74;148;0;0;0
89;22.02.2012;2012;02;16;Keskiviikko;97;95;192;0;0;0
89;22.02.2012;2012;02;17;Keskiviikko;61;59;120;0;0;0
89;22.02.2012;2012;02;18;Keskiviikko;46;43;89;0;0;0
89;22.02.2012;2012;02;19;Keskiviikko;42;39;81;0;0;0
89;22.02.2012;2012;02;20;Keskiviikko;27;25;52;0;0;0
89;22.02.2012;2012;02;21;Keskiviikko;18;15;33;0;0;0
89;22.02.2012;2012;02;22;Keskiviikko;7;6;13;0;0;0
89;22.02.2012;2012;02;23;Keskiviikko;5;3;8;0;0;0
89;23.02.2012;2012;02;00;Torstai;2;0;2;0;0;0
89;23.02.2012;2012;02;01;Torstai;1;1;2;0;0;0
89;23.02.2012;2012;02;02;Torstai;1;0;1;0;0;0
89;23.02.2012;2012;02;03;Torstai;2;0;2;0;0;0
89;23.02.2012;2012;02;04;Torstai;3;3;6;0;0;0
89;23.02.2012;2012;02;05;Torstai;10;7;17;0;0;0
89;23.02.2012;2012;02;06;Torstai;21;19;40;0;0;0
89;23.02.2012;2012;02;07;Torstai;76;75;151;0;0;0
89;23.02.2012;2012;02;08;Torstai;79;76;155;0;0;0
89;23.02.2012;2012;02;09;Torstai;46;45;91;0;0;0
89;23.02.2012;2012;02;10;Torstai;40;39;79;0;0;0
89;23.02.2012;2012;02;11;Torstai;47;44;91;0;0;0
89;23.02.2012;2012;02;12;Torstai;39;35;74;0;0;0
89;23.02.2012;2012;02;13;Torstai;40;40;80;0;0;0
89;23.02.2012;2012;02;14;Torstai;59;58;117;0;0;0
89;23.02.2012;2012;02;15;Torstai;76;72;148;0;0;0
89;23.02.2012;2012;02;16;Torstai;85;81;166;0;0;0
89;23.02.2012;2012;02;17;Torstai;62;59;121;0;0;0
89;23.02.2012;2012;02;18;Torstai;45;43;88;0;0;0
89;23.02.2012;2012;02;19;Torstai;32;32;64;0;0;0
89;23.02.2012;2012;02;20;Torstai;36;33;69;0;0;0
89;23.02.2012;2012;02;21;Torstai;20;18;38;0;0;0
89;23.02.2012;2012;02;22;Torstai;9;8;17;0;0;0
89;23.02.2012;2012;02;23;Torstai;9;7;16;0;0;0
89;24.02.2012;2012;02;00;Perjantai;8;5;13;0;0;0
89;24.02.2012;2012;02;01;Perjantai;4;2;6;0;0;0
89;24.02.2012;2012;02;02;Perjantai;3;2;5;0;0;0
89;24.02.2012;2012;02;03;Perjantai;3;2;5;0;0;0
89;24.02.2012;2012;02;04;Perjantai;3;2;5;0;0;0
89;24.02.2012;2012;02;05;Perjantai;10;8;18;0;0;0
89;24.02.2012;2012;02;06;Perjantai;24;21;45;0;0;0
89;24.02.2012;2012;02;07;Perjantai;79;78;157;0;0;0
89;24.02.2012;2012;02;08;Perjantai;78;76;154;0;0;0
89;24.02.2012;2012;02;09;Perjantai;41;39;80;0;0;0
89;24.02.2012;2012;02;10;Perjantai;31;28;59;0;0;0
89;24.02.2012;2012;02;11;Perjantai;54;52;106;0;0;0
89;24.02.2012;2012;02;12;Perjantai;47;44;91;0;0;0
89;24.02.2012;2012;02;13;Perjantai;59;57;116;0;0;0
89;24.02.2012;2012;02;14;Perjantai;77;74;151;0;0;0
89;24.02.2012;2012;02;15;Perjantai;67;65;132;0;0;0
89;24.02.2012;2012;02;16;Perjantai;67;66;133;0;0;0
89;24.02.2012;2012;02;17;Perjantai;51;48;99;0;0;0
89;24.02.2012;2012;02;18;Perjantai;37;34;71;0;0;0
89;24.02.2012;2012;02;19;Perjantai;26;23;49;0;0;0
89;24.02.2012;2012;02;20;Perjantai;32;31;63;0;0;0
89;24.02.2012;2012;02;21;Perjantai;21;20;41;0;0;0
89;24.02.2012;2012;02;22;Perjantai;18;15;33;0;0;0
89;24.02.2012;2012;02;23;Perjantai;8;6;14;0;0;0
89;25.02.2012;2012;02;00;Lauantai;12;9;21;0;0;0
89;25.02.2012;2012;02;01;Lauantai;7;4;11;0;0;0
89;25.02.2012;2012;02;02;Lauantai;4;1;5;0;0;0
89;25.02.2012;2012;02;03;Lauantai;8;5;13;0;0;0
89;25.02.2012;2012;02;04;Lauantai;8;5;13;0;0;0
89;25.02.2012;2012;02;05;Lauantai;5;2;7;0;0;0
89;25.02.2012;2012;02;06;Lauantai;7;3;10;0;0;0
89;25.02.2012;2012;02;07;Lauantai;9;7;16;0;0;0
89;25.02.2012;2012;02;08;Lauantai;14;12;26;0;0;0
89;25.02.2012;2012;02;09;Lauantai;21;21;42;0;0;0
89;25.02.2012;2012;02;10;Lauantai;26;23;49;0;0;0
89;25.02.2012;2012;02;11;Lauantai;34;30;64;0;0;0
89;25.02.2012;2012;02;12;Lauantai;33;29;62;0;0;0
89;25.02.2012;2012;02;13;Lauantai;25;24;49;0;0;0
89;25.02.2012;2012;02;14;Lauantai;31;29;60;0;0;0
89;25.02.2012;2012;02;15;Lauantai;35;32;67;0;0;0
89;25.02.2012;2012;02;16;Lauantai;25;24;49;0;0;0
89;25.02.2012;2012;02;17;Lauantai;28;27;55;0;0;0
89;25.02.2012;2012;02;18;Lauantai;25;25;50;0;0;0
89;25.02.2012;2012;02;19;Lauantai;27;24;51;0;0;0
89;25.02.2012;2012;02;20;Lauantai;17;15;32;0;0;0
89;25.02.2012;2012;02;21;Lauantai;13;11;24;0;0;0
89;25.02.2012;2012;02;22;Lauantai;11;9;20;0;0;0
89;25.02.2012;2012;02;23;Lauantai;10;9;19;0;0;0
89;26.02.2012;2012;02;00;Sunnuntai;11;10;21;0;0;0
89;26.02.2012;2012;02;01;Sunnuntai;7;6;13;0;0;0
89;26.02.2012;2012;02;02;Sunnuntai;8;4;12;0;0;0
89;26.02.2012;2012;02;03;Sunnuntai;12;9;21;0;0;0
89;26.02.2012;2012;02;04;Sunnuntai;4;1;5;0;0;0
89;26.02.2012;2012;02;05;Sunnuntai;4;4;8;0;0;0
89;26.02.2012;2012;02;06;Sunnuntai;4;3;7;0;0;0
89;26.02.2012;2012;02;07;Sunnuntai;3;2;5;0;0;0
89;26.02.2012;2012;02;08;Sunnuntai;5;4;9;0;0;0
89;26.02.2012;2012;02;09;Sunnuntai;6;4;10;0;0;0
89;26.02.2012;2012;02;10;Sunnuntai;13;12;25;0;0;0
89;26.02.2012;2012;02;11;Sunnuntai;21;20;41;0;0;0
89;26.02.2012;2012;02;12;Sunnuntai;32;30;62;0;0;0
89;26.02.2012;2012;02;13;Sunnuntai;41;40;81;0;0;0
89;26.02.2012;2012;02;14;Sunnuntai;35;31;66;0;0;0
89;26.02.2012;2012;02;15;Sunnuntai;25;23;48;0;0;0
89;26.02.2012;2012;02;16;Sunnuntai;28;27;55;0;0;0
89;26.02.2012;2012;02;17;Sunnuntai;22;20;42;0;0;0
89;26.02.2012;2012;02;18;Sunnuntai;22;20;42;0;0;0
89;26.02.2012;2012;02;19;Sunnuntai;19;16;35;0;0;0
89;26.02.2012;2012;02;20;Sunnuntai;15;12;27;0;0;0
89;26.02.2012;2012;02;21;Sunnuntai;14;11;25;0;0;0
89;26.02.2012;2012;02;22;Sunnuntai;5;3;8;0;0;0
89;26.02.2012;2012;02;23;Sunnuntai;6;2;8;0;0;0
89;27.02.2012;2012;02;00;Maanantai;0;0;0;0;0;0
89;27.02.2012;2012;02;01;Maanantai;1;0;1;0;0;0
89;27.02.2012;2012;02;02;Maanantai;1;0;1;0;0;0
89;27.02.2012;2012;02;03;Maanantai;2;0;2;0;0;0
89;27.02.2012;2012;02;04;Maanantai;3;3;6;0;0;0
89;27.02.2012;2012;02;05;Maanantai;9;6;15;0;0;0
89;27.02.2012;2012;02;06;Maanantai;18;17;35;0;0;0
89;27.02.2012;2012;02;07;Maanantai;59;57;116;0;0;0
89;27.02.2012;2012;02;08;Maanantai;68;66;134;0;0;0
89;27.02.2012;2012;02;09;Maanantai;48;46;94;0;0;0
89;27.02.2012;2012;02;10;Maanantai;30;28;58;0;0;0
89;27.02.2012;2012;02;11;Maanantai;26;23;49;0;0;0
89;27.02.2012;2012;02;12;Maanantai;38;36;74;0;0;0
89;27.02.2012;2012;02;13;Maanantai;34;33;67;0;0;0
89;27.02.2012;2012;02;14;Maanantai;50;49;99;0;0;0
89;27.02.2012;2012;02;15;Maanantai;85;83;168;0;0;0
89;27.02.2012;2012;02;16;Maanantai;95;92;187;0;0;0
89;27.02.2012;2012;02;17;Maanantai;43;41;84;0;0;0
89;27.02.2012;2012;02;18;Maanantai;39;38;77;0;0;0
89;27.02.2012;2012;02;19;Maanantai;33;30;63;0;0;0
89;27.02.2012;2012;02;20;Maanantai;26;25;51;0;0;0
89;27.02.2012;2012;02;21;Maanantai;18;16;34;0;0;0
89;27.02.2012;2012;02;22;Maanantai;7;5;12;0;0;0
89;27.02.2012;2012;02;23;Maanantai;5;2;7;0;0;0
89;28.02.2012;2012;02;00;Tiistai;0;0;0;0;0;0
89;28.02.2012;2012;02;01;Tiistai;0;0;0;0;0;0
89;28.02.2012;2012;02;02;Tiistai;1;0;1;0;0;0
89;28.02.2012;2012;02;03;Tiistai;2;1;3;0;0;0
89;28.02.2012;2012;02;04;Tiistai;3;0;3;0;0;0
89;28.02.2012;2012;02;05;Tiistai;6;4;10;0;0;0
89;28.02.2012;2012;02;06;Tiistai;22;22;44;0;0;0
89;28.02.2012;2012;02;07;Tiistai;66;64;130;0;0;0
89;28.02.2012;2012;02;08;Tiistai;70;67;137;0;0;0
89;28.02.2012;2012;02;09;Tiistai;29;28;57;0;0;0
89;28.02.2012;2012;02;10;Tiistai;25;21;46;0;0;0
89;28.02.2012;2012;02;11;Tiistai;22;21;43;0;0;0
89;28.02.2012;2012;02;12;Tiistai;25;23;48;0;0;0
89;28.02.2012;2012;02;13;Tiistai;24;21;45;0;0;0
89;28.02.2012;2012;02;14;Tiistai;38;36;74;0;0;0
89;28.02.2012;2012;02;15;Tiistai;55;53;108;0;0;0
89;28.02.2012;2012;02;16;Tiistai;73;71;144;0;0;0
89;28.02.2012;2012;02;17;Tiistai;53;50;103;0;0;0
89;28.02.2012;2012;02;18;Tiistai;32;31;63;0;0;0
89;28.02.2012;2012;02;19;Tiistai;36;34;70;0;0;0
89;28.02.2012;2012;02;20;Tiistai;31;30;61;0;0;0
89;28.02.2012;2012;02;21;Tiistai;20;17;37;0;0;0
89;28.02.2012;2012;02;22;Tiistai;8;6;14;0;0;0
89;28.02.2012;2012;02;23;Tiistai;6;4;10;0;0;0
89;29.02.2012;2012;02;00;Keskiviikko;3;1;4;0;0;0
89;29.02.2012;2012;02;01;Keskiviikko;1;0;1;0;0;0
89;29.02.2012;2012;02;02;Keskiviikko;1;0;1;0;0;0
89;29.02.2012;2012;02;03;Keskiviikko;2;2;4;0;0;0
89;29.02.2012;2012;02;04;Keskiviikko;5;4;9;0;0;0
89;29.02.2012;2012;02;05;Keskiviikko;6;4;10;0;0;0
89;29.02.2012;2012;02;06;Keskiviikko;21;18;39;0;0;0
89;29.02.2012;2012;02;07;Keskiviikko;75;73;148;0;0;0
89;29.02.2012;2012;02;08;Keskiviikko;88;86;174;0;0;0
89;29.02.2012;2012;02;09;Keskiviikko;44;41;85;0;0;0
89;29.02.2012;2012;02;10;Keskiviikko;33;30;63;0;0;0
89;29.02.2012;2012;02;11;Keskiviikko;42;41;83;0;0;0
89;29.02.2012;2012;02;12;Keskiviikko;50;49;99;0;0;0
89;29.02.2012;2012;02;13;Keskiviikko;45;44;89;0;0;0
89;29.02.2012;2012;02;14;Keskiviikko;70;68;138;0;0;0
89;29.02.2012;2012;02;15;Keskiviikko;84;83;167;0;0;0
89;29.02.2012;2012;02;16;Keskiviikko;97;93;190;0;0;0
89;29.02.2012;2012;02;17;Keskiviikko;61;59;120;0;0;0
89;29.02.2012;2012;02;18;Keskiviikko;45;42;87;0;0;0
89;29.02.2012;2012;02;19;Keskiviikko;37;34;71;0;0;0
89;29.02.2012;2012;02;20;Keskiviikko;33;29;62;0;0;0
89;29.02.2012;2012;02;21;Keskiviikko;24;21;45;0;0;0
89;29.02.2012;2012;02;22;Keskiviikko;7;4;11;0;0;0
89;29.02.2012;2012;02;23;Keskiviikko;4;2;6;0;0;0
89;01.03.2012;2012;03;00;Torstai;3;2;5;0;0;0
89;01.03.2012;2012;03;01;Torstai;3;1;4;0;0;0
89;01.03.2012;2012;03;02;Torstai;3;0;3;0;0;0
89;01.03.2012;2012;03;03;Torstai;5;2;7;0;0;0
89;01.03.2012;2012;03;04;Torstai;3;1;4;0;0;0
89;01.03.2012;2012;03;05;Torstai;6;5;11;0;0;0
89;01.03.2012;2012;03;06;Torstai;25;23;48;0;0;0
89;01.03.2012;2012;03;07;Torstai;72;69;141;0;0;0
89;01.03.2012;2012;03;08;Torstai;85;83;168;0;0;0
89;01.03.2012;2012;03;09;Torstai;47;44;91;0;0;0
89;01.03.2012;2012;03;10;Torstai;39;37;76;0;0;0
89;01.03.2012;2012;03;11;Torstai;38;37;75;0;0;0
89;01.03.2012;2012;03;12;Torstai;40;37;77;0;0;0
89;01.03.2012;2012;03;13;Torstai;45;42;87;0;0;0
89;01.03.2012;2012;03;14;Torstai;58;56;114;0;0;0
89;01.03.2012;2012;03;15;Torstai;88;87;175;0;0;0
89;01.03.2012;2012;03;16;Torstai;84;83;167;0;0;0
89;01.03.2012;2012;03;17;Torstai;65;64;129;0;0;0
89;01.03.2012;2012;03;18;Torstai;41;38;79;0;0;0
89;01.03.2012;2012;03;19;Torstai;28;26;54;0;0;0
89;01.03.2012;2012;03;20;Torstai;39;36;75;0;0;0
89;01.03.2012;2012;03;21;Torstai;16;15;31;0;0;0
89;01.03.2012;2012;03;22;Torstai;10;9;19;0;0;0
89;01.03.2012;2012;03;23;Torstai;4;4;8;0;0;0
89;02.03.2012;2012;03;00;Perjantai;3;1;4;0;0;0
89;02.03.2012;2012;03;01;Perjantai;3;1;4;0;0;0
89;02.03.2012;2012;03;02;Perjantai;1;0;1;0;0;0
89;02.03.2012;2012;03;03;Perjantai;6;4;10;0;0;0
89;02.03.2012;2012;03;04;Perjantai;5;3;8;0;0;0
89;02.03.2012;2012;03;05;Perjantai;6;5;11;0;0;0
89;02.03.2012;2012;03;06;Perjantai;20;19;39;0;0;0
89;02.03.2012;2012;03;07;Perjantai;65;63;128;0;0;0
89;02.03.2012;2012;03;08;Perjantai;69;67;136;0;0;0
89;02.03.2012;2012;03;09;Perjantai;45;42;87;0;0;0
89;02.03.2012;2012;03;10;Perjantai;31;28;59;0;0;0
89;02.03.2012;2012;03;11;Perjantai;48;45;93;0;0;0
89;02.03.2012;2012;03;12;Perjantai;51;50;101;0;0;0
89;02.03.2012;2012;03;13;Perjantai;56;56;112;0;0;0
89;02.03.2012;2012;03;14;Perjantai;74;73;147;0;0;0
89;02.03.2012;2012;03;15;Perjantai;87;83;170;0;0;0
89;02.03.2012;2012;03;16;Perjantai;75;74;149;0;0;0
89;02.03.2012;2012;03;17;Perjantai;55;53;108;0;0;0
89;02.03.2012;2012;03;18;Perjantai;40;39;79;0;0;0
89;02.03.2012;2012;03;19;Perjantai;27;24;51;0;0;0
89;02.03.2012;2012;03;20;Perjantai;23;22;45;0;0;0
89;02.03.2012;2012;03;21;Perjantai;16;14;30;0;0;0
89;02.03.2012;2012;03;22;Perjantai;16;14;30;0;0;0
89;02.03.2012;2012;03;23;Perjantai;12;11;23;0;0;0
89;03.03.2012;2012;03;00;Lauantai;10;8;18;0;0;0
89;03.03.2012;2012;03;01;Lauantai;8;6;14;0;0;0
89;03.03.2012;2012;03;02;Lauantai;6;3;9;0;0;0
89;03.03.2012;2012;03;03;Lauantai;6;6;12;0;0;0
89;03.03.2012;2012;03;04;Lauantai;5;2;7;0;0;0
89;03.03.2012;2012;03;05;Lauantai;4;2;6;0;0;0
89;03.03.2012;2012;03;06;Lauantai;7;6;13;0;0;0
89;03.03.2012;2012;03;07;Lauantai;8;6;14;0;0;0
89;03.03.2012;2012;03;08;Lauantai;10;8;18;0;0;0
89;03.03.2012;2012;03;09;Lauantai;22;20;42;0;0;0
89;03.03.2012;2012;03;10;Lauantai;26;24;50;0;0;0
89;03.03.2012;2012;03;11;Lauantai;49;45;94;0;0;0
89;03.03.2012;2012;03;12;Lauantai;40;37;77;0;0;0
89;03.03.2012;2012;03;13;Lauantai;37;34;71;0;0;0
89;03.03.2012;2012;03;14;Lauantai;40;39;79;0;0;0
89;03.03.2012;2012;03;15;Lauantai;37;36;73;0;0;0
89;03.03.2012;2012;03;16;Lauantai;29;28;57;0;0;0
89;03.03.2012;2012;03;17;Lauantai;28;25;53;0;0;0
89;03.03.2012;2012;03;18;Lauantai;19;17;36;0;0;0
89;03.03.2012;2012;03;19;Lauantai;25;25;50;0;0;0
89;03.03.2012;2012;03;20;Lauantai;17;14;31;0;0;0
89;03.03.2012;2012;03;21;Lauantai;8;5;13;0;0;0
89;03.03.2012;2012;03;22;Lauantai;13;11;24;0;0;0
89;03.03.2012;2012;03;23;Lauantai;10;8;18;0;0;0
89;04.03.2012;2012;03;00;Sunnuntai;9;6;15;0;0;0
89;04.03.2012;2012;03;01;Sunnuntai;4;4;8;0;0;0
89;04.03.2012;2012;03;02;Sunnuntai;6;3;9;0;0;0
89;04.03.2012;2012;03;03;Sunnuntai;12;9;21;0;0;0
89;04.03.2012;2012;03;04;Sunnuntai;4;1;5;0;0;0
89;04.03.2012;2012;03;05;Sunnuntai;4;2;6;0;0;0
89;04.03.2012;2012;03;06;Sunnuntai;2;1;3;0;0;0
89;04.03.2012;2012;03;07;Sunnuntai;3;0;3;0;0;0
89;04.03.2012;2012;03;08;Sunnuntai;5;3;8;0;0;0
89;04.03.2012;2012;03;09;Sunnuntai;12;12;24;0;0;0
89;04.03.2012;2012;03;10;Sunnuntai;12;10;22;0;0;0
89;04.03.2012;2012;03;11;Sunnuntai;19;18;37;0;0;0
89;04.03.2012;2012;03;12;Sunnuntai;29;27;56;0;0;0
89;04.03.2012;2012;03;13;Sunnuntai;35;35;70;0;0;0
89;04.03.2012;2012;03;14;Sunnuntai;34;32;66;0;0;0
89;04.03.2012;2012;03;15;Sunnuntai;25;25;50;0;0;0
89;04.03.2012;2012;03;16;Sunnuntai;21;20;41;0;0;0
89;04.03.2012;2012;03;17;Sunnuntai;23;21;44;0;0;0
89;04.03.2012;2012;03;18;Sunnuntai;22;21;43;0;0;0
89;04.03.2012;2012;03;19;Sunnuntai;14;11;25;0;0;0
89;04.03.2012;2012;03;20;Sunnuntai;11;10;21;0;0;0
89;04.03.2012;2012;03;21;Sunnuntai;5;5;10;0;0;0
89;04.03.2012;2012;03;22;Sunnuntai;7;5;12;0;0;0
89;04.03.2012;2012;03;23;Sunnuntai;6;3;9;0;0;0
89;05.03.2012;2012;03;00;Maanantai;1;0;1;0;0;0
89;05.03.2012;2012;03;01;Maanantai;3;0;3;0;0;0
89;05.03.2012;2012;03;02;Maanantai;2;2;4;0;0;0
89;05.03.2012;2012;03;03;Maanantai;1;1;2;0;0;0
89;05.03.2012;2012;03;04;Maanantai;6;3;9;0;0;0
89;05.03.2012;2012;03;05;Maanantai;6;4;10;0;0;0
89;05.03.2012;2012;03;06;Maanantai;14;13;27;0;0;0
89;05.03.2012;2012;03;07;Maanantai;35;32;67;0;0;0
89;05.03.2012;2012;03;08;Maanantai;53;50;103;0;0;0
89;05.03.2012;2012;03;09;Maanantai;37;33;70;0;0;0
89;05.03.2012;2012;03;10;Maanantai;29;27;56;0;0;0
89;05.03.2012;2012;03;11;Maanantai;30;29;59;0;0;0
89;05.03.2012;2012;03;12;Maanantai;43;41;84;0;0;0
89;05.03.2012;2012;03;13;Maanantai;48;48;96;0;0;0
89;05.03.2012;2012;03;14;Maanantai;40;39;79;0;0;0
89;05.03.2012;2012;03;15;Maanantai;58;56;114;0;0;0
89;05.03.2012;2012;03;16;Maanantai;66;64;130;0;0;0
89;05.03.2012;2012;03;17;Maanantai;44;42;86;0;0;0
89;05.03.2012;2012;03;18;Maanantai;33;32;65;0;0;0
89;05.03.2012;2012;03;19;Maanantai;20;17;37;0;0;0
89;05.03.2012;2012;03;20;Maanantai;19;17;36;0;0;0
89;05.03.2012;2012;03;21;Maanantai;16;14;30;0;0;0
89;05.03.2012;2012;03;22;Maanantai;8;6;14;0;0;0
89;05.03.2012;2012;03;23;Maanantai;3;1;4;0;0;0
89;06.03.2012;2012;03;00;Tiistai;3;2;5;0;0;0
89;06.03.2012;2012;03;01;Tiistai;2;2;4;0;0;0
89;06.03.2012;2012;03;02;Tiistai;4;1;5;0;0;0
89;06.03.2012;2012;03;03;Tiistai;1;0;1;0;0;0
89;06.03.2012;2012;03;04;Tiistai;1;0;1;0;0;0
89;06.03.2012;2012;03;05;Tiistai;4;3;7;0;0;0
89;06.03.2012;2012;03;06;Tiistai;22;21;43;0;0;0
89;06.03.2012;2012;03;07;Tiistai;44;42;86;0;0;0
89;06.03.2012;2012;03;08;Tiistai;43;40;83;0;0;0
89;06.03.2012;2012;03;09;Tiistai;33;29;62;0;0;0
89;06.03.2012;2012;03;10;Tiistai;25;24;49;0;0;0
89;06.03.2012;2012;03;11;Tiistai;33;31;64;0;0;0
89;06.03.2012;2012;03;12;Tiistai;31;28;59;0;0;0
89;06.03.2012;2012;03;13;Tiistai;36;35;71;0;0;0
89;06.03.2012;2012;03;14;Tiistai;46;44;90;0;0;0
89;06.03.2012;2012;03;15;Tiistai;58;61;119;0;0;0
89;06.03.2012;2012;03;16;Tiistai;68;66;134;0;0;0
89;06.03.2012;2012;03;17;Tiistai;46;44;90;0;0;0
89;06.03.2012;2012;03;18;Tiistai;36;35;71;0;0;0
89;06.03.2012;2012;03;19;Tiistai;16;14;30;0;0;0
89;06.03.2012;2012;03;20;Tiistai;20;18;38;0;0;0
89;06.03.2012;2012;03;21;Tiistai;14;13;27;0;0;0
89;06.03.2012;2012;03;22;Tiistai;7;5;12;0;0;0
89;06.03.2012;2012;03;23;Tiistai;5;3;8;0;0;0
89;07.03.2012;2012;03;00;Keskiviikko;3;3;6;0;0;0
89;07.03.2012;2012;03;01;Keskiviikko;4;0;4;0;0;0
89;07.03.2012;2012;03;02;Keskiviikko;3;1;4;0;0;0
89;07.03.2012;2012;03;03;Keskiviikko;1;0;1;0;0;0
89;07.03.2012;2012;03;04;Keskiviikko;2;1;3;0;0;0
89;07.03.2012;2012;03;05;Keskiviikko;4;2;6;0;0;0
89;07.03.2012;2012;03;06;Keskiviikko;24;20;44;0;0;0
89;07.03.2012;2012;03;07;Keskiviikko;35;33;68;0;0;0
89;07.03.2012;2012;03;08;Keskiviikko;41;39;80;0;0;0
89;07.03.2012;2012;03;09;Keskiviikko;20;17;37;0;0;0
89;07.03.2012;2012;03;10;Keskiviikko;29;26;55;0;0;0
89;07.03.2012;2012;03;11;Keskiviikko;34;32;66;0;0;0
89;07.03.2012;2012;03;12;Keskiviikko;35;33;68;0;0;0
89;07.03.2012;2012;03;13;Keskiviikko;27;25;52;0;0;0
89;07.03.2012;2012;03;14;Keskiviikko;40;38;78;0;0;0
89;07.03.2012;2012;03;15;Keskiviikko;70;65;135;0;0;0
89;07.03.2012;2012;03;16;Keskiviikko;61;62;123;0;0;0
89;07.03.2012;2012;03;17;Keskiviikko;46;44;90;0;0;0
89;07.03.2012;2012;03;18;Keskiviikko;28;28;56;0;0;0
89;07.03.2012;2012;03;19;Keskiviikko;18;17;35;0;0;0
89;07.03.2012;2012;03;20;Keskiviikko;15;15;30;0;0;0
89;07.03.2012;2012;03;21;Keskiviikko;14;13;27;0;0;0
89;07.03.2012;2012;03;22;Keskiviikko;10;7;17;0;0;0
89;07.03.2012;2012;03;23;Keskiviikko;6;3;9;0;0;0
89;08.03.2012;2012;03;00;Torstai;5;2;7;0;0;0
89;08.03.2012;2012;03;01;Torstai;4;3;7;0;0;0
89;08.03.2012;2012;03;02;Torstai;4;0;4;0;0;0
89;08.03.2012;2012;03;03;Torstai;5;3;8;0;0;0
89;08.03.2012;2012;03;04;Torstai;2;0;2;0;0;0
89;08.03.2012;2012;03;05;Torstai;5;4;9;0;0;0
89;08.03.2012;2012;03;06;Torstai;21;20;41;0;0;0
89;08.03.2012;2012;03;07;Torstai;38;36;74;0;0;0
89;08.03.2012;2012;03;08;Torstai;49;49;98;0;0;0
89;08.03.2012;2012;03;09;Torstai;26;23;49;0;0;0
89;08.03.2012;2012;03;10;Torstai;21;21;42;0;0;0
89;08.03.2012;2012;03;11;Torstai;34;31;65;0;0;0
89;08.03.2012;2012;03;12;Torstai;33;32;65;0;0;0
89;08.03.2012;2012;03;13;Torstai;30;28;58;0;0;0
89;08.03.2012;2012;03;14;Torstai;32;31;63;0;0;0
89;08.03.2012;2012;03;15;Torstai;59;53;112;0;0;0
89;08.03.2012;2012;03;16;Torstai;52;51;103;0;0;0
89;08.03.2012;2012;03;17;Torstai;45;42;87;0;0;0
89;08.03.2012;2012;03;18;Torstai;26;23;49;0;0;0
89;08.03.2012;2012;03;19;Torstai;24;22;46;0;0;0
89;08.03.2012;2012;03;20;Torstai;20;18;38;0;0;0
89;08.03.2012;2012;03;21;Torstai;11;11;22;0;0;0
89;08.03.2012;2012;03;22;Torstai;10;9;19;0;0;0
89;08.03.2012;2012;03;23;Torstai;6;4;10;0;0;0
89;09.03.2012;2012;03;00;Perjantai;5;5;10;0;0;0
89;09.03.2012;2012;03;01;Perjantai;3;3;6;0;0;0
89;09.03.2012;2012;03;02;Perjantai;4;2;6;0;0;0
89;09.03.2012;2012;03;03;Perjantai;3;3;6;0;0;0
89;09.03.2012;2012;03;04;Perjantai;5;3;8;0;0;0
89;09.03.2012;2012;03;05;Perjantai;4;3;7;0;0;0
89;09.03.2012;2012;03;06;Perjantai;19;17;36;0;0;0
89;09.03.2012;2012;03;07;Perjantai;34;32;66;0;0;0
89;09.03.2012;2012;03;08;Perjantai;39;36;75;0;0;0
89;09.03.2012;2012;03;09;Perjantai;25;22;47;0;0;0
89;09.03.2012;2012;03;10;Perjantai;25;24;49;0;0;0
89;09.03.2012;2012;03;11;Perjantai;31;28;59;0;0;0
89;09.03.2012;2012;03;12;Perjantai;41;39;80;0;0;0
89;09.03.2012;2012;03;13;Perjantai;36;33;69;0;0;0
89;09.03.2012;2012;03;14;Perjantai;43;41;84;0;0;0
89;09.03.2012;2012;03;15;Perjantai;47;46;93;0;0;0
89;09.03.2012;2012;03;16;Perjantai;56;53;109;0;0;0
89;09.03.2012;2012;03;17;Perjantai;37;36;73;0;0;0
89;09.03.2012;2012;03;18;Perjantai;24;21;45;0;0;0
89;09.03.2012;2012;03;19;Perjantai;21;19;40;0;0;0
89;09.03.2012;2012;03;20;Perjantai;18;16;34;0;0;0
89;09.03.2012;2012;03;21;Perjantai;10;10;20;0;0;0
89;09.03.2012;2012;03;22;Perjantai;10;6;16;0;0;0
89;09.03.2012;2012;03;23;Perjantai;6;4;10;0;0;0
89;10.03.2012;2012;03;00;Lauantai;6;4;10;0;0;0
89;10.03.2012;2012;03;01;Lauantai;4;1;5;0;0;0
89;10.03.2012;2012;03;02;Lauantai;7;6;13;0;0;0
89;10.03.2012;2012;03;03;Lauantai;7;4;11;0;0;0
89;10.03.2012;2012;03;04;Lauantai;5;3;8;0;0;0
89;10.03.2012;2012;03;05;Lauantai;2;1;3;0;0;0
89;10.03.2012;2012;03;06;Lauantai;6;5;11;0;0;0
89;10.03.2012;2012;03;07;Lauantai;6;4;10;0;0;0
89;10.03.2012;2012;03;08;Lauantai;11;10;21;0;0;0
89;10.03.2012;2012;03;09;Lauantai;18;16;34;0;0;0
89;10.03.2012;2012;03;10;Lauantai;24;29;53;0;0;0
89;10.03.2012;2012;03;11;Lauantai;29;52;81;0;0;0
89;10.03.2012;2012;03;12;Lauantai;30;49;79;0;0;0
89;10.03.2012;2012;03;13;Lauantai;38;42;80;0;0;0
89;10.03.2012;2012;03;14;Lauantai;48;30;78;0;0;0
89;10.03.2012;2012;03;15;Lauantai;37;30;67;0;0;0
89;10.03.2012;2012;03;16;Lauantai;43;27;70;0;0;0
89;10.03.2012;2012;03;17;Lauantai;25;18;43;0;0;0
89;10.03.2012;2012;03;18;Lauantai;35;20;55;0;0;0
89;10.03.2012;2012;03;19;Lauantai;26;15;41;0;0;0
89;10.03.2012;2012;03;20;Lauantai;13;16;29;0;0;0
89;10.03.2012;2012;03;21;Lauantai;13;13;26;0;0;0
89;10.03.2012;2012;03;22;Lauantai;8;13;21;0;0;0
89;10.03.2012;2012;03;23;Lauantai;9;8;17;0;0;0
89;11.03.2012;2012;03;00;Sunnuntai;4;7;11;0;0;0
89;11.03.2012;2012;03;01;Sunnuntai;5;5;10;0;0;0
89;11.03.2012;2012;03;02;Sunnuntai;3;1;4;0;0;0
89;11.03.2012;2012;03;03;Sunnuntai;11;2;13;0;0;0
89;11.03.2012;2012;03;04;Sunnuntai;11;2;13;0;0;0
89;11.03.2012;2012;03;05;Sunnuntai;1;1;2;0;0;0
89;11.03.2012;2012;03;06;Sunnuntai;7;7;14;0;0;0
89;11.03.2012;2012;03;07;Sunnuntai;4;0;4;0;0;0
89;11.03.2012;2012;03;08;Sunnuntai;2;7;9;0;0;0
89;11.03.2012;2012;03;09;Sunnuntai;7;8;15;0;0;0
89;11.03.2012;2012;03;10;Sunnuntai;13;20;33;0;0;0
89;11.03.2012;2012;03;11;Sunnuntai;16;31;47;0;0;0
89;11.03.2012;2012;03;12;Sunnuntai;24;30;54;0;0;0
89;11.03.2012;2012;03;13;Sunnuntai;28;35;63;0;0;0
89;11.03.2012;2012;03;14;Sunnuntai;30;36;66;0;0;0
89;11.03.2012;2012;03;15;Sunnuntai;28;29;57;0;0;0
89;11.03.2012;2012;03;16;Sunnuntai;29;27;56;0;0;0
89;11.03.2012;2012;03;17;Sunnuntai;30;24;54;0;0;0
89;11.03.2012;2012;03;18;Sunnuntai;31;17;48;0;0;0
89;11.03.2012;2012;03;19;Sunnuntai;13;9;22;0;0;0
89;11.03.2012;2012;03;20;Sunnuntai;21;7;28;0;0;0
89;11.03.2012;2012;03;21;Sunnuntai;15;5;20;0;0;0
89;11.03.2012;2012;03;22;Sunnuntai;10;6;16;0;0;0
89;11.03.2012;2012;03;23;Sunnuntai;7;4;11;0;0;0
89;12.03.2012;2012;03;00;Maanantai;6;1;7;1;1;2
89;12.03.2012;2012;03;01;Maanantai;1;0;1;0;0;0
89;12.03.2012;2012;03;02;Maanantai;0;0;0;1;0;1
89;12.03.2012;2012;03;03;Maanantai;5;5;10;4;5;9
89;12.03.2012;2012;03;04;Maanantai;1;5;6;0;1;1
89;12.03.2012;2012;03;05;Maanantai;6;7;13;1;1;2
89;12.03.2012;2012;03;06;Maanantai;15;36;51;6;14;20
89;12.03.2012;2012;03;07;Maanantai;29;129;158;11;42;53
89;12.03.2012;2012;03;08;Maanantai;44;131;175;24;60;84
89;12.03.2012;2012;03;09;Maanantai;31;65;96;22;57;79
89;12.03.2012;2012;03;10;Maanantai;27;43;70;27;34;61
89;12.03.2012;2012;03;11;Maanantai;34;42;76;44;44;88
89;12.03.2012;2012;03;12;Maanantai;45;49;94;41;39;80
89;12.03.2012;2012;03;13;Maanantai;56;51;107;61;46;107
89;12.03.2012;2012;03;14;Maanantai;67;49;116;58;42;100
89;12.03.2012;2012;03;15;Maanantai;115;39;154;85;31;116
89;12.03.2012;2012;03;16;Maanantai;144;68;212;65;35;100
89;12.03.2012;2012;03;17;Maanantai;74;29;103;50;23;73
89;12.03.2012;2012;03;18;Maanantai;43;29;72;47;26;73
89;12.03.2012;2012;03;19;Maanantai;48;21;69;33;24;57
89;12.03.2012;2012;03;20;Maanantai;37;13;50;26;11;37
89;12.03.2012;2012;03;21;Maanantai;35;15;50;8;14;22
89;12.03.2012;2012;03;22;Maanantai;12;5;17;4;0;4
89;12.03.2012;2012;03;23;Maanantai;6;2;8;3;2;5
89;13.03.2012;2012;03;00;Tiistai;2;0;2;1;2;3
89;13.03.2012;2012;03;01;Tiistai;1;1;2;2;0;2
89;13.03.2012;2012;03;02;Tiistai;1;0;1;0;1;1
89;13.03.2012;2012;03;03;Tiistai;5;7;12;0;0;0
89;13.03.2012;2012;03;04;Tiistai;0;3;3;2;2;4
89;13.03.2012;2012;03;05;Tiistai;3;9;12;1;6;7
89;13.03.2012;2012;03;06;Tiistai;16;50;66;13;13;26
89;13.03.2012;2012;03;07;Tiistai;36;134;170;7;59;66
89;13.03.2012;2012;03;08;Tiistai;35;137;172;21;55;76
89;13.03.2012;2012;03;09;Tiistai;27;66;93;15;44;59
89;13.03.2012;2012;03;10;Tiistai;15;43;58;27;57;84
89;13.03.2012;2012;03;11;Tiistai;23;37;60;31;30;61
89;13.03.2012;2012;03;12;Tiistai;41;39;80;43;31;74
89;13.03.2012;2012;03;13;Tiistai;46;42;88;46;27;73
89;13.03.2012;2012;03;14;Tiistai;69;44;113;42;41;83
89;13.03.2012;2012;03;15;Tiistai;108;55;163;72;35;107
89;13.03.2012;2012;03;16;Tiistai;128;63;191;60;38;98
89;13.03.2012;2012;03;17;Tiistai;76;61;137;38;31;69
89;13.03.2012;2012;03;18;Tiistai;38;30;68;40;43;83
89;13.03.2012;2012;03;19;Tiistai;44;30;74;27;25;52
89;13.03.2012;2012;03;20;Tiistai;42;20;62;33;24;57
89;13.03.2012;2012;03;21;Tiistai;49;19;68;27;8;35
89;13.03.2012;2012;03;22;Tiistai;16;7;23;1;2;3
89;13.03.2012;2012;03;23;Tiistai;7;0;7;4;2;6
89;14.03.2012;2012;03;00;Keskiviikko;5;4;9;3;0;3
89;14.03.2012;2012;03;01;Keskiviikko;0;0;0;0;1;1
89;14.03.2012;2012;03;02;Keskiviikko;0;0;0;0;1;1
89;14.03.2012;2012;03;03;Keskiviikko;1;3;4;2;0;2
89;14.03.2012;2012;03;04;Keskiviikko;1;3;4;1;2;3
89;14.03.2012;2012;03;05;Keskiviikko;3;7;10;2;4;6
89;14.03.2012;2012;03;06;Keskiviikko;15;48;63;13;14;27
89;14.03.2012;2012;03;07;Keskiviikko;25;125;150;13;52;65
89;14.03.2012;2012;03;08;Keskiviikko;37;129;166;32;62;94
89;14.03.2012;2012;03;09;Keskiviikko;46;57;103;38;62;100
89;14.03.2012;2012;03;10;Keskiviikko;23;37;60;29;48;77
89;14.03.2012;2012;03;11;Keskiviikko;26;43;69;52;54;106
89;14.03.2012;2012;03;12;Keskiviikko;46;55;101;39;48;87
89;14.03.2012;2012;03;13;Keskiviikko;55;44;99;73;36;109
89;14.03.2012;2012;03;14;Keskiviikko;73;62;135;52;37;89
89;14.03.2012;2012;03;15;Keskiviikko;114;49;163;62;43;105
89;14.03.2012;2012;03;16;Keskiviikko;132;68;200;73;40;113
89;14.03.2012;2012;03;17;Keskiviikko;68;54;122;55;31;86
89;14.03.2012;2012;03;18;Keskiviikko;47;37;84;44;23;67
89;14.03.2012;2012;03;19;Keskiviikko;39;16;55;40;19;59
89;14.03.2012;2012;03;20;Keskiviikko;46;19;65;21;22;43
89;14.03.2012;2012;03;21;Keskiviikko;26;16;42;18;13;31
89;14.03.2012;2012;03;22;Keskiviikko;10;3;13;10;6;16
89;14.03.2012;2012;03;23;Keskiviikko;1;3;4;5;2;7
89;15.03.2012;2012;03;00;Torstai;3;2;5;3;1;4
89;15.03.2012;2012;03;01;Torstai;2;2;4;2;1;3
89;15.03.2012;2012;03;02;Torstai;3;0;3;0;2;2
89;15.03.2012;2012;03;03;Torstai;0;1;1;1;2;3
89;15.03.2012;2012;03;04;Torstai;1;2;3;2;4;6
89;15.03.2012;2012;03;05;Torstai;15;15;30;17;22;39
89;15.03.2012;2012;03;06;Torstai;22;43;65;7;17;24
89;15.03.2012;2012;03;07;Torstai;28;137;165;13;33;46
89;15.03.2012;2012;03;08;Torstai;42;138;180;17;55;72
89;15.03.2012;2012;03;09;Torstai;32;55;87;15;60;75
89;15.03.2012;2012;03;10;Torstai;29;36;65;17;44;61
89;15.03.2012;2012;03;11;Torstai;38;35;73;71;42;113
89;15.03.2012;2012;03;12;Torstai;45;60;105;34;34;68
89;15.03.2012;2012;03;13;Torstai;55;42;97;41;33;74
89;15.03.2012;2012;03;14;Torstai;61;49;110;38;30;68
89;15.03.2012;2012;03;15;Torstai;114;56;170;58;21;79
89;15.03.2012;2012;03;16;Torstai;134;47;181;49;17;66
89;15.03.2012;2012;03;17;Torstai;76;45;121;42;28;70
89;15.03.2012;2012;03;18;Torstai;60;40;100;34;30;64
89;15.03.2012;2012;03;19;Torstai;50;26;76;26;18;44
89;15.03.2012;2012;03;20;Torstai;49;17;66;25;8;33
89;15.03.2012;2012;03;21;Torstai;36;17;53;11;10;21
89;15.03.2012;2012;03;22;Torstai;7;11;18;6;4;10
89;15.03.2012;2012;03;23;Torstai;8;2;10;2;2;4
89;16.03.2012;2012;03;00;Perjantai;5;3;8;1;1;2
89;16.03.2012;2012;03;01;Perjantai;1;2;3;2;0;2
89;16.03.2012;2012;03;02;Perjantai;6;0;6;1;0;1
89;16.03.2012;2012;03;03;Perjantai;1;3;4;1;0;1
89;16.03.2012;2012;03;04;Perjantai;0;2;2;0;1;1
89;16.03.2012;2012;03;05;Perjantai;7;5;12;0;0;0
89;16.03.2012;2012;03;06;Perjantai;9;51;60;10;12;22
89;16.03.2012;2012;03;07;Perjantai;35;122;157;9;47;56
89;16.03.2012;2012;03;08;Perjantai;47;114;161;24;60;84
89;16.03.2012;2012;03;09;Perjantai;24;66;90;18;49;67
89;16.03.2012;2012;03;10;Perjantai;26;51;77;19;34;53
89;16.03.2012;2012;03;11;Perjantai;33;53;86;50;33;83
89;16.03.2012;2012;03;12;Perjantai;40;53;93;25;58;83
89;16.03.2012;2012;03;13;Perjantai;57;52;109;48;44;92
89;16.03.2012;2012;03;14;Perjantai;86;43;129;65;32;97
89;16.03.2012;2012;03;15;Perjantai;101;47;148;54;31;85
89;16.03.2012;2012;03;16;Perjantai;76;59;135;39;44;83
89;16.03.2012;2012;03;17;Perjantai;72;22;94;50;6;56
89;16.03.2012;2012;03;18;Perjantai;30;35;65;34;24;58
89;16.03.2012;2012;03;19;Perjantai;27;21;48;13;18;31
89;16.03.2012;2012;03;20;Perjantai;34;24;58;12;7;19
89;16.03.2012;2012;03;21;Perjantai;20;26;46;12;11;23
89;16.03.2012;2012;03;22;Perjantai;13;8;21;9;9;18
89;16.03.2012;2012;03;23;Perjantai;12;11;23;6;8;14
89;17.03.2012;2012;03;00;Lauantai;16;13;29;11;2;13
89;17.03.2012;2012;03;01;Lauantai;10;2;12;5;3;8
89;17.03.2012;2012;03;02;Lauantai;11;2;13;14;8;22
89;17.03.2012;2012;03;03;Lauantai;7;1;8;9;0;9
89;17.03.2012;2012;03;04;Lauantai;11;0;11;3;2;5
89;17.03.2012;2012;03;05;Lauantai;3;4;7;1;2;3
89;17.03.2012;2012;03;06;Lauantai;3;2;5;3;1;4
89;17.03.2012;2012;03;07;Lauantai;5;7;12;1;7;8
89;17.03.2012;2012;03;08;Lauantai;4;18;22;12;16;28
89;17.03.2012;2012;03;09;Lauantai;10;24;34;17;8;25
89;17.03.2012;2012;03;10;Lauantai;5;23;28;16;33;49
89;17.03.2012;2012;03;11;Lauantai;11;44;55;19;44;63
89;17.03.2012;2012;03;12;Lauantai;19;36;55;31;56;87
89;17.03.2012;2012;03;13;Lauantai;29;51;80;31;35;66
89;17.03.2012;2012;03;14;Lauantai;23;32;55;47;32;79
89;17.03.2012;2012;03;15;Lauantai;50;31;81;23;39;62
89;17.03.2012;2012;03;16;Lauantai;33;41;74;34;27;61
89;17.03.2012;2012;03;17;Lauantai;35;15;50;32;22;54
89;17.03.2012;2012;03;18;Lauantai;25;26;51;29;24;53
89;17.03.2012;2012;03;19;Lauantai;21;27;48;26;13;39
89;17.03.2012;2012;03;20;Lauantai;16;16;32;13;8;21
89;17.03.2012;2012;03;21;Lauantai;12;15;27;4;8;12
89;17.03.2012;2012;03;22;Lauantai;7;16;23;1;7;8
89;17.03.2012;2012;03;23;Lauantai;8;5;13;3;4;7
89;18.03.2012;2012;03;00;Sunnuntai;8;8;16;2;6;8
89;18.03.2012;2012;03;01;Sunnuntai;11;1;12;3;4;7
89;18.03.2012;2012;03;02;Sunnuntai;18;1;19;7;4;11
89;18.03.2012;2012;03;03;Sunnuntai;12;0;12;9;1;10
89;18.03.2012;2012;03;04;Sunnuntai;9;2;11;6;1;7
89;18.03.2012;2012;03;05;Sunnuntai;2;1;3;0;1;1
89;18.03.2012;2012;03;06;Sunnuntai;6;4;10;9;5;14
89;18.03.2012;2012;03;07;Sunnuntai;1;0;1;5;6;11
89;18.03.2012;2012;03;08;Sunnuntai;6;10;16;11;19;30
89;18.03.2012;2012;03;09;Sunnuntai;6;25;31;33;46;79
89;18.03.2012;2012;03;10;Sunnuntai;11;21;32;46;50;96
89;18.03.2012;2012;03;11;Sunnuntai;23;42;65;63;84;147
89;18.03.2012;2012;03;12;Sunnuntai;32;31;63;69;121;190
89;18.03.2012;2012;03;13;Sunnuntai;21;38;59;124;84;208
89;18.03.2012;2012;03;14;Sunnuntai;30;45;75;70;69;139
89;18.03.2012;2012;03;15;Sunnuntai;37;20;57;82;55;137
89;18.03.2012;2012;03;16;Sunnuntai;33;39;72;59;52;111
89;18.03.2012;2012;03;17;Sunnuntai;31;25;56;54;48;102
89;18.03.2012;2012;03;18;Sunnuntai;37;18;55;32;30;62
89;18.03.2012;2012;03;19;Sunnuntai;16;12;28;22;7;29
89;18.03.2012;2012;03;20;Sunnuntai;24;12;36;15;10;25
89;18.03.2012;2012;03;21;Sunnuntai;11;5;16;6;6;12
89;18.03.2012;2012;03;22;Sunnuntai;9;4;13;2;2;4
89;18.03.2012;2012;03;23;Sunnuntai;2;2;4;5;2;7
89;19.03.2012;2012;03;00;Maanantai;1;1;2;1;3;4
89;19.03.2012;2012;03;01;Maanantai;0;0;0;2;0;2
89;19.03.2012;2012;03;02;Maanantai;0;0;0;1;2;3
89;19.03.2012;2012;03;03;Maanantai;2;0;2;0;0;0
89;19.03.2012;2012;03;04;Maanantai;1;4;5;0;0;0
89;19.03.2012;2012;03;05;Maanantai;3;11;14;4;1;5
89;19.03.2012;2012;03;06;Maanantai;15;28;43;7;15;22
89;19.03.2012;2012;03;07;Maanantai;36;142;178;7;44;51
89;19.03.2012;2012;03;08;Maanantai;39;137;176;15;44;59
89;19.03.2012;2012;03;09;Maanantai;31;71;102;12;42;54
89;19.03.2012;2012;03;10;Maanantai;34;43;77;30;39;69
89;19.03.2012;2012;03;11;Maanantai;36;39;75;28;40;68
89;19.03.2012;2012;03;12;Maanantai;30;43;73;34;28;62
89;19.03.2012;2012;03;13;Maanantai;43;37;80;42;38;80
89;19.03.2012;2012;03;14;Maanantai;67;42;109;40;44;84
89;19.03.2012;2012;03;15;Maanantai;108;52;160;49;27;76
89;19.03.2012;2012;03;16;Maanantai;139;58;197;72;23;95
89;19.03.2012;2012;03;17;Maanantai;59;44;103;48;22;70
89;19.03.2012;2012;03;18;Maanantai;59;35;94;39;40;79
89;19.03.2012;2012;03;19;Maanantai;35;19;54;30;31;61
89;19.03.2012;2012;03;20;Maanantai;36;20;56;25;27;52
89;19.03.2012;2012;03;21;Maanantai;25;5;30;13;5;18
89;19.03.2012;2012;03;22;Maanantai;7;7;14;3;5;8
89;19.03.2012;2012;03;23;Maanantai;5;1;6;3;2;5
89;20.03.2012;2012;03;00;Tiistai;1;1;2;1;1;2
89;20.03.2012;2012;03;01;Tiistai;1;2;3;1;0;1
89;20.03.2012;2012;03;02;Tiistai;1;1;2;0;0;0
89;20.03.2012;2012;03;03;Tiistai;0;1;1;3;0;3
89;20.03.2012;2012;03;04;Tiistai;2;4;6;1;0;1
89;20.03.2012;2012;03;05;Tiistai;5;10;15;0;0;0
89;20.03.2012;2012;03;06;Tiistai;14;48;62;12;19;31
89;20.03.2012;2012;03;07;Tiistai;31;138;169;11;56;67
89;20.03.2012;2012;03;08;Tiistai;52;140;192;22;46;68
89;20.03.2012;2012;03;09;Tiistai;37;75;112;30;44;74
89;20.03.2012;2012;03;10;Tiistai;26;57;83;26;51;77
89;20.03.2012;2012;03;11;Tiistai;32;67;99;44;52;96
89;20.03.2012;2012;03;12;Tiistai;50;51;101;36;61;97
89;20.03.2012;2012;03;13;Tiistai;44;66;110;56;39;95
89;20.03.2012;2012;03;14;Tiistai;63;61;124;69;45;114
89;20.03.2012;2012;03;15;Tiistai;118;58;176;63;49;112
89;20.03.2012;2012;03;16;Tiistai;126;69;195;77;55;132
89;20.03.2012;2012;03;17;Tiistai;92;57;149;51;48;99
89;20.03.2012;2012;03;18;Tiistai;64;36;100;54;32;86
89;20.03.2012;2012;03;19;Tiistai;51;31;82;48;24;72
89;20.03.2012;2012;03;20;Tiistai;41;18;59;22;11;33
89;20.03.2012;2012;03;21;Tiistai;28;10;38;14;11;25
89;20.03.2012;2012;03;22;Tiistai;21;11;32;6;5;11
89;20.03.2012;2012;03;23;Tiistai;5;4;9;1;2;3
89;21.03.2012;2012;03;00;Keskiviikko;3;2;5;1;0;1
89;21.03.2012;2012;03;01;Keskiviikko;3;1;4;0;2;2
89;21.03.2012;2012;03;02;Keskiviikko;0;2;2;2;0;2
89;21.03.2012;2012;03;03;Keskiviikko;0;3;3;0;0;0
89;21.03.2012;2012;03;04;Keskiviikko;7;7;14;2;4;6
89;21.03.2012;2012;03;05;Keskiviikko;5;9;14;1;0;1
89;21.03.2012;2012;03;06;Keskiviikko;23;43;66;12;11;23
89;21.03.2012;2012;03;07;Keskiviikko;30;125;155;17;50;67
89;21.03.2012;2012;03;08;Keskiviikko;44;119;163;28;48;76
89;21.03.2012;2012;03;09;Keskiviikko;20;65;85;20;52;72
89;21.03.2012;2012;03;10;Keskiviikko;24;55;79;21;45;66
89;21.03.2012;2012;03;11;Keskiviikko;43;58;101;47;39;86
89;21.03.2012;2012;03;12;Keskiviikko;41;66;107;42;50;92
89;21.03.2012;2012;03;13;Keskiviikko;44;55;99;53;51;104
89;21.03.2012;2012;03;14;Keskiviikko;67;54;121;42;52;94
89;21.03.2012;2012;03;15;Keskiviikko;99;69;168;52;33;85
89;21.03.2012;2012;03;16;Keskiviikko;111;77;188;56;29;85
89;21.03.2012;2012;03;17;Keskiviikko;72;58;130;55;27;82
89;21.03.2012;2012;03;18;Keskiviikko;74;42;116;33;33;66
89;21.03.2012;2012;03;19;Keskiviikko;42;22;64;28;31;59
89;21.03.2012;2012;03;20;Keskiviikko;46;27;73;17;15;32
89;21.03.2012;2012;03;21;Keskiviikko;26;18;44;19;9;28
89;21.03.2012;2012;03;22;Keskiviikko;9;1;10;7;8;15
89;21.03.2012;2012;03;23;Keskiviikko;5;4;9;6;4;10
89;22.03.2012;2012;03;00;Torstai;5;2;7;1;1;2
89;22.03.2012;2012;03;01;Torstai;2;1;3;2;1;3
89;22.03.2012;2012;03;02;Torstai;4;2;6;3;0;3
89;22.03.2012;2012;03;03;Torstai;2;2;4;3;0;3
89;22.03.2012;2012;03;04;Torstai;4;0;4;5;1;6
89;22.03.2012;2012;03;05;Torstai;3;13;16;1;1;2
89;22.03.2012;2012;03;06;Torstai;10;37;47;9;15;24
89;22.03.2012;2012;03;07;Torstai;38;113;151;9;51;60
89;22.03.2012;2012;03;08;Torstai;36;123;159;22;43;65
89;22.03.2012;2012;03;09;Torstai;27;59;86;21;37;58
89;22.03.2012;2012;03;10;Torstai;24;52;76;31;35;66
89;22.03.2012;2012;03;11;Torstai;28;52;80;21;21;42
89;22.03.2012;2012;03;12;Torstai;40;42;82;23;30;53
89;22.03.2012;2012;03;13;Torstai;36;34;70;42;21;63
89;22.03.2012;2012;03;14;Torstai;49;38;87;23;24;47
89;22.03.2012;2012;03;15;Torstai;108;50;158;38;26;64
89;22.03.2012;2012;03;16;Torstai;129;60;189;64;24;88
89;22.03.2012;2012;03;17;Torstai;59;44;103;45;32;77
89;22.03.2012;2012;03;18;Torstai;64;47;111;29;31;60
89;22.03.2012;2012;03;19;Torstai;41;26;67;45;20;65
89;22.03.2012;2012;03;20;Torstai;38;15;53;19;18;37
89;22.03.2012;2012;03;21;Torstai;24;16;40;7;9;16
89;22.03.2012;2012;03;22;Torstai;22;12;34;10;4;14
89;22.03.2012;2012;03;23;Torstai;6;2;8;2;3;5
89;23.03.2012;2012;03;00;Perjantai;5;2;7;1;1;2
89;23.03.2012;2012;03;01;Perjantai;5;1;6;1;2;3
89;23.03.2012;2012;03;02;Perjantai;7;0;7;3;0;3
89;23.03.2012;2012;03;03;Perjantai;2;1;3;2;0;2
89;23.03.2012;2012;03;04;Perjantai;0;1;1;0;1;1
89;23.03.2012;2012;03;05;Perjantai;3;11;14;3;0;3
89;23.03.2012;2012;03;06;Perjantai;14;36;50;6;13;19
89;23.03.2012;2012;03;07;Perjantai;29;116;145;14;44;58
89;23.03.2012;2012;03;08;Perjantai;34;107;141;24;73;97
89;23.03.2012;2012;03;09;Perjantai;20;65;85;19;45;64
89;23.03.2012;2012;03;10;Perjantai;25;43;68;30;47;77
89;23.03.2012;2012;03;11;Perjantai;29;57;86;31;32;63
89;23.03.2012;2012;03;12;Perjantai;39;55;94;42;46;88
89;23.03.2012;2012;03;13;Perjantai;72;73;145;38;49;87
89;23.03.2012;2012;03;14;Perjantai;77;58;135;47;40;87
89;23.03.2012;2012;03;15;Perjantai;106;52;158;46;25;71
89;23.03.2012;2012;03;16;Perjantai;91;50;141;54;31;85
89;23.03.2012;2012;03;17;Perjantai;70;53;123;32;19;51
89;23.03.2012;2012;03;18;Perjantai;50;30;80;30;31;61
89;23.03.2012;2012;03;19;Perjantai;41;26;67;23;20;43
89;23.03.2012;2012;03;20;Perjantai;24;20;44;12;9;21
89;23.03.2012;2012;03;21;Perjantai;23;14;37;11;6;17
89;23.03.2012;2012;03;22;Perjantai;21;18;39;8;16;24
89;23.03.2012;2012;03;23;Perjantai;8;24;32;5;12;17
89;24.03.2012;2012;03;00;Lauantai;11;7;18;2;5;7
89;24.03.2012;2012;03;01;Lauantai;17;5;22;5;3;8
89;24.03.2012;2012;03;02;Lauantai;14;5;19;9;3;12
89;24.03.2012;2012;03;03;Lauantai;8;1;9;4;0;4
89;24.03.2012;2012;03;04;Lauantai;8;0;8;1;2;3
89;24.03.2012;2012;03;05;Lauantai;2;4;6;3;1;4
89;24.03.2012;2012;03;06;Lauantai;5;6;11;6;3;9
89;24.03.2012;2012;03;07;Lauantai;4;10;14;5;11;16
89;24.03.2012;2012;03;08;Lauantai;7;16;23;8;15;23
89;24.03.2012;2012;03;09;Lauantai;10;38;48;15;33;48
89;24.03.2012;2012;03;10;Lauantai;14;32;46;23;42;65
89;24.03.2012;2012;03;11;Lauantai;22;52;74;30;75;105
89;24.03.2012;2012;03;12;Lauantai;28;40;68;50;74;124
89;24.03.2012;2012;03;13;Lauantai;35;62;97;65;59;124
89;24.03.2012;2012;03;14;Lauantai;55;41;96;70;43;113
89;24.03.2012;2012;03;15;Lauantai;37;39;76;42;40;82
89;24.03.2012;2012;03;16;Lauantai;45;53;98;53;41;94
89;24.03.2012;2012;03;17;Lauantai;34;46;80;40;21;61
89;24.03.2012;2012;03;18;Lauantai;39;23;62;33;38;71
89;24.03.2012;2012;03;19;Lauantai;17;23;40;20;18;38
89;24.03.2012;2012;03;20;Lauantai;30;12;42;19;18;37
89;24.03.2012;2012;03;21;Lauantai;10;14;24;6;6;12
89;24.03.2012;2012;03;22;Lauantai;10;25;35;3;2;5
89;24.03.2012;2012;03;23;Lauantai;10;23;33;5;9;14
89;25.03.2012;2012;03;00;Sunnuntai;10;10;20;6;9;15
89;25.03.2012;2012;03;01;Sunnuntai;15;3;18;11;2;13
89;25.03.2012;2012;03;02;Sunnuntai;0;0;0;0;0;0
89;25.03.2012;2012;03;03;Sunnuntai;21;1;22;13;3;16
89;25.03.2012;2012;03;04;Sunnuntai;0;0;0;0;0;0
89;25.03.2012;2012;03;05;Sunnuntai;10;2;12;7;0;7
89;25.03.2012;2012;03;06;Sunnuntai;5;1;6;3;0;3
89;25.03.2012;2012;03;07;Sunnuntai;2;3;5;2;5;7
89;25.03.2012;2012;03;08;Sunnuntai;8;1;9;5;8;13
89;25.03.2012;2012;03;09;Sunnuntai;8;13;21;21;17;38
89;25.03.2012;2012;03;10;Sunnuntai;4;32;36;23;28;51
89;25.03.2012;2012;03;11;Sunnuntai;11;29;40;48;54;102
89;25.03.2012;2012;03;12;Sunnuntai;20;21;41;35;48;83
89;25.03.2012;2012;03;13;Sunnuntai;26;39;65;72;73;145
89;25.03.2012;2012;03;14;Sunnuntai;42;27;69;88;70;158
89;25.03.2012;2012;03;15;Sunnuntai;48;37;85;72;82;154
89;25.03.2012;2012;03;16;Sunnuntai;33;42;75;65;57;122
89;25.03.2012;2012;03;17;Sunnuntai;43;28;71;40;30;70
89;25.03.2012;2012;03;18;Sunnuntai;42;21;63;43;26;69
89;25.03.2012;2012;03;19;Sunnuntai;29;30;59;31;39;70
89;25.03.2012;2012;03;20;Sunnuntai;27;16;43;25;18;43
89;25.03.2012;2012;03;21;Sunnuntai;18;14;32;4;13;17
89;25.03.2012;2012;03;22;Sunnuntai;6;6;12;7;0;7
89;25.03.2012;2012;03;23;Sunnuntai;11;2;13;3;4;7
89;26.03.2012;2012;03;00;Maanantai;5;2;7;1;0;1
89;26.03.2012;2012;03;01;Maanantai;2;1;3;0;0;0
89;26.03.2012;2012;03;02;Maanantai;1;1;2;2;0;2
89;26.03.2012;2012;03;03;Maanantai;1;4;5;1;0;1
89;26.03.2012;2012;03;04;Maanantai;4;3;7;0;0;0
89;26.03.2012;2012;03;05;Maanantai;1;13;14;2;0;2
89;26.03.2012;2012;03;06;Maanantai;16;39;55;1;8;9
89;26.03.2012;2012;03;07;Maanantai;31;117;148;15;37;52
89;26.03.2012;2012;03;08;Maanantai;43;128;171;14;54;68
89;26.03.2012;2012;03;09;Maanantai;35;79;114;15;45;60
89;26.03.2012;2012;03;10;Maanantai;28;48;76;27;36;63
89;26.03.2012;2012;03;11;Maanantai;33;64;97;37;41;78
89;26.03.2012;2012;03;12;Maanantai;56;59;115;37;45;82
89;26.03.2012;2012;03;13;Maanantai;59;68;127;30;37;67
89;26.03.2012;2012;03;14;Maanantai;87;57;144;44;21;65
89;26.03.2012;2012;03;15;Maanantai;119;57;176;48;28;76
89;26.03.2012;2012;03;16;Maanantai;145;82;227;42;20;62
89;26.03.2012;2012;03;17;Maanantai;73;37;110;29;14;43
89;26.03.2012;2012;03;18;Maanantai;53;36;89;21;19;40
89;26.03.2012;2012;03;19;Maanantai;42;14;56;18;18;36
89;26.03.2012;2012;03;20;Maanantai;38;14;52;19;20;39
89;26.03.2012;2012;03;21;Maanantai;23;15;38;9;3;12
89;26.03.2012;2012;03;22;Maanantai;8;4;12;4;1;5
89;26.03.2012;2012;03;23;Maanantai;6;3;9;4;2;6
89;27.03.2012;2012;03;00;Tiistai;1;2;3;2;1;3
89;27.03.2012;2012;03;01;Tiistai;4;0;4;2;1;3
89;27.03.2012;2012;03;02;Tiistai;3;2;5;1;0;1
89;27.03.2012;2012;03;03;Tiistai;2;2;4;3;3;6
89;27.03.2012;2012;03;04;Tiistai;0;3;3;0;0;0
89;27.03.2012;2012;03;05;Tiistai;5;13;18;3;1;4
89;27.03.2012;2012;03;06;Tiistai;12;36;48;6;7;13
89;27.03.2012;2012;03;07;Tiistai;31;129;160;10;41;51
89;27.03.2012;2012;03;08;Tiistai;39;121;160;19;48;67
89;27.03.2012;2012;03;09;Tiistai;30;58;88;20;30;50
89;27.03.2012;2012;03;10;Tiistai;23;46;69;28;51;79
89;27.03.2012;2012;03;11;Tiistai;28;47;75;24;43;67
89;27.03.2012;2012;03;12;Tiistai;36;44;80;26;28;54
89;27.03.2012;2012;03;13;Tiistai;59;48;107;40;24;64
89;27.03.2012;2012;03;14;Tiistai;72;44;116;48;28;76
89;27.03.2012;2012;03;15;Tiistai;126;52;178;57;23;80
89;27.03.2012;2012;03;16;Tiistai;131;54;185;41;28;69
89;27.03.2012;2012;03;17;Tiistai;83;61;144;56;27;83
89;27.03.2012;2012;03;18;Tiistai;48;36;84;55;39;94
89;27.03.2012;2012;03;19;Tiistai;43;28;71;30;40;70
89;27.03.2012;2012;03;20;Tiistai;53;20;73;32;23;55
89;27.03.2012;2012;03;21;Tiistai;22;12;34;15;15;30
89;27.03.2012;2012;03;22;Tiistai;17;7;24;5;4;9
89;27.03.2012;2012;03;23;Tiistai;9;4;13;1;0;1
89;28.03.2012;2012;03;00;Keskiviikko;1;0;1;1;0;1
89;28.03.2012;2012;03;01;Keskiviikko;2;0;2;2;1;3
89;28.03.2012;2012;03;02;Keskiviikko;1;2;3;0;0;0
89;28.03.2012;2012;03;03;Keskiviikko;1;3;4;1;0;1
89;28.03.2012;2012;03;04;Keskiviikko;1;3;4;0;0;0
89;28.03.2012;2012;03;05;Keskiviikko;5;9;14;3;1;4
89;28.03.2012;2012;03;06;Keskiviikko;14;46;60;8;10;18
89;28.03.2012;2012;03;07;Keskiviikko;32;138;170;11;45;56
89;28.03.2012;2012;03;08;Keskiviikko;43;134;177;26;57;83
89;28.03.2012;2012;03;09;Keskiviikko;32;68;100;13;24;37
89;28.03.2012;2012;03;10;Keskiviikko;27;54;81;27;40;67
89;28.03.2012;2012;03;11;Keskiviikko;34;55;89;34;33;67
89;28.03.2012;2012;03;12;Keskiviikko;75;69;144;42;50;92
89;28.03.2012;2012;03;13;Keskiviikko;67;62;129;53;31;84
89;28.03.2012;2012;03;14;Keskiviikko;82;60;142;56;37;93
89;28.03.2012;2012;03;15;Keskiviikko;132;66;198;47;32;79
89;28.03.2012;2012;03;16;Keskiviikko;129;61;190;67;55;122
89;28.03.2012;2012;03;17;Keskiviikko;86;83;169;56;26;82
89;28.03.2012;2012;03;18;Keskiviikko;58;55;113;53;29;82
89;28.03.2012;2012;03;19;Keskiviikko;64;35;99;40;30;70
89;28.03.2012;2012;03;20;Keskiviikko;49;16;65;35;30;65
89;28.03.2012;2012;03;21;Keskiviikko;53;23;76;15;17;32
89;28.03.2012;2012;03;22;Keskiviikko;6;4;10;3;2;5
89;28.03.2012;2012;03;23;Keskiviikko;7;1;8;3;0;3
89;29.03.2012;2012;03;00;Torstai;1;2;3;1;3;4
89;29.03.2012;2012;03;01;Torstai;2;1;3;2;1;3
89;29.03.2012;2012;03;02;Torstai;4;0;4;3;2;5
89;29.03.2012;2012;03;03;Torstai;2;3;5;2;3;5
89;29.03.2012;2012;03;04;Torstai;1;3;4;2;0;2
89;29.03.2012;2012;03;05;Torstai;6;11;17;2;1;3
89;29.03.2012;2012;03;06;Torstai;17;46;63;3;15;18
89;29.03.2012;2012;03;07;Torstai;32;114;146;12;45;57
89;29.03.2012;2012;03;08;Torstai;36;160;196;18;41;59
89;29.03.2012;2012;03;09;Torstai;33;79;112;26;35;61
89;29.03.2012;2012;03;10;Torstai;33;49;82;23;39;62
89;29.03.2012;2012;03;11;Torstai;29;43;72;23;36;59
89;29.03.2012;2012;03;12;Torstai;42;58;100;20;38;58
89;29.03.2012;2012;03;13;Torstai;54;57;111;38;19;57
89;29.03.2012;2012;03;14;Torstai;79;58;137;35;25;60
89;29.03.2012;2012;03;15;Torstai;136;41;177;45;21;66
89;29.03.2012;2012;03;16;Torstai;129;58;187;49;23;72
89;29.03.2012;2012;03;17;Torstai;78;51;129;22;22;44
89;29.03.2012;2012;03;18;Torstai;44;46;90;56;22;78
89;29.03.2012;2012;03;19;Torstai;63;37;100;36;26;62
89;29.03.2012;2012;03;20;Torstai;52;28;80;19;13;32
89;29.03.2012;2012;03;21;Torstai;38;27;65;15;13;28
89;29.03.2012;2012;03;22;Torstai;7;7;14;5;7;12
89;29.03.2012;2012;03;23;Torstai;10;8;18;3;0;3
89;30.03.2012;2012;03;00;Perjantai;8;1;9;1;1;2
89;30.03.2012;2012;03;01;Perjantai;6;0;6;4;0;4
89;30.03.2012;2012;03;02;Perjantai;7;3;10;1;1;2
89;30.03.2012;2012;03;03;Perjantai;12;4;16;1;0;1
89;30.03.2012;2012;03;04;Perjantai;2;3;5;1;1;2
89;30.03.2012;2012;03;05;Perjantai;5;12;17;3;0;3
89;30.03.2012;2012;03;06;Perjantai;7;32;39;10;6;16
89;30.03.2012;2012;03;07;Perjantai;27;112;139;8;45;53
89;30.03.2012;2012;03;08;Perjantai;34;128;162;17;46;63
89;30.03.2012;2012;03;09;Perjantai;14;63;77;19;33;52
89;30.03.2012;2012;03;10;Perjantai;27;61;88;38;41;79
89;30.03.2012;2012;03;11;Perjantai;41;61;102;32;31;63
89;30.03.2012;2012;03;12;Perjantai;53;57;110;30;45;75
89;30.03.2012;2012;03;13;Perjantai;76;78;154;41;47;88
89;30.03.2012;2012;03;14;Perjantai;102;57;159;53;30;83
89;30.03.2012;2012;03;15;Perjantai;105;61;166;42;40;82
89;30.03.2012;2012;03;16;Perjantai;95;61;156;46;30;76
89;30.03.2012;2012;03;17;Perjantai;60;55;115;39;22;61
89;30.03.2012;2012;03;18;Perjantai;52;37;89;42;27;69
89;30.03.2012;2012;03;19;Perjantai;70;27;97;27;17;44
89;30.03.2012;2012;03;20;Perjantai;32;35;67;11;14;25
89;30.03.2012;2012;03;21;Perjantai;33;22;55;18;11;29
89;30.03.2012;2012;03;22;Perjantai;21;21;42;4;9;13
89;30.03.2012;2012;03;23;Perjantai;15;7;22;5;8;13
89;31.03.2012;2012;03;00;Lauantai;22;9;31;9;2;11
89;31.03.2012;2012;03;01;Lauantai;12;2;14;0;0;0
89;31.03.2012;2012;03;02;Lauantai;11;6;17;6;1;7
89;31.03.2012;2012;03;03;Lauantai;12;2;14;6;0;6
89;31.03.2012;2012;03;04;Lauantai;10;5;15;4;2;6
89;31.03.2012;2012;03;05;Lauantai;4;0;4;1;1;2
89;31.03.2012;2012;03;06;Lauantai;4;7;11;5;0;5
89;31.03.2012;2012;03;07;Lauantai;9;17;26;5;10;15
89;31.03.2012;2012;03;08;Lauantai;5;20;25;9;10;19
89;31.03.2012;2012;03;09;Lauantai;13;35;48;15;35;50
89;31.03.2012;2012;03;10;Lauantai;18;65;83;29;30;59
89;31.03.2012;2012;03;11;Lauantai;30;56;86;42;59;101
89;31.03.2012;2012;03;12;Lauantai;32;55;87;37;63;100
89;31.03.2012;2012;03;13;Lauantai;53;40;93;51;33;84
89;31.03.2012;2012;03;14;Lauantai;40;42;82;52;44;96
89;31.03.2012;2012;03;15;Lauantai;47;44;91;52;37;89
89;31.03.2012;2012;03;16;Lauantai;48;39;87;36;25;61
89;31.03.2012;2012;03;17;Lauantai;58;33;91;35;28;63
89;31.03.2012;2012;03;18;Lauantai;30;36;66;30;24;54
89;31.03.2012;2012;03;19;Lauantai;34;32;66;23;24;47
89;31.03.2012;2012;03;20;Lauantai;33;25;58;17;15;32
89;31.03.2012;2012;03;21;Lauantai;26;10;36;10;4;14
89;31.03.2012;2012;03;22;Lauantai;10;14;24;7;12;19
89;31.03.2012;2012;03;23;Lauantai;16;14;30;6;11;17
89;01.04.2012;2012;04;00;Sunnuntai;10;11;21;2;5;7
89;01.04.2012;2012;04;01;Sunnuntai;21;3;24;5;3;8
89;01.04.2012;2012;04;02;Sunnuntai;6;1;7;4;1;5
89;01.04.2012;2012;04;03;Sunnuntai;16;1;17;10;0;10
89;01.04.2012;2012;04;04;Sunnuntai;14;1;15;7;1;8
89;01.04.2012;2012;04;05;Sunnuntai;3;0;3;2;0;2
89;01.04.2012;2012;04;06;Sunnuntai;1;4;5;1;0;1
89;01.04.2012;2012;04;07;Sunnuntai;4;3;7;4;6;10
89;01.04.2012;2012;04;08;Sunnuntai;7;7;14;11;10;21
89;01.04.2012;2012;04;09;Sunnuntai;9;14;23;24;16;40
89;01.04.2012;2012;04;10;Sunnuntai;8;20;28;28;44;72
89;01.04.2012;2012;04;11;Sunnuntai;25;39;64;43;45;88
89;01.04.2012;2012;04;12;Sunnuntai;41;40;81;56;77;133
89;01.04.2012;2012;04;13;Sunnuntai;33;35;68;69;70;139
89;01.04.2012;2012;04;14;Sunnuntai;33;40;73;54;59;113
89;01.04.2012;2012;04;15;Sunnuntai;35;46;81;54;51;105
89;01.04.2012;2012;04;16;Sunnuntai;35;36;71;49;44;93
89;01.04.2012;2012;04;17;Sunnuntai;40;42;82;40;30;70
89;01.04.2012;2012;04;18;Sunnuntai;45;31;76;36;18;54
89;01.04.2012;2012;04;19;Sunnuntai;23;12;35;23;24;47
89;01.04.2012;2012;04;20;Sunnuntai;33;18;51;24;16;40
89;01.04.2012;2012;04;21;Sunnuntai;13;12;25;14;4;18
89;01.04.2012;2012;04;22;Sunnuntai;15;5;20;2;4;6
89;01.04.2012;2012;04;23;Sunnuntai;8;0;8;3;2;5
89;02.04.2012;2012;04;00;Maanantai;4;2;6;0;1;1
89;02.04.2012;2012;04;01;Maanantai;3;1;4;1;0;1
89;02.04.2012;2012;04;02;Maanantai;1;0;1;1;0;1
89;02.04.2012;2012;04;03;Maanantai;2;2;4;0;0;0
89;02.04.2012;2012;04;04;Maanantai;0;5;5;0;0;0
89;02.04.2012;2012;04;05;Maanantai;5;14;19;2;3;5
89;02.04.2012;2012;04;06;Maanantai;16;36;52;6;9;15
89;02.04.2012;2012;04;07;Maanantai;36;110;146;11;36;47
89;02.04.2012;2012;04;08;Maanantai;40;128;168;19;47;66
89;02.04.2012;2012;04;09;Maanantai;33;99;132;12;55;67
89;02.04.2012;2012;04;10;Maanantai;39;59;98;46;48;94
89;02.04.2012;2012;04;11;Maanantai;48;65;113;30;41;71
89;02.04.2012;2012;04;12;Maanantai;61;60;121;40;32;72
89;02.04.2012;2012;04;13;Maanantai;72;57;129;26;34;60
89;02.04.2012;2012;04;14;Maanantai;81;67;148;47;26;73
89;02.04.2012;2012;04;15;Maanantai;140;76;216;52;29;81
89;02.04.2012;2012;04;16;Maanantai;147;73;220;59;37;96
89;02.04.2012;2012;04;17;Maanantai;74;61;135;36;27;63
89;02.04.2012;2012;04;18;Maanantai;70;65;135;36;30;66
89;02.04.2012;2012;04;19;Maanantai;44;28;72;28;27;55
89;02.04.2012;2012;04;20;Maanantai;50;25;75;31;22;53
89;02.04.2012;2012;04;21;Maanantai;29;6;35;14;8;22
89;02.04.2012;2012;04;22;Maanantai;16;2;18;1;4;5
89;02.04.2012;2012;04;23;Maanantai;7;1;8;1;2;3
89;03.04.2012;2012;04;00;Tiistai;3;3;6;2;0;2
89;03.04.2012;2012;04;01;Tiistai;2;1;3;0;0;0
89;03.04.2012;2012;04;02;Tiistai;2;3;5;0;1;1
89;03.04.2012;2012;04;03;Tiistai;0;2;2;0;0;0
89;03.04.2012;2012;04;04;Tiistai;0;5;5;2;0;2
89;03.04.2012;2012;04;05;Tiistai;5;12;17;0;5;5
89;03.04.2012;2012;04;06;Tiistai;16;48;64;10;13;23
89;03.04.2012;2012;04;07;Tiistai;29;135;164;8;45;53
89;03.04.2012;2012;04;08;Tiistai;42;135;177;9;35;44
89;03.04.2012;2012;04;09;Tiistai;39;68;107;18;42;60
89;03.04.2012;2012;04;10;Tiistai;25;53;78;18;38;56
89;03.04.2012;2012;04;11;Tiistai;45;61;106;36;41;77
89;03.04.2012;2012;04;12;Tiistai;48;60;108;36;39;75
89;03.04.2012;2012;04;13;Tiistai;65;56;121;35;24;59
89;03.04.2012;2012;04;14;Tiistai;69;73;142;37;44;81
89;03.04.2012;2012;04;15;Tiistai;116;66;182;49;25;74
89;03.04.2012;2012;04;16;Tiistai;158;73;231;59;30;89
89;03.04.2012;2012;04;17;Tiistai;78;56;134;51;24;75
89;03.04.2012;2012;04;18;Tiistai;60;38;98;39;35;74
89;03.04.2012;2012;04;19;Tiistai;49;33;82;36;27;63
89;03.04.2012;2012;04;20;Tiistai;48;21;69;37;21;58
89;03.04.2012;2012;04;21;Tiistai;38;14;52;16;9;25
89;03.04.2012;2012;04;22;Tiistai;12;3;15;11;1;12
89;03.04.2012;2012;04;23;Tiistai;8;5;13;0;2;2
89;04.04.2012;2012;04;00;Keskiviikko;3;2;5;1;1;2
89;04.04.2012;2012;04;01;Keskiviikko;2;3;5;0;0;0
89;04.04.2012;2012;04;02;Keskiviikko;0;0;0;0;0;0
89;04.04.2012;2012;04;03;Keskiviikko;1;3;4;0;0;0
89;04.04.2012;2012;04;04;Keskiviikko;1;3;4;2;1;3
89;04.04.2012;2012;04;05;Keskiviikko;5;16;21;1;4;5
89;04.04.2012;2012;04;06;Keskiviikko;20;39;59;7;12;19
89;04.04.2012;2012;04;07;Keskiviikko;30;113;143;6;43;49
89;04.04.2012;2012;04;08;Keskiviikko;46;134;180;16;50;66
89;04.04.2012;2012;04;09;Keskiviikko;28;75;103;27;34;61
89;04.04.2012;2012;04;10;Keskiviikko;34;57;91;14;59;73
89;04.04.2012;2012;04;11;Keskiviikko;40;69;109;35;49;84
89;04.04.2012;2012;04;12;Keskiviikko;59;72;131;41;38;79
89;04.04.2012;2012;04;13;Keskiviikko;63;74;137;59;45;104
89;04.04.2012;2012;04;14;Keskiviikko;103;78;181;36;36;72
89;04.04.2012;2012;04;15;Keskiviikko;145;68;213;47;33;80
89;04.04.2012;2012;04;16;Keskiviikko;150;88;238;45;33;78
89;04.04.2012;2012;04;17;Keskiviikko;85;50;135;38;22;60
89;04.04.2012;2012;04;18;Keskiviikko;73;57;130;35;35;70
89;04.04.2012;2012;04;19;Keskiviikko;46;46;92;29;23;52
89;04.04.2012;2012;04;20;Keskiviikko;55;23;78;29;20;49
89;04.04.2012;2012;04;21;Keskiviikko;31;18;49;12;6;18
89;04.04.2012;2012;04;22;Keskiviikko;15;11;26;4;4;8
89;04.04.2012;2012;04;23;Keskiviikko;12;6;18;4;6;10
89;05.04.2012;2012;04;00;Torstai;4;3;7;5;1;6
89;05.04.2012;2012;04;01;Torstai;8;2;10;3;0;3
89;05.04.2012;2012;04;02;Torstai;8;1;9;0;1;1
89;05.04.2012;2012;04;03;Torstai;2;0;2;1;0;1
89;05.04.2012;2012;04;04;Torstai;4;2;6;4;0;4
89;05.04.2012;2012;04;05;Torstai;6;16;22;1;3;4
89;05.04.2012;2012;04;06;Torstai;17;39;56;3;15;18
89;05.04.2012;2012;04;07;Torstai;24;106;130;16;39;55
89;05.04.2012;2012;04;08;Torstai;33;108;141;17;36;53
89;05.04.2012;2012;04;09;Torstai;25;70;95;19;44;63
89;05.04.2012;2012;04;10;Torstai;30;44;74;29;35;64
89;05.04.2012;2012;04;11;Torstai;45;46;91;17;34;51
89;05.04.2012;2012;04;12;Torstai;49;78;127;43;48;91
89;05.04.2012;2012;04;13;Torstai;80;69;149;26;27;53
89;05.04.2012;2012;04;14;Torstai;100;66;166;38;36;74
89;05.04.2012;2012;04;15;Torstai;110;52;162;37;33;70
89;05.04.2012;2012;04;16;Torstai;118;52;170;40;26;66
89;05.04.2012;2012;04;17;Torstai;54;36;90;24;27;51
89;05.04.2012;2012;04;18;Torstai;39;28;67;26;26;52
89;05.04.2012;2012;04;19;Torstai;51;26;77;23;19;42
89;05.04.2012;2012;04;20;Torstai;38;22;60;10;15;25
89;05.04.2012;2012;04;21;Torstai;13;21;34;11;12;23
89;05.04.2012;2012;04;22;Torstai;17;16;33;6;6;12
89;05.04.2012;2012;04;23;Torstai;7;21;28;2;14;16
89;06.04.2012;2012;04;00;Perjantai;1;9;10;7;0;7
89;06.04.2012;2012;04;01;Perjantai;9;6;15;4;0;4
89;06.04.2012;2012;04;02;Perjantai;11;0;11;9;2;11
89;06.04.2012;2012;04;03;Perjantai;10;1;11;2;0;2
89;06.04.2012;2012;04;04;Perjantai;10;0;10;10;0;10
89;06.04.2012;2012;04;05;Perjantai;6;1;7;3;2;5
89;06.04.2012;2012;04;06;Perjantai;2;8;10;2;4;6
89;06.04.2012;2012;04;07;Perjantai;4;3;7;1;8;9
89;06.04.2012;2012;04;08;Perjantai;4;10;14;15;15;30
89;06.04.2012;2012;04;09;Perjantai;8;12;20;27;23;50
89;06.04.2012;2012;04;10;Perjantai;11;14;25;29;44;73
89;06.04.2012;2012;04;11;Perjantai;19;34;53;35;41;76
89;06.04.2012;2012;04;12;Perjantai;21;38;59;47;45;92
89;06.04.2012;2012;04;13;Perjantai;26;41;67;54;66;120
89;06.04.2012;2012;04;14;Perjantai;41;37;78;47;50;97
89;06.04.2012;2012;04;15;Perjantai;42;24;66;53;42;95
89;06.04.2012;2012;04;16;Perjantai;33;32;65;34;48;82
89;06.04.2012;2012;04;17;Perjantai;34;43;77;46;38;84
89;06.04.2012;2012;04;18;Perjantai;38;43;81;36;34;70
89;06.04.2012;2012;04;19;Perjantai;30;22;52;21;15;36
89;06.04.2012;2012;04;20;Perjantai;15;19;34;17;20;37
89;06.04.2012;2012;04;21;Perjantai;17;12;29;6;4;10
89;06.04.2012;2012;04;22;Perjantai;19;11;30;3;8;11
89;06.04.2012;2012;04;23;Perjantai;8;9;17;3;7;10
89;07.04.2012;2012;04;00;Lauantai;4;5;9;0;1;1
89;07.04.2012;2012;04;01;Lauantai;10;6;16;5;3;8
89;07.04.2012;2012;04;02;Lauantai;7;1;8;4;4;8
89;07.04.2012;2012;04;03;Lauantai;8;1;9;2;0;2
89;07.04.2012;2012;04;04;Lauantai;3;1;4;4;0;4
89;07.04.2012;2012;04;05;Lauantai;1;2;3;1;1;2
89;07.04.2012;2012;04;06;Lauantai;2;10;12;4;3;7
89;07.04.2012;2012;04;07;Lauantai;3;11;14;6;8;14
89;07.04.2012;2012;04;08;Lauantai;9;19;28;9;8;17
89;07.04.2012;2012;04;09;Lauantai;6;31;37;9;18;27
89;07.04.2012;2012;04;10;Lauantai;13;34;47;14;38;52
89;07.04.2012;2012;04;11;Lauantai;20;48;68;29;59;88
89;07.04.2012;2012;04;12;Lauantai;44;52;96;37;45;82
89;07.04.2012;2012;04;13;Lauantai;53;45;98;37;33;70
89;07.04.2012;2012;04;14;Lauantai;58;30;88;42;36;78
89;07.04.2012;2012;04;15;Lauantai;46;30;76;40;37;77
89;07.04.2012;2012;04;16;Lauantai;36;24;60;35;25;60
89;07.04.2012;2012;04;17;Lauantai;21;43;64;41;44;85
89;07.04.2012;2012;04;18;Lauantai;22;24;46;30;27;57
89;07.04.2012;2012;04;19;Lauantai;28;30;58;23;19;42
89;07.04.2012;2012;04;20;Lauantai;19;17;36;17;16;33
89;07.04.2012;2012;04;21;Lauantai;10;15;25;8;4;12
89;07.04.2012;2012;04;22;Lauantai;8;27;35;2;6;8
89;07.04.2012;2012;04;23;Lauantai;5;9;14;1;10;11
89;08.04.2012;2012;04;00;Sunnuntai;7;14;21;4;3;7
89;08.04.2012;2012;04;01;Sunnuntai;11;3;14;6;0;6
89;08.04.2012;2012;04;02;Sunnuntai;7;1;8;2;2;4
89;08.04.2012;2012;04;03;Sunnuntai;17;4;21;6;0;6
89;08.04.2012;2012;04;04;Sunnuntai;10;1;11;13;1;14
89;08.04.2012;2012;04;05;Sunnuntai;3;0;3;0;0;0
89;08.04.2012;2012;04;06;Sunnuntai;5;9;14;3;3;6
89;08.04.2012;2012;04;07;Sunnuntai;1;1;2;5;5;10
89;08.04.2012;2012;04;08;Sunnuntai;5;6;11;8;6;14
89;08.04.2012;2012;04;09;Sunnuntai;10;9;19;25;27;52
89;08.04.2012;2012;04;10;Sunnuntai;13;11;24;36;43;79
89;08.04.2012;2012;04;11;Sunnuntai;19;23;42;51;51;102
89;08.04.2012;2012;04;12;Sunnuntai;34;29;63;43;35;78
89;08.04.2012;2012;04;13;Sunnuntai;27;54;81;61;53;114
89;08.04.2012;2012;04;14;Sunnuntai;33;31;64;42;59;101
89;08.04.2012;2012;04;15;Sunnuntai;41;32;73;51;47;98
89;08.04.2012;2012;04;16;Sunnuntai;32;37;69;41;30;71
89;08.04.2012;2012;04;17;Sunnuntai;28;28;56;28;22;50
89;08.04.2012;2012;04;18;Sunnuntai;33;29;62;31;22;53
89;08.04.2012;2012;04;19;Sunnuntai;24;16;40;23;28;51
89;08.04.2012;2012;04;20;Sunnuntai;26;16;42;16;15;31
89;08.04.2012;2012;04;21;Sunnuntai;8;22;30;7;16;23
89;08.04.2012;2012;04;22;Sunnuntai;6;8;14;2;1;3
89;08.04.2012;2012;04;23;Sunnuntai;8;12;20;2;2;4
89;09.04.2012;2012;04;00;Maanantai;9;5;14;1;1;2
89;09.04.2012;2012;04;01;Maanantai;3;0;3;3;2;5
89;09.04.2012;2012;04;02;Maanantai;1;4;5;1;1;2
89;09.04.2012;2012;04;03;Maanantai;8;0;8;4;0;4
89;09.04.2012;2012;04;04;Maanantai;4;1;5;1;1;2
89;09.04.2012;2012;04;05;Maanantai;3;1;4;0;0;0
89;09.04.2012;2012;04;06;Maanantai;5;6;11;3;3;6
89;09.04.2012;2012;04;07;Maanantai;3;6;9;3;10;13
89;09.04.2012;2012;04;08;Maanantai;2;14;16;13;12;25
89;09.04.2012;2012;04;09;Maanantai;12;17;29;21;18;39
89;09.04.2012;2012;04;10;Maanantai;20;25;45;34;26;60
89;09.04.2012;2012;04;11;Maanantai;25;37;62;57;57;114
89;09.04.2012;2012;04;12;Maanantai;37;45;82;54;66;120
89;09.04.2012;2012;04;13;Maanantai;36;47;83;68;76;144
89;09.04.2012;2012;04;14;Maanantai;52;52;104;47;47;94
89;09.04.2012;2012;04;15;Maanantai;54;33;87;60;52;112
89;09.04.2012;2012;04;16;Maanantai;45;40;85;65;43;108
89;09.04.2012;2012;04;17;Maanantai;40;36;76;45;50;95
89;09.04.2012;2012;04;18;Maanantai;25;25;50;40;36;76
89;09.04.2012;2012;04;19;Maanantai;34;21;55;35;26;61
89;09.04.2012;2012;04;20;Maanantai;27;16;43;26;30;56
89;09.04.2012;2012;04;21;Maanantai;21;10;31;13;6;19
89;09.04.2012;2012;04;22;Maanantai;6;10;16;9;2;11
89;09.04.2012;2012;04;23;Maanantai;9;5;14;1;2;3
89;10.04.2012;2012;04;00;Tiistai;7;4;11;1;1;2
89;10.04.2012;2012;04;01;Tiistai;2;0;2;2;0;2
89;10.04.2012;2012;04;02;Tiistai;4;1;5;1;0;1
89;10.04.2012;2012;04;03;Tiistai;2;4;6;1;0;1
89;10.04.2012;2012;04;04;Tiistai;4;7;11;1;0;1
89;10.04.2012;2012;04;05;Tiistai;8;8;16;3;1;4
89;10.04.2012;2012;04;06;Tiistai;14;43;57;3;15;18
89;10.04.2012;2012;04;07;Tiistai;37;150;187;8;41;49
89;10.04.2012;2012;04;08;Tiistai;44;155;199;18;44;62
89;10.04.2012;2012;04;09;Tiistai;38;101;139;8;21;29
89;10.04.2012;2012;04;10;Tiistai;41;69;110;24;36;60
89;10.04.2012;2012;04;11;Tiistai;49;62;111;27;42;69
89;10.04.2012;2012;04;12;Tiistai;49;61;110;38;32;70
89;10.04.2012;2012;04;13;Tiistai;71;44;115;31;29;60
89;10.04.2012;2012;04;14;Tiistai;87;53;140;27;20;47
89;10.04.2012;2012;04;15;Tiistai;128;53;181;40;14;54
89;10.04.2012;2012;04;16;Tiistai;153;56;209;29;16;45
89;10.04.2012;2012;04;17;Tiistai;76;39;115;25;11;36
89;10.04.2012;2012;04;18;Tiistai;53;41;94;25;15;40
89;10.04.2012;2012;04;19;Tiistai;42;23;65;24;15;39
89;10.04.2012;2012;04;20;Tiistai;38;33;71;27;17;44
89;10.04.2012;2012;04;21;Tiistai;27;15;42;12;9;21
89;10.04.2012;2012;04;22;Tiistai;10;8;18;3;5;8
89;10.04.2012;2012;04;23;Tiistai;10;1;11;2;3;5
89;11.04.2012;2012;04;00;Keskiviikko;4;1;5;1;0;1
89;11.04.2012;2012;04;01;Keskiviikko;2;1;3;0;1;1
89;11.04.2012;2012;04;02;Keskiviikko;0;0;0;0;1;1
89;11.04.2012;2012;04;03;Keskiviikko;1;1;2;1;0;1
89;11.04.2012;2012;04;04;Keskiviikko;2;7;9;1;1;2
89;11.04.2012;2012;04;05;Keskiviikko;5;7;12;2;1;3
89;11.04.2012;2012;04;06;Keskiviikko;12;56;68;5;16;21
89;11.04.2012;2012;04;07;Keskiviikko;40;132;172;7;46;53
89;11.04.2012;2012;04;08;Keskiviikko;40;128;168;12;32;44
89;11.04.2012;2012;04;09;Keskiviikko;25;65;90;9;22;31
89;11.04.2012;2012;04;10;Keskiviikko;25;40;65;15;20;35
89;11.04.2012;2012;04;11;Keskiviikko;27;44;71;14;25;39
89;11.04.2012;2012;04;12;Keskiviikko;36;43;79;8;24;32
89;11.04.2012;2012;04;13;Keskiviikko;48;63;111;18;18;36
89;11.04.2012;2012;04;14;Keskiviikko;71;54;125;33;24;57
89;11.04.2012;2012;04;15;Keskiviikko;99;57;156;35;18;53
89;11.04.2012;2012;04;16;Keskiviikko;130;62;192;50;17;67
89;11.04.2012;2012;04;17;Keskiviikko;75;49;124;34;16;50
89;11.04.2012;2012;04;18;Keskiviikko;56;32;88;32;16;48
89;11.04.2012;2012;04;19;Keskiviikko;38;27;65;26;26;52
89;11.04.2012;2012;04;20;Keskiviikko;47;28;75;18;23;41
89;11.04.2012;2012;04;21;Keskiviikko;29;10;39;8;3;11
89;11.04.2012;2012;04;22;Keskiviikko;9;6;15;7;6;13
89;11.04.2012;2012;04;23;Keskiviikko;7;4;11;2;4;6
89;12.04.2012;2012;04;00;Torstai;7;1;8;1;2;3
89;12.04.2012;2012;04;01;Torstai;2;2;4;1;3;4
89;12.04.2012;2012;04;02;Torstai;3;4;7;1;0;1
89;12.04.2012;2012;04;03;Torstai;0;0;0;1;0;1
89;12.04.2012;2012;04;04;Torstai;3;3;6;2;1;3
89;12.04.2012;2012;04;05;Torstai;3;7;10;0;1;1
89;12.04.2012;2012;04;06;Torstai;17;43;60;10;17;27
89;12.04.2012;2012;04;07;Torstai;39;130;169;10;40;50
89;12.04.2012;2012;04;08;Torstai;49;126;175;18;34;52
89;12.04.2012;2012;04;09;Torstai;30;69;99;18;34;52
89;12.04.2012;2012;04;10;Torstai;35;56;91;19;25;44
89;12.04.2012;2012;04;11;Torstai;29;53;82;30;34;64
89;12.04.2012;2012;04;12;Torstai;32;64;96;19;38;57
89;12.04.2012;2012;04;13;Torstai;56;70;126;45;30;75
89;12.04.2012;2012;04;14;Torstai;78;68;146;32;31;63
89;12.04.2012;2012;04;15;Torstai;123;57;180;38;30;68
89;12.04.2012;2012;04;16;Torstai;146;59;205;55;29;84
89;12.04.2012;2012;04;17;Torstai;103;58;161;51;27;78
89;12.04.2012;2012;04;18;Torstai;77;42;119;37;19;56
89;12.04.2012;2012;04;19;Torstai;49;29;78;32;25;57
89;12.04.2012;2012;04;20;Torstai;51;24;75;20;16;36
89;12.04.2012;2012;04;21;Torstai;37;15;52;11;11;22
89;12.04.2012;2012;04;22;Torstai;9;18;27;5;5;10
89;12.04.2012;2012;04;23;Torstai;5;3;8;3;2;5
89;13.04.2012;2012;04;00;Perjantai;8;8;16;2;1;3
89;13.04.2012;2012;04;01;Perjantai;2;1;3;8;5;13
89;13.04.2012;2012;04;02;Perjantai;5;0;5;2;0;2
89;13.04.2012;2012;04;03;Perjantai;4;3;7;1;0;1
89;13.04.2012;2012;04;04;Perjantai;3;4;7;1;0;1
89;13.04.2012;2012;04;05;Perjantai;2;11;13;5;1;6
89;13.04.2012;2012;04;06;Perjantai;10;51;61;2;11;13
89;13.04.2012;2012;04;07;Perjantai;35;127;162;9;25;34
89;13.04.2012;2012;04;08;Perjantai;48;140;188;15;24;39
89;13.04.2012;2012;04;09;Perjantai;14;97;111;16;25;41
89;13.04.2012;2012;04;10;Perjantai;40;75;115;28;36;64
89;13.04.2012;2012;04;11;Perjantai;47;76;123;28;27;55
89;13.04.2012;2012;04;12;Perjantai;57;65;122;31;26;57
89;13.04.2012;2012;04;13;Perjantai;87;61;148;29;31;60
89;13.04.2012;2012;04;14;Perjantai;122;69;191;43;37;80
89;13.04.2012;2012;04;15;Perjantai;137;60;197;48;19;67
89;13.04.2012;2012;04;16;Perjantai;115;80;195;41;29;70
89;13.04.2012;2012;04;17;Perjantai;66;75;141;42;35;77
89;13.04.2012;2012;04;18;Perjantai;77;58;135;43;48;91
89;13.04.2012;2012;04;19;Perjantai;51;45;96;35;27;62
89;13.04.2012;2012;04;20;Perjantai;65;35;100;14;13;27
89;13.04.2012;2012;04;21;Perjantai;31;17;48;7;12;19
89;13.04.2012;2012;04;22;Perjantai;23;19;42;13;10;23
89;13.04.2012;2012;04;23;Perjantai;17;19;36;2;13;15
89;14.04.2012;2012;04;00;Lauantai;14;6;20;4;2;6
89;14.04.2012;2012;04;01;Lauantai;12;12;24;4;8;12
89;14.04.2012;2012;04;02;Lauantai;20;6;26;9;1;10
89;14.04.2012;2012;04;03;Lauantai;15;3;18;7;0;7
89;14.04.2012;2012;04;04;Lauantai;18;1;19;7;1;8
89;14.04.2012;2012;04;05;Lauantai;2;8;10;3;1;4
89;14.04.2012;2012;04;06;Lauantai;7;8;15;2;7;9
89;14.04.2012;2012;04;07;Lauantai;5;19;24;8;6;14
89;14.04.2012;2012;04;08;Lauantai;9;25;34;13;18;31
89;14.04.2012;2012;04;09;Lauantai;22;51;73;23;31;54
89;14.04.2012;2012;04;10;Lauantai;23;55;78;20;37;57
89;14.04.2012;2012;04;11;Lauantai;25;48;73;23;14;37
89;14.04.2012;2012;04;12;Lauantai;34;45;79;22;20;42
89;14.04.2012;2012;04;13;Lauantai;42;30;72;18;19;37
89;14.04.2012;2012;04;14;Lauantai;53;38;91;14;9;23
89;14.04.2012;2012;04;15;Lauantai;34;18;52;16;16;32
89;14.04.2012;2012;04;16;Lauantai;20;23;43;19;10;29
89;14.04.2012;2012;04;17;Lauantai;34;17;51;13;8;21
89;14.04.2012;2012;04;18;Lauantai;20;16;36;7;11;18
89;14.04.2012;2012;04;19;Lauantai;7;14;21;7;7;14
89;14.04.2012;2012;04;20;Lauantai;21;17;38;4;8;12
89;14.04.2012;2012;04;21;Lauantai;7;6;13;1;6;7
89;14.04.2012;2012;04;22;Lauantai;13;12;25;5;2;7
89;14.04.2012;2012;04;23;Lauantai;7;8;15;4;10;14
89;15.04.2012;2012;04;00;Sunnuntai;6;8;14;3;2;5
89;15.04.2012;2012;04;01;Sunnuntai;2;9;11;4;1;5
89;15.04.2012;2012;04;02;Sunnuntai;11;0;11;4;1;5
89;15.04.2012;2012;04;03;Sunnuntai;12;0;12;7;0;7
89;15.04.2012;2012;04;04;Sunnuntai;8;1;9;4;0;4
89;15.04.2012;2012;04;05;Sunnuntai;4;2;6;4;1;5
89;15.04.2012;2012;04;06;Sunnuntai;5;1;6;0;0;0
89;15.04.2012;2012;04;07;Sunnuntai;4;2;6;7;6;13
89;15.04.2012;2012;04;08;Sunnuntai;4;7;11;5;7;12
89;15.04.2012;2012;04;09;Sunnuntai;9;5;14;22;14;36
89;15.04.2012;2012;04;10;Sunnuntai;9;36;45;23;17;40
89;15.04.2012;2012;04;11;Sunnuntai;13;33;46;21;37;58
89;15.04.2012;2012;04;12;Sunnuntai;20;45;65;40;47;87
89;15.04.2012;2012;04;13;Sunnuntai;31;46;77;54;42;96
89;15.04.2012;2012;04;14;Sunnuntai;47;29;76;42;34;76
89;15.04.2012;2012;04;15;Sunnuntai;31;34;65;45;31;76
89;15.04.2012;2012;04;16;Sunnuntai;38;36;74;35;30;65
89;15.04.2012;2012;04;17;Sunnuntai;31;22;53;19;26;45
89;15.04.2012;2012;04;18;Sunnuntai;26;25;51;29;17;46
89;15.04.2012;2012;04;19;Sunnuntai;18;18;36;14;7;21
89;15.04.2012;2012;04;20;Sunnuntai;18;20;38;17;22;39
89;15.04.2012;2012;04;21;Sunnuntai;17;5;22;14;7;21
89;15.04.2012;2012;04;22;Sunnuntai;12;6;18;7;3;10
89;15.04.2012;2012;04;23;Sunnuntai;6;1;7;2;2;4
89;16.04.2012;2012;04;00;Maanantai;1;3;4;2;2;4
89;16.04.2012;2012;04;01;Maanantai;1;1;2;0;1;1
89;16.04.2012;2012;04;02;Maanantai;3;0;3;0;0;0
89;16.04.2012;2012;04;03;Maanantai;1;1;2;1;0;1
89;16.04.2012;2012;04;04;Maanantai;3;6;9;1;0;1
89;16.04.2012;2012;04;05;Maanantai;5;10;15;2;1;3
89;16.04.2012;2012;04;06;Maanantai;16;52;68;2;10;12
89;16.04.2012;2012;04;07;Maanantai;46;151;197;9;29;38
89;16.04.2012;2012;04;08;Maanantai;49;169;218;17;37;54
89;16.04.2012;2012;04;09;Maanantai;36;113;149;13;30;43
89;16.04.2012;2012;04;10;Maanantai;41;74;115;23;40;63
89;16.04.2012;2012;04;11;Maanantai;49;66;115;37;41;78
89;16.04.2012;2012;04;12;Maanantai;64;75;139;19;35;54
89;16.04.2012;2012;04;13;Maanantai;75;92;167;52;49;101
89;16.04.2012;2012;04;14;Maanantai;92;97;189;43;29;72
89;16.04.2012;2012;04;15;Maanantai;143;91;234;43;40;83
89;16.04.2012;2012;04;16;Maanantai;208;88;296;50;34;84
89;16.04.2012;2012;04;17;Maanantai;134;76;210;60;34;94
89;16.04.2012;2012;04;18;Maanantai;84;75;159;72;52;124
89;16.04.2012;2012;04;19;Maanantai;90;50;140;36;45;81
89;16.04.2012;2012;04;20;Maanantai;76;27;103;43;28;71
89;16.04.2012;2012;04;21;Maanantai;46;11;57;22;15;37
89;16.04.2012;2012;04;22;Maanantai;17;7;24;10;3;13
89;16.04.2012;2012;04;23;Maanantai;7;7;14;2;2;4
89;17.04.2012;2012;04;00;Tiistai;1;3;4;2;2;4
89;17.04.2012;2012;04;01;Tiistai;3;0;3;1;0;1
89;17.04.2012;2012;04;02;Tiistai;0;1;1;2;0;2
89;17.04.2012;2012;04;03;Tiistai;0;0;0;0;0;0
89;17.04.2012;2012;04;04;Tiistai;2;3;5;1;1;2
89;17.04.2012;2012;04;05;Tiistai;5;14;19;2;3;5
89;17.04.2012;2012;04;06;Tiistai;18;68;86;4;15;19
89;17.04.2012;2012;04;07;Tiistai;48;176;224;10;45;55
89;17.04.2012;2012;04;08;Tiistai;49;178;227;22;43;65
89;17.04.2012;2012;04;09;Tiistai;37;97;134;21;40;61
89;17.04.2012;2012;04;10;Tiistai;33;54;87;24;46;70
89;17.04.2012;2012;04;11;Tiistai;55;64;119;32;35;67
89;17.04.2012;2012;04;12;Tiistai;52;74;126;26;36;62
89;17.04.2012;2012;04;13;Tiistai;71;63;134;32;26;58
89;17.04.2012;2012;04;14;Tiistai;113;65;178;40;28;68
89;17.04.2012;2012;04;15;Tiistai;170;54;224;32;24;56
89;17.04.2012;2012;04;16;Tiistai;204;83;287;43;35;78
89;17.04.2012;2012;04;17;Tiistai;102;56;158;41;18;59
89;17.04.2012;2012;04;18;Tiistai;76;48;124;35;17;52
89;17.04.2012;2012;04;19;Tiistai;53;17;70;24;27;51
89;17.04.2012;2012;04;20;Tiistai;54;25;79;16;15;31
89;17.04.2012;2012;04;21;Tiistai;35;17;52;8;11;19
89;17.04.2012;2012;04;22;Tiistai;19;4;23;6;1;7
89;17.04.2012;2012;04;23;Tiistai;5;1;6;1;1;2
89;18.04.2012;2012;04;00;Keskiviikko;4;2;6;1;0;1
89;18.04.2012;2012;04;01;Keskiviikko;1;0;1;2;0;2
89;18.04.2012;2012;04;02;Keskiviikko;1;0;1;0;0;0
89;18.04.2012;2012;04;03;Keskiviikko;0;0;0;0;0;0
89;18.04.2012;2012;04;04;Keskiviikko;1;3;4;0;0;0
89;18.04.2012;2012;04;05;Keskiviikko;7;10;17;2;2;4
89;18.04.2012;2012;04;06;Keskiviikko;9;44;53;6;15;21
89;18.04.2012;2012;04;07;Keskiviikko;40;130;170;18;48;66
89;18.04.2012;2012;04;08;Keskiviikko;48;145;193;20;40;60
89;18.04.2012;2012;04;09;Keskiviikko;36;64;100;10;30;40
89;18.04.2012;2012;04;10;Keskiviikko;21;53;74;16;31;47
89;18.04.2012;2012;04;11;Keskiviikko;39;42;81;23;26;49
89;18.04.2012;2012;04;12;Keskiviikko;29;57;86;23;31;54
89;18.04.2012;2012;04;13;Keskiviikko;48;57;105;24;26;50
89;18.04.2012;2012;04;14;Keskiviikko;85;68;153;27;24;51
89;18.04.2012;2012;04;15;Keskiviikko;114;57;171;36;31;67
89;18.04.2012;2012;04;16;Keskiviikko;140;71;211;40;19;59
89;18.04.2012;2012;04;17;Keskiviikko;97;59;156;47;26;73
89;18.04.2012;2012;04;18;Keskiviikko;81;42;123;39;28;67
89;18.04.2012;2012;04;19;Keskiviikko;62;37;99;49;32;81
89;18.04.2012;2012;04;20;Keskiviikko;52;30;82;30;22;52
89;18.04.2012;2012;04;21;Keskiviikko;25;20;45;11;11;22
89;18.04.2012;2012;04;22;Keskiviikko;12;11;23;7;3;10
89;18.04.2012;2012;04;23;Keskiviikko;9;4;13;4;9;13
89;19.04.2012;2012;04;00;Torstai;5;5;10;3;0;3
89;19.04.2012;2012;04;01;Torstai;10;1;11;4;1;5
89;19.04.2012;2012;04;02;Torstai;4;0;4;1;0;1
89;19.04.2012;2012;04;03;Torstai;2;5;7;0;0;0
89;19.04.2012;2012;04;04;Torstai;2;4;6;0;1;1
89;19.04.2012;2012;04;05;Torstai;6;15;21;1;0;1
89;19.04.2012;2012;04;06;Torstai;18;54;72;4;15;19
89;19.04.2012;2012;04;07;Torstai;54;174;228;16;47;63
89;19.04.2012;2012;04;08;Torstai;42;175;217;16;43;59
89;19.04.2012;2012;04;09;Torstai;23;85;108;15;38;53
89;19.04.2012;2012;04;10;Torstai;44;97;141;30;25;55
89;19.04.2012;2012;04;11;Torstai;45;74;119;29;46;75
89;19.04.2012;2012;04;12;Torstai;63;79;142;29;25;54
89;19.04.2012;2012;04;13;Torstai;82;68;150;25;34;59
89;19.04.2012;2012;04;14;Torstai;106;85;191;30;29;59
89;19.04.2012;2012;04;15;Torstai;156;93;249;53;39;92
89;19.04.2012;2012;04;16;Torstai;181;100;281;66;28;94
89;19.04.2012;2012;04;17;Torstai;110;71;181;44;40;84
89;19.04.2012;2012;04;18;Torstai;94;85;179;52;38;90
89;19.04.2012;2012;04;19;Torstai;87;55;142;53;39;92
89;19.04.2012;2012;04;20;Torstai;89;41;130;36;22;58
89;19.04.2012;2012;04;21;Torstai;44;19;63;19;13;32
89;19.04.2012;2012;04;22;Torstai;14;15;29;8;2;10
89;19.04.2012;2012;04;23;Torstai;15;6;21;4;2;6
89;20.04.2012;2012;04;00;Perjantai;3;6;9;2;3;5
89;20.04.2012;2012;04;01;Perjantai;7;0;7;2;0;2
89;20.04.2012;2012;04;02;Perjantai;3;0;3;45;56;101
89;20.04.2012;2012;04;03;Perjantai;3;1;4;5;0;5
89;20.04.2012;2012;04;04;Perjantai;3;3;6;0;2;2
89;20.04.2012;2012;04;05;Perjantai;6;15;21;5;2;7
89;20.04.2012;2012;04;06;Perjantai;18;67;85;5;9;14
89;20.04.2012;2012;04;07;Perjantai;51;200;251;9;31;40
89;20.04.2012;2012;04;08;Perjantai;60;184;244;19;47;66
89;20.04.2012;2012;04;09;Perjantai;34;121;155;26;42;68
89;20.04.2012;2012;04;10;Perjantai;63;76;139;29;32;61
89;20.04.2012;2012;04;11;Perjantai;53;91;144;23;46;69
89;20.04.2012;2012;04;12;Perjantai;56;84;140;23;42;65
89;20.04.2012;2012;04;13;Perjantai;90;97;187;32;36;68
89;20.04.2012;2012;04;14;Perjantai;148;85;233;56;26;82
89;20.04.2012;2012;04;15;Perjantai;164;88;252;26;17;43
89;20.04.2012;2012;04;16;Perjantai;138;84;222;33;16;49
89;20.04.2012;2012;04;17;Perjantai;90;70;160;22;27;49
89;20.04.2012;2012;04;18;Perjantai;99;67;166;41;26;67
89;20.04.2012;2012;04;19;Perjantai;70;34;104;29;19;48
89;20.04.2012;2012;04;20;Perjantai;51;34;85;17;17;34
89;20.04.2012;2012;04;21;Perjantai;37;21;58;16;8;24
89;20.04.2012;2012;04;22;Perjantai;14;26;40;3;5;8
89;20.04.2012;2012;04;23;Perjantai;15;15;30;4;9;13
89;21.04.2012;2012;04;00;Lauantai;10;7;17;0;5;5
89;21.04.2012;2012;04;01;Lauantai;21;8;29;5;1;6
89;21.04.2012;2012;04;02;Lauantai;12;5;17;11;1;12
89;21.04.2012;2012;04;03;Lauantai;6;4;10;6;1;7
89;21.04.2012;2012;04;04;Lauantai;10;1;11;12;1;13
89;21.04.2012;2012;04;05;Lauantai;3;5;8;0;2;2
89;21.04.2012;2012;04;06;Lauantai;8;4;12;1;1;2
89;21.04.2012;2012;04;07;Lauantai;4;26;30;4;10;14
89;21.04.2012;2012;04;08;Lauantai;9;27;36;11;6;17
89;21.04.2012;2012;04;09;Lauantai;17;52;69;9;18;27
89;21.04.2012;2012;04;10;Lauantai;17;52;69;7;23;30
89;21.04.2012;2012;04;11;Lauantai;41;38;79;26;32;58
89;21.04.2012;2012;04;12;Lauantai;27;48;75;9;17;26
89;21.04.2012;2012;04;13;Lauantai;37;45;82;24;20;44
89;21.04.2012;2012;04;14;Lauantai;47;48;95;30;17;47
89;21.04.2012;2012;04;15;Lauantai;55;49;104;29;19;48
89;21.04.2012;2012;04;16;Lauantai;57;42;99;26;28;54
89;21.04.2012;2012;04;17;Lauantai;49;36;85;22;20;42
89;21.04.2012;2012;04;18;Lauantai;44;21;65;20;15;35
89;21.04.2012;2012;04;19;Lauantai;37;32;69;12;17;29
89;21.04.2012;2012;04;20;Lauantai;20;23;43;21;24;45
89;21.04.2012;2012;04;21;Lauantai;13;15;28;5;3;8
89;21.04.2012;2012;04;22;Lauantai;16;10;26;4;6;10
89;21.04.2012;2012;04;23;Lauantai;8;14;22;4;10;14
89;22.04.2012;2012;04;00;Sunnuntai;7;27;34;3;6;9
89;22.04.2012;2012;04;01;Sunnuntai;12;13;25;7;1;8
89;22.04.2012;2012;04;02;Sunnuntai;13;7;20;4;4;8
89;22.04.2012;2012;04;03;Sunnuntai;12;1;13;12;0;12
89;22.04.2012;2012;04;04;Sunnuntai;10;2;12;11;0;11
89;22.04.2012;2012;04;05;Sunnuntai;1;2;3;0;2;2
89;22.04.2012;2012;04;06;Sunnuntai;3;9;12;3;3;6
89;22.04.2012;2012;04;07;Sunnuntai;4;5;9;2;9;11
89;22.04.2012;2012;04;08;Sunnuntai;6;8;14;9;12;21
89;22.04.2012;2012;04;09;Sunnuntai;13;25;38;22;15;37
89;22.04.2012;2012;04;10;Sunnuntai;14;59;73;34;34;68
89;22.04.2012;2012;04;11;Sunnuntai;36;70;106;64;73;137
89;22.04.2012;2012;04;12;Sunnuntai;40;66;106;58;64;122
89;22.04.2012;2012;04;13;Sunnuntai;75;93;168;53;35;88
89;22.04.2012;2012;04;14;Sunnuntai;59;49;108;48;35;83
89;22.04.2012;2012;04;15;Sunnuntai;88;39;127;45;28;73
89;22.04.2012;2012;04;16;Sunnuntai;86;70;156;44;45;89
89;22.04.2012;2012;04;17;Sunnuntai;76;72;148;58;39;97
89;22.04.2012;2012;04;18;Sunnuntai;101;71;172;58;53;111
89;22.04.2012;2012;04;19;Sunnuntai;48;29;77;51;55;106
89;22.04.2012;2012;04;20;Sunnuntai;39;24;63;44;22;66
89;22.04.2012;2012;04;21;Sunnuntai;23;6;29;10;17;27
89;22.04.2012;2012;04;22;Sunnuntai;9;10;19;8;12;20
89;22.04.2012;2012;04;23;Sunnuntai;12;6;18;5;2;7
89;23.04.2012;2012;04;00;Maanantai;4;3;7;1;1;2
89;23.04.2012;2012;04;01;Maanantai;0;0;0;1;1;2
89;23.04.2012;2012;04;02;Maanantai;2;0;2;0;1;1
89;23.04.2012;2012;04;03;Maanantai;1;3;4;2;0;2
89;23.04.2012;2012;04;04;Maanantai;1;4;5;1;0;1
89;23.04.2012;2012;04;05;Maanantai;9;14;23;3;0;3
89;23.04.2012;2012;04;06;Maanantai;15;72;87;5;12;17
89;23.04.2012;2012;04;07;Maanantai;58;183;241;9;31;40
89;23.04.2012;2012;04;08;Maanantai;64;196;260;17;44;61
89;23.04.2012;2012;04;09;Maanantai;56;116;172;24;54;78
89;23.04.2012;2012;04;10;Maanantai;61;87;148;30;45;75
89;23.04.2012;2012;04;11;Maanantai;66;109;175;27;40;67
89;23.04.2012;2012;04;12;Maanantai;79;93;172;39;44;83
89;23.04.2012;2012;04;13;Maanantai;105;97;202;43;35;78
89;23.04.2012;2012;04;14;Maanantai;143;81;224;43;53;96
89;23.04.2012;2012;04;15;Maanantai;171;111;282;68;43;111
89;23.04.2012;2012;04;16;Maanantai;222;139;361;54;35;89
89;23.04.2012;2012;04;17;Maanantai;177;86;263;51;47;98
89;23.04.2012;2012;04;18;Maanantai;119;88;207;66;52;118
89;23.04.2012;2012;04;19;Maanantai;100;52;152;63;58;121
89;23.04.2012;2012;04;20;Maanantai;94;38;132;43;41;84
89;23.04.2012;2012;04;21;Maanantai;34;29;63;29;23;52
89;23.04.2012;2012;04;22;Maanantai;21;22;43;13;4;17
89;23.04.2012;2012;04;23;Maanantai;12;3;15;3;2;5
89;24.04.2012;2012;04;00;Tiistai;2;2;4;4;2;6
89;24.04.2012;2012;04;01;Tiistai;5;2;7;4;0;4
89;24.04.2012;2012;04;02;Tiistai;0;2;2;0;1;1
89;24.04.2012;2012;04;03;Tiistai;4;3;7;0;1;1
89;24.04.2012;2012;04;04;Tiistai;4;6;10;1;0;1
89;24.04.2012;2012;04;05;Tiistai;4;11;15;3;1;4
89;24.04.2012;2012;04;06;Tiistai;16;64;80;6;8;14
89;24.04.2012;2012;04;07;Tiistai;80;195;275;16;47;63
89;24.04.2012;2012;04;08;Tiistai;55;183;238;27;46;73
89;24.04.2012;2012;04;09;Tiistai;29;97;126;18;22;40
89;24.04.2012;2012;04;10;Tiistai;34;72;106;15;32;47
89;24.04.2012;2012;04;11;Tiistai;58;76;134;30;25;55
89;24.04.2012;2012;04;12;Tiistai;72;87;159;12;34;46
89;24.04.2012;2012;04;13;Tiistai;85;73;158;33;38;71
89;24.04.2012;2012;04;14;Tiistai;99;75;174;38;25;63
89;24.04.2012;2012;04;15;Tiistai;179;69;248;31;16;47
89;24.04.2012;2012;04;16;Tiistai;181;75;256;25;8;33
89;24.04.2012;2012;04;17;Tiistai;90;69;159;15;16;31
89;24.04.2012;2012;04;18;Tiistai;70;38;108;32;22;54
89;24.04.2012;2012;04;19;Tiistai;52;35;87;38;21;59
89;24.04.2012;2012;04;20;Tiistai;76;28;104;35;18;53
89;24.04.2012;2012;04;21;Tiistai;40;12;52;20;12;32
89;24.04.2012;2012;04;22;Tiistai;6;7;13;3;2;5
89;24.04.2012;2012;04;23;Tiistai;13;4;17;1;2;3
89;25.04.2012;2012;04;00;Keskiviikko;3;2;5;1;3;4
89;25.04.2012;2012;04;01;Keskiviikko;1;3;4;0;0;0
89;25.04.2012;2012;04;02;Keskiviikko;1;0;1;0;0;0
89;25.04.2012;2012;04;03;Keskiviikko;0;0;0;1;1;2
89;25.04.2012;2012;04;04;Keskiviikko;2;2;4;2;1;3
89;25.04.2012;2012;04;05;Keskiviikko;3;14;17;1;0;1
89;25.04.2012;2012;04;06;Keskiviikko;11;57;68;5;10;15
89;25.04.2012;2012;04;07;Keskiviikko;40;143;183;2;25;27
89;25.04.2012;2012;04;08;Keskiviikko;49;141;190;14;34;48
89;25.04.2012;2012;04;09;Keskiviikko;30;66;96;7;19;26
89;25.04.2012;2012;04;10;Keskiviikko;32;56;88;9;22;31
89;25.04.2012;2012;04;11;Keskiviikko;66;64;130;15;28;43
89;25.04.2012;2012;04;12;Keskiviikko;73;84;157;28;34;62
89;25.04.2012;2012;04;13;Keskiviikko;110;80;190;26;28;54
89;25.04.2012;2012;04;14;Keskiviikko;129;104;233;39;24;63
89;25.04.2012;2012;04;15;Keskiviikko;146;127;273;40;30;70
89;25.04.2012;2012;04;16;Keskiviikko;153;131;284;43;29;72
89;25.04.2012;2012;04;17;Keskiviikko;94;84;178;51;30;81
89;25.04.2012;2012;04;18;Keskiviikko;90;79;169;53;45;98
89;25.04.2012;2012;04;19;Keskiviikko;84;61;145;52;47;99
89;25.04.2012;2012;04;20;Keskiviikko;91;43;134;32;33;65
89;25.04.2012;2012;04;21;Keskiviikko;55;35;90;34;15;49
89;25.04.2012;2012;04;22;Keskiviikko;23;14;37;16;3;19
89;25.04.2012;2012;04;23;Keskiviikko;18;22;40;4;8;12
89;26.04.2012;2012;04;00;Torstai;12;4;16;4;2;6
89;26.04.2012;2012;04;01;Torstai;12;3;15;2;1;3
89;26.04.2012;2012;04;02;Torstai;6;1;7;2;0;2
89;26.04.2012;2012;04;03;Torstai;16;0;16;1;0;1
89;26.04.2012;2012;04;04;Torstai;6;3;9;1;0;1
89;26.04.2012;2012;04;05;Torstai;6;13;19;4;0;4
89;26.04.2012;2012;04;06;Torstai;20;64;84;4;12;16
89;26.04.2012;2012;04;07;Torstai;56;168;224;16;41;57
89;26.04.2012;2012;04;08;Torstai;61;202;263;23;35;58
89;26.04.2012;2012;04;09;Torstai;48;132;180;15;61;76
89;26.04.2012;2012;04;10;Torstai;54;98;152;36;46;82
89;26.04.2012;2012;04;11;Torstai;70;99;169;33;40;73
89;26.04.2012;2012;04;12;Torstai;100;95;195;40;53;93
89;26.04.2012;2012;04;13;Torstai;120;100;220;39;34;73
89;26.04.2012;2012;04;14;Torstai;120;88;208;29;36;65
89;26.04.2012;2012;04;15;Torstai;181;94;275;42;25;67
89;26.04.2012;2012;04;16;Torstai;212;115;327;42;30;72
89;26.04.2012;2012;04;17;Torstai;124;89;213;47;29;76
89;26.04.2012;2012;04;18;Torstai;114;68;182;51;32;83
89;26.04.2012;2012;04;19;Torstai;79;53;132;36;32;68
89;26.04.2012;2012;04;20;Torstai;63;61;124;35;30;65
89;26.04.2012;2012;04;21;Torstai;38;18;56;11;12;23
89;26.04.2012;2012;04;22;Torstai;33;15;48;11;4;15
89;26.04.2012;2012;04;23;Torstai;14;18;32;3;7;10
89;27.04.2012;2012;04;00;Perjantai;9;6;15;2;1;3
89;27.04.2012;2012;04;01;Perjantai;14;0;14;1;1;2
89;27.04.2012;2012;04;02;Perjantai;5;2;7;1;0;1
89;27.04.2012;2012;04;03;Perjantai;8;3;11;5;2;7
89;27.04.2012;2012;04;04;Perjantai;3;4;7;1;0;1
89;27.04.2012;2012;04;05;Perjantai;3;7;10;3;0;3
89;27.04.2012;2012;04;06;Perjantai;12;41;53;2;6;8
89;27.04.2012;2012;04;07;Perjantai;22;88;110;3;34;37
89;27.04.2012;2012;04;08;Perjantai;29;116;145;11;29;40
89;27.04.2012;2012;04;09;Perjantai;31;83;114;8;26;34
89;27.04.2012;2012;04;10;Perjantai;41;62;103;25;24;49
89;27.04.2012;2012;04;11;Perjantai;50;61;111;17;39;56
89;27.04.2012;2012;04;12;Perjantai;43;85;128;18;21;39
89;27.04.2012;2012;04;13;Perjantai;66;81;147;25;31;56
89;27.04.2012;2012;04;14;Perjantai;113;85;198;31;26;57
89;27.04.2012;2012;04;15;Perjantai;115;64;179;26;13;39
89;27.04.2012;2012;04;16;Perjantai;110;46;156;20;11;31
89;27.04.2012;2012;04;17;Perjantai;51;56;107;17;20;37
89;27.04.2012;2012;04;18;Perjantai;67;51;118;22;31;53
89;27.04.2012;2012;04;19;Perjantai;62;36;98;23;13;36
89;27.04.2012;2012;04;20;Perjantai;44;32;76;16;17;33
89;27.04.2012;2012;04;21;Perjantai;29;27;56;9;10;19
89;27.04.2012;2012;04;22;Perjantai;16;33;49;5;8;13
89;27.04.2012;2012;04;23;Perjantai;25;27;52;8;11;19
89;28.04.2012;2012;04;00;Lauantai;10;8;18;4;4;8
89;28.04.2012;2012;04;01;Lauantai;15;10;25;1;3;4
89;28.04.2012;2012;04;02;Lauantai;25;2;27;10;0;10
89;28.04.2012;2012;04;03;Lauantai;12;1;13;8;0;8
89;28.04.2012;2012;04;04;Lauantai;12;3;15;7;1;8
89;28.04.2012;2012;04;05;Lauantai;6;2;8;4;1;5
89;28.04.2012;2012;04;06;Lauantai;5;12;17;1;5;6
89;28.04.2012;2012;04;07;Lauantai;6;18;24;5;11;16
89;28.04.2012;2012;04;08;Lauantai;16;31;47;19;16;35
89;28.04.2012;2012;04;09;Lauantai;25;76;101;24;41;65
89;28.04.2012;2012;04;10;Lauantai;38;100;138;41;59;100
89;28.04.2012;2012;04;11;Lauantai;70;126;196;45;72;117
89;28.04.2012;2012;04;12;Lauantai;121;147;268;45;69;114
89;28.04.2012;2012;04;13;Lauantai;111;112;223;48;43;91
89;28.04.2012;2012;04;14;Lauantai;114;101;215;51;53;104
89;28.04.2012;2012;04;15;Lauantai;123;104;227;51;43;94
89;28.04.2012;2012;04;16;Lauantai;117;85;202;76;49;125
89;28.04.2012;2012;04;17;Lauantai;95;98;193;45;55;100
89;28.04.2012;2012;04;18;Lauantai;94;58;152;51;43;94
89;28.04.2012;2012;04;19;Lauantai;53;60;113;27;35;62
89;28.04.2012;2012;04;20;Lauantai;43;53;96;21;25;46
89;28.04.2012;2012;04;21;Lauantai;34;55;89;11;11;22
89;28.04.2012;2012;04;22;Lauantai;32;28;60;15;9;24
89;28.04.2012;2012;04;23;Lauantai;34;37;71;5;13;18
89;29.04.2012;2012;04;00;Sunnuntai;19;13;32;8;5;13
89;29.04.2012;2012;04;01;Sunnuntai;25;10;35;10;3;13
89;29.04.2012;2012;04;02;Sunnuntai;29;4;33;3;0;3
89;29.04.2012;2012;04;03;Sunnuntai;24;2;26;6;0;6
89;29.04.2012;2012;04;04;Sunnuntai;21;2;23;7;1;8
89;29.04.2012;2012;04;05;Sunnuntai;7;3;10;2;1;3
89;29.04.2012;2012;04;06;Sunnuntai;6;4;10;4;1;5
89;29.04.2012;2012;04;07;Sunnuntai;8;18;26;8;4;12
89;29.04.2012;2012;04;08;Sunnuntai;12;13;25;13;16;29
89;29.04.2012;2012;04;09;Sunnuntai;30;29;59;33;35;68
89;29.04.2012;2012;04;10;Sunnuntai;44;60;104;48;59;107
89;29.04.2012;2012;04;11;Sunnuntai;51;94;145;62;57;119
89;29.04.2012;2012;04;12;Sunnuntai;90;123;213;69;85;154
89;29.04.2012;2012;04;13;Sunnuntai;108;139;247;68;83;151
89;29.04.2012;2012;04;14;Sunnuntai;120;125;245;55;67;122
89;29.04.2012;2012;04;15;Sunnuntai;112;92;204;80;56;136
89;29.04.2012;2012;04;16;Sunnuntai;107;94;201;49;32;81
89;29.04.2012;2012;04;17;Sunnuntai;96;74;170;74;41;115
89;29.04.2012;2012;04;18;Sunnuntai;98;84;182;51;40;91
89;29.04.2012;2012;04;19;Sunnuntai;58;61;119;31;42;73
89;29.04.2012;2012;04;20;Sunnuntai;63;45;108;20;30;50
89;29.04.2012;2012;04;21;Sunnuntai;40;32;72;15;14;29
89;29.04.2012;2012;04;22;Sunnuntai;26;14;40;3;14;17
89;29.04.2012;2012;04;23;Sunnuntai;27;20;47;9;2;11
89;30.04.2012;2012;04;00;Maanantai;22;11;33;5;1;6
89;30.04.2012;2012;04;01;Maanantai;16;1;17;1;2;3
89;30.04.2012;2012;04;02;Maanantai;11;5;16;4;1;5
89;30.04.2012;2012;04;03;Maanantai;13;3;16;6;2;8
89;30.04.2012;2012;04;04;Maanantai;7;1;8;2;0;2
89;30.04.2012;2012;04;05;Maanantai;7;15;22;2;0;2
89;30.04.2012;2012;04;06;Maanantai;17;60;77;5;7;12
89;30.04.2012;2012;04;07;Maanantai;23;90;113;9;23;32
89;30.04.2012;2012;04;08;Maanantai;58;120;178;14;20;34
89;30.04.2012;2012;04;09;Maanantai;36;108;144;19;33;52
89;30.04.2012;2012;04;10;Maanantai;61;108;169;24;39;63
89;30.04.2012;2012;04;11;Maanantai;101;166;267;34;69;103
89;30.04.2012;2012;04;12;Maanantai;100;190;290;30;47;77
89;30.04.2012;2012;04;13;Maanantai;142;305;447;28;57;85
89;30.04.2012;2012;04;14;Maanantai;185;324;509;41;53;94
89;30.04.2012;2012;04;15;Maanantai;240;213;453;49;38;87
89;30.04.2012;2012;04;16;Maanantai;228;134;362;39;33;72
89;30.04.2012;2012;04;17;Maanantai;124;132;256;37;49;86
89;30.04.2012;2012;04;18;Maanantai;125;134;259;43;52;95
89;30.04.2012;2012;04;19;Maanantai;87;94;181;33;37;70
89;30.04.2012;2012;04;20;Maanantai;83;102;185;36;29;65
89;30.04.2012;2012;04;21;Maanantai;51;67;118;16;42;58
89;30.04.2012;2012;04;22;Maanantai;46;82;128;29;41;70
89;30.04.2012;2012;04;23;Maanantai;49;51;100;20;16;36
89;01.05.2012;2012;05;00;Tiistai;73;31;104;34;29;63
89;01.05.2012;2012;05;01;Tiistai;67;10;77;22;6;28
89;01.05.2012;2012;05;02;Tiistai;48;5;53;22;0;22
89;01.05.2012;2012;05;03;Tiistai;48;10;58;32;1;33
89;01.05.2012;2012;05;04;Tiistai;28;6;34;28;2;30
89;01.05.2012;2012;05;05;Tiistai;77;5;82;13;3;16
89;01.05.2012;2012;05;06;Tiistai;21;11;32;7;4;11
89;01.05.2012;2012;05;07;Tiistai;7;10;17;6;4;10
89;01.05.2012;2012;05;08;Tiistai;14;15;29;3;18;21
89;01.05.2012;2012;05;09;Tiistai;23;44;67;20;23;43
89;01.05.2012;2012;05;10;Tiistai;50;88;138;34;47;81
89;01.05.2012;2012;05;11;Tiistai;57;234;291;37;101;138
89;01.05.2012;2012;05;12;Tiistai;113;180;293;54;68;122
89;01.05.2012;2012;05;13;Tiistai;181;162;343;75;92;167
89;01.05.2012;2012;05;14;Tiistai;193;165;358;79;43;122
89;01.05.2012;2012;05;15;Tiistai;163;96;259;71;58;129
89;01.05.2012;2012;05;16;Tiistai;150;78;228;52;41;93
89;01.05.2012;2012;05;17;Tiistai;121;63;184;64;40;104
89;01.05.2012;2012;05;18;Tiistai;90;34;124;36;41;77
89;01.05.2012;2012;05;19;Tiistai;52;52;104;40;29;69
89;01.05.2012;2012;05;20;Tiistai;56;18;74;28;12;40
89;01.05.2012;2012;05;21;Tiistai;26;13;39;11;18;29
89;01.05.2012;2012;05;22;Tiistai;9;8;17;2;3;5
89;01.05.2012;2012;05;23;Tiistai;10;4;14;1;1;2
89;02.05.2012;2012;05;00;Keskiviikko;3;2;5;0;1;1
89;02.05.2012;2012;05;01;Keskiviikko;0;2;2;3;0;3
89;02.05.2012;2012;05;02;Keskiviikko;2;2;4;0;0;0
89;02.05.2012;2012;05;03;Keskiviikko;2;1;3;1;0;1
89;02.05.2012;2012;05;04;Keskiviikko;0;3;3;0;0;0
89;02.05.2012;2012;05;05;Keskiviikko;6;11;17;0;2;2
89;02.05.2012;2012;05;06;Keskiviikko;15;66;81;6;9;15
89;02.05.2012;2012;05;07;Keskiviikko;43;182;225;9;29;38
89;02.05.2012;2012;05;08;Keskiviikko;59;199;258;6;25;31
89;02.05.2012;2012;05;09;Keskiviikko;50;108;158;10;36;46
89;02.05.2012;2012;05;10;Keskiviikko;45;79;124;20;33;53
89;02.05.2012;2012;05;11;Keskiviikko;65;71;136;28;23;51
89;02.05.2012;2012;05;12;Keskiviikko;69;104;173;22;29;51
89;02.05.2012;2012;05;13;Keskiviikko;83;84;167;28;33;61
89;02.05.2012;2012;05;14;Keskiviikko;143;104;247;40;36;76
89;02.05.2012;2012;05;15;Keskiviikko;198;96;294;38;33;71
89;02.05.2012;2012;05;16;Keskiviikko;245;103;348;38;27;65
89;02.05.2012;2012;05;17;Keskiviikko;96;77;173;57;36;93
89;02.05.2012;2012;05;18;Keskiviikko;92;68;160;42;37;79
89;02.05.2012;2012;05;19;Keskiviikko;91;51;142;32;37;69
89;02.05.2012;2012;05;20;Keskiviikko;99;38;137;35;25;60
89;02.05.2012;2012;05;21;Keskiviikko;48;16;64;13;13;26
89;02.05.2012;2012;05;22;Keskiviikko;13;7;20;6;2;8
89;02.05.2012;2012;05;23;Keskiviikko;8;5;13;5;2;7
89;03.05.2012;2012;05;00;Torstai;3;3;6;2;3;5
89;03.05.2012;2012;05;01;Torstai;0;0;0;1;0;1
89;03.05.2012;2012;05;02;Torstai;3;2;5;0;1;1
89;03.05.2012;2012;05;03;Torstai;2;3;5;1;1;2
89;03.05.2012;2012;05;04;Torstai;1;4;5;2;1;3
89;03.05.2012;2012;05;05;Torstai;5;13;18;2;0;2
89;03.05.2012;2012;05;06;Torstai;18;77;95;5;5;10
89;03.05.2012;2012;05;07;Torstai;49;197;246;8;36;44
89;03.05.2012;2012;05;08;Torstai;59;178;237;8;26;34
89;03.05.2012;2012;05;09;Torstai;40;106;146;15;29;44
89;03.05.2012;2012;05;10;Torstai;54;97;151;17;35;52
89;03.05.2012;2012;05;11;Torstai;58;91;149;29;32;61
89;03.05.2012;2012;05;12;Torstai;78;78;156;30;31;61
89;03.05.2012;2012;05;13;Torstai;107;86;193;28;25;53
89;03.05.2012;2012;05;14;Torstai;133;93;226;28;35;63
89;03.05.2012;2012;05;15;Torstai;228;96;324;43;27;70
89;03.05.2012;2012;05;16;Torstai;224;97;321;40;26;66
89;03.05.2012;2012;05;17;Torstai;107;97;204;45;37;82
89;03.05.2012;2012;05;18;Torstai;132;81;213;45;40;85
89;03.05.2012;2012;05;19;Torstai;85;62;147;39;31;70
89;03.05.2012;2012;05;20;Torstai;89;36;125;40;28;68
89;03.05.2012;2012;05;21;Torstai;68;21;89;19;14;33
89;03.05.2012;2012;05;22;Torstai;22;14;36;4;11;15
89;03.05.2012;2012;05;23;Torstai;15;5;20;4;3;7
89;04.05.2012;2012;05;00;Perjantai;3;2;5;0;0;0
89;04.05.2012;2012;05;01;Perjantai;4;1;5;0;1;1
89;04.05.2012;2012;05;02;Perjantai;0;2;2;1;0;1
89;04.05.2012;2012;05;03;Perjantai;0;2;2;0;0;0
89;04.05.2012;2012;05;04;Perjantai;2;3;5;1;0;1
89;04.05.2012;2012;05;05;Perjantai;7;16;23;0;1;1
89;04.05.2012;2012;05;06;Perjantai;20;79;99;7;13;20
89;04.05.2012;2012;05;07;Perjantai;64;184;248;7;33;40
89;04.05.2012;2012;05;08;Perjantai;55;208;263;16;61;77
89;04.05.2012;2012;05;09;Perjantai;40;135;175;19;36;55
89;04.05.2012;2012;05;10;Perjantai;57;93;150;31;42;73
89;04.05.2012;2012;05;11;Perjantai;68;98;166;71;46;117
89;04.05.2012;2012;05;12;Perjantai;74;86;160;32;32;64
89;04.05.2012;2012;05;13;Perjantai;129;91;220;23;33;56
89;04.05.2012;2012;05;14;Perjantai;172;112;284;30;25;55
89;04.05.2012;2012;05;15;Perjantai;187;82;269;41;26;67
89;04.05.2012;2012;05;16;Perjantai;187;99;286;25;28;53
89;04.05.2012;2012;05;17;Perjantai;106;83;189;31;22;53
89;04.05.2012;2012;05;18;Perjantai;101;69;170;36;32;68
89;04.05.2012;2012;05;19;Perjantai;58;61;119;23;23;46
89;04.05.2012;2012;05;20;Perjantai;73;31;104;16;17;33
89;04.05.2012;2012;05;21;Perjantai;44;30;74;12;8;20
89;04.05.2012;2012;05;22;Perjantai;35;17;52;9;6;15
89;04.05.2012;2012;05;23;Perjantai;19;17;36;2;7;9
89;05.05.2012;2012;05;00;Lauantai;13;18;31;5;12;17
89;05.05.2012;2012;05;01;Lauantai;15;12;27;7;2;9
89;05.05.2012;2012;05;02;Lauantai;18;5;23;5;0;5
89;05.05.2012;2012;05;03;Lauantai;9;0;9;4;0;4
89;05.05.2012;2012;05;04;Lauantai;13;1;14;6;1;7
89;05.05.2012;2012;05;05;Lauantai;5;7;12;0;2;2
89;05.05.2012;2012;05;06;Lauantai;5;10;15;5;5;10
89;05.05.2012;2012;05;07;Lauantai;5;10;15;2;9;11
89;05.05.2012;2012;05;08;Lauantai;12;29;41;10;7;17
89;05.05.2012;2012;05;09;Lauantai;16;70;86;13;30;43
89;05.05.2012;2012;05;10;Lauantai;29;60;89;11;29;40
89;05.05.2012;2012;05;11;Lauantai;32;74;106;18;26;44
89;05.05.2012;2012;05;12;Lauantai;40;74;114;17;38;55
89;05.05.2012;2012;05;13;Lauantai;84;72;156;30;25;55
89;05.05.2012;2012;05;14;Lauantai;70;46;116;16;26;42
89;05.05.2012;2012;05;15;Lauantai;65;29;94;18;20;38
89;05.05.2012;2012;05;16;Lauantai;55;30;85;17;12;29
89;05.05.2012;2012;05;17;Lauantai;40;22;62;13;11;24
89;05.05.2012;2012;05;18;Lauantai;45;19;64;8;16;24
89;05.05.2012;2012;05;19;Lauantai;27;28;55;22;13;35
89;05.05.2012;2012;05;20;Lauantai;19;13;32;4;10;14
89;05.05.2012;2012;05;21;Lauantai;22;19;41;5;5;10
89;05.05.2012;2012;05;22;Lauantai;10;19;29;6;8;14
89;05.05.2012;2012;05;23;Lauantai;10;12;22;2;3;5
89;06.05.2012;2012;05;00;Sunnuntai;9;8;17;1;5;6
89;06.05.2012;2012;05;01;Sunnuntai;3;9;12;2;1;3
89;06.05.2012;2012;05;02;Sunnuntai;10;7;17;1;1;2
89;06.05.2012;2012;05;03;Sunnuntai;6;1;7;2;2;4
89;06.05.2012;2012;05;04;Sunnuntai;6;0;6;9;0;9
89;06.05.2012;2012;05;05;Sunnuntai;2;1;3;1;0;1
89;06.05.2012;2012;05;06;Sunnuntai;4;6;10;1;0;1
89;06.05.2012;2012;05;07;Sunnuntai;2;4;6;2;4;6
89;06.05.2012;2012;05;08;Sunnuntai;4;12;16;9;7;16
89;06.05.2012;2012;05;09;Sunnuntai;11;8;19;13;20;33
89;06.05.2012;2012;05;10;Sunnuntai;11;29;40;12;19;31
89;06.05.2012;2012;05;11;Sunnuntai;29;54;83;30;47;77
89;06.05.2012;2012;05;12;Sunnuntai;39;81;120;42;47;89
89;06.05.2012;2012;05;13;Sunnuntai;43;94;137;52;58;110
89;06.05.2012;2012;05;14;Sunnuntai;71;91;162;39;56;95
89;06.05.2012;2012;05;15;Sunnuntai;95;65;160;45;39;84
89;06.05.2012;2012;05;16;Sunnuntai;67;69;136;31;30;61
89;06.05.2012;2012;05;17;Sunnuntai;64;55;119;34;34;68
89;06.05.2012;2012;05;18;Sunnuntai;75;57;132;42;42;84
89;06.05.2012;2012;05;19;Sunnuntai;55;51;106;39;37;76
89;06.05.2012;2012;05;20;Sunnuntai;54;42;96;26;25;51
89;06.05.2012;2012;05;21;Sunnuntai;38;29;67;12;19;31
89;06.05.2012;2012;05;22;Sunnuntai;14;12;26;8;6;14
89;06.05.2012;2012;05;23;Sunnuntai;9;10;19;5;1;6
89;07.05.2012;2012;05;00;Maanantai;2;3;5;0;3;3
89;07.05.2012;2012;05;01;Maanantai;1;1;2;1;0;1
89;07.05.2012;2012;05;02;Maanantai;1;1;2;0;0;0
89;07.05.2012;2012;05;03;Maanantai;1;4;5;1;0;1
89;07.05.2012;2012;05;04;Maanantai;2;6;8;1;3;4
89;07.05.2012;2012;05;05;Maanantai;9;13;22;1;0;1
89;07.05.2012;2012;05;06;Maanantai;20;96;116;2;8;10
89;07.05.2012;2012;05;07;Maanantai;60;208;268;4;40;44
89;07.05.2012;2012;05;08;Maanantai;69;281;350;16;32;48
89;07.05.2012;2012;05;09;Maanantai;50;142;192;26;58;84
89;07.05.2012;2012;05;10;Maanantai;50;114;164;18;37;55
89;07.05.2012;2012;05;11;Maanantai;82;89;171;22;43;65
89;07.05.2012;2012;05;12;Maanantai;90;125;215;25;34;59
89;07.05.2012;2012;05;13;Maanantai;125;102;227;25;55;80
89;07.05.2012;2012;05;14;Maanantai;175;102;277;50;40;90
89;07.05.2012;2012;05;15;Maanantai;218;116;334;67;39;106
89;07.05.2012;2012;05;16;Maanantai;269;144;413;40;33;73
89;07.05.2012;2012;05;17;Maanantai;170;97;267;29;38;67
89;07.05.2012;2012;05;18;Maanantai;140;84;224;65;50;115
89;07.05.2012;2012;05;19;Maanantai;105;60;165;44;49;93
89;07.05.2012;2012;05;20;Maanantai;81;54;135;36;32;68
89;07.05.2012;2012;05;21;Maanantai;60;16;76;17;11;28
89;07.05.2012;2012;05;22;Maanantai;28;12;40;5;9;14
89;07.05.2012;2012;05;23;Maanantai;6;5;11;2;1;3
89;08.05.2012;2012;05;00;Tiistai;4;5;9;1;0;1
89;08.05.2012;2012;05;01;Tiistai;7;2;9;1;0;1
89;08.05.2012;2012;05;02;Tiistai;1;3;4;1;2;3
89;08.05.2012;2012;05;03;Tiistai;0;4;4;0;0;0
89;08.05.2012;2012;05;04;Tiistai;3;6;9;0;1;1
89;08.05.2012;2012;05;05;Tiistai;5;18;23;3;5;8
89;08.05.2012;2012;05;06;Tiistai;22;99;121;2;5;7
89;08.05.2012;2012;05;07;Tiistai;63;251;314;7;44;51
89;08.05.2012;2012;05;08;Tiistai;86;258;344;23;40;63
89;08.05.2012;2012;05;09;Tiistai;49;117;166;17;44;61
89;08.05.2012;2012;05;10;Tiistai;51;87;138;17;32;49
89;08.05.2012;2012;05;11;Tiistai;69;118;187;30;37;67
89;08.05.2012;2012;05;12;Tiistai;92;108;200;32;41;73
89;08.05.2012;2012;05;13;Tiistai;108;92;200;28;47;75
89;08.05.2012;2012;05;14;Tiistai;153;115;268;31;28;59
89;08.05.2012;2012;05;15;Tiistai;232;113;345;34;30;64
89;08.05.2012;2012;05;16;Tiistai;300;147;447;36;37;73
89;08.05.2012;2012;05;17;Tiistai;175;139;314;35;53;88
89;08.05.2012;2012;05;18;Tiistai;130;89;219;52;46;98
89;08.05.2012;2012;05;19;Tiistai;143;96;239;44;45;89
89;08.05.2012;2012;05;20;Tiistai;111;44;155;36;23;59
89;08.05.2012;2012;05;21;Tiistai;54;14;68;8;6;14
89;08.05.2012;2012;05;22;Tiistai;30;11;41;14;7;21
89;08.05.2012;2012;05;23;Tiistai;12;17;29;6;4;10
89;09.05.2012;2012;05;00;Keskiviikko;8;9;17;2;1;3
89;09.05.2012;2012;05;01;Keskiviikko;5;0;5;1;0;1
89;09.05.2012;2012;05;02;Keskiviikko;2;2;4;1;2;3
89;09.05.2012;2012;05;03;Keskiviikko;1;2;3;1;0;1
89;09.05.2012;2012;05;04;Keskiviikko;2;3;5;1;3;4
89;09.05.2012;2012;05;05;Keskiviikko;6;19;25;1;3;4
89;09.05.2012;2012;05;06;Keskiviikko;21;105;126;4;12;16
89;09.05.2012;2012;05;07;Keskiviikko;47;239;286;5;30;35
89;09.05.2012;2012;05;08;Keskiviikko;78;257;335;12;38;50
89;09.05.2012;2012;05;09;Keskiviikko;58;165;223;16;36;52
89;09.05.2012;2012;05;10;Keskiviikko;69;118;187;26;33;59
89;09.05.2012;2012;05;11;Keskiviikko;94;112;206;24;36;60
89;09.05.2012;2012;05;12;Keskiviikko;137;138;275;25;43;68
89;09.05.2012;2012;05;13;Keskiviikko;134;129;263;28;41;69
89;09.05.2012;2012;05;14;Keskiviikko;191;114;305;26;44;70
89;09.05.2012;2012;05;15;Keskiviikko;277;163;440;71;48;119
89;09.05.2012;2012;05;16;Keskiviikko;258;145;403;29;40;69
89;09.05.2012;2012;05;17;Keskiviikko;162;119;281;44;26;70
89;09.05.2012;2012;05;18;Keskiviikko;134;97;231;43;53;96
89;09.05.2012;2012;05;19;Keskiviikko;127;76;203;36;42;78
89;09.05.2012;2012;05;20;Keskiviikko;103;53;156;27;27;54
89;09.05.2012;2012;05;21;Keskiviikko;58;32;90;12;6;18
89;09.05.2012;2012;05;22;Keskiviikko;29;10;39;5;3;8
89;09.05.2012;2012;05;23;Keskiviikko;15;2;17;2;1;3
89;10.05.2012;2012;05;00;Torstai;7;4;11;0;2;2
89;10.05.2012;2012;05;01;Torstai;4;0;4;2;0;2
89;10.05.2012;2012;05;02;Torstai;1;0;1;0;0;0
89;10.05.2012;2012;05;03;Torstai;0;1;1;3;0;3
89;10.05.2012;2012;05;04;Torstai;3;6;9;0;1;1
89;10.05.2012;2012;05;05;Torstai;7;11;18;1;2;3
89;10.05.2012;2012;05;06;Torstai;13;83;96;3;4;7
89;10.05.2012;2012;05;07;Torstai;45;179;224;4;27;31
89;10.05.2012;2012;05;08;Torstai;45;205;250;8;20;28
89;10.05.2012;2012;05;09;Torstai;19;76;95;5;21;26
89;10.05.2012;2012;05;10;Torstai;37;45;82;7;10;17
89;10.05.2012;2012;05;11;Torstai;31;40;71;8;12;20
89;10.05.2012;2012;05;12;Torstai;48;63;111;10;18;28
89;10.05.2012;2012;05;13;Torstai;80;89;169;13;19;32
89;10.05.2012;2012;05;14;Torstai;128;91;219;43;27;70
89;10.05.2012;2012;05;15;Torstai;167;125;292;26;31;57
89;10.05.2012;2012;05;16;Torstai;225;97;322;31;29;60
89;10.05.2012;2012;05;17;Torstai;134;90;224;39;37;76
89;10.05.2012;2012;05;18;Torstai;129;95;224;44;21;65
89;10.05.2012;2012;05;19;Torstai;86;41;127;41;23;64
89;10.05.2012;2012;05;20;Torstai;77;44;121;22;12;34
89;10.05.2012;2012;05;21;Torstai;47;27;74;17;9;26
89;10.05.2012;2012;05;22;Torstai;29;24;53;4;4;8
89;10.05.2012;2012;05;23;Torstai;9;8;17;2;5;7
89;11.05.2012;2012;05;00;Perjantai;8;5;13;2;2;4
89;11.05.2012;2012;05;01;Perjantai;5;1;6;1;2;3
89;11.05.2012;2012;05;02;Perjantai;4;2;6;5;1;6
89;11.05.2012;2012;05;03;Perjantai;4;2;6;3;0;3
89;11.05.2012;2012;05;04;Perjantai;4;3;7;2;1;3
89;11.05.2012;2012;05;05;Perjantai;7;9;16;0;0;0
89;11.05.2012;2012;05;06;Perjantai;16;61;77;2;6;8
89;11.05.2012;2012;05;07;Perjantai;36;141;177;6;24;30
89;11.05.2012;2012;05;08;Perjantai;29;117;146;5;21;26
89;11.05.2012;2012;05;09;Perjantai;22;67;89;10;15;25
89;11.05.2012;2012;05;10;Perjantai;29;50;79;6;16;22
89;11.05.2012;2012;05;11;Perjantai;34;43;77;12;17;29
89;11.05.2012;2012;05;12;Perjantai;28;46;74;12;20;32
89;11.05.2012;2012;05;13;Perjantai;67;54;121;19;24;43
89;11.05.2012;2012;05;14;Perjantai;106;98;204;24;22;46
89;11.05.2012;2012;05;15;Perjantai;130;45;175;31;22;53
89;11.05.2012;2012;05;16;Perjantai;117;62;179;24;22;46
89;11.05.2012;2012;05;17;Perjantai;84;71;155;32;23;55
89;11.05.2012;2012;05;18;Perjantai;73;55;128;13;29;42
89;11.05.2012;2012;05;19;Perjantai;58;69;127;23;26;49
89;11.05.2012;2012;05;20;Perjantai;49;60;109;8;18;26
89;11.05.2012;2012;05;21;Perjantai;41;19;60;12;8;20
89;11.05.2012;2012;05;22;Perjantai;30;10;40;11;3;14
89;11.05.2012;2012;05;23;Perjantai;14;26;40;3;14;17
89;12.05.2012;2012;05;00;Lauantai;12;22;34;6;8;14
89;12.05.2012;2012;05;01;Lauantai;21;7;28;4;2;6
89;12.05.2012;2012;05;02;Lauantai;25;6;31;10;2;12
89;12.05.2012;2012;05;03;Lauantai;18;0;18;10;0;10
89;12.05.2012;2012;05;04;Lauantai;18;3;21;7;0;7
89;12.05.2012;2012;05;05;Lauantai;4;2;6;0;0;0
89;12.05.2012;2012;05;06;Lauantai;5;6;11;1;2;3
89;12.05.2012;2012;05;07;Lauantai;6;17;23;2;2;4
89;12.05.2012;2012;05;08;Lauantai;9;18;27;2;11;13
89;12.05.2012;2012;05;09;Lauantai;6;20;26;8;8;16
89;12.05.2012;2012;05;10;Lauantai;9;37;46;9;12;21
89;12.05.2012;2012;05;11;Lauantai;13;27;40;9;15;24
89;12.05.2012;2012;05;12;Lauantai;60;63;123;14;22;36
89;12.05.2012;2012;05;13;Lauantai;39;112;151;20;31;51
89;12.05.2012;2012;05;14;Lauantai;68;71;139;26;36;62
89;12.05.2012;2012;05;15;Lauantai;65;56;121;29;32;61
89;12.05.2012;2012;05;16;Lauantai;92;69;161;40;34;74
89;12.05.2012;2012;05;17;Lauantai;67;50;117;36;39;75
89;12.05.2012;2012;05;18;Lauantai;62;61;123;37;25;62
89;12.05.2012;2012;05;19;Lauantai;50;41;91;21;24;45
89;12.05.2012;2012;05;20;Lauantai;46;42;88;21;15;36
89;12.05.2012;2012;05;21;Lauantai;28;38;66;8;22;30
89;12.05.2012;2012;05;22;Lauantai;22;24;46;23;25;48
89;12.05.2012;2012;05;23;Lauantai;10;15;25;6;7;13
89;13.05.2012;2012;05;00;Sunnuntai;16;9;25;5;12;17
89;13.05.2012;2012;05;01;Sunnuntai;15;8;23;4;3;7
89;13.05.2012;2012;05;02;Sunnuntai;23;2;25;7;2;9
89;13.05.2012;2012;05;03;Sunnuntai;14;0;14;22;0;22
89;13.05.2012;2012;05;04;Sunnuntai;17;0;17;3;0;3
89;13.05.2012;2012;05;05;Sunnuntai;6;2;8;2;2;4
89;13.05.2012;2012;05;06;Sunnuntai;7;9;16;3;5;8
89;13.05.2012;2012;05;07;Sunnuntai;7;15;22;5;6;11
89;13.05.2012;2012;05;08;Sunnuntai;11;22;33;8;17;25
89;13.05.2012;2012;05;09;Sunnuntai;27;49;76;30;25;55
89;13.05.2012;2012;05;10;Sunnuntai;30;47;77;33;52;85
89;13.05.2012;2012;05;11;Sunnuntai;58;77;135;34;55;89
89;13.05.2012;2012;05;12;Sunnuntai;109;97;206;46;52;98
89;13.05.2012;2012;05;13;Sunnuntai;82;95;177;51;46;97
89;13.05.2012;2012;05;14;Sunnuntai;86;107;193;27;50;77
89;13.05.2012;2012;05;15;Sunnuntai;107;86;193;34;39;73
89;13.05.2012;2012;05;16;Sunnuntai;80;66;146;38;39;77
89;13.05.2012;2012;05;17;Sunnuntai;67;51;118;28;31;59
89;13.05.2012;2012;05;18;Sunnuntai;64;67;131;29;38;67
89;13.05.2012;2012;05;19;Sunnuntai;63;62;125;50;54;104
89;13.05.2012;2012;05;20;Sunnuntai;61;45;106;34;25;59
89;13.05.2012;2012;05;21;Sunnuntai;33;27;60;18;16;34
89;13.05.2012;2012;05;22;Sunnuntai;25;10;35;6;10;16
89;13.05.2012;2012;05;23;Sunnuntai;14;5;19;1;0;1
89;14.05.2012;2012;05;00;Maanantai;3;0;3;1;0;1
89;14.05.2012;2012;05;01;Maanantai;1;0;1;1;1;2
89;14.05.2012;2012;05;02;Maanantai;1;2;3;0;1;1
89;14.05.2012;2012;05;03;Maanantai;1;2;3;0;0;0
89;14.05.2012;2012;05;04;Maanantai;3;8;11;0;2;2
89;14.05.2012;2012;05;05;Maanantai;8;10;18;3;1;4
89;14.05.2012;2012;05;06;Maanantai;23;84;107;5;10;15
89;14.05.2012;2012;05;07;Maanantai;55;228;283;11;24;35
89;14.05.2012;2012;05;08;Maanantai;68;263;331;21;30;51
89;14.05.2012;2012;05;09;Maanantai;56;122;178;11;32;43
89;14.05.2012;2012;05;10;Maanantai;47;91;138;8;25;33
89;14.05.2012;2012;05;11;Maanantai;62;62;124;16;23;39
89;14.05.2012;2012;05;12;Maanantai;91;74;165;31;18;49
89;14.05.2012;2012;05;13;Maanantai;83;81;164;20;15;35
89;14.05.2012;2012;05;14;Maanantai;123;90;213;24;8;32
89;14.05.2012;2012;05;15;Maanantai;185;91;276;37;21;58
89;14.05.2012;2012;05;16;Maanantai;236;92;328;17;14;31
89;14.05.2012;2012;05;17;Maanantai;148;63;211;24;24;48
89;14.05.2012;2012;05;18;Maanantai;105;61;166;30;37;67
89;14.05.2012;2012;05;19;Maanantai;85;45;130;19;31;50
89;14.05.2012;2012;05;20;Maanantai;67;27;94;17;15;32
89;14.05.2012;2012;05;21;Maanantai;29;16;45;10;7;17
89;14.05.2012;2012;05;22;Maanantai;16;6;22;6;5;11
89;14.05.2012;2012;05;23;Maanantai;11;7;18;1;2;3
89;15.05.2012;2012;05;00;Tiistai;4;2;6;1;0;1
89;15.05.2012;2012;05;01;Tiistai;4;1;5;1;1;2
89;15.05.2012;2012;05;02;Tiistai;1;3;4;1;0;1
89;15.05.2012;2012;05;03;Tiistai;2;1;3;0;1;1
89;15.05.2012;2012;05;04;Tiistai;1;6;7;2;3;5
89;15.05.2012;2012;05;05;Tiistai;9;17;26;0;2;2
89;15.05.2012;2012;05;06;Tiistai;23;91;114;1;8;9
89;15.05.2012;2012;05;07;Tiistai;56;237;293;7;28;35
89;15.05.2012;2012;05;08;Tiistai;61;251;312;17;28;45
89;15.05.2012;2012;05;09;Tiistai;43;125;168;20;30;50
89;15.05.2012;2012;05;10;Tiistai;63;87;150;15;30;45
89;15.05.2012;2012;05;11;Tiistai;73;118;191;20;38;58
89;15.05.2012;2012;05;12;Tiistai;79;97;176;18;33;51
89;15.05.2012;2012;05;13;Tiistai;95;103;198;24;31;55
89;15.05.2012;2012;05;14;Tiistai;136;114;250;32;40;72
89;15.05.2012;2012;05;15;Tiistai;242;141;383;28;33;61
89;15.05.2012;2012;05;16;Tiistai;298;117;415;35;26;61
89;15.05.2012;2012;05;17;Tiistai;181;129;310;38;38;76
89;15.05.2012;2012;05;18;Tiistai;123;93;216;55;38;93
89;15.05.2012;2012;05;19;Tiistai;134;68;202;48;41;89
89;15.05.2012;2012;05;20;Tiistai;89;57;146;31;18;49
89;15.05.2012;2012;05;21;Tiistai;52;24;76;10;10;20
89;15.05.2012;2012;05;22;Tiistai;18;6;24;6;2;8
89;15.05.2012;2012;05;23;Tiistai;17;8;25;4;8;12
89;16.05.2012;2012;05;00;Keskiviikko;3;2;5;1;1;2
89;16.05.2012;2012;05;01;Keskiviikko;4;1;5;0;1;1
89;16.05.2012;2012;05;02;Keskiviikko;3;2;5;0;0;0
89;16.05.2012;2012;05;03;Keskiviikko;0;1;1;1;0;1
89;16.05.2012;2012;05;04;Keskiviikko;1;4;5;1;2;3
89;16.05.2012;2012;05;05;Keskiviikko;4;12;16;4;1;5
89;16.05.2012;2012;05;06;Keskiviikko;25;88;113;4;5;9
89;16.05.2012;2012;05;07;Keskiviikko;70;239;309;8;28;36
89;16.05.2012;2012;05;08;Keskiviikko;58;263;321;10;35;45
89;16.05.2012;2012;05;09;Keskiviikko;59;163;222;8;28;36
89;16.05.2012;2012;05;10;Keskiviikko;72;102;174;12;30;42
89;16.05.2012;2012;05;11;Keskiviikko;53;103;156;25;29;54
89;16.05.2012;2012;05;12;Keskiviikko;118;122;240;17;28;45
89;16.05.2012;2012;05;13;Keskiviikko;116;127;243;27;32;59
89;16.05.2012;2012;05;14;Keskiviikko;184;135;319;33;35;68
89;16.05.2012;2012;05;15;Keskiviikko;252;136;388;42;26;68
89;16.05.2012;2012;05;16;Keskiviikko;251;136;387;31;39;70
89;16.05.2012;2012;05;17;Keskiviikko;143;121;264;24;35;59
89;16.05.2012;2012;05;18;Keskiviikko;140;155;295;25;44;69
89;16.05.2012;2012;05;19;Keskiviikko;133;122;255;41;31;72
89;16.05.2012;2012;05;20;Keskiviikko;141;93;234;26;31;57
89;16.05.2012;2012;05;21;Keskiviikko;96;83;179;28;14;42
89;16.05.2012;2012;05;22;Keskiviikko;49;55;104;10;11;21
89;16.05.2012;2012;05;23;Keskiviikko;58;39;97;10;9;19
89;17.05.2012;2012;05;00;Torstai;31;27;58;1;6;7
89;17.05.2012;2012;05;01;Torstai;37;11;48;7;7;14
89;17.05.2012;2012;05;02;Torstai;25;7;32;7;1;8
89;17.05.2012;2012;05;03;Torstai;23;4;27;14;2;16
89;17.05.2012;2012;05;04;Torstai;22;5;27;9;0;9
89;17.05.2012;2012;05;05;Torstai;8;1;9;7;5;12
89;17.05.2012;2012;05;06;Torstai;8;11;19;3;2;5
89;17.05.2012;2012;05;07;Torstai;10;5;15;4;6;10
89;17.05.2012;2012;05;08;Torstai;3;9;12;7;7;14
89;17.05.2012;2012;05;09;Torstai;6;15;21;7;12;19
89;17.05.2012;2012;05;10;Torstai;8;23;31;14;12;26
89;17.05.2012;2012;05;11;Torstai;38;56;94;28;49;77
89;17.05.2012;2012;05;12;Torstai;53;76;129;38;72;110
89;17.05.2012;2012;05;13;Torstai;75;112;187;49;62;111
89;17.05.2012;2012;05;14;Torstai;106;102;208;40;68;108
89;17.05.2012;2012;05;15;Torstai;100;107;207;66;59;125
89;17.05.2012;2012;05;16;Torstai;111;96;207;51;47;98
89;17.05.2012;2012;05;17;Torstai;51;33;84;16;24;40
89;17.05.2012;2012;05;18;Torstai;35;50;85;31;19;50
89;17.05.2012;2012;05;19;Torstai;32;48;80;18;19;37
89;17.05.2012;2012;05;20;Torstai;39;25;64;16;10;26
89;17.05.2012;2012;05;21;Torstai;35;33;68;12;14;26
89;17.05.2012;2012;05;22;Torstai;25;25;50;9;4;13
89;17.05.2012;2012;05;23;Torstai;13;12;25;9;11;20
89;18.05.2012;2012;05;00;Perjantai;11;3;14;5;2;7
89;18.05.2012;2012;05;01;Perjantai;4;2;6;3;3;6
89;18.05.2012;2012;05;02;Perjantai;0;0;0;1;3;4
89;18.05.2012;2012;05;03;Perjantai;1;2;3;1;0;1
89;18.05.2012;2012;05;04;Perjantai;5;4;9;1;2;3
89;18.05.2012;2012;05;05;Perjantai;2;15;17;2;0;2
89;18.05.2012;2012;05;06;Perjantai;18;58;76;6;8;14
89;18.05.2012;2012;05;07;Perjantai;41;122;163;5;16;21
89;18.05.2012;2012;05;08;Perjantai;47;145;192;8;30;38
89;18.05.2012;2012;05;09;Perjantai;28;104;132;7;30;37
89;18.05.2012;2012;05;10;Perjantai;24;43;67;7;11;18
89;18.05.2012;2012;05;11;Perjantai;38;47;85;23;12;35
89;18.05.2012;2012;05;12;Perjantai;42;68;110;16;29;45
89;18.05.2012;2012;05;13;Perjantai;64;75;139;18;26;44
89;18.05.2012;2012;05;14;Perjantai;116;72;188;24;22;46
89;18.05.2012;2012;05;15;Perjantai;122;70;192;21;12;33
89;18.05.2012;2012;05;16;Perjantai;118;62;180;15;17;32
89;18.05.2012;2012;05;17;Perjantai;88;73;161;20;24;44
89;18.05.2012;2012;05;18;Perjantai;62;63;125;27;35;62
89;18.05.2012;2012;05;19;Perjantai;53;52;105;16;16;32
89;18.05.2012;2012;05;20;Perjantai;44;26;70;16;8;24
89;18.05.2012;2012;05;21;Perjantai;30;21;51;12;5;17
89;18.05.2012;2012;05;22;Perjantai;37;15;52;5;7;12
89;18.05.2012;2012;05;23;Perjantai;26;16;42;5;7;12
89;19.05.2012;2012;05;00;Lauantai;10;11;21;1;2;3
89;19.05.2012;2012;05;01;Lauantai;19;10;29;2;5;7
89;19.05.2012;2012;05;02;Lauantai;15;3;18;2;2;4
89;19.05.2012;2012;05;03;Lauantai;7;3;10;3;0;3
89;19.05.2012;2012;05;04;Lauantai;5;1;6;6;2;8
89;19.05.2012;2012;05;05;Lauantai;3;8;11;3;3;6
89;19.05.2012;2012;05;06;Lauantai;4;13;17;6;1;7
89;19.05.2012;2012;05;07;Lauantai;5;18;23;8;8;16
89;19.05.2012;2012;05;08;Lauantai;10;33;43;15;19;34
89;19.05.2012;2012;05;09;Lauantai;28;71;99;23;42;65
89;19.05.2012;2012;05;10;Lauantai;32;126;158;27;48;75
89;19.05.2012;2012;05;11;Lauantai;73;138;211;26;52;78
89;19.05.2012;2012;05;12;Lauantai;97;131;228;39;50;89
89;19.05.2012;2012;05;13;Lauantai;146;119;265;28;43;71
89;19.05.2012;2012;05;14;Lauantai;127;104;231;46;39;85
89;19.05.2012;2012;05;15;Lauantai;103;61;164;30;37;67
89;19.05.2012;2012;05;16;Lauantai;82;86;168;35;42;77
89;19.05.2012;2012;05;17;Lauantai;86;76;162;41;45;86
89;19.05.2012;2012;05;18;Lauantai;83;91;174;44;53;97
89;19.05.2012;2012;05;19;Lauantai;72;65;137;35;40;75
89;19.05.2012;2012;05;20;Lauantai;48;38;86;18;14;32
89;19.05.2012;2012;05;21;Lauantai;39;46;85;13;18;31
89;19.05.2012;2012;05;22;Lauantai;20;23;43;13;16;29
89;19.05.2012;2012;05;23;Lauantai;30;38;68;5;8;13
89;20.05.2012;2012;05;00;Sunnuntai;20;40;60;5;19;24
89;20.05.2012;2012;05;01;Sunnuntai;18;18;36;5;3;8
89;20.05.2012;2012;05;02;Sunnuntai;22;1;23;7;1;8
89;20.05.2012;2012;05;03;Sunnuntai;21;0;21;12;0;12
89;20.05.2012;2012;05;04;Sunnuntai;19;3;22;8;0;8
89;20.05.2012;2012;05;05;Sunnuntai;3;3;6;1;1;2
89;20.05.2012;2012;05;06;Sunnuntai;7;10;17;2;6;8
89;20.05.2012;2012;05;07;Sunnuntai;7;7;14;4;1;5
89;20.05.2012;2012;05;08;Sunnuntai;8;15;23;14;8;22
89;20.05.2012;2012;05;09;Sunnuntai;21;42;63;15;32;47
89;20.05.2012;2012;05;10;Sunnuntai;32;55;87;28;43;71
89;20.05.2012;2012;05;11;Sunnuntai;52;97;149;29;65;94
89;20.05.2012;2012;05;12;Sunnuntai;77;114;191;39;65;104
89;20.05.2012;2012;05;13;Sunnuntai;112;112;224;49;55;104
89;20.05.2012;2012;05;14;Sunnuntai;87;66;153;49;54;103
89;20.05.2012;2012;05;15;Sunnuntai;68;60;128;17;21;38
89;20.05.2012;2012;05;16;Sunnuntai;69;33;102;14;19;33
89;20.05.2012;2012;05;17;Sunnuntai;32;24;56;14;16;30
89;20.05.2012;2012;05;18;Sunnuntai;52;28;80;29;35;64
89;20.05.2012;2012;05;19;Sunnuntai;41;23;64;9;13;22
89;20.05.2012;2012;05;20;Sunnuntai;25;23;48;10;11;21
89;20.05.2012;2012;05;21;Sunnuntai;24;7;31;7;4;11
89;20.05.2012;2012;05;22;Sunnuntai;14;7;21;2;5;7
89;20.05.2012;2012;05;23;Sunnuntai;7;13;20;4;0;4
89;21.05.2012;2012;05;00;Maanantai;2;4;6;0;1;1
89;21.05.2012;2012;05;01;Maanantai;3;3;6;0;0;0
89;21.05.2012;2012;05;02;Maanantai;1;0;1;0;1;1
89;21.05.2012;2012;05;03;Maanantai;2;2;4;0;1;1
89;21.05.2012;2012;05;04;Maanantai;2;5;7;2;1;3
89;21.05.2012;2012;05;05;Maanantai;10;12;22;5;4;9
89;21.05.2012;2012;05;06;Maanantai;19;99;118;8;13;21
89;21.05.2012;2012;05;07;Maanantai;71;232;303;3;26;29
89;21.05.2012;2012;05;08;Maanantai;72;276;348;15;39;54
89;21.05.2012;2012;05;09;Maanantai;91;179;270;54;84;138
89;21.05.2012;2012;05;10;Maanantai;70;117;187;10;36;46
89;21.05.2012;2012;05;11;Maanantai;120;147;267;32;54;86
89;21.05.2012;2012;05;12;Maanantai;115;112;227;22;28;50
89;21.05.2012;2012;05;13;Maanantai;105;123;228;22;46;68
89;21.05.2012;2012;05;14;Maanantai;177;106;283;43;33;76
89;21.05.2012;2012;05;15;Maanantai;255;120;375;45;21;66
89;21.05.2012;2012;05;16;Maanantai;287;150;437;45;34;79
89;21.05.2012;2012;05;17;Maanantai;191;95;286;35;37;72
89;21.05.2012;2012;05;18;Maanantai;161;99;260;46;65;111
89;21.05.2012;2012;05;19;Maanantai;117;62;179;50;52;102
89;21.05.2012;2012;05;20;Maanantai;74;64;138;44;41;85
89;21.05.2012;2012;05;21;Maanantai;72;34;106;18;18;36
89;21.05.2012;2012;05;22;Maanantai;35;11;46;7;6;13
89;21.05.2012;2012;05;23;Maanantai;13;11;24;1;6;7
89;22.05.2012;2012;05;00;Tiistai;3;5;8;0;2;2
89;22.05.2012;2012;05;01;Tiistai;4;4;8;0;1;1
89;22.05.2012;2012;05;02;Tiistai;1;1;2;0;1;1
89;22.05.2012;2012;05;03;Tiistai;1;5;6;0;1;1
89;22.05.2012;2012;05;04;Tiistai;3;5;8;1;1;2
89;22.05.2012;2012;05;05;Tiistai;7;17;24;3;4;7
89;22.05.2012;2012;05;06;Tiistai;23;109;132;5;11;16
89;22.05.2012;2012;05;07;Tiistai;50;271;321;10;30;40
89;22.05.2012;2012;05;08;Tiistai;71;258;329;17;35;52
89;22.05.2012;2012;05;09;Tiistai;48;135;183;16;37;53
89;22.05.2012;2012;05;10;Tiistai;60;119;179;22;33;55
89;22.05.2012;2012;05;11;Tiistai;83;116;199;17;45;62
89;22.05.2012;2012;05;12;Tiistai;109;106;215;23;28;51
89;22.05.2012;2012;05;13;Tiistai;111;134;245;31;36;67
89;22.05.2012;2012;05;14;Tiistai;144;110;254;27;31;58
89;22.05.2012;2012;05;15;Tiistai;281;124;405;40;47;87
89;22.05.2012;2012;05;16;Tiistai;301;136;437;35;22;57
89;22.05.2012;2012;05;17;Tiistai;183;130;313;37;28;65
89;22.05.2012;2012;05;18;Tiistai;145;99;244;50;49;99
89;22.05.2012;2012;05;19;Tiistai;144;73;217;50;51;101
89;22.05.2012;2012;05;20;Tiistai;122;67;189;46;40;86
89;22.05.2012;2012;05;21;Tiistai;59;44;103;24;28;52
89;22.05.2012;2012;05;22;Tiistai;42;20;62;9;12;21
89;22.05.2012;2012;05;23;Tiistai;13;8;21;3;2;5
89;23.05.2012;2012;05;00;Keskiviikko;8;9;17;2;4;6
89;23.05.2012;2012;05;01;Keskiviikko;7;2;9;3;0;3
89;23.05.2012;2012;05;02;Keskiviikko;1;3;4;2;0;2
89;23.05.2012;2012;05;03;Keskiviikko;1;2;3;0;0;0
89;23.05.2012;2012;05;04;Keskiviikko;6;8;14;0;2;2
89;23.05.2012;2012;05;05;Keskiviikko;10;19;29;2;0;2
89;23.05.2012;2012;05;06;Keskiviikko;25;102;127;6;7;13
89;23.05.2012;2012;05;07;Keskiviikko;56;253;309;3;28;31
89;23.05.2012;2012;05;08;Keskiviikko;98;249;347;13;32;45
89;23.05.2012;2012;05;09;Keskiviikko;52;143;195;11;32;43
89;23.05.2012;2012;05;10;Keskiviikko;63;131;194;22;36;58
89;23.05.2012;2012;05;11;Keskiviikko;77;143;220;22;34;56
89;23.05.2012;2012;05;12;Keskiviikko;121;134;255;30;31;61
89;23.05.2012;2012;05;13;Keskiviikko;140;113;253;42;50;92
89;23.05.2012;2012;05;14;Keskiviikko;170;120;290;36;28;64
89;23.05.2012;2012;05;15;Keskiviikko;225;130;355;26;25;51
89;23.05.2012;2012;05;16;Keskiviikko;309;171;480;42;30;72
89;23.05.2012;2012;05;17;Keskiviikko;202;148;350;38;44;82
89;23.05.2012;2012;05;18;Keskiviikko;143;117;260;42;43;85
89;23.05.2012;2012;05;19;Keskiviikko;126;87;213;50;29;79
89;23.05.2012;2012;05;20;Keskiviikko;126;81;207;34;39;73
89;23.05.2012;2012;05;21;Keskiviikko;82;44;126;31;22;53
89;23.05.2012;2012;05;22;Keskiviikko;52;16;68;12;9;21
89;23.05.2012;2012;05;23;Keskiviikko;18;17;35;8;5;13
89;24.05.2012;2012;05;00;Torstai;17;4;21;0;4;4
89;24.05.2012;2012;05;01;Torstai;7;3;10;1;1;2
89;24.05.2012;2012;05;02;Torstai;8;3;11;2;1;3
89;24.05.2012;2012;05;03;Torstai;4;2;6;2;0;2
89;24.05.2012;2012;05;04;Torstai;2;5;7;1;5;6
89;24.05.2012;2012;05;05;Torstai;10;14;24;3;1;4
89;24.05.2012;2012;05;06;Torstai;23;90;113;4;7;11
89;24.05.2012;2012;05;07;Torstai;60;205;265;6;35;41
89;24.05.2012;2012;05;08;Torstai;72;267;339;10;43;53
89;24.05.2012;2012;05;09;Torstai;47;247;294;10;29;39
89;24.05.2012;2012;05;10;Torstai;101;112;213;18;32;50
89;24.05.2012;2012;05;11;Torstai;80;119;199;11;31;42
89;24.05.2012;2012;05;12;Torstai;173;133;306;16;29;45
89;24.05.2012;2012;05;13;Torstai;131;122;253;22;25;47
89;24.05.2012;2012;05;14;Torstai;170;129;299;56;33;89
89;24.05.2012;2012;05;15;Torstai;254;142;396;26;24;50
89;24.05.2012;2012;05;16;Torstai;275;132;407;38;28;66
89;24.05.2012;2012;05;17;Torstai;188;149;337;49;44;93
89;24.05.2012;2012;05;18;Torstai;157;133;290;38;54;92
89;24.05.2012;2012;05;19;Torstai;190;95;285;46;50;96
89;24.05.2012;2012;05;20;Torstai;133;80;213;31;42;73
89;24.05.2012;2012;05;21;Torstai;90;46;136;19;13;32
89;24.05.2012;2012;05;22;Torstai;36;27;63;12;10;22
89;24.05.2012;2012;05;23;Torstai;25;15;40;3;5;8
89;25.05.2012;2012;05;00;Perjantai;16;12;28;2;1;3
89;25.05.2012;2012;05;01;Perjantai;5;2;7;1;3;4
89;25.05.2012;2012;05;02;Perjantai;4;2;6;1;1;2
89;25.05.2012;2012;05;03;Perjantai;2;4;6;1;1;2
89;25.05.2012;2012;05;04;Perjantai;3;6;9;1;1;2
89;25.05.2012;2012;05;05;Perjantai;3;11;14;2;2;4
89;25.05.2012;2012;05;06;Perjantai;25;84;109;3;6;9
89;25.05.2012;2012;05;07;Perjantai;57;216;273;9;26;35
89;25.05.2012;2012;05;08;Perjantai;64;253;317;19;65;84
89;25.05.2012;2012;05;09;Perjantai;52;143;195;20;62;82
89;25.05.2012;2012;05;10;Perjantai;78;140;218;30;34;64
89;25.05.2012;2012;05;11;Perjantai;104;117;221;37;19;56
89;25.05.2012;2012;05;12;Perjantai;109;119;228;21;20;41
89;25.05.2012;2012;05;13;Perjantai;166;114;280;19;29;48
89;25.05.2012;2012;05;14;Perjantai;174;127;301;19;34;53
89;25.05.2012;2012;05;15;Perjantai;215;115;330;24;18;42
89;25.05.2012;2012;05;16;Perjantai;225;116;341;24;20;44
89;25.05.2012;2012;05;17;Perjantai;140;108;248;23;23;46
89;25.05.2012;2012;05;18;Perjantai;119;86;205;34;28;62
89;25.05.2012;2012;05;19;Perjantai;125;101;226;58;54;112
89;25.05.2012;2012;05;20;Perjantai;135;63;198;20;23;43
89;25.05.2012;2012;05;21;Perjantai;114;88;202;39;21;60
89;25.05.2012;2012;05;22;Perjantai;72;90;162;23;23;46
89;25.05.2012;2012;05;23;Perjantai;62;40;102;18;34;52
89;26.05.2012;2012;05;00;Lauantai;33;34;67;8;21;29
89;26.05.2012;2012;05;01;Lauantai;35;34;69;7;15;22
89;26.05.2012;2012;05;02;Lauantai;36;9;45;13;4;17
89;26.05.2012;2012;05;03;Lauantai;21;4;25;16;2;18
89;26.05.2012;2012;05;04;Lauantai;25;3;28;12;4;16
89;26.05.2012;2012;05;05;Lauantai;9;7;16;1;5;6
89;26.05.2012;2012;05;06;Lauantai;5;16;21;2;7;9
89;26.05.2012;2012;05;07;Lauantai;8;26;34;2;2;4
89;26.05.2012;2012;05;08;Lauantai;11;48;59;9;16;25
89;26.05.2012;2012;05;09;Lauantai;17;102;119;11;39;50
89;26.05.2012;2012;05;10;Lauantai;56;117;173;27;45;72
89;26.05.2012;2012;05;11;Lauantai;83;138;221;21;79;100
89;26.05.2012;2012;05;12;Lauantai;108;126;234;60;519;579
89;26.05.2012;2012;05;13;Lauantai;91;259;350;153;1135;1288
89;26.05.2012;2012;05;14;Lauantai;126;145;271;53;400;453
89;26.05.2012;2012;05;15;Lauantai;143;150;293;45;244;289
89;26.05.2012;2012;05;16;Lauantai;123;122;245;39;84;123
89;26.05.2012;2012;05;17;Lauantai;143;110;253;55;47;102
89;26.05.2012;2012;05;18;Lauantai;113;126;239;25;23;48
89;26.05.2012;2012;05;19;Lauantai;90;95;185;36;51;87
89;26.05.2012;2012;05;20;Lauantai;97;85;182;17;23;40
89;26.05.2012;2012;05;21;Lauantai;46;61;107;14;19;33
89;26.05.2012;2012;05;22;Lauantai;56;66;122;11;20;31
89;26.05.2012;2012;05;23;Lauantai;35;54;89;5;20;25
89;27.05.2012;2012;05;00;Sunnuntai;33;41;74;4;11;15
89;27.05.2012;2012;05;01;Sunnuntai;53;22;75;4;4;8
89;27.05.2012;2012;05;02;Sunnuntai;38;10;48;8;4;12
89;27.05.2012;2012;05;03;Sunnuntai;41;6;47;10;0;10
89;27.05.2012;2012;05;04;Sunnuntai;32;0;32;9;0;9
89;27.05.2012;2012;05;05;Sunnuntai;11;5;16;2;0;2
89;27.05.2012;2012;05;06;Sunnuntai;8;10;18;3;4;7
89;27.05.2012;2012;05;07;Sunnuntai;7;10;17;6;8;14
89;27.05.2012;2012;05;08;Sunnuntai;12;16;28;10;12;22
89;27.05.2012;2012;05;09;Sunnuntai;19;53;72;12;24;36
89;27.05.2012;2012;05;10;Sunnuntai;55;69;124;20;53;73
89;27.05.2012;2012;05;11;Sunnuntai;55;116;171;52;59;111
89;27.05.2012;2012;05;12;Sunnuntai;133;131;264;54;56;110
89;27.05.2012;2012;05;13;Sunnuntai;141;164;305;48;46;94
89;27.05.2012;2012;05;14;Sunnuntai;151;168;319;49;64;113
89;27.05.2012;2012;05;15;Sunnuntai;161;152;313;66;74;140
89;27.05.2012;2012;05;16;Sunnuntai;138;151;289;40;48;88
89;27.05.2012;2012;05;17;Sunnuntai;157;123;280;56;62;118
89;27.05.2012;2012;05;18;Sunnuntai;111;130;241;41;43;84
89;27.05.2012;2012;05;19;Sunnuntai;120;76;196;44;48;92
89;27.05.2012;2012;05;20;Sunnuntai;105;63;168;34;24;58
89;27.05.2012;2012;05;21;Sunnuntai;53;34;87;10;19;29
89;27.05.2012;2012;05;22;Sunnuntai;27;22;49;10;9;19
89;27.05.2012;2012;05;23;Sunnuntai;11;7;18;1;3;4
89;28.05.2012;2012;05;00;Maanantai;22;3;25;7;2;9
89;28.05.2012;2012;05;01;Maanantai;10;2;12;2;1;3
89;28.05.2012;2012;05;02;Maanantai;2;5;7;0;0;0
89;28.05.2012;2012;05;03;Maanantai;1;3;4;1;0;1
89;28.05.2012;2012;05;04;Maanantai;1;6;7;1;1;2
89;28.05.2012;2012;05;05;Maanantai;11;21;32;2;4;6
89;28.05.2012;2012;05;06;Maanantai;22;74;96;2;9;11
89;28.05.2012;2012;05;07;Maanantai;54;185;239;4;19;23
89;28.05.2012;2012;05;08;Maanantai;79;264;343;6;26;32
89;28.05.2012;2012;05;09;Maanantai;46;138;184;15;25;40
89;28.05.2012;2012;05;10;Maanantai;41;90;131;12;22;34
89;28.05.2012;2012;05;11;Maanantai;64;89;153;15;22;37
89;28.05.2012;2012;05;12;Maanantai;99;122;221;25;24;49
89;28.05.2012;2012;05;13;Maanantai;135;117;252;23;33;56
89;28.05.2012;2012;05;14;Maanantai;162;120;282;25;28;53
89;28.05.2012;2012;05;15;Maanantai;217;144;361;47;42;89
89;28.05.2012;2012;05;16;Maanantai;282;125;407;40;21;61
89;28.05.2012;2012;05;17;Maanantai;160;111;271;33;35;68
89;28.05.2012;2012;05;18;Maanantai;152;86;238;45;34;79
89;28.05.2012;2012;05;19;Maanantai;108;65;173;27;41;68
89;28.05.2012;2012;05;20;Maanantai;88;54;142;24;32;56
89;28.05.2012;2012;05;21;Maanantai;65;36;101;20;15;35
89;28.05.2012;2012;05;22;Maanantai;28;16;44;7;7;14
89;28.05.2012;2012;05;23;Maanantai;16;13;29;7;5;12
89;29.05.2012;2012;05;00;Tiistai;8;5;13;3;2;5
89;29.05.2012;2012;05;01;Tiistai;3;7;10;0;1;1
89;29.05.2012;2012;05;02;Tiistai;4;2;6;0;0;0
89;29.05.2012;2012;05;03;Tiistai;2;4;6;0;0;0
89;29.05.2012;2012;05;04;Tiistai;6;10;16;2;0;2
89;29.05.2012;2012;05;05;Tiistai;6;23;29;4;5;9
89;29.05.2012;2012;05;06;Tiistai;32;93;125;3;5;8
89;29.05.2012;2012;05;07;Tiistai;51;240;291;4;22;26
89;29.05.2012;2012;05;08;Tiistai;55;291;346;10;37;47
89;29.05.2012;2012;05;09;Tiistai;47;145;192;14;38;52
89;29.05.2012;2012;05;10;Tiistai;54;120;174;12;35;47
89;29.05.2012;2012;05;11;Tiistai;107;98;205;39;19;58
89;29.05.2012;2012;05;12;Tiistai;82;116;198;20;77;97
89;29.05.2012;2012;05;13;Tiistai;116;131;247;15;26;41
89;29.05.2012;2012;05;14;Tiistai;180;121;301;44;36;80
89;29.05.2012;2012;05;15;Tiistai;235;108;343;29;24;53
89;29.05.2012;2012;05;16;Tiistai;267;121;388;35;15;50
89;29.05.2012;2012;05;17;Tiistai;195;92;287;33;26;59
89;29.05.2012;2012;05;18;Tiistai;117;98;215;39;45;84
89;29.05.2012;2012;05;19;Tiistai;117;44;161;47;46;93
89;29.05.2012;2012;05;20;Tiistai;113;43;156;42;23;65
89;29.05.2012;2012;05;21;Tiistai;73;24;97;17;20;37
89;29.05.2012;2012;05;22;Tiistai;25;9;34;3;5;8
89;29.05.2012;2012;05;23;Tiistai;13;8;21;4;1;5
89;30.05.2012;2012;05;00;Keskiviikko;11;4;15;1;1;2
89;30.05.2012;2012;05;01;Keskiviikko;5;5;10;3;0;3
89;30.05.2012;2012;05;02;Keskiviikko;5;1;6;1;2;3
89;30.05.2012;2012;05;03;Keskiviikko;1;1;2;0;0;0
89;30.05.2012;2012;05;04;Keskiviikko;2;3;5;0;1;1
89;30.05.2012;2012;05;05;Keskiviikko;8;19;27;3;2;5
89;30.05.2012;2012;05;06;Keskiviikko;27;93;120;5;8;13
89;30.05.2012;2012;05;07;Keskiviikko;51;206;257;7;24;31
89;30.05.2012;2012;05;08;Keskiviikko;68;300;368;5;32;37
89;30.05.2012;2012;05;09;Keskiviikko;47;207;254;12;31;43
89;30.05.2012;2012;05;10;Keskiviikko;50;136;186;22;30;52
89;30.05.2012;2012;05;11;Keskiviikko;86;143;229;23;44;67
89;30.05.2012;2012;05;12;Keskiviikko;143;108;251;18;32;50
89;30.05.2012;2012;05;13;Keskiviikko;151;120;271;24;27;51
89;30.05.2012;2012;05;14;Keskiviikko;201;135;336;38;20;58
89;30.05.2012;2012;05;15;Keskiviikko;220;113;333;33;21;54
89;30.05.2012;2012;05;16;Keskiviikko;275;144;419;33;28;61
89;30.05.2012;2012;05;17;Keskiviikko;176;119;295;22;13;35
89;30.05.2012;2012;05;18;Keskiviikko;120;100;220;31;37;68
89;30.05.2012;2012;05;19;Keskiviikko;94;63;157;31;30;61
89;30.05.2012;2012;05;20;Keskiviikko;100;52;152;21;33;54
89;30.05.2012;2012;05;21;Keskiviikko;64;47;111;16;12;28
89;30.05.2012;2012;05;22;Keskiviikko;49;23;72;6;5;11
89;30.05.2012;2012;05;23;Keskiviikko;21;19;40;8;12;20
89;31.05.2012;2012;05;00;Torstai;11;6;17;0;3;3
89;31.05.2012;2012;05;01;Torstai;5;3;8;2;1;3
89;31.05.2012;2012;05;02;Torstai;6;4;10;1;3;4
89;31.05.2012;2012;05;03;Torstai;8;3;11;3;0;3
89;31.05.2012;2012;05;04;Torstai;10;4;14;3;1;4
89;31.05.2012;2012;05;05;Torstai;5;13;18;0;2;2
89;31.05.2012;2012;05;06;Torstai;30;85;115;1;6;7
89;31.05.2012;2012;05;07;Torstai;58;214;272;7;21;28
89;31.05.2012;2012;05;08;Torstai;79;287;366;15;33;48
89;31.05.2012;2012;05;09;Torstai;47;156;203;21;39;60
89;31.05.2012;2012;05;10;Torstai;60;106;166;32;41;73
89;31.05.2012;2012;05;11;Torstai;115;144;259;27;64;91
89;31.05.2012;2012;05;12;Torstai;146;116;262;36;33;69
89;31.05.2012;2012;05;13;Torstai;109;121;230;21;25;46
89;31.05.2012;2012;05;14;Torstai;159;102;261;27;33;60
89;31.05.2012;2012;05;15;Torstai;213;102;315;34;24;58
89;31.05.2012;2012;05;16;Torstai;243;133;376;33;19;52
89;31.05.2012;2012;05;17;Torstai;164;94;258;29;28;57
89;31.05.2012;2012;05;18;Torstai;143;105;248;32;30;62
89;31.05.2012;2012;05;19;Torstai;154;65;219;39;20;59
89;31.05.2012;2012;05;20;Torstai;107;49;156;21;26;47
89;31.05.2012;2012;05;21;Torstai;56;28;84;13;12;25
89;31.05.2012;2012;05;22;Torstai;33;13;46;2;18;20
89;31.05.2012;2012;05;23;Torstai;22;9;31;3;7;10
89;01.06.2012;2012;06;00;Perjantai;8;8;16;4;3;7
89;01.06.2012;2012;06;01;Perjantai;6;4;10;2;0;2
89;01.06.2012;2012;06;02;Perjantai;2;4;6;3;0;3
89;01.06.2012;2012;06;03;Perjantai;5;2;7;1;0;1
89;01.06.2012;2012;06;04;Perjantai;5;6;11;5;4;9
89;01.06.2012;2012;06;05;Perjantai;9;16;25;5;1;6
89;01.06.2012;2012;06;06;Perjantai;26;91;117;1;7;8
89;01.06.2012;2012;06;07;Perjantai;45;188;233;9;25;34
89;01.06.2012;2012;06;08;Perjantai;53;227;280;11;26;37
89;01.06.2012;2012;06;09;Perjantai;50;114;164;19;31;50
89;01.06.2012;2012;06;10;Perjantai;76;112;188;15;36;51
89;01.06.2012;2012;06;11;Perjantai;132;125;257;28;33;61
89;01.06.2012;2012;06;12;Perjantai;130;122;252;19;23;42
89;01.06.2012;2012;06;13;Perjantai;164;151;315;18;28;46
89;01.06.2012;2012;06;14;Perjantai;147;94;241;12;13;25
89;01.06.2012;2012;06;15;Perjantai;190;101;291;21;31;52
89;01.06.2012;2012;06;16;Perjantai;171;106;277;28;15;43
89;01.06.2012;2012;06;17;Perjantai;114;52;166;23;13;36
89;01.06.2012;2012;06;18;Perjantai;84;37;121;20;13;33
89;01.06.2012;2012;06;19;Perjantai;46;34;80;16;5;21
89;01.06.2012;2012;06;20;Perjantai;54;35;89;10;10;20
89;01.06.2012;2012;06;21;Perjantai;25;25;50;8;4;12
89;01.06.2012;2012;06;22;Perjantai;19;22;41;5;7;12
89;01.06.2012;2012;06;23;Perjantai;21;18;39;2;8;10
89;02.06.2012;2012;06;00;Lauantai;22;11;33;6;10;16
89;02.06.2012;2012;06;01;Lauantai;25;15;40;3;2;5
89;02.06.2012;2012;06;02;Lauantai;12;4;16;7;4;11
89;02.06.2012;2012;06;03;Lauantai;14;1;15;5;2;7
89;02.06.2012;2012;06;04;Lauantai;10;2;12;5;3;8
89;02.06.2012;2012;06;05;Lauantai;8;5;13;5;5;10
89;02.06.2012;2012;06;06;Lauantai;4;14;18;2;5;7
89;02.06.2012;2012;06;07;Lauantai;7;26;33;6;6;12
89;02.06.2012;2012;06;08;Lauantai;23;66;89;12;18;30
89;02.06.2012;2012;06;09;Lauantai;48;86;134;16;20;36
89;02.06.2012;2012;06;10;Lauantai;65;78;143;24;33;57
89;02.06.2012;2012;06;11;Lauantai;66;73;139;20;19;39
89;02.06.2012;2012;06;12;Lauantai;56;81;137;29;39;68
89;02.06.2012;2012;06;13;Lauantai;73;74;147;26;20;46
89;02.06.2012;2012;06;14;Lauantai;64;50;114;24;14;38
89;02.06.2012;2012;06;15;Lauantai;59;39;98;13;14;27
89;02.06.2012;2012;06;16;Lauantai;42;26;68;8;14;22
89;02.06.2012;2012;06;17;Lauantai;23;21;44;9;10;19
89;02.06.2012;2012;06;18;Lauantai;24;35;59;12;8;20
89;02.06.2012;2012;06;19;Lauantai;21;28;49;9;13;22
89;02.06.2012;2012;06;20;Lauantai;20;33;53;12;11;23
89;02.06.2012;2012;06;21;Lauantai;24;51;75;3;7;10
89;02.06.2012;2012;06;22;Lauantai;25;47;72;4;13;17
89;02.06.2012;2012;06;23;Lauantai;34;24;58;8;14;22
89;03.06.2012;2012;06;00;Sunnuntai;28;31;59;3;8;11
89;03.06.2012;2012;06;01;Sunnuntai;26;11;37;9;2;11
89;03.06.2012;2012;06;02;Sunnuntai;37;2;39;11;1;12
89;03.06.2012;2012;06;03;Sunnuntai;38;3;41;11;1;12
89;03.06.2012;2012;06;04;Sunnuntai;17;2;19;7;0;7
89;03.06.2012;2012;06;05;Sunnuntai;7;2;9;2;2;4
89;03.06.2012;2012;06;06;Sunnuntai;3;6;9;4;2;6
89;03.06.2012;2012;06;07;Sunnuntai;3;9;12;5;6;11
89;03.06.2012;2012;06;08;Sunnuntai;6;10;16;6;16;22
89;03.06.2012;2012;06;09;Sunnuntai;21;26;47;14;25;39
89;03.06.2012;2012;06;10;Sunnuntai;29;51;80;28;38;66
89;03.06.2012;2012;06;11;Sunnuntai;32;61;93;37;34;71
89;03.06.2012;2012;06;12;Sunnuntai;45;79;124;32;51;83
89;03.06.2012;2012;06;13;Sunnuntai;80;67;147;38;33;71
89;03.06.2012;2012;06;14;Sunnuntai;75;87;162;31;34;65
89;03.06.2012;2012;06;15;Sunnuntai;76;58;134;30;34;64
89;03.06.2012;2012;06;16;Sunnuntai;59;51;110;29;18;47
89;03.06.2012;2012;06;17;Sunnuntai;55;26;81;18;9;27
89;03.06.2012;2012;06;18;Sunnuntai;37;19;56;22;19;41
89;03.06.2012;2012;06;19;Sunnuntai;44;26;70;14;17;31
89;03.06.2012;2012;06;20;Sunnuntai;26;13;39;18;14;32
89;03.06.2012;2012;06;21;Sunnuntai;25;18;43;12;5;17
89;03.06.2012;2012;06;22;Sunnuntai;19;18;37;5;5;10
89;03.06.2012;2012;06;23;Sunnuntai;12;5;17;1;4;5
89;04.06.2012;2012;06;00;Maanantai;7;2;9;1;1;2
89;04.06.2012;2012;06;01;Maanantai;6;3;9;3;0;3
89;04.06.2012;2012;06;02;Maanantai;4;1;5;2;3;5
89;04.06.2012;2012;06;03;Maanantai;2;5;7;0;0;0
89;04.06.2012;2012;06;04;Maanantai;4;4;8;1;1;2
89;04.06.2012;2012;06;05;Maanantai;5;18;23;3;7;10
89;04.06.2012;2012;06;06;Maanantai;17;72;89;5;6;11
89;04.06.2012;2012;06;07;Maanantai;47;178;225;7;20;27
89;04.06.2012;2012;06;08;Maanantai;60;203;263;6;23;29
89;04.06.2012;2012;06;09;Maanantai;43;109;152;8;21;29
89;04.06.2012;2012;06;10;Maanantai;45;77;122;12;35;47
89;04.06.2012;2012;06;11;Maanantai;63;73;136;17;31;48
89;04.06.2012;2012;06;12;Maanantai;65;90;155;15;27;42
89;04.06.2012;2012;06;13;Maanantai;77;74;151;24;10;34
89;04.06.2012;2012;06;14;Maanantai;94;91;185;27;25;52
89;04.06.2012;2012;06;15;Maanantai;180;93;273;24;10;34
89;04.06.2012;2012;06;16;Maanantai;220;108;328;29;23;52
89;04.06.2012;2012;06;17;Maanantai;137;58;195;36;24;60
89;04.06.2012;2012;06;18;Maanantai;111;57;168;27;24;51
89;04.06.2012;2012;06;19;Maanantai;67;27;94;16;32;48
89;04.06.2012;2012;06;20;Maanantai;70;43;113;27;18;45
89;04.06.2012;2012;06;21;Maanantai;40;27;67;12;7;19
89;04.06.2012;2012;06;22;Maanantai;18;12;30;2;1;3
89;04.06.2012;2012;06;23;Maanantai;8;8;16;2;0;2
89;05.06.2012;2012;06;00;Tiistai;12;4;16;0;1;1
89;05.06.2012;2012;06;01;Tiistai;10;2;12;1;3;4
89;05.06.2012;2012;06;02;Tiistai;2;1;3;2;0;2
89;05.06.2012;2012;06;03;Tiistai;2;3;5;2;0;2
89;05.06.2012;2012;06;04;Tiistai;1;6;7;0;1;1
89;05.06.2012;2012;06;05;Tiistai;3;11;14;2;2;4
89;05.06.2012;2012;06;06;Tiistai;25;83;108;4;9;13
89;05.06.2012;2012;06;07;Tiistai;42;167;209;3;22;25
89;05.06.2012;2012;06;08;Tiistai;51;170;221;8;33;41
89;05.06.2012;2012;06;09;Tiistai;29;93;122;17;44;61
89;05.06.2012;2012;06;10;Tiistai;40;92;132;15;27;42
89;05.06.2012;2012;06;11;Tiistai;62;71;133;11;32;43
89;05.06.2012;2012;06;12;Tiistai;67;95;162;16;29;45
89;05.06.2012;2012;06;13;Tiistai;94;111;205;24;22;46
89;05.06.2012;2012;06;14;Tiistai;128;109;237;30;29;59
89;05.06.2012;2012;06;15;Tiistai;213;100;313;35;26;61
89;05.06.2012;2012;06;16;Tiistai;214;110;324;39;34;73
89;05.06.2012;2012;06;17;Tiistai;171;108;279;20;22;42
89;05.06.2012;2012;06;18;Tiistai;106;56;162;37;16;53
89;05.06.2012;2012;06;19;Tiistai;96;56;152;20;32;52
89;05.06.2012;2012;06;20;Tiistai;102;42;144;26;22;48
89;05.06.2012;2012;06;21;Tiistai;54;26;80;10;14;24
89;05.06.2012;2012;06;22;Tiistai;32;16;48;11;6;17
89;05.06.2012;2012;06;23;Tiistai;17;9;26;6;5;11
89;06.06.2012;2012;06;00;Keskiviikko;12;6;18;3;5;8
89;06.06.2012;2012;06;01;Keskiviikko;5;0;5;3;0;3
89;06.06.2012;2012;06;02;Keskiviikko;2;0;2;0;0;0
89;06.06.2012;2012;06;03;Keskiviikko;6;3;9;0;0;0
89;06.06.2012;2012;06;04;Keskiviikko;1;6;7;0;1;1
89;06.06.2012;2012;06;05;Keskiviikko;8;19;27;1;1;2
89;06.06.2012;2012;06;06;Keskiviikko;27;91;118;3;8;11
89;06.06.2012;2012;06;07;Keskiviikko;66;209;275;11;20;31
89;06.06.2012;2012;06;08;Keskiviikko;49;182;231;6;31;37
89;06.06.2012;2012;06;09;Keskiviikko;33;116;149;9;27;36
89;06.06.2012;2012;06;10;Keskiviikko;61;105;166;23;36;59
89;06.06.2012;2012;06;11;Keskiviikko;61;124;185;28;51;79
89;06.06.2012;2012;06;12;Keskiviikko;105;147;252;35;57;92
89;06.06.2012;2012;06;13;Keskiviikko;121;139;260;31;47;78
89;06.06.2012;2012;06;14;Keskiviikko;143;87;230;29;33;62
89;06.06.2012;2012;06;15;Keskiviikko;228;135;363;49;29;78
89;06.06.2012;2012;06;16;Keskiviikko;265;183;448;40;31;71
89;06.06.2012;2012;06;17;Keskiviikko;187;154;341;43;37;80
89;06.06.2012;2012;06;18;Keskiviikko;174;113;287;49;37;86
89;06.06.2012;2012;06;19;Keskiviikko;149;74;223;41;45;86
89;06.06.2012;2012;06;20;Keskiviikko;143;93;236;45;41;86
89;06.06.2012;2012;06;21;Keskiviikko;84;51;135;25;16;41
89;06.06.2012;2012;06;22;Keskiviikko;36;24;60;8;8;16
89;06.06.2012;2012;06;23;Keskiviikko;36;13;49;4;3;7
89;07.06.2012;2012;06;00;Torstai;18;8;26;5;4;9
89;07.06.2012;2012;06;01;Torstai;17;3;20;3;0;3
89;07.06.2012;2012;06;02;Torstai;16;3;19;6;0;6
89;07.06.2012;2012;06;03;Torstai;10;0;10;3;3;6
89;07.06.2012;2012;06;04;Torstai;3;7;10;2;0;2
89;07.06.2012;2012;06;05;Torstai;7;15;22;2;5;7
89;07.06.2012;2012;06;06;Torstai;32;100;132;2;4;6
89;07.06.2012;2012;06;07;Torstai;49;200;249;5;18;23
89;07.06.2012;2012;06;08;Torstai;47;211;258;5;49;54
89;07.06.2012;2012;06;09;Torstai;29;103;132;14;45;59
89;07.06.2012;2012;06;10;Torstai;42;100;142;27;37;64
89;07.06.2012;2012;06;11;Torstai;67;82;149;21;22;43
89;07.06.2012;2012;06;12;Torstai;112;95;207;50;27;77
89;07.06.2012;2012;06;13;Torstai;98;127;225;21;53;74
89;07.06.2012;2012;06;14;Torstai;127;106;233;23;28;51
89;07.06.2012;2012;06;15;Torstai;232;117;349;32;38;70
89;07.06.2012;2012;06;16;Torstai;249;133;382;22;25;47
89;07.06.2012;2012;06;17;Torstai;178;100;278;36;22;58
89;07.06.2012;2012;06;18;Torstai;140;78;218;40;27;67
89;07.06.2012;2012;06;19;Torstai;103;66;169;36;39;75
89;07.06.2012;2012;06;20;Torstai;105;56;161;18;23;41
89;07.06.2012;2012;06;21;Torstai;72;40;112;12;10;22
89;07.06.2012;2012;06;22;Torstai;44;24;68;9;8;17
89;07.06.2012;2012;06;23;Torstai;26;24;50;3;4;7
89;08.06.2012;2012;06;00;Perjantai;18;9;27;9;3;12
89;08.06.2012;2012;06;01;Perjantai;6;1;7;0;4;4
89;08.06.2012;2012;06;02;Perjantai;12;2;14;2;3;5
89;08.06.2012;2012;06;03;Perjantai;8;2;10;3;0;3
89;08.06.2012;2012;06;04;Perjantai;4;6;10;4;2;6
89;08.06.2012;2012;06;05;Perjantai;2;16;18;3;2;5
89;08.06.2012;2012;06;06;Perjantai;28;83;111;4;6;10
89;08.06.2012;2012;06;07;Perjantai;55;165;220;11;18;29
89;08.06.2012;2012;06;08;Perjantai;49;165;214;12;26;38
89;08.06.2012;2012;06;09;Perjantai;34;118;152;13;31;44
89;08.06.2012;2012;06;10;Perjantai;55;108;163;19;27;46
89;08.06.2012;2012;06;11;Perjantai;81;87;168;30;28;58
89;08.06.2012;2012;06;12;Perjantai;79;104;183;28;27;55
89;08.06.2012;2012;06;13;Perjantai;139;122;261;23;53;76
89;08.06.2012;2012;06;14;Perjantai;176;108;284;25;36;61
89;08.06.2012;2012;06;15;Perjantai;191;110;301;28;26;54
89;08.06.2012;2012;06;16;Perjantai;197;111;308;20;25;45
89;08.06.2012;2012;06;17;Perjantai;142;75;217;23;25;48
89;08.06.2012;2012;06;18;Perjantai;123;105;228;30;17;47
89;08.06.2012;2012;06;19;Perjantai;63;88;151;9;25;34
89;08.06.2012;2012;06;20;Perjantai;94;72;166;17;22;39
89;08.06.2012;2012;06;21;Perjantai;71;64;135;16;21;37
89;08.06.2012;2012;06;22;Perjantai;53;65;118;3;11;14
89;08.06.2012;2012;06;23;Perjantai;38;43;81;5;14;19
89;09.06.2012;2012;06;00;Lauantai;43;18;61;3;7;10
89;09.06.2012;2012;06;01;Lauantai;30;15;45;3;3;6
89;09.06.2012;2012;06;02;Lauantai;27;3;30;9;1;10
89;09.06.2012;2012;06;03;Lauantai;19;5;24;8;0;8
89;09.06.2012;2012;06;04;Lauantai;17;4;21;4;2;6
89;09.06.2012;2012;06;05;Lauantai;10;5;15;9;3;12
89;09.06.2012;2012;06;06;Lauantai;8;14;22;4;3;7
89;09.06.2012;2012;06;07;Lauantai;12;13;25;0;2;2
89;09.06.2012;2012;06;08;Lauantai;20;33;53;4;11;15
89;09.06.2012;2012;06;09;Lauantai;18;60;78;6;20;26
89;09.06.2012;2012;06;10;Lauantai;28;107;135;11;35;46
89;09.06.2012;2012;06;11;Lauantai;58;83;141;24;26;50
89;09.06.2012;2012;06;12;Lauantai;67;88;155;20;32;52
89;09.06.2012;2012;06;13;Lauantai;107;86;193;29;38;67
89;09.06.2012;2012;06;14;Lauantai;104;87;191;29;30;59
89;09.06.2012;2012;06;15;Lauantai;124;85;209;23;28;51
89;09.06.2012;2012;06;16;Lauantai;107;77;184;33;25;58
89;09.06.2012;2012;06;17;Lauantai;102;81;183;43;35;78
89;09.06.2012;2012;06;18;Lauantai;78;88;166;41;41;82
89;09.06.2012;2012;06;19;Lauantai;66;70;136;24;38;62
89;09.06.2012;2012;06;20;Lauantai;64;67;131;20;14;34
89;09.06.2012;2012;06;21;Lauantai;46;66;112;11;29;40
89;09.06.2012;2012;06;22;Lauantai;36;57;93;53;52;105
89;09.06.2012;2012;06;23;Lauantai;31;39;70;6;11;17
89;10.06.2012;2012;06;00;Sunnuntai;23;59;82;13;14;27
89;10.06.2012;2012;06;01;Sunnuntai;31;15;46;7;3;10
89;10.06.2012;2012;06;02;Sunnuntai;31;4;35;2;7;9
89;10.06.2012;2012;06;03;Sunnuntai;27;4;31;12;1;13
89;10.06.2012;2012;06;04;Sunnuntai;28;1;29;7;1;8
89;10.06.2012;2012;06;05;Sunnuntai;8;5;13;2;1;3
89;10.06.2012;2012;06;06;Sunnuntai;6;7;13;4;6;10
89;10.06.2012;2012;06;07;Sunnuntai;5;8;13;2;8;10
89;10.06.2012;2012;06;08;Sunnuntai;18;19;37;8;9;17
89;10.06.2012;2012;06;09;Sunnuntai;28;47;75;12;27;39
89;10.06.2012;2012;06;10;Sunnuntai;45;59;104;32;42;74
89;10.06.2012;2012;06;11;Sunnuntai;62;116;178;31;38;69
89;10.06.2012;2012;06;12;Sunnuntai;107;134;241;46;57;103
89;10.06.2012;2012;06;13;Sunnuntai;113;168;281;51;80;131
89;10.06.2012;2012;06;14;Sunnuntai;167;144;311;50;70;120
89;10.06.2012;2012;06;15;Sunnuntai;168;155;323;52;85;137
89;10.06.2012;2012;06;16;Sunnuntai;170;151;321;52;61;113
89;10.06.2012;2012;06;17;Sunnuntai;141;122;263;42;43;85
89;10.06.2012;2012;06;18;Sunnuntai;107;95;202;44;54;98
89;10.06.2012;2012;06;19;Sunnuntai;92;42;134;35;39;74
89;10.06.2012;2012;06;20;Sunnuntai;47;41;88;16;21;37
89;10.06.2012;2012;06;21;Sunnuntai;39;30;69;8;10;18
89;10.06.2012;2012;06;22;Sunnuntai;18;25;43;3;1;4
89;10.06.2012;2012;06;23;Sunnuntai;14;6;20;3;0;3
89;11.06.2012;2012;06;00;Maanantai;16;5;21;2;0;2
89;11.06.2012;2012;06;01;Maanantai;4;3;7;0;0;0
89;11.06.2012;2012;06;02;Maanantai;6;2;8;0;0;0
89;11.06.2012;2012;06;03;Maanantai;3;3;6;1;0;1
89;11.06.2012;2012;06;04;Maanantai;1;9;10;4;1;5
89;11.06.2012;2012;06;05;Maanantai;7;19;26;1;6;7
89;11.06.2012;2012;06;06;Maanantai;27;86;113;2;6;8
89;11.06.2012;2012;06;07;Maanantai;46;229;275;6;23;29
89;11.06.2012;2012;06;08;Maanantai;66;234;300;11;28;39
89;11.06.2012;2012;06;09;Maanantai;53;123;176;8;25;33
89;11.06.2012;2012;06;10;Maanantai;63;108;171;28;42;70
89;11.06.2012;2012;06;11;Maanantai;85;137;222;26;32;58
89;11.06.2012;2012;06;12;Maanantai;104;147;251;36;43;79
89;11.06.2012;2012;06;13;Maanantai;125;132;257;29;33;62
89;11.06.2012;2012;06;14;Maanantai;178;134;312;38;47;85
89;11.06.2012;2012;06;15;Maanantai;265;112;377;26;10;36
89;11.06.2012;2012;06;16;Maanantai;280;126;406;31;22;53
89;11.06.2012;2012;06;17;Maanantai;212;125;337;30;39;69
89;11.06.2012;2012;06;18;Maanantai;154;95;249;43;41;84
89;11.06.2012;2012;06;19;Maanantai;135;83;218;26;30;56
89;11.06.2012;2012;06;20;Maanantai;120;46;166;35;24;59
89;11.06.2012;2012;06;21;Maanantai;53;57;110;24;25;49
89;11.06.2012;2012;06;22;Maanantai;30;17;47;8;8;16
89;11.06.2012;2012;06;23;Maanantai;19;19;38;3;5;8
89;12.06.2012;2012;06;00;Tiistai;9;12;21;3;1;4
89;12.06.2012;2012;06;01;Tiistai;9;3;12;3;3;6
89;12.06.2012;2012;06;02;Tiistai;8;5;13;2;6;8
89;12.06.2012;2012;06;03;Tiistai;6;3;9;1;0;1
89;12.06.2012;2012;06;04;Tiistai;7;10;17;2;1;3
89;12.06.2012;2012;06;05;Tiistai;5;20;25;1;4;5
89;12.06.2012;2012;06;06;Tiistai;29;101;130;1;13;14
89;12.06.2012;2012;06;07;Tiistai;52;228;280;8;23;31
89;12.06.2012;2012;06;08;Tiistai;67;222;289;7;37;44
89;12.06.2012;2012;06;09;Tiistai;38;157;195;14;45;59
89;12.06.2012;2012;06;10;Tiistai;66;134;200;20;32;52
89;12.06.2012;2012;06;11;Tiistai;121;176;297;21;53;74
89;12.06.2012;2012;06;12;Tiistai;123;118;241;26;46;72
89;12.06.2012;2012;06;13;Tiistai;129;152;281;36;55;91
89;12.06.2012;2012;06;14;Tiistai;188;175;363;56;52;108
89;12.06.2012;2012;06;15;Tiistai;265;157;422;27;29;56
89;12.06.2012;2012;06;16;Tiistai;322;188;510;41;31;72
89;12.06.2012;2012;06;17;Tiistai;234;218;452;30;55;85
89;12.06.2012;2012;06;18;Tiistai;171;123;294;40;25;65
89;12.06.2012;2012;06;19;Tiistai;203;87;290;55;38;93
89;12.06.2012;2012;06;20;Tiistai;142;51;193;40;33;73
89;12.06.2012;2012;06;21;Tiistai;88;59;147;23;26;49
89;12.06.2012;2012;06;22;Tiistai;37;33;70;13;12;25
89;12.06.2012;2012;06;23;Tiistai;28;22;50;7;3;10
89;13.06.2012;2012;06;00;Keskiviikko;24;12;36;2;4;6
89;13.06.2012;2012;06;01;Keskiviikko;6;8;14;2;3;5
89;13.06.2012;2012;06;02;Keskiviikko;8;4;12;2;0;2
89;13.06.2012;2012;06;03;Keskiviikko;7;1;8;1;1;2
89;13.06.2012;2012;06;04;Keskiviikko;4;7;11;1;2;3
89;13.06.2012;2012;06;05;Keskiviikko;8;16;24;5;7;12
89;13.06.2012;2012;06;06;Keskiviikko;29;100;129;2;7;9
89;13.06.2012;2012;06;07;Keskiviikko;57;240;297;4;16;20
89;13.06.2012;2012;06;08;Keskiviikko;71;245;316;26;34;60
89;13.06.2012;2012;06;09;Keskiviikko;50;128;178;20;41;61
89;13.06.2012;2012;06;10;Keskiviikko;82;127;209;13;46;59
89;13.06.2012;2012;06;11;Keskiviikko;93;145;238;43;84;127
89;13.06.2012;2012;06;12;Keskiviikko;111;163;274;32;60;92
89;13.06.2012;2012;06;13;Keskiviikko;156;145;301;32;31;63
89;13.06.2012;2012;06;14;Keskiviikko;173;163;336;40;39;79
89;13.06.2012;2012;06;15;Keskiviikko;306;169;475;55;83;138
89;13.06.2012;2012;06;16;Keskiviikko;308;211;519;38;37;75
89;13.06.2012;2012;06;17;Keskiviikko;245;187;432;54;51;105
89;13.06.2012;2012;06;18;Keskiviikko;177;130;307;77;50;127
89;13.06.2012;2012;06;19;Keskiviikko;179;78;257;48;36;84
89;13.06.2012;2012;06;20;Keskiviikko;158;78;236;49;29;78
89;13.06.2012;2012;06;21;Keskiviikko;102;65;167;18;22;40
89;13.06.2012;2012;06;22;Keskiviikko;43;34;77;18;18;36
89;13.06.2012;2012;06;23;Keskiviikko;24;10;34;5;11;16
89;14.06.2012;2012;06;00;Torstai;16;11;27;4;4;8
89;14.06.2012;2012;06;01;Torstai;11;4;15;3;2;5
89;14.06.2012;2012;06;02;Torstai;5;4;9;2;2;4
89;14.06.2012;2012;06;03;Torstai;8;8;16;1;0;1
89;14.06.2012;2012;06;04;Torstai;5;2;7;0;0;0
89;14.06.2012;2012;06;05;Torstai;4;22;26;3;2;5
89;14.06.2012;2012;06;06;Torstai;32;101;133;4;8;12
89;14.06.2012;2012;06;07;Torstai;65;220;285;9;22;31
89;14.06.2012;2012;06;08;Torstai;66;257;323;12;29;41
89;14.06.2012;2012;06;09;Torstai;43;116;159;20;21;41
89;14.06.2012;2012;06;10;Torstai;52;137;189;20;32;52
89;14.06.2012;2012;06;11;Torstai;80;118;198;30;29;59
89;14.06.2012;2012;06;12;Torstai;127;117;244;27;34;61
89;14.06.2012;2012;06;13;Torstai;161;147;308;26;46;72
89;14.06.2012;2012;06;14;Torstai;186;153;339;34;44;78
89;14.06.2012;2012;06;15;Torstai;247;172;419;25;30;55
89;14.06.2012;2012;06;16;Torstai;350;198;548;43;36;79
89;14.06.2012;2012;06;17;Torstai;228;196;424;34;41;75
89;14.06.2012;2012;06;18;Torstai;189;130;319;33;40;73
89;14.06.2012;2012;06;19;Torstai;176;108;284;54;42;96
89;14.06.2012;2012;06;20;Torstai;130;60;190;25;19;44
89;14.06.2012;2012;06;21;Torstai;89;41;130;19;21;40
89;14.06.2012;2012;06;22;Torstai;47;25;72;13;11;24
89;14.06.2012;2012;06;23;Torstai;16;16;32;4;0;4
89;15.06.2012;2012;06;00;Perjantai;15;9;24;2;2;4
89;15.06.2012;2012;06;01;Perjantai;15;7;22;1;1;2
89;15.06.2012;2012;06;02;Perjantai;16;12;28;7;1;8
89;15.06.2012;2012;06;03;Perjantai;11;4;15;2;0;2
89;15.06.2012;2012;06;04;Perjantai;9;3;12;1;0;1
89;15.06.2012;2012;06;05;Perjantai;8;21;29;3;3;6
89;15.06.2012;2012;06;06;Perjantai;31;88;119;4;11;15
89;15.06.2012;2012;06;07;Perjantai;47;206;253;9;31;40
89;15.06.2012;2012;06;08;Perjantai;68;193;261;8;21;29
89;15.06.2012;2012;06;09;Perjantai;41;128;169;10;24;34
89;15.06.2012;2012;06;10;Perjantai;76;90;166;17;32;49
89;15.06.2012;2012;06;11;Perjantai;93;102;195;13;17;30
89;15.06.2012;2012;06;12;Perjantai;71;104;175;14;32;46
89;15.06.2012;2012;06;13;Perjantai;147;131;278;31;43;74
89;15.06.2012;2012;06;14;Perjantai;148;109;257;22;29;51
89;15.06.2012;2012;06;15;Perjantai;227;124;351;27;27;54
89;15.06.2012;2012;06;16;Perjantai;210;127;337;27;32;59
89;15.06.2012;2012;06;17;Perjantai;138;132;270;20;28;48
89;15.06.2012;2012;06;18;Perjantai;149;120;269;32;36;68
89;15.06.2012;2012;06;19;Perjantai;127;83;210;24;29;53
89;15.06.2012;2012;06;20;Perjantai;99;88;187;27;32;59
89;15.06.2012;2012;06;21;Perjantai;76;83;159;20;35;55
89;15.06.2012;2012;06;22;Perjantai;61;70;131;12;15;27
89;15.06.2012;2012;06;23;Perjantai;37;47;84;11;22;33
89;16.06.2012;2012;06;00;Lauantai;52;39;91;9;6;15
89;16.06.2012;2012;06;01;Lauantai;39;17;56;8;8;16
89;16.06.2012;2012;06;02;Lauantai;39;8;47;6;2;8
89;16.06.2012;2012;06;03;Lauantai;43;2;45;10;0;10
89;16.06.2012;2012;06;04;Lauantai;16;3;19;5;0;5
89;16.06.2012;2012;06;05;Lauantai;12;12;24;3;2;5
89;16.06.2012;2012;06;06;Lauantai;5;9;14;1;7;8
89;16.06.2012;2012;06;07;Lauantai;10;19;29;10;8;18
89;16.06.2012;2012;06;08;Lauantai;25;46;71;10;15;25
89;16.06.2012;2012;06;09;Lauantai;24;89;113;17;31;48
89;16.06.2012;2012;06;10;Lauantai;48;156;204;17;39;56
89;16.06.2012;2012;06;11;Lauantai;107;164;271;25;47;72
89;16.06.2012;2012;06;12;Lauantai;143;206;349;34;57;91
89;16.06.2012;2012;06;13;Lauantai;191;193;384;31;40;71
89;16.06.2012;2012;06;14;Lauantai;236;169;405;58;54;112
89;16.06.2012;2012;06;15;Lauantai;221;175;396;47;48;95
89;16.06.2012;2012;06;16;Lauantai;173;126;299;42;50;92
89;16.06.2012;2012;06;17;Lauantai;186;156;342;41;64;105
89;16.06.2012;2012;06;18;Lauantai;134;137;271;53;44;97
89;16.06.2012;2012;06;19;Lauantai;105;77;182;34;45;79
89;16.06.2012;2012;06;20;Lauantai;87;117;204;37;32;69
89;16.06.2012;2012;06;21;Lauantai;90;103;193;25;32;57
89;16.06.2012;2012;06;22;Lauantai;73;80;153;23;38;61
89;16.06.2012;2012;06;23;Lauantai;52;81;133;36;58;94
89;17.06.2012;2012;06;00;Sunnuntai;52;45;97;13;15;28
89;17.06.2012;2012;06;01;Sunnuntai;45;27;72;12;7;19
89;17.06.2012;2012;06;02;Sunnuntai;50;13;63;6;2;8
89;17.06.2012;2012;06;03;Sunnuntai;37;3;40;6;0;6
89;17.06.2012;2012;06;04;Sunnuntai;29;1;30;3;1;4
89;17.06.2012;2012;06;05;Sunnuntai;13;4;17;7;2;9
89;17.06.2012;2012;06;06;Sunnuntai;7;10;17;0;0;0
89;17.06.2012;2012;06;07;Sunnuntai;1;7;8;0;1;1
89;17.06.2012;2012;06;08;Sunnuntai;7;13;20;3;4;7
89;17.06.2012;2012;06;09;Sunnuntai;21;22;43;10;15;25
89;17.06.2012;2012;06;10;Sunnuntai;20;36;56;20;30;50
89;17.06.2012;2012;06;11;Sunnuntai;25;56;81;24;37;61
89;17.06.2012;2012;06;12;Sunnuntai;51;50;101;20;25;45
89;17.06.2012;2012;06;13;Sunnuntai;47;62;109;24;27;51
89;17.06.2012;2012;06;14;Sunnuntai;82;82;164;25;38;63
89;17.06.2012;2012;06;15;Sunnuntai;89;72;161;32;28;60
89;17.06.2012;2012;06;16;Sunnuntai;88;79;167;20;36;56
89;17.06.2012;2012;06;17;Sunnuntai;72;78;150;24;25;49
89;17.06.2012;2012;06;18;Sunnuntai;74;83;157;40;37;77
89;17.06.2012;2012;06;19;Sunnuntai;90;80;170;48;33;81
89;17.06.2012;2012;06;20;Sunnuntai;83;69;152;27;36;63
89;17.06.2012;2012;06;21;Sunnuntai;53;40;93;14;27;41
89;17.06.2012;2012;06;22;Sunnuntai;30;18;48;5;11;16
89;17.06.2012;2012;06;23;Sunnuntai;17;10;27;6;2;8
89;18.06.2012;2012;06;00;Maanantai;8;13;21;2;3;5
89;18.06.2012;2012;06;01;Maanantai;4;6;10;4;4;8
89;18.06.2012;2012;06;02;Maanantai;3;4;7;0;0;0
89;18.06.2012;2012;06;03;Maanantai;9;1;10;2;0;2
89;18.06.2012;2012;06;04;Maanantai;6;8;14;0;1;1
89;18.06.2012;2012;06;05;Maanantai;14;15;29;3;3;6
89;18.06.2012;2012;06;06;Maanantai;25;82;107;3;6;9
89;18.06.2012;2012;06;07;Maanantai;33;124;157;7;18;25
89;18.06.2012;2012;06;08;Maanantai;33;142;175;3;18;21
89;18.06.2012;2012;06;09;Maanantai;29;101;130;11;19;30
89;18.06.2012;2012;06;10;Maanantai;33;77;110;22;14;36
89;18.06.2012;2012;06;11;Maanantai;40;61;101;14;17;31
89;18.06.2012;2012;06;12;Maanantai;58;76;134;10;20;30
89;18.06.2012;2012;06;13;Maanantai;66;49;115;24;17;41
89;18.06.2012;2012;06;14;Maanantai;80;77;157;15;21;36
89;18.06.2012;2012;06;15;Maanantai;159;108;267;17;19;36
89;18.06.2012;2012;06;16;Maanantai;222;113;335;26;27;53
89;18.06.2012;2012;06;17;Maanantai;133;107;240;42;28;70
89;18.06.2012;2012;06;18;Maanantai;100;64;164;29;24;53
89;18.06.2012;2012;06;19;Maanantai;116;58;174;29;28;57
89;18.06.2012;2012;06;20;Maanantai;80;65;145;25;26;51
89;18.06.2012;2012;06;21;Maanantai;68;46;114;22;22;44
89;18.06.2012;2012;06;22;Maanantai;33;21;54;18;9;27
89;18.06.2012;2012;06;23;Maanantai;14;19;33;4;5;9
89;19.06.2012;2012;06;00;Tiistai;14;13;27;0;1;1
89;19.06.2012;2012;06;01;Tiistai;13;10;23;0;1;1
89;19.06.2012;2012;06;02;Tiistai;5;3;8;4;1;5
89;19.06.2012;2012;06;03;Tiistai;4;3;7;0;1;1
89;19.06.2012;2012;06;04;Tiistai;5;7;12;1;0;1
89;19.06.2012;2012;06;05;Tiistai;5;20;25;2;6;8
89;19.06.2012;2012;06;06;Tiistai;27;102;129;3;4;7
89;19.06.2012;2012;06;07;Tiistai;49;202;251;4;19;23
89;19.06.2012;2012;06;08;Tiistai;48;222;270;9;27;36
89;19.06.2012;2012;06;09;Tiistai;54;117;171;24;25;49
89;19.06.2012;2012;06;10;Tiistai;58;124;182;23;33;56
89;19.06.2012;2012;06;11;Tiistai;66;92;158;18;28;46
89;19.06.2012;2012;06;12;Tiistai;99;146;245;21;38;59
89;19.06.2012;2012;06;13;Tiistai;113;124;237;25;25;50
89;19.06.2012;2012;06;14;Tiistai;152;111;263;37;31;68
89;19.06.2012;2012;06;15;Tiistai;215;120;335;28;23;51
89;19.06.2012;2012;06;16;Tiistai;298;107;405;26;17;43
89;19.06.2012;2012;06;17;Tiistai;162;119;281;22;22;44
89;19.06.2012;2012;06;18;Tiistai;117;105;222;32;37;69
89;19.06.2012;2012;06;19;Tiistai;124;74;198;30;41;71
89;19.06.2012;2012;06;20;Tiistai;94;52;146;25;29;54
89;19.06.2012;2012;06;21;Tiistai;56;25;81;24;13;37
89;19.06.2012;2012;06;22;Tiistai;20;13;33;7;7;14
89;19.06.2012;2012;06;23;Tiistai;14;12;26;3;3;6
89;20.06.2012;2012;06;00;Keskiviikko;13;12;25;4;2;6
89;20.06.2012;2012;06;01;Keskiviikko;7;7;14;1;2;3
89;20.06.2012;2012;06;02;Keskiviikko;7;2;9;2;0;2
89;20.06.2012;2012;06;03;Keskiviikko;3;2;5;0;0;0
89;20.06.2012;2012;06;04;Keskiviikko;2;4;6;4;2;6
89;20.06.2012;2012;06;05;Keskiviikko;5;22;27;0;5;5
89;20.06.2012;2012;06;06;Keskiviikko;25;96;121;3;2;5
89;20.06.2012;2012;06;07;Keskiviikko;43;176;219;2;15;17
89;20.06.2012;2012;06;08;Keskiviikko;46;178;224;9;28;37
89;20.06.2012;2012;06;09;Keskiviikko;55;102;157;14;24;38
89;20.06.2012;2012;06;10;Keskiviikko;44;107;151;16;26;42
89;20.06.2012;2012;06;11;Keskiviikko;67;124;191;13;30;43
89;20.06.2012;2012;06;12;Keskiviikko;82;102;184;27;25;52
89;20.06.2012;2012;06;13;Keskiviikko;92;119;211;30;22;52
89;20.06.2012;2012;06;14;Keskiviikko;139;98;237;21;22;43
89;20.06.2012;2012;06;15;Keskiviikko;165;146;311;33;25;58
89;20.06.2012;2012;06;16;Keskiviikko;253;158;411;37;27;64
89;20.06.2012;2012;06;17;Keskiviikko;177;110;287;24;33;57
89;20.06.2012;2012;06;18;Keskiviikko;149;104;253;31;20;51
89;20.06.2012;2012;06;19;Keskiviikko;113;48;161;22;26;48
89;20.06.2012;2012;06;20;Keskiviikko;84;44;128;21;15;36
89;20.06.2012;2012;06;21;Keskiviikko;45;31;76;7;6;13
89;20.06.2012;2012;06;22;Keskiviikko;36;22;58;3;3;6
89;20.06.2012;2012;06;23;Keskiviikko;29;7;36;4;2;6
89;21.06.2012;2012;06;00;Torstai;19;9;28;2;2;4
89;21.06.2012;2012;06;01;Torstai;9;5;14;1;0;1
89;21.06.2012;2012;06;02;Torstai;11;0;11;0;2;2
89;21.06.2012;2012;06;03;Torstai;14;4;18;3;0;3
89;21.06.2012;2012;06;04;Torstai;3;5;8;1;0;1
89;21.06.2012;2012;06;05;Torstai;5;11;16;4;10;14
89;21.06.2012;2012;06;06;Torstai;21;75;96;0;4;4
89;21.06.2012;2012;06;07;Torstai;37;150;187;6;5;11
89;21.06.2012;2012;06;08;Torstai;27;130;157;2;16;18
89;21.06.2012;2012;06;09;Torstai;28;75;103;7;17;24
89;21.06.2012;2012;06;10;Torstai;48;85;133;9;16;25
89;21.06.2012;2012;06;11;Torstai;78;96;174;18;19;37
89;21.06.2012;2012;06;12;Torstai;81;105;186;20;18;38
89;21.06.2012;2012;06;13;Torstai;95;78;173;12;20;32
89;21.06.2012;2012;06;14;Torstai;156;106;262;25;21;46
89;21.06.2012;2012;06;15;Torstai;171;91;262;17;9;26
89;21.06.2012;2012;06;16;Torstai;126;65;191;19;27;46
89;21.06.2012;2012;06;17;Torstai;118;87;205;14;20;34
89;21.06.2012;2012;06;18;Torstai;94;56;150;26;28;54
89;21.06.2012;2012;06;19;Torstai;75;58;133;25;23;48
89;21.06.2012;2012;06;20;Torstai;76;66;142;19;19;38
89;21.06.2012;2012;06;21;Torstai;50;48;98;12;14;26
89;21.06.2012;2012;06;22;Torstai;35;67;102;9;22;31
89;21.06.2012;2012;06;23;Torstai;25;14;39;4;5;9
89;22.06.2012;2012;06;00;Perjantai;22;19;41;5;2;7
89;22.06.2012;2012;06;01;Perjantai;18;9;27;2;1;3
89;22.06.2012;2012;06;02;Perjantai;27;3;30;7;1;8
89;22.06.2012;2012;06;03;Perjantai;17;8;25;0;2;2
89;22.06.2012;2012;06;04;Perjantai;13;5;18;4;0;4
89;22.06.2012;2012;06;05;Perjantai;7;6;13;5;6;11
89;22.06.2012;2012;06;06;Perjantai;6;20;26;2;6;8
89;22.06.2012;2012;06;07;Perjantai;8;16;24;4;2;6
89;22.06.2012;2012;06;08;Perjantai;18;39;57;7;17;24
89;22.06.2012;2012;06;09;Perjantai;47;79;126;11;14;25
89;22.06.2012;2012;06;10;Perjantai;70;98;168;17;28;45
89;22.06.2012;2012;06;11;Perjantai;118;84;202;24;34;58
89;22.06.2012;2012;06;12;Perjantai;105;84;189;26;40;66
89;22.06.2012;2012;06;13;Perjantai;93;78;171;30;53;83
89;22.06.2012;2012;06;14;Perjantai;91;86;177;25;38;63
89;22.06.2012;2012;06;15;Perjantai;59;70;129;30;28;58
89;22.06.2012;2012;06;16;Perjantai;84;85;169;29;35;64
89;22.06.2012;2012;06;17;Perjantai;77;75;152;18;21;39
89;22.06.2012;2012;06;18;Perjantai;56;147;203;36;59;95
89;22.06.2012;2012;06;19;Perjantai;65;58;123;23;35;58
89;22.06.2012;2012;06;20;Perjantai;55;59;114;19;15;34
89;22.06.2012;2012;06;21;Perjantai;110;66;176;21;8;29
89;22.06.2012;2012;06;22;Perjantai;48;40;88;4;6;10
89;22.06.2012;2012;06;23;Perjantai;39;51;90;10;6;16
89;23.06.2012;2012;06;00;Lauantai;32;24;56;8;5;13
89;23.06.2012;2012;06;01;Lauantai;50;13;63;4;9;13
89;23.06.2012;2012;06;02;Lauantai;14;6;20;5;3;8
89;23.06.2012;2012;06;03;Lauantai;28;11;39;8;0;8
89;23.06.2012;2012;06;04;Lauantai;15;5;20;6;1;7
89;23.06.2012;2012;06;05;Lauantai;7;4;11;1;1;2
89;23.06.2012;2012;06;06;Lauantai;12;7;19;5;1;6
89;23.06.2012;2012;06;07;Lauantai;5;10;15;3;5;8
89;23.06.2012;2012;06;08;Lauantai;11;8;19;8;11;19
89;23.06.2012;2012;06;09;Lauantai;17;19;36;5;17;22
89;23.06.2012;2012;06;10;Lauantai;27;49;76;25;21;46
89;23.06.2012;2012;06;11;Lauantai;53;82;135;30;86;116
89;23.06.2012;2012;06;12;Lauantai;88;75;163;39;62;101
89;23.06.2012;2012;06;13;Lauantai;87;104;191;29;51;80
89;23.06.2012;2012;06;14;Lauantai;121;141;262;43;54;97
89;23.06.2012;2012;06;15;Lauantai;134;126;260;34;54;88
89;23.06.2012;2012;06;16;Lauantai;116;153;269;39;67;106
89;23.06.2012;2012;06;17;Lauantai;89;98;187;26;20;46
89;23.06.2012;2012;06;18;Lauantai;91;100;191;24;43;67
89;23.06.2012;2012;06;19;Lauantai;106;74;180;45;43;88
89;23.06.2012;2012;06;20;Lauantai;73;91;164;15;17;32
89;23.06.2012;2012;06;21;Lauantai;52;42;94;15;16;31
89;23.06.2012;2012;06;22;Lauantai;40;47;87;3;11;14
89;23.06.2012;2012;06;23;Lauantai;19;25;44;2;10;12
89;24.06.2012;2012;06;00;Sunnuntai;22;27;49;2;4;6
89;24.06.2012;2012;06;01;Sunnuntai;19;9;28;2;3;5
89;24.06.2012;2012;06;02;Sunnuntai;13;8;21;4;5;9
89;24.06.2012;2012;06;03;Sunnuntai;12;2;14;4;0;4
89;24.06.2012;2012;06;04;Sunnuntai;13;7;20;4;1;5
89;24.06.2012;2012;06;05;Sunnuntai;9;3;12;4;0;4
89;24.06.2012;2012;06;06;Sunnuntai;5;13;18;3;3;6
89;24.06.2012;2012;06;07;Sunnuntai;7;15;22;4;8;12
89;24.06.2012;2012;06;08;Sunnuntai;7;12;19;9;5;14
89;24.06.2012;2012;06;09;Sunnuntai;15;34;49;14;20;34
89;24.06.2012;2012;06;10;Sunnuntai;46;49;95;26;20;46
89;24.06.2012;2012;06;11;Sunnuntai;69;102;171;25;36;61
89;24.06.2012;2012;06;12;Sunnuntai;101;126;227;27;56;83
89;24.06.2012;2012;06;13;Sunnuntai;89;153;242;45;61;106
89;24.06.2012;2012;06;14;Sunnuntai;101;126;227;22;47;69
89;24.06.2012;2012;06;15;Sunnuntai;101;63;164;30;44;74
89;24.06.2012;2012;06;16;Sunnuntai;125;81;206;37;33;70
89;24.06.2012;2012;06;17;Sunnuntai;100;89;189;32;41;73
89;24.06.2012;2012;06;18;Sunnuntai;84;83;167;31;35;66
89;24.06.2012;2012;06;19;Sunnuntai;85;66;151;25;36;61
89;24.06.2012;2012;06;20;Sunnuntai;51;39;90;22;15;37
89;24.06.2012;2012;06;21;Sunnuntai;55;37;92;16;14;30
89;24.06.2012;2012;06;22;Sunnuntai;17;22;39;9;4;13
89;24.06.2012;2012;06;23;Sunnuntai;17;11;28;2;5;7
89;25.06.2012;2012;06;00;Maanantai;16;8;24;3;1;4
89;25.06.2012;2012;06;01;Maanantai;14;5;19;0;1;1
89;25.06.2012;2012;06;02;Maanantai;3;1;4;0;1;1
89;25.06.2012;2012;06;03;Maanantai;2;3;5;0;0;0
89;25.06.2012;2012;06;04;Maanantai;4;7;11;10;3;13
89;25.06.2012;2012;06;05;Maanantai;4;12;16;4;1;5
89;25.06.2012;2012;06;06;Maanantai;23;82;105;1;2;3
89;25.06.2012;2012;06;07;Maanantai;39;142;181;7;8;15
89;25.06.2012;2012;06;08;Maanantai;38;158;196;3;19;22
89;25.06.2012;2012;06;09;Maanantai;26;111;137;15;12;27
89;25.06.2012;2012;06;10;Maanantai;46;98;144;11;19;30
89;25.06.2012;2012;06;11;Maanantai;69;108;177;18;72;90
89;25.06.2012;2012;06;12;Maanantai;96;106;202;29;24;53
89;25.06.2012;2012;06;13;Maanantai;78;121;199;21;14;35
89;25.06.2012;2012;06;14;Maanantai;121;106;227;18;20;38
89;25.06.2012;2012;06;15;Maanantai;212;109;321;17;18;35
89;25.06.2012;2012;06;16;Maanantai;229;116;345;30;30;60
89;25.06.2012;2012;06;17;Maanantai;164;85;249;30;27;57
89;25.06.2012;2012;06;18;Maanantai;123;100;223;29;36;65
89;25.06.2012;2012;06;19;Maanantai;130;56;186;36;27;63
89;25.06.2012;2012;06;20;Maanantai;98;54;152;27;35;62
89;25.06.2012;2012;06;21;Maanantai;56;51;107;15;22;37
89;25.06.2012;2012;06;22;Maanantai;31;26;57;23;38;61
89;25.06.2012;2012;06;23;Maanantai;22;13;35;3;4;7
89;26.06.2012;2012;06;00;Tiistai;10;11;21;4;6;10
89;26.06.2012;2012;06;01;Tiistai;10;1;11;6;5;11
89;26.06.2012;2012;06;02;Tiistai;3;2;5;1;1;2
89;26.06.2012;2012;06;03;Tiistai;2;1;3;3;1;4
89;26.06.2012;2012;06;04;Tiistai;4;7;11;0;0;0
89;26.06.2012;2012;06;05;Tiistai;6;16;22;1;2;3
89;26.06.2012;2012;06;06;Tiistai;30;83;113;3;5;8
89;26.06.2012;2012;06;07;Tiistai;39;175;214;7;20;27
89;26.06.2012;2012;06;08;Tiistai;42;181;223;10;31;41
89;26.06.2012;2012;06;09;Tiistai;41;103;144;11;21;32
89;26.06.2012;2012;06;10;Tiistai;42;80;122;18;23;41
89;26.06.2012;2012;06;11;Tiistai;55;68;123;17;29;46
89;26.06.2012;2012;06;12;Tiistai;63;90;153;16;41;57
89;26.06.2012;2012;06;13;Tiistai;83;90;173;22;23;45
89;26.06.2012;2012;06;14;Tiistai;124;101;225;29;24;53
89;26.06.2012;2012;06;15;Tiistai;186;85;271;24;22;46
89;26.06.2012;2012;06;16;Tiistai;195;102;297;22;22;44
89;26.06.2012;2012;06;17;Tiistai;155;98;253;24;22;46
89;26.06.2012;2012;06;18;Tiistai;89;64;153;28;19;47
89;26.06.2012;2012;06;19;Tiistai;90;45;135;37;21;58
89;26.06.2012;2012;06;20;Tiistai;97;51;148;28;14;42
89;26.06.2012;2012;06;21;Tiistai;51;40;91;20;21;41
89;26.06.2012;2012;06;22;Tiistai;31;19;50;6;5;11
89;26.06.2012;2012;06;23;Tiistai;14;16;30;6;11;17
89;27.06.2012;2012;06;00;Keskiviikko;13;9;22;1;5;6
89;27.06.2012;2012;06;01;Keskiviikko;4;3;7;1;0;1
89;27.06.2012;2012;06;02;Keskiviikko;9;1;10;0;1;1
89;27.06.2012;2012;06;03;Keskiviikko;1;3;4;2;2;4
89;27.06.2012;2012;06;04;Keskiviikko;4;1;5;1;2;3
89;27.06.2012;2012;06;05;Keskiviikko;3;17;20;2;4;6
89;27.06.2012;2012;06;06;Keskiviikko;24;76;100;4;4;8
89;27.06.2012;2012;06;07;Keskiviikko;39;168;207;3;15;18
89;27.06.2012;2012;06;08;Keskiviikko;30;160;190;3;16;19
89;27.06.2012;2012;06;09;Keskiviikko;36;95;131;9;23;32
89;27.06.2012;2012;06;10;Keskiviikko;49;96;145;19;31;50
89;27.06.2012;2012;06;11;Keskiviikko;63;85;148;17;34;51
89;27.06.2012;2012;06;12;Keskiviikko;71;102;173;27;41;68
89;27.06.2012;2012;06;13;Keskiviikko;109;97;206;25;38;63
89;27.06.2012;2012;06;14;Keskiviikko;120;78;198;29;21;50
89;27.06.2012;2012;06;15;Keskiviikko;171;81;252;23;24;47
89;27.06.2012;2012;06;16;Keskiviikko;191;90;281;13;10;23
89;27.06.2012;2012;06;17;Keskiviikko;127;61;188;24;14;38
89;27.06.2012;2012;06;18;Keskiviikko;85;48;133;20;13;33
89;27.06.2012;2012;06;19;Keskiviikko;83;22;105;17;9;26
89;27.06.2012;2012;06;20;Keskiviikko;55;29;84;10;17;27
89;27.06.2012;2012;06;21;Keskiviikko;36;23;59;17;9;26
89;27.06.2012;2012;06;22;Keskiviikko;21;5;26;4;1;5
89;27.06.2012;2012;06;23;Keskiviikko;4;3;7;2;5;7
89;28.06.2012;2012;06;00;Torstai;4;15;19;2;0;2
89;28.06.2012;2012;06;01;Torstai;6;6;12;0;3;3
89;28.06.2012;2012;06;02;Torstai;7;3;10;3;1;4
89;28.06.2012;2012;06;03;Torstai;6;2;8;1;0;1
89;28.06.2012;2012;06;04;Torstai;9;3;12;3;0;3
89;28.06.2012;2012;06;05;Torstai;3;11;14;14;10;24
89;28.06.2012;2012;06;06;Torstai;16;66;82;4;5;9
89;28.06.2012;2012;06;07;Torstai;33;134;167;5;13;18
89;28.06.2012;2012;06;08;Torstai;32;140;172;3;14;17
89;28.06.2012;2012;06;09;Torstai;23;98;121;10;20;30
89;28.06.2012;2012;06;10;Torstai;43;76;119;18;20;38
89;28.06.2012;2012;06;11;Torstai;52;79;131;29;42;71
89;28.06.2012;2012;06;12;Torstai;75;92;167;23;23;46
89;28.06.2012;2012;06;13;Torstai;86;81;167;21;29;50
89;28.06.2012;2012;06;14;Torstai;109;82;191;16;19;35
89;28.06.2012;2012;06;15;Torstai;148;90;238;23;20;43
89;28.06.2012;2012;06;16;Torstai;188;90;278;26;12;38
89;28.06.2012;2012;06;17;Torstai;112;100;212;23;30;53
89;28.06.2012;2012;06;18;Torstai;118;73;191;35;36;71
89;28.06.2012;2012;06;19;Torstai;96;70;166;24;25;49
89;28.06.2012;2012;06;20;Torstai;101;54;155;31;24;55
89;28.06.2012;2012;06;21;Torstai;78;46;124;21;17;38
89;28.06.2012;2012;06;22;Torstai;32;15;47;10;7;17
89;28.06.2012;2012;06;23;Torstai;19;15;34;4;9;13
89;29.06.2012;2012;06;00;Perjantai;17;12;29;1;7;8
89;29.06.2012;2012;06;01;Perjantai;8;3;11;9;2;11
89;29.06.2012;2012;06;02;Perjantai;3;3;6;2;2;4
89;29.06.2012;2012;06;03;Perjantai;6;6;12;0;0;0
89;29.06.2012;2012;06;04;Perjantai;6;9;15;5;0;5
89;29.06.2012;2012;06;05;Perjantai;5;14;19;0;2;2
89;29.06.2012;2012;06;06;Perjantai;21;73;94;3;8;11
89;29.06.2012;2012;06;07;Perjantai;32;112;144;7;15;22
89;29.06.2012;2012;06;08;Perjantai;40;149;189;6;13;19
89;29.06.2012;2012;06;09;Perjantai;29;95;124;9;25;34
89;29.06.2012;2012;06;10;Perjantai;45;113;158;22;37;59
89;29.06.2012;2012;06;11;Perjantai;62;110;172;24;31;55
89;29.06.2012;2012;06;12;Perjantai;89;111;200;23;41;64
89;29.06.2012;2012;06;13;Perjantai;123;115;238;24;23;47
89;29.06.2012;2012;06;14;Perjantai;143;137;280;20;22;42
89;29.06.2012;2012;06;15;Perjantai;178;115;293;23;34;57
89;29.06.2012;2012;06;16;Perjantai;166;118;284;25;36;61
89;29.06.2012;2012;06;17;Perjantai;142;120;262;27;35;62
89;29.06.2012;2012;06;18;Perjantai;125;108;233;32;21;53
89;29.06.2012;2012;06;19;Perjantai;115;89;204;40;29;69
89;29.06.2012;2012;06;20;Perjantai;76;58;134;16;21;37
89;29.06.2012;2012;06;21;Perjantai;105;95;200;17;27;44
89;29.06.2012;2012;06;22;Perjantai;48;62;110;21;16;37
89;29.06.2012;2012;06;23;Perjantai;48;56;104;2;21;23
89;30.06.2012;2012;06;00;Lauantai;47;46;93;4;4;8
89;30.06.2012;2012;06;01;Lauantai;43;24;67;13;5;18
89;30.06.2012;2012;06;02;Lauantai;29;11;40;9;3;12
89;30.06.2012;2012;06;03;Lauantai;39;2;41;7;2;9
89;30.06.2012;2012;06;04;Lauantai;26;4;30;10;2;12
89;30.06.2012;2012;06;05;Lauantai;7;8;15;4;2;6
89;30.06.2012;2012;06;06;Lauantai;7;21;28;3;2;5
89;30.06.2012;2012;06;07;Lauantai;17;20;37;2;8;10
89;30.06.2012;2012;06;08;Lauantai;15;42;57;13;15;28
89;30.06.2012;2012;06;09;Lauantai;22;66;88;17;18;35
89;30.06.2012;2012;06;10;Lauantai;41;64;105;22;20;42
89;30.06.2012;2012;06;11;Lauantai;59;85;144;16;26;42
89;30.06.2012;2012;06;12;Lauantai;61;109;170;23;38;61
89;30.06.2012;2012;06;13;Lauantai;72;91;163;23;18;41
89;30.06.2012;2012;06;14;Lauantai;85;75;160;27;23;50
89;30.06.2012;2012;06;15;Lauantai;105;84;189;19;21;40
89;30.06.2012;2012;06;16;Lauantai;76;43;119;21;25;46
89;30.06.2012;2012;06;17;Lauantai;64;29;93;15;16;31
89;30.06.2012;2012;06;18;Lauantai;41;31;72;14;12;26
89;30.06.2012;2012;06;19;Lauantai;28;27;55;10;13;23
89;30.06.2012;2012;06;20;Lauantai;21;37;58;10;15;25
89;30.06.2012;2012;06;21;Lauantai;23;25;48;9;10;19
89;30.06.2012;2012;06;22;Lauantai;12;27;39;4;7;11
89;30.06.2012;2012;06;23;Lauantai;7;16;23;4;7;11
89;01.07.2012;2012;07;00;Sunnuntai;15;20;35;1;11;12
89;01.07.2012;2012;07;01;Sunnuntai;20;6;26;2;1;3
89;01.07.2012;2012;07;02;Sunnuntai;22;0;22;6;1;7
89;01.07.2012;2012;07;03;Sunnuntai;25;3;28;6;0;6
89;01.07.2012;2012;07;04;Sunnuntai;20;4;24;12;1;13
89;01.07.2012;2012;07;05;Sunnuntai;3;4;7;4;2;6
89;01.07.2012;2012;07;06;Sunnuntai;6;11;17;2;3;5
89;01.07.2012;2012;07;07;Sunnuntai;6;6;12;3;7;10
89;01.07.2012;2012;07;08;Sunnuntai;2;12;14;9;9;18
89;01.07.2012;2012;07;09;Sunnuntai;21;14;35;12;18;30
89;01.07.2012;2012;07;10;Sunnuntai;26;47;73;22;25;47
89;01.07.2012;2012;07;11;Sunnuntai;48;61;109;35;46;81
89;01.07.2012;2012;07;12;Sunnuntai;54;69;123;36;28;64
89;01.07.2012;2012;07;13;Sunnuntai;80;96;176;34;48;82
89;01.07.2012;2012;07;14;Sunnuntai;77;82;159;27;51;78
89;01.07.2012;2012;07;15;Sunnuntai;89;72;161;26;38;64
89;01.07.2012;2012;07;16;Sunnuntai;75;69;144;33;21;54
89;01.07.2012;2012;07;17;Sunnuntai;93;98;191;18;40;58
89;01.07.2012;2012;07;18;Sunnuntai;85;117;202;31;28;59
89;01.07.2012;2012;07;19;Sunnuntai;97;116;213;34;38;72
89;01.07.2012;2012;07;20;Sunnuntai;81;64;145;25;23;48
89;01.07.2012;2012;07;21;Sunnuntai;31;14;45;12;10;22
89;01.07.2012;2012;07;22;Sunnuntai;21;9;30;4;7;11
89;01.07.2012;2012;07;23;Sunnuntai;34;10;44;17;4;21
89;02.07.2012;2012;07;00;Maanantai;26;18;44;2;4;6
89;02.07.2012;2012;07;01;Maanantai;14;3;17;3;1;4
89;02.07.2012;2012;07;02;Maanantai;7;5;12;1;1;2
89;02.07.2012;2012;07;03;Maanantai;5;2;7;3;0;3
89;02.07.2012;2012;07;04;Maanantai;2;4;6;0;0;0
89;02.07.2012;2012;07;05;Maanantai;5;10;15;10;0;10
89;02.07.2012;2012;07;06;Maanantai;14;64;78;3;4;7
89;02.07.2012;2012;07;07;Maanantai;25;89;114;1;10;11
89;02.07.2012;2012;07;08;Maanantai;20;139;159;6;15;21
89;02.07.2012;2012;07;09;Maanantai;37;107;144;13;22;35
89;02.07.2012;2012;07;10;Maanantai;46;94;140;22;34;56
89;02.07.2012;2012;07;11;Maanantai;78;131;209;20;29;49
89;02.07.2012;2012;07;12;Maanantai;89;122;211;34;36;70
89;02.07.2012;2012;07;13;Maanantai;153;153;306;33;46;79
89;02.07.2012;2012;07;14;Maanantai;136;142;278;33;33;66
89;02.07.2012;2012;07;15;Maanantai;203;128;331;34;30;64
89;02.07.2012;2012;07;16;Maanantai;202;137;339;45;44;89
89;02.07.2012;2012;07;17;Maanantai;181;157;338;39;42;81
89;02.07.2012;2012;07;18;Maanantai;144;179;323;37;55;92
89;02.07.2012;2012;07;19;Maanantai;188;82;270;59;30;89
89;02.07.2012;2012;07;20;Maanantai;111;66;177;39;22;61
89;02.07.2012;2012;07;21;Maanantai;75;40;115;21;14;35
89;02.07.2012;2012;07;22;Maanantai;38;37;75;10;16;26
89;02.07.2012;2012;07;23;Maanantai;25;29;54;3;7;10
89;03.07.2012;2012;07;00;Tiistai;8;8;16;1;7;8
89;03.07.2012;2012;07;01;Tiistai;9;6;15;2;1;3
89;03.07.2012;2012;07;02;Tiistai;7;3;10;3;1;4
89;03.07.2012;2012;07;03;Tiistai;3;2;5;3;1;4
89;03.07.2012;2012;07;04;Tiistai;4;6;10;3;0;3
89;03.07.2012;2012;07;05;Tiistai;6;17;23;1;0;1
89;03.07.2012;2012;07;06;Tiistai;19;89;108;4;8;12
89;03.07.2012;2012;07;07;Tiistai;37;127;164;5;16;21
89;03.07.2012;2012;07;08;Tiistai;43;158;201;6;20;26
89;03.07.2012;2012;07;09;Tiistai;41;131;172;16;26;42
89;03.07.2012;2012;07;10;Tiistai;75;122;197;22;47;69
89;03.07.2012;2012;07;11;Tiistai;94;124;218;18;69;87
89;03.07.2012;2012;07;12;Tiistai;100;173;273;22;45;67
89;03.07.2012;2012;07;13;Tiistai;139;176;315;31;55;86
89;03.07.2012;2012;07;14;Tiistai;170;150;320;34;47;81
89;03.07.2012;2012;07;15;Tiistai;231;164;395;43;42;85
89;03.07.2012;2012;07;16;Tiistai;258;172;430;37;38;75
89;03.07.2012;2012;07;17;Tiistai;229;148;377;36;21;57
89;03.07.2012;2012;07;18;Tiistai;174;127;301;31;37;68
89;03.07.2012;2012;07;19;Tiistai;177;109;286;39;44;83
89;03.07.2012;2012;07;20;Tiistai;151;100;251;28;30;58
89;03.07.2012;2012;07;21;Tiistai;83;60;143;33;25;58
89;03.07.2012;2012;07;22;Tiistai;48;29;77;15;14;29
89;03.07.2012;2012;07;23;Tiistai;36;20;56;3;5;8
89;04.07.2012;2012;07;00;Keskiviikko;14;15;29;2;6;8
89;04.07.2012;2012;07;01;Keskiviikko;11;4;15;1;3;4
89;04.07.2012;2012;07;02;Keskiviikko;4;4;8;2;0;2
89;04.07.2012;2012;07;03;Keskiviikko;6;2;8;0;0;0
89;04.07.2012;2012;07;04;Keskiviikko;2;6;8;1;0;1
89;04.07.2012;2012;07;05;Keskiviikko;5;17;22;2;4;6
89;04.07.2012;2012;07;06;Keskiviikko;20;92;112;6;9;15
89;04.07.2012;2012;07;07;Keskiviikko;38;142;180;6;10;16
89;04.07.2012;2012;07;08;Keskiviikko;30;141;171;3;20;23
89;04.07.2012;2012;07;09;Keskiviikko;32;134;166;9;25;34
89;04.07.2012;2012;07;10;Keskiviikko;68;138;206;22;41;63
89;04.07.2012;2012;07;11;Keskiviikko;115;138;253;25;68;93
89;04.07.2012;2012;07;12;Keskiviikko;131;148;279;19;48;67
89;04.07.2012;2012;07;13;Keskiviikko;147;148;295;49;75;124
89;04.07.2012;2012;07;14;Keskiviikko;193;155;348;39;44;83
89;04.07.2012;2012;07;15;Keskiviikko;240;178;418;50;51;101
89;04.07.2012;2012;07;16;Keskiviikko;263;160;423;43;47;90
89;04.07.2012;2012;07;17;Keskiviikko;221;179;400;39;45;84
89;04.07.2012;2012;07;18;Keskiviikko;210;145;355;34;59;93
89;04.07.2012;2012;07;19;Keskiviikko;136;105;241;40;43;83
89;04.07.2012;2012;07;20;Keskiviikko;126;84;210;30;30;60
89;04.07.2012;2012;07;21;Keskiviikko;125;71;196;32;34;66
89;04.07.2012;2012;07;22;Keskiviikko;61;53;114;13;20;33
89;04.07.2012;2012;07;23;Keskiviikko;50;14;64;8;3;11
89;05.07.2012;2012;07;00;Torstai;17;4;21;4;3;7
89;05.07.2012;2012;07;01;Torstai;15;11;26;1;2;3
89;05.07.2012;2012;07;02;Torstai;17;3;20;1;1;2
89;05.07.2012;2012;07;03;Torstai;7;1;8;2;0;2
89;05.07.2012;2012;07;04;Torstai;9;4;13;4;0;4
89;05.07.2012;2012;07;05;Torstai;8;22;30;1;2;3
89;05.07.2012;2012;07;06;Torstai;24;82;106;4;7;11
89;05.07.2012;2012;07;07;Torstai;38;151;189;5;12;17
89;05.07.2012;2012;07;08;Torstai;25;140;165;10;28;38
89;05.07.2012;2012;07;09;Torstai;40;132;172;10;11;21
89;05.07.2012;2012;07;10;Torstai;48;102;150;18;20;38
89;05.07.2012;2012;07;11;Torstai;96;166;262;21;34;55
89;05.07.2012;2012;07;12;Torstai;100;171;271;18;45;63
89;05.07.2012;2012;07;13;Torstai;171;151;322;42;34;76
89;05.07.2012;2012;07;14;Torstai;195;153;348;44;40;84
89;05.07.2012;2012;07;15;Torstai;267;172;439;48;45;93
89;05.07.2012;2012;07;16;Torstai;281;222;503;41;50;91
89;05.07.2012;2012;07;17;Torstai;232;227;459;43;58;101
89;05.07.2012;2012;07;18;Torstai;182;228;410;51;66;117
89;05.07.2012;2012;07;19;Torstai;176;168;344;35;55;90
89;05.07.2012;2012;07;20;Torstai;165;123;288;48;39;87
89;05.07.2012;2012;07;21;Torstai;144;97;241;35;20;55
89;05.07.2012;2012;07;22;Torstai;83;58;141;23;28;51
89;05.07.2012;2012;07;23;Torstai;53;45;98;21;18;39
89;06.07.2012;2012;07;00;Perjantai;25;11;36;5;6;11
89;06.07.2012;2012;07;01;Perjantai;16;15;31;3;1;4
89;06.07.2012;2012;07;02;Perjantai;21;4;25;9;1;10
89;06.07.2012;2012;07;03;Perjantai;16;0;16;2;0;2
89;06.07.2012;2012;07;04;Perjantai;11;5;16;1;0;1
89;06.07.2012;2012;07;05;Perjantai;7;18;25;4;2;6
89;06.07.2012;2012;07;06;Perjantai;18;81;99;3;8;11
89;06.07.2012;2012;07;07;Perjantai;26;132;158;3;12;15
89;06.07.2012;2012;07;08;Perjantai;37;143;180;9;24;33
89;06.07.2012;2012;07;09;Perjantai;44;127;171;15;16;31
89;06.07.2012;2012;07;10;Perjantai;70;150;220;17;29;46
89;06.07.2012;2012;07;11;Perjantai;132;150;282;17;32;49
89;06.07.2012;2012;07;12;Perjantai;160;188;348;23;45;68
89;06.07.2012;2012;07;13;Perjantai;192;181;373;43;42;85
89;06.07.2012;2012;07;14;Perjantai;232;154;386;35;41;76
89;06.07.2012;2012;07;15;Perjantai;256;178;434;33;44;77
89;06.07.2012;2012;07;16;Perjantai;207;198;405;41;38;79
89;06.07.2012;2012;07;17;Perjantai;196;196;392;34;43;77
89;06.07.2012;2012;07;18;Perjantai;176;173;349;28;42;70
89;06.07.2012;2012;07;19;Perjantai;185;179;364;33;34;67
89;06.07.2012;2012;07;20;Perjantai;173;169;342;36;30;66
89;06.07.2012;2012;07;21;Perjantai;113;135;248;35;47;82
89;06.07.2012;2012;07;22;Perjantai;114;138;252;23;36;59
89;06.07.2012;2012;07;23;Perjantai;66;111;177;12;38;50
89;07.07.2012;2012;07;00;Lauantai;66;103;169;7;24;31
89;07.07.2012;2012;07;01;Lauantai;70;53;123;7;12;19
89;07.07.2012;2012;07;02;Lauantai;52;17;69;12;5;17
89;07.07.2012;2012;07;03;Lauantai;57;8;65;10;7;17
89;07.07.2012;2012;07;04;Lauantai;45;3;48;16;1;17
89;07.07.2012;2012;07;05;Lauantai;11;8;19;3;0;3
89;07.07.2012;2012;07;06;Lauantai;12;19;31;2;8;10
89;07.07.2012;2012;07;07;Lauantai;12;29;41;3;5;8
89;07.07.2012;2012;07;08;Lauantai;21;60;81;11;8;19
89;07.07.2012;2012;07;09;Lauantai;30;88;118;13;32;45
89;07.07.2012;2012;07;10;Lauantai;73;147;220;18;37;55
89;07.07.2012;2012;07;11;Lauantai;121;108;229;23;32;55
89;07.07.2012;2012;07;12;Lauantai;141;165;306;14;35;49
89;07.07.2012;2012;07;13;Lauantai;202;176;378;32;26;58
89;07.07.2012;2012;07;14;Lauantai;204;165;369;39;42;81
89;07.07.2012;2012;07;15;Lauantai;203;173;376;27;29;56
89;07.07.2012;2012;07;16;Lauantai;155;161;316;31;25;56
89;07.07.2012;2012;07;17;Lauantai;139;160;299;39;49;88
89;07.07.2012;2012;07;18;Lauantai;126;147;273;34;56;90
89;07.07.2012;2012;07;19;Lauantai;139;174;313;36;46;82
89;07.07.2012;2012;07;20;Lauantai;161;124;285;27;34;61
89;07.07.2012;2012;07;21;Lauantai;77;97;174;17;32;49
89;07.07.2012;2012;07;22;Lauantai;49;107;156;12;11;23
89;07.07.2012;2012;07;23;Lauantai;55;91;146;13;18;31
89;08.07.2012;2012;07;00;Sunnuntai;49;45;94;18;28;46
89;08.07.2012;2012;07;01;Sunnuntai;59;33;92;9;10;19
89;08.07.2012;2012;07;02;Sunnuntai;56;13;69;6;7;13
89;08.07.2012;2012;07;03;Sunnuntai;68;11;79;19;1;20
89;08.07.2012;2012;07;04;Sunnuntai;34;5;39;15;2;17
89;08.07.2012;2012;07;05;Sunnuntai;14;10;24;0;2;2
89;08.07.2012;2012;07;06;Sunnuntai;10;14;24;3;2;5
89;08.07.2012;2012;07;07;Sunnuntai;3;8;11;1;4;5
89;08.07.2012;2012;07;08;Sunnuntai;5;6;11;1;5;6
89;08.07.2012;2012;07;09;Sunnuntai;6;16;22;4;7;11
89;08.07.2012;2012;07;10;Sunnuntai;24;37;61;8;29;37
89;08.07.2012;2012;07;11;Sunnuntai;40;66;106;17;36;53
89;08.07.2012;2012;07;12;Sunnuntai;45;78;123;26;46;72
89;08.07.2012;2012;07;13;Sunnuntai;74;117;191;35;56;91
89;08.07.2012;2012;07;14;Sunnuntai;67;87;154;25;58;83
89;08.07.2012;2012;07;15;Sunnuntai;112;81;193;32;35;67
89;08.07.2012;2012;07;16;Sunnuntai;98;89;187;40;22;62
89;08.07.2012;2012;07;17;Sunnuntai;96;81;177;24;49;73
89;08.07.2012;2012;07;18;Sunnuntai;64;67;131;33;19;52
89;08.07.2012;2012;07;19;Sunnuntai;75;55;130;32;30;62
89;08.07.2012;2012;07;20;Sunnuntai;60;44;104;29;22;51
89;08.07.2012;2012;07;21;Sunnuntai;49;54;103;14;18;32
89;08.07.2012;2012;07;22;Sunnuntai;35;16;51;14;11;25
89;08.07.2012;2012;07;23;Sunnuntai;18;28;46;7;5;12
89;09.07.2012;2012;07;00;Maanantai;14;3;17;1;4;5
89;09.07.2012;2012;07;01;Maanantai;9;9;18;4;1;5
89;09.07.2012;2012;07;02;Maanantai;5;1;6;2;0;2
89;09.07.2012;2012;07;03;Maanantai;4;6;10;2;0;2
89;09.07.2012;2012;07;04;Maanantai;9;6;15;3;0;3
89;09.07.2012;2012;07;05;Maanantai;4;20;24;0;2;2
89;09.07.2012;2012;07;06;Maanantai;27;67;94;4;8;12
89;09.07.2012;2012;07;07;Maanantai;26;86;112;0;7;7
89;09.07.2012;2012;07;08;Maanantai;16;101;117;9;18;27
89;09.07.2012;2012;07;09;Maanantai;28;71;99;9;9;18
89;09.07.2012;2012;07;10;Maanantai;41;95;136;12;30;42
89;09.07.2012;2012;07;11;Maanantai;61;140;201;23;23;46
89;09.07.2012;2012;07;12;Maanantai;79;111;190;17;22;39
89;09.07.2012;2012;07;13;Maanantai;99;130;229;18;24;42
89;09.07.2012;2012;07;14;Maanantai;138;118;256;22;40;62
89;09.07.2012;2012;07;15;Maanantai;180;155;335;22;28;50
89;09.07.2012;2012;07;16;Maanantai;228;121;349;41;24;65
89;09.07.2012;2012;07;17;Maanantai;152;151;303;36;48;84
89;09.07.2012;2012;07;18;Maanantai;199;180;379;33;68;101
89;09.07.2012;2012;07;19;Maanantai;210;101;311;63;44;107
89;09.07.2012;2012;07;20;Maanantai;136;96;232;37;40;77
89;09.07.2012;2012;07;21;Maanantai;69;64;133;26;24;50
89;09.07.2012;2012;07;22;Maanantai;54;48;102;14;19;33
89;09.07.2012;2012;07;23;Maanantai;31;19;50;7;8;15
89;10.07.2012;2012;07;00;Tiistai;13;14;27;1;1;2
89;10.07.2012;2012;07;01;Tiistai;17;6;23;5;3;8
89;10.07.2012;2012;07;02;Tiistai;12;8;20;1;0;1
89;10.07.2012;2012;07;03;Tiistai;15;1;16;0;0;0
89;10.07.2012;2012;07;04;Tiistai;7;2;9;1;1;2
89;10.07.2012;2012;07;05;Tiistai;10;18;28;3;2;5
89;10.07.2012;2012;07;06;Tiistai;26;85;111;2;5;7
89;10.07.2012;2012;07;07;Tiistai;27;122;149;4;9;13
89;10.07.2012;2012;07;08;Tiistai;33;126;159;6;20;26
89;10.07.2012;2012;07;09;Tiistai;37;99;136;13;14;27
89;10.07.2012;2012;07;10;Tiistai;54;110;164;17;35;52
89;10.07.2012;2012;07;11;Tiistai;76;122;198;22;53;75
89;10.07.2012;2012;07;12;Tiistai;110;149;259;26;25;51
89;10.07.2012;2012;07;13;Tiistai;106;114;220;23;20;43
89;10.07.2012;2012;07;14;Tiistai;138;112;250;20;25;45
89;10.07.2012;2012;07;15;Tiistai;169;106;275;22;20;42
89;10.07.2012;2012;07;16;Tiistai;194;107;301;17;12;29
89;10.07.2012;2012;07;17;Tiistai;121;81;202;19;15;34
89;10.07.2012;2012;07;18;Tiistai;110;59;169;30;14;44
89;10.07.2012;2012;07;19;Tiistai;88;51;139;27;25;52
89;10.07.2012;2012;07;20;Tiistai;67;38;105;21;16;37
89;10.07.2012;2012;07;21;Tiistai;53;49;102;21;13;34
89;10.07.2012;2012;07;22;Tiistai;33;18;51;8;3;11
89;10.07.2012;2012;07;23;Tiistai;11;17;28;2;4;6
89;11.07.2012;2012;07;00;Keskiviikko;12;4;16;2;1;3
89;11.07.2012;2012;07;01;Keskiviikko;8;4;12;0;0;0
89;11.07.2012;2012;07;02;Keskiviikko;7;1;8;0;0;0
89;11.07.2012;2012;07;03;Keskiviikko;9;2;11;1;1;2
89;11.07.2012;2012;07;04;Keskiviikko;7;3;10;1;1;2
89;11.07.2012;2012;07;05;Keskiviikko;3;8;11;1;1;2
89;11.07.2012;2012;07;06;Keskiviikko;13;49;62;1;2;3
89;11.07.2012;2012;07;07;Keskiviikko;22;85;107;4;12;16
89;11.07.2012;2012;07;08;Keskiviikko;26;122;148;6;19;25
89;11.07.2012;2012;07;09;Keskiviikko;30;82;112;9;14;23
89;11.07.2012;2012;07;10;Keskiviikko;33;106;139;19;26;45
89;11.07.2012;2012;07;11;Keskiviikko;61;85;146;21;25;46
89;11.07.2012;2012;07;12;Keskiviikko;81;112;193;28;45;73
89;11.07.2012;2012;07;13;Keskiviikko;118;110;228;30;40;70
89;11.07.2012;2012;07;14;Keskiviikko;91;58;149;47;39;86
89;11.07.2012;2012;07;15;Keskiviikko;130;73;203;24;21;45
89;11.07.2012;2012;07;16;Keskiviikko;145;95;240;22;21;43
89;11.07.2012;2012;07;17;Keskiviikko;165;126;291;16;23;39
89;11.07.2012;2012;07;18;Keskiviikko;111;137;248;37;46;83
89;11.07.2012;2012;07;19;Keskiviikko;154;126;280;31;51;82
89;11.07.2012;2012;07;20;Keskiviikko;131;109;240;33;34;67
89;11.07.2012;2012;07;21;Keskiviikko;104;76;180;29;24;53
89;11.07.2012;2012;07;22;Keskiviikko;58;55;113;15;27;42
89;11.07.2012;2012;07;23;Keskiviikko;51;37;88;6;6;12
89;12.07.2012;2012;07;00;Torstai;33;10;43;6;3;9
89;12.07.2012;2012;07;01;Torstai;26;4;30;6;0;6
89;12.07.2012;2012;07;02;Torstai;24;8;32;4;0;4
89;12.07.2012;2012;07;03;Torstai;17;2;19;5;0;5
89;12.07.2012;2012;07;04;Torstai;14;3;17;6;0;6
89;12.07.2012;2012;07;05;Torstai;8;20;28;2;4;6
89;12.07.2012;2012;07;06;Torstai;25;72;97;2;3;5
89;12.07.2012;2012;07;07;Torstai;19;113;132;7;14;21
89;12.07.2012;2012;07;08;Torstai;31;124;155;6;14;20
89;12.07.2012;2012;07;09;Torstai;38;95;133;7;20;27
89;12.07.2012;2012;07;10;Torstai;60;112;172;25;54;79
89;12.07.2012;2012;07;11;Torstai;71;91;162;16;24;40
89;12.07.2012;2012;07;12;Torstai;66;94;160;19;16;35
89;12.07.2012;2012;07;13;Torstai;74;69;143;15;20;35
89;12.07.2012;2012;07;14;Torstai;96;73;169;16;15;31
89;12.07.2012;2012;07;15;Torstai;126;104;230;27;24;51
89;12.07.2012;2012;07;16;Torstai;174;98;272;26;16;42
89;12.07.2012;2012;07;17;Torstai;159;133;292;26;32;58
89;12.07.2012;2012;07;18;Torstai;147;125;272;33;59;92
89;12.07.2012;2012;07;19;Torstai;126;96;222;32;43;75
89;12.07.2012;2012;07;20;Torstai;118;76;194;27;25;52
89;12.07.2012;2012;07;21;Torstai;88;46;134;20;24;44
89;12.07.2012;2012;07;22;Torstai;41;33;74;14;11;25
89;12.07.2012;2012;07;23;Torstai;38;24;62;8;5;13
89;13.07.2012;2012;07;00;Perjantai;20;6;26;4;3;7
89;13.07.2012;2012;07;01;Perjantai;25;9;34;2;1;3
89;13.07.2012;2012;07;02;Perjantai;12;9;21;2;0;2
89;13.07.2012;2012;07;03;Perjantai;9;6;15;3;0;3
89;13.07.2012;2012;07;04;Perjantai;11;4;15;0;1;1
89;13.07.2012;2012;07;05;Perjantai;8;18;26;2;1;3
89;13.07.2012;2012;07;06;Perjantai;21;65;86;3;4;7
89;13.07.2012;2012;07;07;Perjantai;20;95;115;5;13;18
89;13.07.2012;2012;07;08;Perjantai;40;108;148;13;14;27
89;13.07.2012;2012;07;09;Perjantai;31;85;116;20;22;42
89;13.07.2012;2012;07;10;Perjantai;51;99;150;22;37;59
89;13.07.2012;2012;07;11;Perjantai;72;133;205;17;47;64
89;13.07.2012;2012;07;12;Perjantai;99;146;245;20;27;47
89;13.07.2012;2012;07;13;Perjantai;113;97;210;21;17;38
89;13.07.2012;2012;07;14;Perjantai;141;64;205;16;11;27
89;13.07.2012;2012;07;15;Perjantai;129;86;215;24;16;40
89;13.07.2012;2012;07;16;Perjantai;120;49;169;22;21;43
89;13.07.2012;2012;07;17;Perjantai;83;49;132;27;16;43
89;13.07.2012;2012;07;18;Perjantai;41;43;84;10;7;17
89;13.07.2012;2012;07;19;Perjantai;45;24;69;5;5;10
89;13.07.2012;2012;07;20;Perjantai;30;33;63;5;7;12
89;13.07.2012;2012;07;21;Perjantai;23;25;48;6;8;14
89;13.07.2012;2012;07;22;Perjantai;12;21;33;5;6;11
89;13.07.2012;2012;07;23;Perjantai;17;12;29;2;7;9
89;14.07.2012;2012;07;00;Lauantai;20;16;36;5;3;8
89;14.07.2012;2012;07;01;Lauantai;12;3;15;1;3;4
89;14.07.2012;2012;07;02;Lauantai;18;2;20;5;1;6
89;14.07.2012;2012;07;03;Lauantai;17;2;19;4;1;5
89;14.07.2012;2012;07;04;Lauantai;15;4;19;11;1;12
89;14.07.2012;2012;07;05;Lauantai;12;6;18;6;1;7
89;14.07.2012;2012;07;06;Lauantai;1;11;12;2;2;4
89;14.07.2012;2012;07;07;Lauantai;7;15;22;0;8;8
89;14.07.2012;2012;07;08;Lauantai;12;22;34;10;10;20
89;14.07.2012;2012;07;09;Lauantai;21;54;75;13;23;36
89;14.07.2012;2012;07;10;Lauantai;31;80;111;19;35;54
89;14.07.2012;2012;07;11;Lauantai;47;124;171;28;32;60
89;14.07.2012;2012;07;12;Lauantai;85;113;198;26;26;52
89;14.07.2012;2012;07;13;Lauantai;102;76;178;17;24;41
89;14.07.2012;2012;07;14;Lauantai;53;31;84;6;14;20
89;14.07.2012;2012;07;15;Lauantai;71;44;115;15;17;32
89;14.07.2012;2012;07;16;Lauantai;58;57;115;16;18;34
89;14.07.2012;2012;07;17;Lauantai;62;67;129;14;30;44
89;14.07.2012;2012;07;18;Lauantai;83;88;171;43;39;82
89;14.07.2012;2012;07;19;Lauantai;63;87;150;12;37;49
89;14.07.2012;2012;07;20;Lauantai;44;56;100;33;26;59
89;14.07.2012;2012;07;21;Lauantai;45;83;128;6;22;28
89;14.07.2012;2012;07;22;Lauantai;35;79;114;2;28;30
89;14.07.2012;2012;07;23;Lauantai;35;51;86;6;7;13
89;15.07.2012;2012;07;00;Sunnuntai;55;22;77;10;8;18
89;15.07.2012;2012;07;01;Sunnuntai;28;11;39;4;3;7
89;15.07.2012;2012;07;02;Sunnuntai;34;13;47;10;2;12
89;15.07.2012;2012;07;03;Sunnuntai;59;0;59;11;0;11
89;15.07.2012;2012;07;04;Sunnuntai;34;3;37;12;0;12
89;15.07.2012;2012;07;05;Sunnuntai;6;6;12;1;2;3
89;15.07.2012;2012;07;06;Sunnuntai;7;8;15;2;2;4
89;15.07.2012;2012;07;07;Sunnuntai;4;9;13;6;7;13
89;15.07.2012;2012;07;08;Sunnuntai;18;18;36;6;13;19
89;15.07.2012;2012;07;09;Sunnuntai;30;28;58;10;14;24
89;15.07.2012;2012;07;10;Sunnuntai;22;74;96;33;48;81
89;15.07.2012;2012;07;11;Sunnuntai;41;112;153;45;65;110
89;15.07.2012;2012;07;12;Sunnuntai;112;152;264;47;64;111
89;15.07.2012;2012;07;13;Sunnuntai;146;205;351;41;88;129
89;15.07.2012;2012;07;14;Sunnuntai;173;123;296;36;44;80
89;15.07.2012;2012;07;15;Sunnuntai;147;160;307;67;60;127
89;15.07.2012;2012;07;16;Sunnuntai;170;127;297;72;46;118
89;15.07.2012;2012;07;17;Sunnuntai;162;153;315;37;55;92
89;15.07.2012;2012;07;18;Sunnuntai;151;111;262;39;40;79
89;15.07.2012;2012;07;19;Sunnuntai;114;103;217;29;31;60
89;15.07.2012;2012;07;20;Sunnuntai;138;77;215;59;30;89
89;15.07.2012;2012;07;21;Sunnuntai;61;47;108;19;16;35
89;15.07.2012;2012;07;22;Sunnuntai;63;23;86;19;10;29
89;15.07.2012;2012;07;23;Sunnuntai;28;20;48;5;11;16
89;16.07.2012;2012;07;00;Maanantai;23;11;34;4;3;7
89;16.07.2012;2012;07;01;Maanantai;9;2;11;2;1;3
89;16.07.2012;2012;07;02;Maanantai;8;5;13;2;3;5
89;16.07.2012;2012;07;03;Maanantai;10;3;13;1;1;2
89;16.07.2012;2012;07;04;Maanantai;5;6;11;4;1;5
89;16.07.2012;2012;07;05;Maanantai;12;12;24;1;3;4
89;16.07.2012;2012;07;06;Maanantai;23;77;100;1;3;4
89;16.07.2012;2012;07;07;Maanantai;26;113;139;5;9;14
89;16.07.2012;2012;07;08;Maanantai;29;105;134;6;15;21
89;16.07.2012;2012;07;09;Maanantai;33;98;131;7;31;38
89;16.07.2012;2012;07;10;Maanantai;68;138;206;30;38;68
89;16.07.2012;2012;07;11;Maanantai;79;158;237;26;64;90
89;16.07.2012;2012;07;12;Maanantai;119;163;282;39;55;94
89;16.07.2012;2012;07;13;Maanantai;136;194;330;44;48;92
89;16.07.2012;2012;07;14;Maanantai;192;149;341;36;28;64
89;16.07.2012;2012;07;15;Maanantai;232;151;383;38;33;71
89;16.07.2012;2012;07;16;Maanantai;231;154;385;47;34;81
89;16.07.2012;2012;07;17;Maanantai;181;150;331;42;48;90
89;16.07.2012;2012;07;18;Maanantai;138;179;317;46;56;102
89;16.07.2012;2012;07;19;Maanantai;201;106;307;62;36;98
89;16.07.2012;2012;07;20;Maanantai;131;88;219;30;39;69
89;16.07.2012;2012;07;21;Maanantai;84;58;142;17;15;32
89;16.07.2012;2012;07;22;Maanantai;37;40;77;11;15;26
89;16.07.2012;2012;07;23;Maanantai;30;26;56;3;5;8
89;17.07.2012;2012;07;00;Tiistai;12;10;22;3;7;10
89;17.07.2012;2012;07;01;Tiistai;10;5;15;4;2;6
89;17.07.2012;2012;07;02;Tiistai;8;2;10;1;2;3
89;17.07.2012;2012;07;03;Tiistai;10;4;14;0;0;0
89;17.07.2012;2012;07;04;Tiistai;7;8;15;0;0;0
89;17.07.2012;2012;07;05;Tiistai;4;12;16;1;6;7
89;17.07.2012;2012;07;06;Tiistai;22;87;109;3;9;12
89;17.07.2012;2012;07;07;Tiistai;25;121;146;6;15;21
89;17.07.2012;2012;07;08;Tiistai;24;103;127;19;32;51
89;17.07.2012;2012;07;09;Tiistai;47;111;158;13;22;35
89;17.07.2012;2012;07;10;Tiistai;86;121;207;15;47;62
89;17.07.2012;2012;07;11;Tiistai;104;204;308;31;35;66
89;17.07.2012;2012;07;12;Tiistai;131;150;281;29;46;75
89;17.07.2012;2012;07;13;Tiistai;171;176;347;23;32;55
89;17.07.2012;2012;07;14;Tiistai;219;147;366;30;22;52
89;17.07.2012;2012;07;15;Tiistai;205;186;391;43;46;89
89;17.07.2012;2012;07;16;Tiistai;269;187;456;45;32;77
89;17.07.2012;2012;07;17;Tiistai;228;174;402;45;53;98
89;17.07.2012;2012;07;18;Tiistai;174;169;343;38;42;80
89;17.07.2012;2012;07;19;Tiistai;184;106;290;60;49;109
89;17.07.2012;2012;07;20;Tiistai;120;107;227;36;32;68
89;17.07.2012;2012;07;21;Tiistai;80;44;124;27;22;49
89;17.07.2012;2012;07;22;Tiistai;45;27;72;12;15;27
89;17.07.2012;2012;07;23;Tiistai;18;11;29;7;4;11
89;18.07.2012;2012;07;00;Keskiviikko;16;14;30;0;4;4
89;18.07.2012;2012;07;01;Keskiviikko;14;9;23;3;0;3
89;18.07.2012;2012;07;02;Keskiviikko;6;3;9;2;1;3
89;18.07.2012;2012;07;03;Keskiviikko;9;3;12;5;2;7
89;18.07.2012;2012;07;04;Keskiviikko;6;5;11;6;0;6
89;18.07.2012;2012;07;05;Keskiviikko;4;19;23;2;2;4
89;18.07.2012;2012;07;06;Keskiviikko;21;78;99;2;2;4
89;18.07.2012;2012;07;07;Keskiviikko;29;117;146;2;15;17
89;18.07.2012;2012;07;08;Keskiviikko;28;131;159;9;19;28
89;18.07.2012;2012;07;09;Keskiviikko;32;116;148;7;27;34
89;18.07.2012;2012;07;10;Keskiviikko;66;130;196;23;38;61
89;18.07.2012;2012;07;11;Keskiviikko;81;136;217;19;39;58
89;18.07.2012;2012;07;12;Keskiviikko;109;150;259;28;43;71
89;18.07.2012;2012;07;13;Keskiviikko;157;167;324;31;46;77
89;18.07.2012;2012;07;14;Keskiviikko;161;178;339;38;41;79
89;18.07.2012;2012;07;15;Keskiviikko;226;156;382;46;33;79
89;18.07.2012;2012;07;16;Keskiviikko;248;184;432;46;28;74
89;18.07.2012;2012;07;17;Keskiviikko;218;179;397;36;42;78
89;18.07.2012;2012;07;18;Keskiviikko;171;164;335;47;61;108
89;18.07.2012;2012;07;19;Keskiviikko;149;98;247;38;37;75
89;18.07.2012;2012;07;20;Keskiviikko;134;87;221;23;18;41
89;18.07.2012;2012;07;21;Keskiviikko;106;59;165;23;14;37
89;18.07.2012;2012;07;22;Keskiviikko;40;32;72;9;11;20
89;18.07.2012;2012;07;23;Keskiviikko;43;34;77;7;8;15
89;19.07.2012;2012;07;00;Torstai;18;13;31;3;4;7
89;19.07.2012;2012;07;01;Torstai;15;13;28;3;3;6
89;19.07.2012;2012;07;02;Torstai;15;9;24;4;1;5
89;19.07.2012;2012;07;03;Torstai;21;3;24;6;1;7
89;19.07.2012;2012;07;04;Torstai;17;3;20;5;2;7
89;19.07.2012;2012;07;05;Torstai;7;13;20;1;0;1
89;19.07.2012;2012;07;06;Torstai;18;68;86;2;6;8
89;19.07.2012;2012;07;07;Torstai;27;115;142;4;13;17
89;19.07.2012;2012;07;08;Torstai;26;92;118;6;26;32
89;19.07.2012;2012;07;09;Torstai;31;92;123;10;21;31
89;19.07.2012;2012;07;10;Torstai;47;87;134;13;29;42
89;19.07.2012;2012;07;11;Torstai;33;55;88;11;16;27
89;19.07.2012;2012;07;12;Torstai;44;75;119;14;23;37
89;19.07.2012;2012;07;13;Torstai;63;83;146;5;15;20
89;19.07.2012;2012;07;14;Torstai;81;70;151;11;16;27
89;19.07.2012;2012;07;15;Torstai;125;98;223;15;13;28
89;19.07.2012;2012;07;16;Torstai;145;92;237;21;15;36
89;19.07.2012;2012;07;17;Torstai;126;83;209;22;25;47
89;19.07.2012;2012;07;18;Torstai;91;104;195;38;47;85
89;19.07.2012;2012;07;19;Torstai;84;75;159;17;29;46
89;19.07.2012;2012;07;20;Torstai;87;52;139;26;17;43
89;19.07.2012;2012;07;21;Torstai;77;33;110;15;10;25
89;19.07.2012;2012;07;22;Torstai;34;22;56;12;6;18
89;19.07.2012;2012;07;23;Torstai;14;18;32;2;2;4
89;20.07.2012;2012;07;00;Perjantai;13;11;24;2;4;6
89;20.07.2012;2012;07;01;Perjantai;8;3;11;2;0;2
89;20.07.2012;2012;07;02;Perjantai;13;5;18;2;2;4
89;20.07.2012;2012;07;03;Perjantai;5;2;7;4;0;4
89;20.07.2012;2012;07;04;Perjantai;3;1;4;2;1;3
89;20.07.2012;2012;07;05;Perjantai;6;19;25;3;3;6
89;20.07.2012;2012;07;06;Perjantai;23;72;95;2;4;6
89;20.07.2012;2012;07;07;Perjantai;23;82;105;4;9;13
89;20.07.2012;2012;07;08;Perjantai;28;93;121;11;25;36
89;20.07.2012;2012;07;09;Perjantai;24;94;118;15;28;43
89;20.07.2012;2012;07;10;Perjantai;64;117;181;30;31;61
89;20.07.2012;2012;07;11;Perjantai;81;152;233;15;39;54
89;20.07.2012;2012;07;12;Perjantai;118;157;275;24;38;62
89;20.07.2012;2012;07;13;Perjantai;135;134;269;33;37;70
89;20.07.2012;2012;07;14;Perjantai;168;136;304;35;37;72
89;20.07.2012;2012;07;15;Perjantai;197;127;324;32;29;61
89;20.07.2012;2012;07;16;Perjantai;178;148;326;41;40;81
89;20.07.2012;2012;07;17;Perjantai;148;117;265;32;25;57
89;20.07.2012;2012;07;18;Perjantai;127;113;240;19;24;43
89;20.07.2012;2012;07;19;Perjantai;122;95;217;29;32;61
89;20.07.2012;2012;07;20;Perjantai;106;99;205;36;38;74
89;20.07.2012;2012;07;21;Perjantai;65;84;149;24;41;65
89;20.07.2012;2012;07;22;Perjantai;54;78;132;20;20;40
89;20.07.2012;2012;07;23;Perjantai;64;81;145;6;20;26
89;21.07.2012;2012;07;00;Lauantai;46;32;78;8;6;14
89;21.07.2012;2012;07;01;Lauantai;39;40;79;4;3;7
89;21.07.2012;2012;07;02;Lauantai;34;11;45;2;3;5
89;21.07.2012;2012;07;03;Lauantai;38;4;42;6;0;6
89;21.07.2012;2012;07;04;Lauantai;27;5;32;7;3;10
89;21.07.2012;2012;07;05;Lauantai;6;13;19;3;2;5
89;21.07.2012;2012;07;06;Lauantai;9;9;18;2;2;4
89;21.07.2012;2012;07;07;Lauantai;11;18;29;3;6;9
89;21.07.2012;2012;07;08;Lauantai;15;32;47;9;13;22
89;21.07.2012;2012;07;09;Lauantai;38;89;127;11;15;26
89;21.07.2012;2012;07;10;Lauantai;48;108;156;20;45;65
89;21.07.2012;2012;07;11;Lauantai;61;77;138;12;19;31
89;21.07.2012;2012;07;12;Lauantai;44;47;91;11;24;35
89;21.07.2012;2012;07;13;Lauantai;37;46;83;7;9;16
89;21.07.2012;2012;07;14;Lauantai;58;55;113;21;18;39
89;21.07.2012;2012;07;15;Lauantai;63;59;122;13;12;25
89;21.07.2012;2012;07;16;Lauantai;67;59;126;29;34;63
89;21.07.2012;2012;07;17;Lauantai;60;102;162;19;36;55
89;21.07.2012;2012;07;18;Lauantai;76;64;140;21;27;48
89;21.07.2012;2012;07;19;Lauantai;55;71;126;45;25;70
89;21.07.2012;2012;07;20;Lauantai;72;78;150;22;26;48
89;21.07.2012;2012;07;21;Lauantai;51;67;118;15;12;27
89;21.07.2012;2012;07;22;Lauantai;26;56;82;5;12;17
89;21.07.2012;2012;07;23;Lauantai;40;54;94;8;15;23
89;22.07.2012;2012;07;00;Sunnuntai;37;33;70;3;6;9
89;22.07.2012;2012;07;01;Sunnuntai;30;20;50;4;4;8
89;22.07.2012;2012;07;02;Sunnuntai;36;4;40;7;2;9
89;22.07.2012;2012;07;03;Sunnuntai;28;3;31;16;1;17
89;22.07.2012;2012;07;04;Sunnuntai;22;2;24;10;0;10
89;22.07.2012;2012;07;05;Sunnuntai;10;5;15;4;4;8
89;22.07.2012;2012;07;06;Sunnuntai;8;10;18;1;4;5
89;22.07.2012;2012;07;07;Sunnuntai;8;7;15;3;3;6
89;22.07.2012;2012;07;08;Sunnuntai;10;13;23;13;15;28
89;22.07.2012;2012;07;09;Sunnuntai;16;44;60;17;12;29
89;22.07.2012;2012;07;10;Sunnuntai;38;73;111;23;36;59
89;22.07.2012;2012;07;11;Sunnuntai;62;98;160;49;58;107
89;22.07.2012;2012;07;12;Sunnuntai;89;114;203;47;65;112
89;22.07.2012;2012;07;13;Sunnuntai;104;131;235;53;83;136
89;22.07.2012;2012;07;14;Sunnuntai;117;120;237;33;43;76
89;22.07.2012;2012;07;15;Sunnuntai;117;91;208;38;38;76
89;22.07.2012;2012;07;16;Sunnuntai;152;105;257;54;46;100
89;22.07.2012;2012;07;17;Sunnuntai;90;93;183;32;54;86
89;22.07.2012;2012;07;18;Sunnuntai;80;62;142;28;36;64
89;22.07.2012;2012;07;19;Sunnuntai;50;55;105;25;27;52
89;22.07.2012;2012;07;20;Sunnuntai;85;42;127;44;21;65
89;22.07.2012;2012;07;21;Sunnuntai;38;24;62;11;7;18
89;22.07.2012;2012;07;22;Sunnuntai;24;22;46;5;9;14
89;22.07.2012;2012;07;23;Sunnuntai;11;9;20;4;2;6
89;23.07.2012;2012;07;00;Maanantai;6;10;16;2;0;2
89;23.07.2012;2012;07;01;Maanantai;4;10;14;0;0;0
89;23.07.2012;2012;07;02;Maanantai;3;4;7;3;2;5
89;23.07.2012;2012;07;03;Maanantai;6;1;7;0;0;0
89;23.07.2012;2012;07;04;Maanantai;10;4;14;2;0;2
89;23.07.2012;2012;07;05;Maanantai;9;20;29;1;3;4
89;23.07.2012;2012;07;06;Maanantai;26;83;109;4;5;9
89;23.07.2012;2012;07;07;Maanantai;25;112;137;6;9;15
89;23.07.2012;2012;07;08;Maanantai;30;115;145;7;22;29
89;23.07.2012;2012;07;09;Maanantai;39;107;146;8;16;24
89;23.07.2012;2012;07;10;Maanantai;60;105;165;21;38;59
89;23.07.2012;2012;07;11;Maanantai;87;149;236;30;34;64
89;23.07.2012;2012;07;12;Maanantai;106;148;254;24;37;61
89;23.07.2012;2012;07;13;Maanantai;131;141;272;44;35;79
89;23.07.2012;2012;07;14;Maanantai;205;124;329;27;27;54
89;23.07.2012;2012;07;15;Maanantai;198;77;275;24;13;37
89;23.07.2012;2012;07;16;Maanantai;174;99;273;31;22;53
89;23.07.2012;2012;07;17;Maanantai;131;75;206;32;24;56
89;23.07.2012;2012;07;18;Maanantai;113;117;230;33;34;67
89;23.07.2012;2012;07;19;Maanantai;130;52;182;29;29;58
89;23.07.2012;2012;07;20;Maanantai;66;34;100;18;19;37
89;23.07.2012;2012;07;21;Maanantai;39;30;69;16;36;52
89;23.07.2012;2012;07;22;Maanantai;39;10;49;5;3;8
89;23.07.2012;2012;07;23;Maanantai;10;9;19;1;1;2
89;24.07.2012;2012;07;00;Tiistai;4;9;13;1;1;2
89;24.07.2012;2012;07;01;Tiistai;7;5;12;1;2;3
89;24.07.2012;2012;07;02;Tiistai;10;1;11;3;0;3
89;24.07.2012;2012;07;03;Tiistai;3;3;6;0;0;0
89;24.07.2012;2012;07;04;Tiistai;3;3;6;1;0;1
89;24.07.2012;2012;07;05;Tiistai;6;20;26;0;3;3
89;24.07.2012;2012;07;06;Tiistai;18;70;88;3;6;9
89;24.07.2012;2012;07;07;Tiistai;20;121;141;1;15;16
89;24.07.2012;2012;07;08;Tiistai;29;113;142;5;26;31
89;24.07.2012;2012;07;09;Tiistai;33;106;139;11;22;33
89;24.07.2012;2012;07;10;Tiistai;67;106;173;26;32;58
89;24.07.2012;2012;07;11;Tiistai;92;165;257;17;37;54
89;24.07.2012;2012;07;12;Tiistai;132;178;310;23;49;72
89;24.07.2012;2012;07;13;Tiistai;141;167;308;38;61;99
89;24.07.2012;2012;07;14;Tiistai;209;174;383;44;49;93
89;24.07.2012;2012;07;15;Tiistai;221;185;406;34;42;76
89;24.07.2012;2012;07;16;Tiistai;271;184;455;44;47;91
89;24.07.2012;2012;07;17;Tiistai;205;152;357;26;32;58
89;24.07.2012;2012;07;18;Tiistai;160;128;288;29;38;67
89;24.07.2012;2012;07;19;Tiistai;152;132;284;42;39;81
89;24.07.2012;2012;07;20;Tiistai;116;80;196;25;35;60
89;24.07.2012;2012;07;21;Tiistai;85;50;135;23;20;43
89;24.07.2012;2012;07;22;Tiistai;69;25;94;9;17;26
89;24.07.2012;2012;07;23;Tiistai;31;25;56;6;10;16
89;25.07.2012;2012;07;00;Keskiviikko;28;17;45;2;3;5
89;25.07.2012;2012;07;01;Keskiviikko;10;11;21;1;0;1
89;25.07.2012;2012;07;02;Keskiviikko;15;1;16;2;1;3
89;25.07.2012;2012;07;03;Keskiviikko;5;2;7;4;2;6
89;25.07.2012;2012;07;04;Keskiviikko;3;3;6;2;1;3
89;25.07.2012;2012;07;05;Keskiviikko;3;28;31;2;2;4
89;25.07.2012;2012;07;06;Keskiviikko;26;76;102;3;8;11
89;25.07.2012;2012;07;07;Keskiviikko;24;125;149;2;17;19
89;25.07.2012;2012;07;08;Keskiviikko;40;133;173;5;29;34
89;25.07.2012;2012;07;09;Keskiviikko;39;89;128;21;30;51
89;25.07.2012;2012;07;10;Keskiviikko;71;138;209;25;35;60
89;25.07.2012;2012;07;11;Keskiviikko;109;177;286;27;54;81
89;25.07.2012;2012;07;12;Keskiviikko;107;162;269;30;65;95
89;25.07.2012;2012;07;13;Keskiviikko;130;141;271;39;46;85
89;25.07.2012;2012;07;14;Keskiviikko;166;134;300;20;28;48
89;25.07.2012;2012;07;15;Keskiviikko;175;129;304;31;19;50
89;25.07.2012;2012;07;16;Keskiviikko;173;98;271;23;24;47
89;25.07.2012;2012;07;17;Keskiviikko;117;51;168;17;12;29
89;25.07.2012;2012;07;18;Keskiviikko;80;50;130;20;25;45
89;25.07.2012;2012;07;19;Keskiviikko;49;34;83;24;16;40
89;25.07.2012;2012;07;20;Keskiviikko;59;28;87;15;13;28
89;25.07.2012;2012;07;21;Keskiviikko;43;34;77;23;10;33
89;25.07.2012;2012;07;22;Keskiviikko;22;24;46;10;10;20
89;25.07.2012;2012;07;23;Keskiviikko;16;20;36;7;4;11
89;26.07.2012;2012;07;00;Torstai;18;13;31;3;2;5
89;26.07.2012;2012;07;01;Torstai;11;3;14;2;0;2
89;26.07.2012;2012;07;02;Torstai;9;1;10;0;0;0
89;26.07.2012;2012;07;03;Torstai;16;1;17;2;0;2
89;26.07.2012;2012;07;04;Torstai;6;3;9;2;0;2
89;26.07.2012;2012;07;05;Torstai;8;27;35;4;0;4
89;26.07.2012;2012;07;06;Torstai;19;87;106;4;7;11
89;26.07.2012;2012;07;07;Torstai;24;129;153;2;13;15
89;26.07.2012;2012;07;08;Torstai;37;128;165;8;17;25
89;26.07.2012;2012;07;09;Torstai;47;95;142;16;22;38
89;26.07.2012;2012;07;10;Torstai;61;139;200;28;58;86
89;26.07.2012;2012;07;11;Torstai;96;168;264;25;46;71
89;26.07.2012;2012;07;12;Torstai;112;137;249;30;52;82
89;26.07.2012;2012;07;13;Torstai;133;166;299;33;54;87
89;26.07.2012;2012;07;14;Torstai;176;162;338;30;41;71
89;26.07.2012;2012;07;15;Torstai;236;162;398;30;50;80
89;26.07.2012;2012;07;16;Torstai;229;180;409;40;40;80
89;26.07.2012;2012;07;17;Torstai;186;247;433;51;64;115
89;26.07.2012;2012;07;18;Torstai;158;232;390;49;70;119
89;26.07.2012;2012;07;19;Torstai;191;152;343;47;37;84
89;26.07.2012;2012;07;20;Torstai;185;109;294;32;31;63
89;26.07.2012;2012;07;21;Torstai;150;75;225;37;13;50
89;26.07.2012;2012;07;22;Torstai;91;47;138;9;17;26
89;26.07.2012;2012;07;23;Torstai;69;27;96;15;14;29
89;27.07.2012;2012;07;00;Perjantai;32;16;48;5;2;7
89;27.07.2012;2012;07;01;Perjantai;24;4;28;2;2;4
89;27.07.2012;2012;07;02;Perjantai;23;3;26;2;1;3
89;27.07.2012;2012;07;03;Perjantai;10;4;14;1;0;1
89;27.07.2012;2012;07;04;Perjantai;5;5;10;3;2;5
89;27.07.2012;2012;07;05;Perjantai;6;19;25;0;2;2
89;27.07.2012;2012;07;06;Perjantai;22;79;101;3;3;6
89;27.07.2012;2012;07;07;Perjantai;19;98;117;6;15;21
89;27.07.2012;2012;07;08;Perjantai;27;116;143;9;18;27
89;27.07.2012;2012;07;09;Perjantai;36;103;139;10;21;31
89;27.07.2012;2012;07;10;Perjantai;43;116;159;23;30;53
89;27.07.2012;2012;07;11;Perjantai;96;156;252;18;41;59
89;27.07.2012;2012;07;12;Perjantai;128;182;310;20;38;58
89;27.07.2012;2012;07;13;Perjantai;186;217;403;34;54;88
89;27.07.2012;2012;07;14;Perjantai;220;177;397;32;31;63
89;27.07.2012;2012;07;15;Perjantai;240;191;431;31;44;75
89;27.07.2012;2012;07;16;Perjantai;233;185;418;37;42;79
89;27.07.2012;2012;07;17;Perjantai;173;201;374;36;34;70
89;27.07.2012;2012;07;18;Perjantai;172;177;349;35;40;75
89;27.07.2012;2012;07;19;Perjantai;124;185;309;12;52;64
89;27.07.2012;2012;07;20;Perjantai;117;129;246;19;30;49
89;27.07.2012;2012;07;21;Perjantai;112;101;213;13;19;32
89;27.07.2012;2012;07;22;Perjantai;69;65;134;14;25;39
89;27.07.2012;2012;07;23;Perjantai;84;50;134;16;19;35
89;28.07.2012;2012;07;00;Lauantai;97;27;124;7;6;13
89;28.07.2012;2012;07;01;Lauantai;108;22;130;23;5;28
89;28.07.2012;2012;07;02;Lauantai;78;7;85;18;2;20
89;28.07.2012;2012;07;03;Lauantai;43;7;50;5;2;7
89;28.07.2012;2012;07;04;Lauantai;38;1;39;19;0;19
89;28.07.2012;2012;07;05;Lauantai;11;8;19;5;3;8
89;28.07.2012;2012;07;06;Lauantai;7;9;16;2;5;7
89;28.07.2012;2012;07;07;Lauantai;9;22;31;3;6;9
89;28.07.2012;2012;07;08;Lauantai;16;40;56;5;11;16
89;28.07.2012;2012;07;09;Lauantai;20;89;109;13;17;30
89;28.07.2012;2012;07;10;Lauantai;55;128;183;8;30;38
89;28.07.2012;2012;07;11;Lauantai;91;162;253;25;49;74
89;28.07.2012;2012;07;12;Lauantai;146;213;359;25;48;73
89;28.07.2012;2012;07;13;Lauantai;165;252;417;31;60;91
89;28.07.2012;2012;07;14;Lauantai;235;195;430;62;62;124
89;28.07.2012;2012;07;15;Lauantai;217;168;385;52;44;96
89;28.07.2012;2012;07;16;Lauantai;191;164;355;32;53;85
89;28.07.2012;2012;07;17;Lauantai;179;174;353;25;38;63
89;28.07.2012;2012;07;18;Lauantai;156;155;311;24;37;61
89;28.07.2012;2012;07;19;Lauantai;117;154;271;20;36;56
89;28.07.2012;2012;07;20;Lauantai;103;169;272;19;34;53
89;28.07.2012;2012;07;21;Lauantai;70;103;173;16;19;35
89;28.07.2012;2012;07;22;Lauantai;76;95;171;13;28;41
89;28.07.2012;2012;07;23;Lauantai;66;78;144;18;35;53
89;29.07.2012;2012;07;00;Sunnuntai;108;24;132;11;11;22
89;29.07.2012;2012;07;01;Sunnuntai;119;19;138;16;4;20
89;29.07.2012;2012;07;02;Sunnuntai;92;12;104;20;2;22
89;29.07.2012;2012;07;03;Sunnuntai;73;6;79;27;2;29
89;29.07.2012;2012;07;04;Sunnuntai;36;2;38;30;2;32
89;29.07.2012;2012;07;05;Sunnuntai;17;5;22;9;2;11
89;29.07.2012;2012;07;06;Sunnuntai;9;12;21;1;2;3
89;29.07.2012;2012;07;07;Sunnuntai;3;12;15;4;4;8
89;29.07.2012;2012;07;08;Sunnuntai;16;15;31;11;6;17
89;29.07.2012;2012;07;09;Sunnuntai;11;22;33;6;9;15
89;29.07.2012;2012;07;10;Sunnuntai;14;32;46;13;17;30
89;29.07.2012;2012;07;11;Sunnuntai;40;89;129;22;31;53
89;29.07.2012;2012;07;12;Sunnuntai;67;95;162;32;49;81
89;29.07.2012;2012;07;13;Sunnuntai;98;169;267;35;62;97
89;29.07.2012;2012;07;14;Sunnuntai;90;104;194;36;31;67
89;29.07.2012;2012;07;15;Sunnuntai;113;102;215;36;39;75
89;29.07.2012;2012;07;16;Sunnuntai;144;104;248;50;37;87
89;29.07.2012;2012;07;17;Sunnuntai;83;59;142;25;33;58
89;29.07.2012;2012;07;18;Sunnuntai;59;37;96;20;21;41
89;29.07.2012;2012;07;19;Sunnuntai;71;63;134;22;24;46
89;29.07.2012;2012;07;20;Sunnuntai;84;69;153;42;35;77
89;29.07.2012;2012;07;21;Sunnuntai;53;51;104;17;14;31
89;29.07.2012;2012;07;22;Sunnuntai;26;22;48;4;11;15
89;29.07.2012;2012;07;23;Sunnuntai;24;13;37;3;7;10
89;30.07.2012;2012;07;00;Maanantai;4;10;14;2;7;9
89;30.07.2012;2012;07;01;Maanantai;5;4;9;4;2;6
89;30.07.2012;2012;07;02;Maanantai;6;0;6;2;0;2
89;30.07.2012;2012;07;03;Maanantai;5;3;8;0;1;1
89;30.07.2012;2012;07;04;Maanantai;4;4;8;2;2;4
89;30.07.2012;2012;07;05;Maanantai;7;15;22;0;2;2
89;30.07.2012;2012;07;06;Maanantai;20;94;114;6;6;12
89;30.07.2012;2012;07;07;Maanantai;36;150;186;6;17;23
89;30.07.2012;2012;07;08;Maanantai;29;135;164;9;21;30
89;30.07.2012;2012;07;09;Maanantai;53;124;177;6;19;25
89;30.07.2012;2012;07;10;Maanantai;57;104;161;15;27;42
89;30.07.2012;2012;07;11;Maanantai;90;86;176;20;22;42
89;30.07.2012;2012;07;12;Maanantai;72;91;163;17;32;49
89;30.07.2012;2012;07;13;Maanantai;92;104;196;20;35;55
89;30.07.2012;2012;07;14;Maanantai;116;119;235;32;37;69
89;30.07.2012;2012;07;15;Maanantai;252;124;376;40;23;63
89;30.07.2012;2012;07;16;Maanantai;290;157;447;29;21;50
89;30.07.2012;2012;07;17;Maanantai;113;53;166;14;17;31
89;30.07.2012;2012;07;18;Maanantai;88;63;151;7;10;17
89;30.07.2012;2012;07;19;Maanantai;59;32;91;9;9;18
89;30.07.2012;2012;07;20;Maanantai;53;20;73;8;4;12
89;30.07.2012;2012;07;21;Maanantai;40;34;74;10;13;23
89;30.07.2012;2012;07;22;Maanantai;28;18;46;12;18;30
89;30.07.2012;2012;07;23;Maanantai;14;16;30;2;6;8
89;31.07.2012;2012;07;00;Tiistai;7;4;11;2;1;3
89;31.07.2012;2012;07;01;Tiistai;10;2;12;5;0;5
89;31.07.2012;2012;07;02;Tiistai;1;2;3;0;1;1
89;31.07.2012;2012;07;03;Tiistai;7;3;10;0;0;0
89;31.07.2012;2012;07;04;Tiistai;1;2;3;2;1;3
89;31.07.2012;2012;07;05;Tiistai;5;19;24;0;1;1
89;31.07.2012;2012;07;06;Tiistai;18;97;115;3;5;8
89;31.07.2012;2012;07;07;Tiistai;37;143;180;5;24;29
89;31.07.2012;2012;07;08;Tiistai;47;147;194;11;26;37
89;31.07.2012;2012;07;09;Tiistai;51;117;168;17;31;48
89;31.07.2012;2012;07;10;Tiistai;60;111;171;31;47;78
89;31.07.2012;2012;07;11;Tiistai;87;137;224;33;48;81
89;31.07.2012;2012;07;12;Tiistai;114;134;248;31;52;83
89;31.07.2012;2012;07;13;Tiistai;119;136;255;33;40;73
89;31.07.2012;2012;07;14;Tiistai;191;123;314;29;33;62
89;31.07.2012;2012;07;15;Tiistai;252;164;416;36;31;67
89;31.07.2012;2012;07;16;Tiistai;248;130;378;35;23;58
89;31.07.2012;2012;07;17;Tiistai;154;94;248;30;29;59
89;31.07.2012;2012;07;18;Tiistai;142;93;235;26;36;62
89;31.07.2012;2012;07;19;Tiistai;115;88;203;29;37;66
89;31.07.2012;2012;07;20;Tiistai;115;73;188;37;19;56
89;31.07.2012;2012;07;21;Tiistai;83;45;128;22;17;39
89;31.07.2012;2012;07;22;Tiistai;24;18;42;6;8;14
89;31.07.2012;2012;07;23;Tiistai;15;13;28;7;2;9
89;01.08.2012;2012;08;00;Keskiviikko;13;4;17;1;3;4
89;01.08.2012;2012;08;01;Keskiviikko;9;9;18;4;2;6
89;01.08.2012;2012;08;02;Keskiviikko;8;3;11;2;0;2
89;01.08.2012;2012;08;03;Keskiviikko;3;3;6;1;1;2
89;01.08.2012;2012;08;04;Keskiviikko;8;3;11;1;0;1
89;01.08.2012;2012;08;05;Keskiviikko;10;16;26;2;3;5
89;01.08.2012;2012;08;06;Keskiviikko;23;92;115;3;8;11
89;01.08.2012;2012;08;07;Keskiviikko;45;173;218;3;24;27
89;01.08.2012;2012;08;08;Keskiviikko;38;174;212;13;20;33
89;01.08.2012;2012;08;09;Keskiviikko;38;132;170;15;22;37
89;01.08.2012;2012;08;10;Keskiviikko;73;109;182;18;38;56
89;01.08.2012;2012;08;11;Keskiviikko;77;170;247;26;40;66
89;01.08.2012;2012;08;12;Keskiviikko;105;170;275;30;47;77
89;01.08.2012;2012;08;13;Keskiviikko;126;150;276;22;37;59
89;01.08.2012;2012;08;14;Keskiviikko;192;128;320;32;42;74
89;01.08.2012;2012;08;15;Keskiviikko;226;155;381;25;33;58
89;01.08.2012;2012;08;16;Keskiviikko;293;167;460;38;31;69
89;01.08.2012;2012;08;17;Keskiviikko;169;95;264;15;32;47
89;01.08.2012;2012;08;18;Keskiviikko;142;68;210;35;14;49
89;01.08.2012;2012;08;19;Keskiviikko;102;79;181;36;31;67
89;01.08.2012;2012;08;20;Keskiviikko;107;69;176;23;28;51
89;01.08.2012;2012;08;21;Keskiviikko;69;51;120;14;21;35
89;01.08.2012;2012;08;22;Keskiviikko;45;36;81;12;8;20
89;01.08.2012;2012;08;23;Keskiviikko;41;34;75;8;9;17
89;02.08.2012;2012;08;00;Torstai;14;13;27;3;4;7
89;02.08.2012;2012;08;01;Torstai;10;3;13;2;2;4
89;02.08.2012;2012;08;02;Torstai;5;2;7;4;0;4
89;02.08.2012;2012;08;03;Torstai;11;3;14;2;0;2
89;02.08.2012;2012;08;04;Torstai;13;2;15;6;0;6
89;02.08.2012;2012;08;05;Torstai;13;20;33;5;2;7
89;02.08.2012;2012;08;06;Torstai;24;83;107;2;9;11
89;02.08.2012;2012;08;07;Torstai;37;188;225;5;17;22
89;02.08.2012;2012;08;08;Torstai;36;166;202;6;19;25
89;02.08.2012;2012;08;09;Torstai;54;115;169;12;28;40
89;02.08.2012;2012;08;10;Torstai;54;125;179;20;29;49
89;02.08.2012;2012;08;11;Torstai;86;122;208;20;35;55
89;02.08.2012;2012;08;12;Torstai;100;146;246;16;32;48
89;02.08.2012;2012;08;13;Torstai;116;145;261;38;39;77
89;02.08.2012;2012;08;14;Torstai;153;134;287;31;40;71
89;02.08.2012;2012;08;15;Torstai;214;151;365;34;34;68
89;02.08.2012;2012;08;16;Torstai;270;136;406;40;30;70
89;02.08.2012;2012;08;17;Torstai;122;89;211;18;23;41
89;02.08.2012;2012;08;18;Torstai;94;69;163;17;11;28
89;02.08.2012;2012;08;19;Torstai;84;36;120;7;13;20
89;02.08.2012;2012;08;20;Torstai;79;51;130;21;14;35
89;02.08.2012;2012;08;21;Torstai;56;29;85;13;19;32
89;02.08.2012;2012;08;22;Torstai;40;31;71;5;7;12
89;02.08.2012;2012;08;23;Torstai;17;15;32;2;10;12
89;03.08.2012;2012;08;00;Perjantai;13;6;19;0;5;5
89;03.08.2012;2012;08;01;Perjantai;12;7;19;3;0;3
89;03.08.2012;2012;08;02;Perjantai;8;0;8;2;1;3
89;03.08.2012;2012;08;03;Perjantai;9;2;11;2;1;3
89;03.08.2012;2012;08;04;Perjantai;4;5;9;2;1;3
89;03.08.2012;2012;08;05;Perjantai;6;19;25;3;4;7
89;03.08.2012;2012;08;06;Perjantai;21;71;92;3;5;8
89;03.08.2012;2012;08;07;Perjantai;35;145;180;10;18;28
89;03.08.2012;2012;08;08;Perjantai;42;153;195;4;22;26
89;03.08.2012;2012;08;09;Perjantai;52;95;147;14;32;46
89;03.08.2012;2012;08;10;Perjantai;63;114;177;22;32;54
89;03.08.2012;2012;08;11;Perjantai;77;147;224;23;41;64
89;03.08.2012;2012;08;12;Perjantai;99;144;243;22;42;64
89;03.08.2012;2012;08;13;Perjantai;141;134;275;23;43;66
89;03.08.2012;2012;08;14;Perjantai;177;137;314;45;45;90
89;03.08.2012;2012;08;15;Perjantai;215;120;335;28;23;51
89;03.08.2012;2012;08;16;Perjantai;204;112;316;22;26;48
89;03.08.2012;2012;08;17;Perjantai;132;125;257;15;29;44
89;03.08.2012;2012;08;18;Perjantai;108;100;208;27;21;48
89;03.08.2012;2012;08;19;Perjantai;87;71;158;27;20;47
89;03.08.2012;2012;08;20;Perjantai;89;57;146;26;39;65
89;03.08.2012;2012;08;21;Perjantai;70;69;139;17;30;47
89;03.08.2012;2012;08;22;Perjantai;52;76;128;25;24;49
89;03.08.2012;2012;08;23;Perjantai;39;39;78;22;21;43
89;04.08.2012;2012;08;00;Lauantai;27;26;53;9;25;34
89;04.08.2012;2012;08;01;Lauantai;16;17;33;6;7;13
89;04.08.2012;2012;08;02;Lauantai;37;1;38;6;2;8
89;04.08.2012;2012;08;03;Lauantai;36;5;41;9;0;9
89;04.08.2012;2012;08;04;Lauantai;21;1;22;17;1;18
89;04.08.2012;2012;08;05;Lauantai;11;3;14;2;1;3
89;04.08.2012;2012;08;06;Lauantai;4;8;12;1;4;5
89;04.08.2012;2012;08;07;Lauantai;13;22;35;9;8;17
89;04.08.2012;2012;08;08;Lauantai;20;25;45;11;12;23
89;04.08.2012;2012;08;09;Lauantai;16;63;79;10;32;42
89;04.08.2012;2012;08;10;Lauantai;37;97;134;19;26;45
89;04.08.2012;2012;08;11;Lauantai;46;132;178;17;44;61
89;04.08.2012;2012;08;12;Lauantai;84;118;202;20;39;59
89;04.08.2012;2012;08;13;Lauantai;89;121;210;24;24;48
89;04.08.2012;2012;08;14;Lauantai;84;107;191;26;33;59
89;04.08.2012;2012;08;15;Lauantai;117;89;206;35;29;64
89;04.08.2012;2012;08;16;Lauantai;106;69;175;30;27;57
89;04.08.2012;2012;08;17;Lauantai;121;108;229;25;31;56
89;04.08.2012;2012;08;18;Lauantai;102;102;204;25;24;49
89;04.08.2012;2012;08;19;Lauantai;85;105;190;38;36;74
89;04.08.2012;2012;08;20;Lauantai;68;85;153;23;28;51
89;04.08.2012;2012;08;21;Lauantai;72;96;168;13;27;40
89;04.08.2012;2012;08;22;Lauantai;41;81;122;15;18;33
89;04.08.2012;2012;08;23;Lauantai;59;48;107;9;15;24
89;05.08.2012;2012;08;00;Sunnuntai;44;39;83;5;14;19
89;05.08.2012;2012;08;01;Sunnuntai;31;27;58;3;2;5
89;05.08.2012;2012;08;02;Sunnuntai;34;7;41;10;2;12
89;05.08.2012;2012;08;03;Sunnuntai;44;6;50;9;2;11
89;05.08.2012;2012;08;04;Sunnuntai;32;7;39;12;0;12
89;05.08.2012;2012;08;05;Sunnuntai;12;0;12;2;3;5
89;05.08.2012;2012;08;06;Sunnuntai;7;13;20;2;1;3
89;05.08.2012;2012;08;07;Sunnuntai;5;10;15;6;5;11
89;05.08.2012;2012;08;08;Sunnuntai;16;19;35;11;13;24
89;05.08.2012;2012;08;09;Sunnuntai;28;40;68;16;21;37
89;05.08.2012;2012;08;10;Sunnuntai;33;63;96;22;43;65
89;05.08.2012;2012;08;11;Sunnuntai;78;105;183;42;50;92
89;05.08.2012;2012;08;12;Sunnuntai;87;87;174;41;64;105
89;05.08.2012;2012;08;13;Sunnuntai;85;98;183;39;45;84
89;05.08.2012;2012;08;14;Sunnuntai;95;142;237;31;54;85
89;05.08.2012;2012;08;15;Sunnuntai;98;145;243;38;34;72
89;05.08.2012;2012;08;16;Sunnuntai;121;118;239;43;45;88
89;05.08.2012;2012;08;17;Sunnuntai;113;112;225;43;44;87
89;05.08.2012;2012;08;18;Sunnuntai;139;91;230;42;30;72
89;05.08.2012;2012;08;19;Sunnuntai;102;84;186;27;35;62
89;05.08.2012;2012;08;20;Sunnuntai;84;64;148;13;27;40
89;05.08.2012;2012;08;21;Sunnuntai;59;32;91;10;14;24
89;05.08.2012;2012;08;22;Sunnuntai;35;21;56;6;10;16
89;05.08.2012;2012;08;23;Sunnuntai;26;14;40;4;4;8
89;06.08.2012;2012;08;00;Maanantai;11;14;25;5;6;11
89;06.08.2012;2012;08;01;Maanantai;5;0;5;3;0;3
89;06.08.2012;2012;08;02;Maanantai;5;4;9;3;1;4
89;06.08.2012;2012;08;03;Maanantai;7;5;12;1;0;1
89;06.08.2012;2012;08;04;Maanantai;6;2;8;4;1;5
89;06.08.2012;2012;08;05;Maanantai;10;19;29;2;2;4
89;06.08.2012;2012;08;06;Maanantai;23;79;102;2;8;10
89;06.08.2012;2012;08;07;Maanantai;41;176;217;8;19;27
89;06.08.2012;2012;08;08;Maanantai;38;193;231;5;21;26
89;06.08.2012;2012;08;09;Maanantai;50;130;180;7;13;20
89;06.08.2012;2012;08;10;Maanantai;52;118;170;13;23;36
89;06.08.2012;2012;08;11;Maanantai;78;122;200;19;37;56
89;06.08.2012;2012;08;12;Maanantai;86;125;211;19;25;44
89;06.08.2012;2012;08;13;Maanantai;111;144;255;15;23;38
89;06.08.2012;2012;08;14;Maanantai;138;118;256;17;39;56
89;06.08.2012;2012;08;15;Maanantai;214;117;331;13;35;48
89;06.08.2012;2012;08;16;Maanantai;271;166;437;33;26;59
89;06.08.2012;2012;08;17;Maanantai;193;116;309;32;38;70
89;06.08.2012;2012;08;18;Maanantai;160;126;286;58;38;96
89;06.08.2012;2012;08;19;Maanantai;167;74;241;32;51;83
89;06.08.2012;2012;08;20;Maanantai;108;65;173;24;34;58
89;06.08.2012;2012;08;21;Maanantai;73;46;119;17;18;35
89;06.08.2012;2012;08;22;Maanantai;35;28;63;10;16;26
89;06.08.2012;2012;08;23;Maanantai;24;19;43;3;9;12
89;07.08.2012;2012;08;00;Tiistai;10;10;20;5;5;10
89;07.08.2012;2012;08;01;Tiistai;12;5;17;3;1;4
89;07.08.2012;2012;08;02;Tiistai;4;3;7;0;0;0
89;07.08.2012;2012;08;03;Tiistai;7;2;9;0;1;1
89;07.08.2012;2012;08;04;Tiistai;3;2;5;0;0;0
89;07.08.2012;2012;08;05;Tiistai;10;22;32;1;3;4
89;07.08.2012;2012;08;06;Tiistai;27;95;122;5;8;13
89;07.08.2012;2012;08;07;Tiistai;47;186;233;5;13;18
89;07.08.2012;2012;08;08;Tiistai;46;208;254;9;21;30
89;07.08.2012;2012;08;09;Tiistai;43;133;176;15;23;38
89;07.08.2012;2012;08;10;Tiistai;65;92;157;20;43;63
89;07.08.2012;2012;08;11;Tiistai;68;98;166;15;44;59
89;07.08.2012;2012;08;12;Tiistai;68;59;127;17;13;30
89;07.08.2012;2012;08;13;Tiistai;70;52;122;15;9;24
89;07.08.2012;2012;08;14;Tiistai;93;43;136;7;21;28
89;07.08.2012;2012;08;15;Tiistai;156;57;213;15;10;25
89;07.08.2012;2012;08;16;Tiistai;185;89;274;14;9;23
89;07.08.2012;2012;08;17;Tiistai;97;35;132;7;4;11
89;07.08.2012;2012;08;18;Tiistai;76;29;105;15;17;32
89;07.08.2012;2012;08;19;Tiistai;33;21;54;13;9;22
89;07.08.2012;2012;08;20;Tiistai;41;21;62;9;4;13
89;07.08.2012;2012;08;21;Tiistai;24;10;34;7;3;10
89;07.08.2012;2012;08;22;Tiistai;13;8;21;4;1;5
89;07.08.2012;2012;08;23;Tiistai;6;4;10;1;0;1
89;08.08.2012;2012;08;00;Keskiviikko;6;9;15;2;1;3
89;08.08.2012;2012;08;01;Keskiviikko;6;0;6;0;0;0
89;08.08.2012;2012;08;02;Keskiviikko;0;0;0;0;0;0
89;08.08.2012;2012;08;03;Keskiviikko;2;2;4;0;0;0
89;08.08.2012;2012;08;04;Keskiviikko;3;0;3;0;0;0
89;08.08.2012;2012;08;05;Keskiviikko;3;12;15;0;2;2
89;08.08.2012;2012;08;06;Keskiviikko;25;53;78;2;4;6
89;08.08.2012;2012;08;07;Keskiviikko;18;84;102;2;9;11
89;08.08.2012;2012;08;08;Keskiviikko;21;118;139;3;22;25
89;08.08.2012;2012;08;09;Keskiviikko;13;83;96;5;13;18
89;08.08.2012;2012;08;10;Keskiviikko;27;35;62;7;11;18
89;08.08.2012;2012;08;11;Keskiviikko;28;50;78;10;11;21
89;08.08.2012;2012;08;12;Keskiviikko;39;59;98;18;15;33
89;08.08.2012;2012;08;13;Keskiviikko;75;85;160;16;27;43
89;08.08.2012;2012;08;14;Keskiviikko;87;78;165;18;33;51
89;08.08.2012;2012;08;15;Keskiviikko;136;98;234;35;37;72
89;08.08.2012;2012;08;16;Keskiviikko;181;110;291;28;26;54
89;08.08.2012;2012;08;17;Keskiviikko;119;84;203;32;19;51
89;08.08.2012;2012;08;18;Keskiviikko;111;80;191;26;35;61
89;08.08.2012;2012;08;19;Keskiviikko;105;76;181;39;30;69
89;08.08.2012;2012;08;20;Keskiviikko;86;60;146;34;23;57
89;08.08.2012;2012;08;21;Keskiviikko;62;34;96;18;16;34
89;08.08.2012;2012;08;22;Keskiviikko;33;27;60;6;10;16
89;08.08.2012;2012;08;23;Keskiviikko;12;23;35;5;9;14
89;09.08.2012;2012;08;00;Torstai;8;12;20;3;1;4
89;09.08.2012;2012;08;01;Torstai;15;5;20;2;0;2
89;09.08.2012;2012;08;02;Torstai;4;3;7;3;2;5
89;09.08.2012;2012;08;03;Torstai;13;3;16;3;0;3
89;09.08.2012;2012;08;04;Torstai;6;4;10;0;0;0
89;09.08.2012;2012;08;05;Torstai;4;15;19;2;3;5
89;09.08.2012;2012;08;06;Torstai;28;85;113;3;4;7
89;09.08.2012;2012;08;07;Torstai;42;217;259;2;26;28
89;09.08.2012;2012;08;08;Torstai;50;193;243;5;27;32
89;09.08.2012;2012;08;09;Torstai;47;139;186;21;34;55
89;09.08.2012;2012;08;10;Torstai;55;116;171;37;41;78
89;09.08.2012;2012;08;11;Torstai;86;109;195;34;48;82
89;09.08.2012;2012;08;12;Torstai;92;133;225;41;43;84
89;09.08.2012;2012;08;13;Torstai;126;149;275;28;33;61
89;09.08.2012;2012;08;14;Torstai;148;135;283;36;35;71
89;09.08.2012;2012;08;15;Torstai;244;145;389;46;39;85
89;09.08.2012;2012;08;16;Torstai;304;145;449;57;38;95
89;09.08.2012;2012;08;17;Torstai;160;143;303;53;65;118
89;09.08.2012;2012;08;18;Torstai;147;133;280;40;72;112
89;09.08.2012;2012;08;19;Torstai;137;114;251;37;64;101
89;09.08.2012;2012;08;20;Torstai;110;85;195;31;51;82
89;09.08.2012;2012;08;21;Torstai;64;52;116;26;29;55
89;09.08.2012;2012;08;22;Torstai;33;41;74;16;15;31
89;09.08.2012;2012;08;23;Torstai;22;10;32;4;13;17
89;10.08.2012;2012;08;00;Perjantai;8;10;18;4;2;6
89;10.08.2012;2012;08;01;Perjantai;12;4;16;1;4;5
89;10.08.2012;2012;08;02;Perjantai;6;1;7;4;1;5
89;10.08.2012;2012;08;03;Perjantai;17;4;21;2;1;3
89;10.08.2012;2012;08;04;Perjantai;9;4;13;0;0;0
89;10.08.2012;2012;08;05;Perjantai;9;16;25;1;4;5
89;10.08.2012;2012;08;06;Perjantai;25;86;111;1;4;5
89;10.08.2012;2012;08;07;Perjantai;41;200;241;6;34;40
89;10.08.2012;2012;08;08;Perjantai;55;189;244;6;26;32
89;10.08.2012;2012;08;09;Perjantai;47;138;185;14;37;51
89;10.08.2012;2012;08;10;Perjantai;67;126;193;25;52;77
89;10.08.2012;2012;08;11;Perjantai;88;158;246;33;72;105
89;10.08.2012;2012;08;12;Perjantai;118;180;298;33;67;100
89;10.08.2012;2012;08;13;Perjantai;170;162;332;45;75;120
89;10.08.2012;2012;08;14;Perjantai;202;184;386;33;59;92
89;10.08.2012;2012;08;15;Perjantai;237;153;390;52;62;114
89;10.08.2012;2012;08;16;Perjantai;243;173;416;32;49;81
89;10.08.2012;2012;08;17;Perjantai;150;136;286;27;52;79
89;10.08.2012;2012;08;18;Perjantai;152;162;314;36;59;95
89;10.08.2012;2012;08;19;Perjantai;116;123;239;46;68;114
89;10.08.2012;2012;08;20;Perjantai;106;87;193;45;38;83
89;10.08.2012;2012;08;21;Perjantai;77;81;158;27;40;67
89;10.08.2012;2012;08;22;Perjantai;54;84;138;29;54;83
89;10.08.2012;2012;08;23;Perjantai;36;45;81;14;21;35
89;11.08.2012;2012;08;00;Lauantai;36;16;52;11;11;22
89;11.08.2012;2012;08;01;Lauantai;23;30;53;6;0;6
89;11.08.2012;2012;08;02;Lauantai;29;9;38;9;1;10
89;11.08.2012;2012;08;03;Lauantai;22;5;27;4;3;7
89;11.08.2012;2012;08;04;Lauantai;34;6;40;12;4;16
89;11.08.2012;2012;08;05;Lauantai;6;8;14;3;1;4
89;11.08.2012;2012;08;06;Lauantai;7;10;17;1;2;3
89;11.08.2012;2012;08;07;Lauantai;7;20;27;4;10;14
89;11.08.2012;2012;08;08;Lauantai;24;46;70;11;18;29
89;11.08.2012;2012;08;09;Lauantai;31;104;135;35;46;81
89;11.08.2012;2012;08;10;Lauantai;61;159;220;36;73;109
89;11.08.2012;2012;08;11;Lauantai;79;180;259;50;98;148
89;11.08.2012;2012;08;12;Lauantai;132;215;347;63;98;161
89;11.08.2012;2012;08;13;Lauantai;156;227;383;54;81;135
89;11.08.2012;2012;08;14;Lauantai;158;188;346;86;102;188
89;11.08.2012;2012;08;15;Lauantai;167;164;331;62;107;169
89;11.08.2012;2012;08;16;Lauantai;141;166;307;61;107;168
89;11.08.2012;2012;08;17;Lauantai;157;174;331;90;115;205
89;11.08.2012;2012;08;18;Lauantai;147;147;294;93;118;211
89;11.08.2012;2012;08;19;Lauantai;105;148;253;68;102;170
89;11.08.2012;2012;08;20;Lauantai;74;120;194;46;72;118
89;11.08.2012;2012;08;21;Lauantai;62;70;132;36;45;81
89;11.08.2012;2012;08;22;Lauantai;49;46;95;19;14;33
89;11.08.2012;2012;08;23;Lauantai;40;51;91;14;17;31
89;12.08.2012;2012;08;00;Sunnuntai;32;40;72;9;17;26
89;12.08.2012;2012;08;01;Sunnuntai;40;13;53;10;15;25
89;12.08.2012;2012;08;02;Sunnuntai;23;6;29;10;5;15
89;12.08.2012;2012;08;03;Sunnuntai;26;2;28;9;4;13
89;12.08.2012;2012;08;04;Sunnuntai;27;9;36;11;3;14
89;12.08.2012;2012;08;05;Sunnuntai;15;5;20;4;0;4
89;12.08.2012;2012;08;06;Sunnuntai;10;13;23;3;3;6
89;12.08.2012;2012;08;07;Sunnuntai;6;9;15;3;5;8
89;12.08.2012;2012;08;08;Sunnuntai;8;23;31;11;9;20
89;12.08.2012;2012;08;09;Sunnuntai;26;51;77;20;31;51
89;12.08.2012;2012;08;10;Sunnuntai;43;79;122;25;58;83
89;12.08.2012;2012;08;11;Sunnuntai;86;97;183;44;87;131
89;12.08.2012;2012;08;12;Sunnuntai;86;149;235;63;92;155
89;12.08.2012;2012;08;13;Sunnuntai;116;146;262;58;106;164
89;12.08.2012;2012;08;14;Sunnuntai;120;179;299;64;126;190
89;12.08.2012;2012;08;15;Sunnuntai;121;184;305;86;132;218
89;12.08.2012;2012;08;16;Sunnuntai;169;234;403;78;151;229
89;12.08.2012;2012;08;17;Sunnuntai;160;199;359;87;102;189
89;12.08.2012;2012;08;18;Sunnuntai;182;217;399;82;127;209
89;12.08.2012;2012;08;19;Sunnuntai;121;156;277;80;100;180
89;12.08.2012;2012;08;20;Sunnuntai;125;108;233;53;71;124
89;12.08.2012;2012;08;21;Sunnuntai;66;72;138;23;67;90
89;12.08.2012;2012;08;22;Sunnuntai;38;35;73;18;17;35
89;12.08.2012;2012;08;23;Sunnuntai;16;19;35;8;7;15
89;13.08.2012;2012;08;00;Maanantai;11;4;15;3;2;5
89;13.08.2012;2012;08;01;Maanantai;4;6;10;4;5;9
89;13.08.2012;2012;08;02;Maanantai;4;5;9;1;0;1
89;13.08.2012;2012;08;03;Maanantai;4;1;5;2;0;2
89;13.08.2012;2012;08;04;Maanantai;15;1;16;2;0;2
89;13.08.2012;2012;08;05;Maanantai;5;26;31;2;2;4
89;13.08.2012;2012;08;06;Maanantai;30;99;129;3;4;7
89;13.08.2012;2012;08;07;Maanantai;49;251;300;7;15;22
89;13.08.2012;2012;08;08;Maanantai;88;302;390;12;26;38
89;13.08.2012;2012;08;09;Maanantai;69;229;298;9;48;57
89;13.08.2012;2012;08;10;Maanantai;70;173;243;25;44;69
89;13.08.2012;2012;08;11;Maanantai;119;155;274;25;50;75
89;13.08.2012;2012;08;12;Maanantai;175;172;347;35;44;79
89;13.08.2012;2012;08;13;Maanantai;170;195;365;64;63;127
89;13.08.2012;2012;08;14;Maanantai;242;165;407;50;63;113
89;13.08.2012;2012;08;15;Maanantai;322;212;534;50;46;96
89;13.08.2012;2012;08;16;Maanantai;387;234;621;58;58;116
89;13.08.2012;2012;08;17;Maanantai;253;215;468;68;90;158
89;13.08.2012;2012;08;18;Maanantai;221;222;443;72;98;170
89;13.08.2012;2012;08;19;Maanantai;212;202;414;83;100;183
89;13.08.2012;2012;08;20;Maanantai;185;124;309;51;69;120
89;13.08.2012;2012;08;21;Maanantai;89;81;170;36;52;88
89;13.08.2012;2012;08;22;Maanantai;28;33;61;17;15;32
89;13.08.2012;2012;08;23;Maanantai;9;12;21;2;9;11
89;14.08.2012;2012;08;00;Tiistai;9;3;12;3;0;3
89;14.08.2012;2012;08;01;Tiistai;8;6;14;2;2;4
89;14.08.2012;2012;08;02;Tiistai;6;4;10;3;1;4
89;14.08.2012;2012;08;03;Tiistai;8;4;12;1;1;2
89;14.08.2012;2012;08;04;Tiistai;3;3;6;2;1;3
89;14.08.2012;2012;08;05;Tiistai;13;20;33;0;3;3
89;14.08.2012;2012;08;06;Tiistai;32;106;138;7;4;11
89;14.08.2012;2012;08;07;Tiistai;47;289;336;2;23;25
89;14.08.2012;2012;08;08;Tiistai;91;374;465;9;30;39
89;14.08.2012;2012;08;09;Tiistai;69;175;244;38;46;84
89;14.08.2012;2012;08;10;Tiistai;76;160;236;28;74;102
89;14.08.2012;2012;08;11;Tiistai;132;192;324;30;62;92
89;14.08.2012;2012;08;12;Tiistai;185;205;390;35;79;114
89;14.08.2012;2012;08;13;Tiistai;180;191;371;39;86;125
89;14.08.2012;2012;08;14;Tiistai;220;186;406;39;86;125
89;14.08.2012;2012;08;15;Tiistai;309;225;534;50;80;130
89;14.08.2012;2012;08;16;Tiistai;386;241;627;50;44;94
89;14.08.2012;2012;08;17;Tiistai;248;280;528;56;71;127
89;14.08.2012;2012;08;18;Tiistai;236;271;507;78;122;200
89;14.08.2012;2012;08;19;Tiistai;280;215;495;74;112;186
89;14.08.2012;2012;08;20;Tiistai;177;136;313;45;67;112
89;14.08.2012;2012;08;21;Tiistai;113;71;184;31;43;74
89;14.08.2012;2012;08;22;Tiistai;71;37;108;10;17;27
89;14.08.2012;2012;08;23;Tiistai;28;18;46;7;5;12
89;15.08.2012;2012;08;00;Keskiviikko;13;9;22;3;1;4
89;15.08.2012;2012;08;01;Keskiviikko;1;10;11;0;3;3
89;15.08.2012;2012;08;02;Keskiviikko;4;0;4;6;0;6
89;15.08.2012;2012;08;03;Keskiviikko;7;3;10;1;0;1
89;15.08.2012;2012;08;04;Keskiviikko;1;5;6;0;0;0
89;15.08.2012;2012;08;05;Keskiviikko;9;17;26;1;2;3
89;15.08.2012;2012;08;06;Keskiviikko;28;91;119;2;4;6
89;15.08.2012;2012;08;07;Keskiviikko;52;296;348;5;21;26
89;15.08.2012;2012;08;08;Keskiviikko;89;326;415;14;31;45
89;15.08.2012;2012;08;09;Keskiviikko;68;213;281;14;48;62
89;15.08.2012;2012;08;10;Keskiviikko;82;141;223;26;49;75
89;15.08.2012;2012;08;11;Keskiviikko;108;136;244;33;48;81
89;15.08.2012;2012;08;12;Keskiviikko;168;236;404;35;55;90
89;15.08.2012;2012;08;13;Keskiviikko;173;195;368;42;45;87
89;15.08.2012;2012;08;14;Keskiviikko;269;193;462;35;48;83
89;15.08.2012;2012;08;15;Keskiviikko;295;209;504;47;52;99
89;15.08.2012;2012;08;16;Keskiviikko;396;255;651;56;65;121
89;15.08.2012;2012;08;17;Keskiviikko;246;264;510;51;55;106
89;15.08.2012;2012;08;18;Keskiviikko;233;250;483;48;93;141
89;15.08.2012;2012;08;19;Keskiviikko;218;232;450;60;108;168
89;15.08.2012;2012;08;20;Keskiviikko;185;126;311;48;64;112
89;15.08.2012;2012;08;21;Keskiviikko;139;91;230;29;31;60
89;15.08.2012;2012;08;22;Keskiviikko;43;41;84;13;21;34
89;15.08.2012;2012;08;23;Keskiviikko;28;19;47;12;8;20
89;16.08.2012;2012;08;00;Torstai;8;6;14;3;2;5
89;16.08.2012;2012;08;01;Torstai;15;4;19;4;0;4
89;16.08.2012;2012;08;02;Torstai;15;1;16;7;0;7
89;16.08.2012;2012;08;03;Torstai;7;1;8;7;2;9
89;16.08.2012;2012;08;04;Torstai;20;7;27;3;1;4
89;16.08.2012;2012;08;05;Torstai;9;23;32;1;0;1
89;16.08.2012;2012;08;06;Torstai;25;104;129;2;4;6
89;16.08.2012;2012;08;07;Torstai;54;245;299;4;33;37
89;16.08.2012;2012;08;08;Torstai;94;339;433;16;30;46
89;16.08.2012;2012;08;09;Torstai;77;187;264;11;30;41
89;16.08.2012;2012;08;10;Torstai;92;162;254;15;46;61
89;16.08.2012;2012;08;11;Torstai;111;134;245;33;48;81
89;16.08.2012;2012;08;12;Torstai;135;163;298;34;49;83
89;16.08.2012;2012;08;13;Torstai;143;170;313;41;94;135
89;16.08.2012;2012;08;14;Torstai;231;193;424;39;41;80
89;16.08.2012;2012;08;15;Torstai;310;180;490;42;50;92
89;16.08.2012;2012;08;16;Torstai;358;249;607;50;61;111
89;16.08.2012;2012;08;17;Torstai;200;231;431;31;46;77
89;16.08.2012;2012;08;18;Torstai;221;308;529;34;86;120
89;16.08.2012;2012;08;19;Torstai;191;267;458;44;72;116
89;16.08.2012;2012;08;20;Torstai;194;168;362;49;67;116
89;16.08.2012;2012;08;21;Torstai;184;124;308;36;34;70
89;16.08.2012;2012;08;22;Torstai;157;53;210;20;15;35
89;16.08.2012;2012;08;23;Torstai;95;20;115;16;11;27
89;17.08.2012;2012;08;00;Perjantai;24;8;32;6;4;10
89;17.08.2012;2012;08;01;Perjantai;17;3;20;3;2;5
89;17.08.2012;2012;08;02;Perjantai;18;2;20;6;3;9
89;17.08.2012;2012;08;03;Perjantai;9;2;11;1;0;1
89;17.08.2012;2012;08;04;Perjantai;10;7;17;1;4;5
89;17.08.2012;2012;08;05;Perjantai;3;19;22;0;1;1
89;17.08.2012;2012;08;06;Perjantai;31;75;106;3;6;9
89;17.08.2012;2012;08;07;Perjantai;57;247;304;5;14;19
89;17.08.2012;2012;08;08;Perjantai;83;272;355;12;25;37
89;17.08.2012;2012;08;09;Perjantai;43;172;215;24;38;62
89;17.08.2012;2012;08;10;Perjantai;75;139;214;32;57;89
89;17.08.2012;2012;08;11;Perjantai;114;152;266;19;44;63
89;17.08.2012;2012;08;12;Perjantai;138;180;318;60;83;143
89;17.08.2012;2012;08;13;Perjantai;222;157;379;46;77;123
89;17.08.2012;2012;08;14;Perjantai;266;169;435;41;42;83
89;17.08.2012;2012;08;15;Perjantai;281;196;477;19;38;57
89;17.08.2012;2012;08;16;Perjantai;255;189;444;48;44;92
89;17.08.2012;2012;08;17;Perjantai;159;187;346;26;47;73
89;17.08.2012;2012;08;18;Perjantai;194;167;361;50;69;119
89;17.08.2012;2012;08;19;Perjantai;148;194;342;36;72;108
89;17.08.2012;2012;08;20;Perjantai;131;145;276;31;51;82
89;17.08.2012;2012;08;21;Perjantai;117;117;234;26;37;63
89;17.08.2012;2012;08;22;Perjantai;68;60;128;19;32;51
89;17.08.2012;2012;08;23;Perjantai;61;38;99;11;27;38
89;18.08.2012;2012;08;00;Lauantai;48;50;98;15;13;28
89;18.08.2012;2012;08;01;Lauantai;49;8;57;7;8;15
89;18.08.2012;2012;08;02;Lauantai;22;9;31;10;4;14
89;18.08.2012;2012;08;03;Lauantai;39;1;40;10;1;11
89;18.08.2012;2012;08;04;Lauantai;33;2;35;4;0;4
89;18.08.2012;2012;08;05;Lauantai;11;10;21;4;1;5
89;18.08.2012;2012;08;06;Lauantai;7;15;22;4;5;9
89;18.08.2012;2012;08;07;Lauantai;4;30;34;5;12;17
89;18.08.2012;2012;08;08;Lauantai;22;50;72;13;15;28
89;18.08.2012;2012;08;09;Lauantai;33;106;139;18;28;46
89;18.08.2012;2012;08;10;Lauantai;54;136;190;23;40;63
89;18.08.2012;2012;08;11;Lauantai;73;173;246;24;50;74
89;18.08.2012;2012;08;12;Lauantai;126;165;291;40;67;107
89;18.08.2012;2012;08;13;Lauantai;100;155;255;36;56;92
89;18.08.2012;2012;08;14;Lauantai;105;128;233;57;56;113
89;18.08.2012;2012;08;15;Lauantai;154;121;275;27;66;93
89;18.08.2012;2012;08;16;Lauantai;133;109;242;48;56;104
89;18.08.2012;2012;08;17;Lauantai;105;131;236;46;57;103
89;18.08.2012;2012;08;18;Lauantai;126;132;258;33;56;89
89;18.08.2012;2012;08;19;Lauantai;87;109;196;33;67;100
89;18.08.2012;2012;08;20;Lauantai;79;91;170;21;51;72
89;18.08.2012;2012;08;21;Lauantai;51;69;120;19;15;34
89;18.08.2012;2012;08;22;Lauantai;37;73;110;9;14;23
89;18.08.2012;2012;08;23;Lauantai;34;36;70;8;12;20
89;19.08.2012;2012;08;00;Sunnuntai;36;19;55;4;12;16
89;19.08.2012;2012;08;01;Sunnuntai;22;25;47;5;3;8
89;19.08.2012;2012;08;02;Sunnuntai;28;12;40;10;2;12
89;19.08.2012;2012;08;03;Sunnuntai;24;0;24;10;0;10
89;19.08.2012;2012;08;04;Sunnuntai;25;2;27;10;1;11
89;19.08.2012;2012;08;05;Sunnuntai;12;4;16;4;3;7
89;19.08.2012;2012;08;06;Sunnuntai;5;10;15;0;1;1
89;19.08.2012;2012;08;07;Sunnuntai;4;14;18;5;4;9
89;19.08.2012;2012;08;08;Sunnuntai;6;25;31;7;23;30
89;19.08.2012;2012;08;09;Sunnuntai;28;50;78;26;21;47
89;19.08.2012;2012;08;10;Sunnuntai;34;69;103;38;35;73
89;19.08.2012;2012;08;11;Sunnuntai;50;97;147;35;46;81
89;19.08.2012;2012;08;12;Sunnuntai;81;145;226;52;86;138
89;19.08.2012;2012;08;13;Sunnuntai;105;110;215;44;59;103
89;19.08.2012;2012;08;14;Sunnuntai;114;128;242;48;72;120
89;19.08.2012;2012;08;15;Sunnuntai;117;118;235;48;64;112
89;19.08.2012;2012;08;16;Sunnuntai;105;118;223;42;65;107
89;19.08.2012;2012;08;17;Sunnuntai;116;100;216;52;57;109
89;19.08.2012;2012;08;18;Sunnuntai;109;87;196;37;43;80
89;19.08.2012;2012;08;19;Sunnuntai;73;73;146;49;47;96
89;19.08.2012;2012;08;20;Sunnuntai;56;65;121;27;42;69
89;19.08.2012;2012;08;21;Sunnuntai;39;32;71;11;15;26
89;19.08.2012;2012;08;22;Sunnuntai;13;11;24;8;10;18
89;19.08.2012;2012;08;23;Sunnuntai;11;19;30;3;4;7
89;20.08.2012;2012;08;00;Maanantai;10;3;13;0;2;2
89;20.08.2012;2012;08;01;Maanantai;0;5;5;1;0;1
89;20.08.2012;2012;08;02;Maanantai;8;1;9;0;1;1
89;20.08.2012;2012;08;03;Maanantai;2;6;8;3;0;3
89;20.08.2012;2012;08;04;Maanantai;10;6;16;1;0;1
89;20.08.2012;2012;08;05;Maanantai;4;18;22;2;1;3
89;20.08.2012;2012;08;06;Maanantai;26;74;100;2;5;7
89;20.08.2012;2012;08;07;Maanantai;58;278;336;8;18;26
89;20.08.2012;2012;08;08;Maanantai;91;290;381;11;33;44
89;20.08.2012;2012;08;09;Maanantai;61;165;226;10;31;41
89;20.08.2012;2012;08;10;Maanantai;46;120;166;23;55;78
89;20.08.2012;2012;08;11;Maanantai;79;138;217;22;26;48
89;20.08.2012;2012;08;12;Maanantai;108;143;251;25;55;80
89;20.08.2012;2012;08;13;Maanantai;131;117;248;34;34;68
89;20.08.2012;2012;08;14;Maanantai;195;112;307;22;29;51
89;20.08.2012;2012;08;15;Maanantai;240;152;392;48;32;80
89;20.08.2012;2012;08;16;Maanantai;333;146;479;50;24;74
89;20.08.2012;2012;08;17;Maanantai;182;141;323;27;31;58
89;20.08.2012;2012;08;18;Maanantai;171;138;309;50;71;121
89;20.08.2012;2012;08;19;Maanantai;138;70;208;34;55;89
89;20.08.2012;2012;08;20;Maanantai;124;70;194;41;41;82
89;20.08.2012;2012;08;21;Maanantai;63;35;98;17;22;39
89;20.08.2012;2012;08;22;Maanantai;34;16;50;18;13;31
89;20.08.2012;2012;08;23;Maanantai;19;5;24;5;3;8
89;21.08.2012;2012;08;00;Tiistai;4;6;10;0;1;1
89;21.08.2012;2012;08;01;Tiistai;3;3;6;2;1;3
89;21.08.2012;2012;08;02;Tiistai;4;1;5;0;1;1
89;21.08.2012;2012;08;03;Tiistai;7;1;8;1;0;1
89;21.08.2012;2012;08;04;Tiistai;1;6;7;0;1;1
89;21.08.2012;2012;08;05;Tiistai;5;21;26;1;3;4
89;21.08.2012;2012;08;06;Tiistai;33;99;132;2;7;9
89;21.08.2012;2012;08;07;Tiistai;44;285;329;7;21;28
89;21.08.2012;2012;08;08;Tiistai;100;281;381;9;39;48
89;21.08.2012;2012;08;09;Tiistai;44;132;176;16;32;48
89;21.08.2012;2012;08;10;Tiistai;67;147;214;18;47;65
89;21.08.2012;2012;08;11;Tiistai;70;98;168;29;46;75
89;21.08.2012;2012;08;12;Tiistai;77;127;204;23;32;55
89;21.08.2012;2012;08;13;Tiistai;126;117;243;22;33;55
89;21.08.2012;2012;08;14;Tiistai;190;118;308;23;49;72
89;21.08.2012;2012;08;15;Tiistai;247;124;371;39;24;63
89;21.08.2012;2012;08;16;Tiistai;331;129;460;38;28;66
89;21.08.2012;2012;08;17;Tiistai;203;122;325;34;28;62
89;21.08.2012;2012;08;18;Tiistai;138;83;221;35;44;79
89;21.08.2012;2012;08;19;Tiistai;120;69;189;46;36;82
89;21.08.2012;2012;08;20;Tiistai;79;53;132;28;30;58
89;21.08.2012;2012;08;21;Tiistai;58;31;89;21;18;39
89;21.08.2012;2012;08;22;Tiistai;17;7;24;1;2;3
89;21.08.2012;2012;08;23;Tiistai;18;4;22;7;6;13
89;22.08.2012;2012;08;00;Keskiviikko;4;2;6;2;1;3
89;22.08.2012;2012;08;01;Keskiviikko;4;3;7;1;0;1
89;22.08.2012;2012;08;02;Keskiviikko;3;2;5;0;0;0
89;22.08.2012;2012;08;03;Keskiviikko;1;1;2;1;0;1
89;22.08.2012;2012;08;04;Keskiviikko;3;4;7;1;0;1
89;22.08.2012;2012;08;05;Keskiviikko;4;15;19;1;2;3
89;22.08.2012;2012;08;06;Keskiviikko;20;74;94;4;8;12
89;22.08.2012;2012;08;07;Keskiviikko;39;210;249;6;19;25
89;22.08.2012;2012;08;08;Keskiviikko;72;258;330;6;31;37
89;22.08.2012;2012;08;09;Keskiviikko;36;115;151;12;26;38
89;22.08.2012;2012;08;10;Keskiviikko;24;61;85;15;32;47
89;22.08.2012;2012;08;11;Keskiviikko;43;96;139;20;32;52
89;22.08.2012;2012;08;12;Keskiviikko;63;78;141;11;16;27
89;22.08.2012;2012;08;13;Keskiviikko;81;82;163;18;22;40
89;22.08.2012;2012;08;14;Keskiviikko;123;85;208;28;28;56
89;22.08.2012;2012;08;15;Keskiviikko;192;99;291;39;29;68
89;22.08.2012;2012;08;16;Keskiviikko;256;122;378;39;21;60
89;22.08.2012;2012;08;17;Keskiviikko;159;61;220;27;32;59
89;22.08.2012;2012;08;18;Keskiviikko;108;62;170;32;42;74
89;22.08.2012;2012;08;19;Keskiviikko;96;48;144;37;27;64
89;22.08.2012;2012;08;20;Keskiviikko;85;45;130;20;24;44
89;22.08.2012;2012;08;21;Keskiviikko;40;23;63;18;24;42
89;22.08.2012;2012;08;22;Keskiviikko;20;6;26;3;8;11
89;22.08.2012;2012;08;23;Keskiviikko;12;12;24;5;3;8
89;23.08.2012;2012;08;00;Torstai;6;8;14;1;3;4
89;23.08.2012;2012;08;01;Torstai;7;9;16;1;0;1
89;23.08.2012;2012;08;02;Torstai;6;2;8;3;2;5
89;23.08.2012;2012;08;03;Torstai;10;0;10;3;0;3
89;23.08.2012;2012;08;04;Torstai;3;7;10;2;3;5
89;23.08.2012;2012;08;05;Torstai;6;16;22;0;1;1
89;23.08.2012;2012;08;06;Torstai;27;74;101;3;10;13
89;23.08.2012;2012;08;07;Torstai;58;243;301;9;24;33
89;23.08.2012;2012;08;08;Torstai;85;246;331;38;54;92
89;23.08.2012;2012;08;09;Torstai;56;161;217;20;20;40
89;23.08.2012;2012;08;10;Torstai;81;89;170;9;35;44
89;23.08.2012;2012;08;11;Torstai;75;97;172;42;22;64
89;23.08.2012;2012;08;12;Torstai;79;107;186;25;27;52
89;23.08.2012;2012;08;13;Torstai;102;114;216;13;25;38
89;23.08.2012;2012;08;14;Torstai;164;122;286;27;24;51
89;23.08.2012;2012;08;15;Torstai;252;131;383;31;27;58
89;23.08.2012;2012;08;16;Torstai;271;140;411;22;29;51
89;23.08.2012;2012;08;17;Torstai;142;154;296;27;67;94
89;23.08.2012;2012;08;18;Torstai;156;149;305;38;44;82
89;23.08.2012;2012;08;19;Torstai;120;132;252;57;56;113
89;23.08.2012;2012;08;20;Torstai;161;116;277;46;32;78
89;23.08.2012;2012;08;21;Torstai;104;66;170;22;27;49
89;23.08.2012;2012;08;22;Torstai;80;29;109;27;6;33
89;23.08.2012;2012;08;23;Torstai;51;13;64;17;4;21
89;24.08.2012;2012;08;00;Perjantai;26;3;29;6;1;7
89;24.08.2012;2012;08;01;Perjantai;17;2;19;7;5;12
89;24.08.2012;2012;08;02;Perjantai;15;2;17;3;0;3
89;24.08.2012;2012;08;03;Perjantai;20;0;20;6;0;6
89;24.08.2012;2012;08;04;Perjantai;13;3;16;1;2;3
89;24.08.2012;2012;08;05;Perjantai;2;17;19;4;3;7
89;24.08.2012;2012;08;06;Perjantai;19;73;92;3;6;9
89;24.08.2012;2012;08;07;Perjantai;46;237;283;8;32;40
89;24.08.2012;2012;08;08;Perjantai;75;248;323;24;32;56
89;24.08.2012;2012;08;09;Perjantai;62;151;213;37;33;70
89;24.08.2012;2012;08;10;Perjantai;65;126;191;36;71;107
89;24.08.2012;2012;08;11;Perjantai;89;100;189;17;23;40
89;24.08.2012;2012;08;12;Perjantai;103;125;228;28;28;56
89;24.08.2012;2012;08;13;Perjantai;169;152;321;29;30;59
89;24.08.2012;2012;08;14;Perjantai;196;148;344;27;49;76
89;24.08.2012;2012;08;15;Perjantai;242;141;383;34;34;68
89;24.08.2012;2012;08;16;Perjantai;227;137;364;33;45;78
89;24.08.2012;2012;08;17;Perjantai;161;107;268;31;32;63
89;24.08.2012;2012;08;18;Perjantai;109;135;244;30;72;102
89;24.08.2012;2012;08;19;Perjantai;84;128;212;22;58;80
89;24.08.2012;2012;08;20;Perjantai;70;123;193;31;38;69
89;24.08.2012;2012;08;21;Perjantai;73;79;152;12;19;31
89;24.08.2012;2012;08;22;Perjantai;53;36;89;14;7;21
89;24.08.2012;2012;08;23;Perjantai;91;29;120;11;10;21
89;25.08.2012;2012;08;00;Lauantai;45;17;62;11;9;20
89;25.08.2012;2012;08;01;Lauantai;43;15;58;9;2;11
89;25.08.2012;2012;08;02;Lauantai;15;11;26;2;1;3
89;25.08.2012;2012;08;03;Lauantai;24;4;28;7;0;7
89;25.08.2012;2012;08;04;Lauantai;14;6;20;5;1;6
89;25.08.2012;2012;08;05;Lauantai;14;4;18;1;0;1
89;25.08.2012;2012;08;06;Lauantai;2;7;9;3;4;7
89;25.08.2012;2012;08;07;Lauantai;9;13;22;4;5;9
89;25.08.2012;2012;08;08;Lauantai;12;37;49;16;10;26
89;25.08.2012;2012;08;09;Lauantai;21;81;102;15;26;41
89;25.08.2012;2012;08;10;Lauantai;54;114;168;27;65;92
89;25.08.2012;2012;08;11;Lauantai;65;126;191;33;52;85
89;25.08.2012;2012;08;12;Lauantai;83;161;244;46;266;312
89;25.08.2012;2012;08;13;Lauantai;125;137;262;36;79;115
89;25.08.2012;2012;08;14;Lauantai;137;128;265;42;59;101
89;25.08.2012;2012;08;15;Lauantai;155;99;254;46;29;75
89;25.08.2012;2012;08;16;Lauantai;92;96;188;35;39;74
89;25.08.2012;2012;08;17;Lauantai;109;82;191;17;29;46
89;25.08.2012;2012;08;18;Lauantai;83;82;165;41;51;92
89;25.08.2012;2012;08;19;Lauantai;62;75;137;17;47;64
89;25.08.2012;2012;08;20;Lauantai;54;76;130;24;28;52
89;25.08.2012;2012;08;21;Lauantai;60;44;104;23;17;40
89;25.08.2012;2012;08;22;Lauantai;36;35;71;8;21;29
89;25.08.2012;2012;08;23;Lauantai;40;32;72;7;13;20
89;26.08.2012;2012;08;00;Sunnuntai;24;24;48;7;9;16
89;26.08.2012;2012;08;01;Sunnuntai;19;8;27;3;3;6
89;26.08.2012;2012;08;02;Sunnuntai;30;5;35;9;1;10
89;26.08.2012;2012;08;03;Sunnuntai;32;2;34;6;3;9
89;26.08.2012;2012;08;04;Sunnuntai;39;0;39;7;0;7
89;26.08.2012;2012;08;05;Sunnuntai;7;1;8;5;1;6
89;26.08.2012;2012;08;06;Sunnuntai;5;9;14;0;1;1
89;26.08.2012;2012;08;07;Sunnuntai;8;8;16;5;3;8
89;26.08.2012;2012;08;08;Sunnuntai;6;15;21;9;14;23
89;26.08.2012;2012;08;09;Sunnuntai;22;39;61;13;32;45
89;26.08.2012;2012;08;10;Sunnuntai;27;66;93;38;41;79
89;26.08.2012;2012;08;11;Sunnuntai;71;88;159;40;86;126
89;26.08.2012;2012;08;12;Sunnuntai;82;142;224;36;76;112
89;26.08.2012;2012;08;13;Sunnuntai;139;154;293;38;82;120
89;26.08.2012;2012;08;14;Sunnuntai;124;136;260;44;57;101
89;26.08.2012;2012;08;15;Sunnuntai;150;134;284;41;48;89
89;26.08.2012;2012;08;16;Sunnuntai;127;120;247;36;60;96
89;26.08.2012;2012;08;17;Sunnuntai;121;87;208;30;34;64
89;26.08.2012;2012;08;18;Sunnuntai;105;110;215;25;43;68
89;26.08.2012;2012;08;19;Sunnuntai;109;59;168;33;24;57
89;26.08.2012;2012;08;20;Sunnuntai;59;36;95;27;35;62
89;26.08.2012;2012;08;21;Sunnuntai;42;28;70;12;15;27
89;26.08.2012;2012;08;22;Sunnuntai;20;9;29;2;12;14
89;26.08.2012;2012;08;23;Sunnuntai;15;11;26;6;1;7
89;27.08.2012;2012;08;00;Maanantai;2;6;8;0;0;0
89;27.08.2012;2012;08;01;Maanantai;4;3;7;1;1;2
89;27.08.2012;2012;08;02;Maanantai;1;0;1;0;0;0
89;27.08.2012;2012;08;03;Maanantai;1;1;2;2;2;4
89;27.08.2012;2012;08;04;Maanantai;7;2;9;1;1;2
89;27.08.2012;2012;08;05;Maanantai;3;23;26;0;1;1
89;27.08.2012;2012;08;06;Maanantai;32;81;113;4;4;8
89;27.08.2012;2012;08;07;Maanantai;43;280;323;5;27;32
89;27.08.2012;2012;08;08;Maanantai;88;295;383;11;24;35
89;27.08.2012;2012;08;09;Maanantai;52;168;220;9;40;49
89;27.08.2012;2012;08;10;Maanantai;68;115;183;14;21;35
89;27.08.2012;2012;08;11;Maanantai;106;107;213;22;40;62
89;27.08.2012;2012;08;12;Maanantai;97;139;236;20;39;59
89;27.08.2012;2012;08;13;Maanantai;114;95;209;26;35;61
89;27.08.2012;2012;08;14;Maanantai;188;131;319;24;40;64
89;27.08.2012;2012;08;15;Maanantai;272;150;422;21;31;52
89;27.08.2012;2012;08;16;Maanantai;309;126;435;40;36;76
89;27.08.2012;2012;08;17;Maanantai;205;133;338;30;42;72
89;27.08.2012;2012;08;18;Maanantai;165;115;280;51;58;109
89;27.08.2012;2012;08;19;Maanantai;130;72;202;45;59;104
89;27.08.2012;2012;08;20;Maanantai;108;62;170;43;45;88
89;27.08.2012;2012;08;21;Maanantai;47;40;87;21;22;43
89;27.08.2012;2012;08;22;Maanantai;24;15;39;4;8;12
89;27.08.2012;2012;08;23;Maanantai;15;6;21;3;1;4
89;28.08.2012;2012;08;00;Tiistai;7;3;10;1;1;2
89;28.08.2012;2012;08;01;Tiistai;5;5;10;2;2;4
89;28.08.2012;2012;08;02;Tiistai;4;2;6;1;0;1
89;28.08.2012;2012;08;03;Tiistai;2;2;4;1;0;1
89;28.08.2012;2012;08;04;Tiistai;4;4;8;0;0;0
89;28.08.2012;2012;08;05;Tiistai;2;15;17;2;2;4
89;28.08.2012;2012;08;06;Tiistai;27;83;110;2;4;6
89;28.08.2012;2012;08;07;Tiistai;52;272;324;3;37;40
89;28.08.2012;2012;08;08;Tiistai;86;298;384;10;49;59
89;28.08.2012;2012;08;09;Tiistai;65;160;225;17;19;36
89;28.08.2012;2012;08;10;Tiistai;62;142;204;17;51;68
89;28.08.2012;2012;08;11;Tiistai;80;124;204;34;39;73
89;28.08.2012;2012;08;12;Tiistai;104;143;247;35;45;80
89;28.08.2012;2012;08;13;Tiistai;159;137;296;22;47;69
89;28.08.2012;2012;08;14;Tiistai;200;148;348;28;36;64
89;28.08.2012;2012;08;15;Tiistai;290;177;467;34;41;75
89;28.08.2012;2012;08;16;Tiistai;357;154;511;49;43;92
89;28.08.2012;2012;08;17;Tiistai;225;163;388;34;39;73
89;28.08.2012;2012;08;18;Tiistai;191;138;329;41;68;109
89;28.08.2012;2012;08;19;Tiistai;147;90;237;54;55;109
89;28.08.2012;2012;08;20;Tiistai;138;71;209;41;37;78
89;28.08.2012;2012;08;21;Tiistai;80;29;109;10;17;27
89;28.08.2012;2012;08;22;Tiistai;41;15;56;5;11;16
89;28.08.2012;2012;08;23;Tiistai;16;7;23;4;3;7
89;29.08.2012;2012;08;00;Keskiviikko;6;2;8;3;1;4
89;29.08.2012;2012;08;01;Keskiviikko;3;5;8;0;0;0
89;29.08.2012;2012;08;02;Keskiviikko;2;1;3;0;0;0
89;29.08.2012;2012;08;03;Keskiviikko;4;2;6;0;0;0
89;29.08.2012;2012;08;04;Keskiviikko;4;6;10;2;0;2
89;29.08.2012;2012;08;05;Keskiviikko;4;17;21;1;1;2
89;29.08.2012;2012;08;06;Keskiviikko;26;77;103;5;7;12
89;29.08.2012;2012;08;07;Keskiviikko;63;274;337;11;26;37
89;29.08.2012;2012;08;08;Keskiviikko;91;286;377;10;32;42
89;29.08.2012;2012;08;09;Keskiviikko;63;170;233;13;38;51
89;29.08.2012;2012;08;10;Keskiviikko;61;114;175;31;84;115
89;29.08.2012;2012;08;11;Keskiviikko;91;121;212;58;70;128
89;29.08.2012;2012;08;12;Keskiviikko;108;129;237;18;30;48
89;29.08.2012;2012;08;13;Keskiviikko;125;132;257;23;51;74
89;29.08.2012;2012;08;14;Keskiviikko;215;119;334;32;35;67
89;29.08.2012;2012;08;15;Keskiviikko;245;137;382;23;25;48
89;29.08.2012;2012;08;16;Keskiviikko;321;147;468;41;30;71
89;29.08.2012;2012;08;17;Keskiviikko;192;162;354;32;35;67
89;29.08.2012;2012;08;18;Keskiviikko;143;141;284;34;39;73
89;29.08.2012;2012;08;19;Keskiviikko;140;65;205;42;47;89
89;29.08.2012;2012;08;20;Keskiviikko;125;78;203;36;21;57
89;29.08.2012;2012;08;21;Keskiviikko;65;44;109;28;23;51
89;29.08.2012;2012;08;22;Keskiviikko;35;20;55;2;15;17
89;29.08.2012;2012;08;23;Keskiviikko;17;11;28;6;5;11
89;30.08.2012;2012;08;00;Torstai;11;7;18;4;3;7
89;30.08.2012;2012;08;01;Torstai;11;3;14;1;0;1
89;30.08.2012;2012;08;02;Torstai;5;3;8;3;1;4
89;30.08.2012;2012;08;03;Torstai;13;1;14;2;0;2
89;30.08.2012;2012;08;04;Torstai;7;4;11;0;2;2
89;30.08.2012;2012;08;05;Torstai;1;10;11;2;2;4
89;30.08.2012;2012;08;06;Torstai;28;76;104;3;10;13
89;30.08.2012;2012;08;07;Torstai;61;238;299;5;28;33
89;30.08.2012;2012;08;08;Torstai;93;285;378;11;26;37
89;30.08.2012;2012;08;09;Torstai;50;140;190;23;28;51
89;30.08.2012;2012;08;10;Torstai;56;116;172;18;32;50
89;30.08.2012;2012;08;11;Torstai;107;128;235;27;43;70
89;30.08.2012;2012;08;12;Torstai;133;117;250;15;30;45
89;30.08.2012;2012;08;13;Torstai;126;132;258;19;28;47
89;30.08.2012;2012;08;14;Torstai;179;121;300;34;34;68
89;30.08.2012;2012;08;15;Torstai;263;142;405;28;46;74
89;30.08.2012;2012;08;16;Torstai;310;121;431;34;27;61
89;30.08.2012;2012;08;17;Torstai;173;130;303;36;45;81
89;30.08.2012;2012;08;18;Torstai;150;102;252;38;43;81
89;30.08.2012;2012;08;19;Torstai;135;83;218;42;50;92
89;30.08.2012;2012;08;20;Torstai;103;66;169;26;35;61
89;30.08.2012;2012;08;21;Torstai;56;41;97;8;13;21
89;30.08.2012;2012;08;22;Torstai;25;21;46;8;16;24
89;30.08.2012;2012;08;23;Torstai;11;7;18;1;5;6
89;31.08.2012;2012;08;00;Perjantai;9;5;14;6;4;10
89;31.08.2012;2012;08;01;Perjantai;6;4;10;4;1;5
89;31.08.2012;2012;08;02;Perjantai;8;0;8;6;0;6
89;31.08.2012;2012;08;03;Perjantai;9;1;10;1;0;1
89;31.08.2012;2012;08;04;Perjantai;2;5;7;0;0;0
89;31.08.2012;2012;08;05;Perjantai;4;12;16;0;4;4
89;31.08.2012;2012;08;06;Perjantai;32;71;103;3;5;8
89;31.08.2012;2012;08;07;Perjantai;56;224;280;6;28;34
89;31.08.2012;2012;08;08;Perjantai;77;254;331;12;43;55
89;31.08.2012;2012;08;09;Perjantai;54;141;195;25;68;93
89;31.08.2012;2012;08;10;Perjantai;65;112;177;49;40;89
89;31.08.2012;2012;08;11;Perjantai;95;107;202;25;49;74
89;31.08.2012;2012;08;12;Perjantai;119;136;255;42;36;78
89;31.08.2012;2012;08;13;Perjantai;178;140;318;20;30;50
89;31.08.2012;2012;08;14;Perjantai;200;131;331;49;37;86
89;31.08.2012;2012;08;15;Perjantai;230;133;363;41;37;78
89;31.08.2012;2012;08;16;Perjantai;221;122;343;36;32;68
89;31.08.2012;2012;08;17;Perjantai;142;113;255;22;38;60
89;31.08.2012;2012;08;18;Perjantai;110;88;198;15;32;47
89;31.08.2012;2012;08;19;Perjantai;106;60;166;25;24;49
89;31.08.2012;2012;08;20;Perjantai;101;57;158;17;22;39
89;31.08.2012;2012;08;21;Perjantai;46;59;105;13;14;27
89;31.08.2012;2012;08;22;Perjantai;35;46;81;9;11;20
89;31.08.2012;2012;08;23;Perjantai;51;51;102;3;8;11
89;01.09.2012;2012;09;00;Lauantai;20;20;40;7;4;11
89;01.09.2012;2012;09;01;Lauantai;22;10;32;5;1;6
89;01.09.2012;2012;09;02;Lauantai;20;8;28;8;1;9
89;01.09.2012;2012;09;03;Lauantai;20;4;24;7;2;9
89;01.09.2012;2012;09;04;Lauantai;19;0;19;7;0;7
89;01.09.2012;2012;09;05;Lauantai;6;7;13;1;1;2
89;01.09.2012;2012;09;06;Lauantai;5;8;13;4;1;5
89;01.09.2012;2012;09;07;Lauantai;4;22;26;0;7;7
89;01.09.2012;2012;09;08;Lauantai;9;39;48;5;11;16
89;01.09.2012;2012;09;09;Lauantai;24;87;111;20;23;43
89;01.09.2012;2012;09;10;Lauantai;32;108;140;48;74;122
89;01.09.2012;2012;09;11;Lauantai;66;154;220;26;81;107
89;01.09.2012;2012;09;12;Lauantai;88;178;266;43;78;121
89;01.09.2012;2012;09;13;Lauantai;120;122;242;31;38;69
89;01.09.2012;2012;09;14;Lauantai;132;122;254;36;41;77
89;01.09.2012;2012;09;15;Lauantai;155;93;248;39;62;101
89;01.09.2012;2012;09;16;Lauantai;131;81;212;41;53;94
89;01.09.2012;2012;09;17;Lauantai;89;62;151;30;29;59
89;01.09.2012;2012;09;18;Lauantai;70;65;135;43;36;79
89;01.09.2012;2012;09;19;Lauantai;67;59;126;19;17;36
89;01.09.2012;2012;09;20;Lauantai;54;58;112;21;29;50
89;01.09.2012;2012;09;21;Lauantai;37;48;85;11;15;26
89;01.09.2012;2012;09;22;Lauantai;31;34;65;3;11;14
89;01.09.2012;2012;09;23;Lauantai;23;20;43;0;8;8
89;02.09.2012;2012;09;00;Sunnuntai;14;30;44;6;11;17
89;02.09.2012;2012;09;01;Sunnuntai;16;23;39;6;4;10
89;02.09.2012;2012;09;02;Sunnuntai;23;11;34;10;1;11
89;02.09.2012;2012;09;03;Sunnuntai;48;4;52;8;0;8
89;02.09.2012;2012;09;04;Sunnuntai;32;3;35;10;1;11
89;02.09.2012;2012;09;05;Sunnuntai;5;5;10;4;2;6
89;02.09.2012;2012;09;06;Sunnuntai;4;8;12;0;1;1
89;02.09.2012;2012;09;07;Sunnuntai;5;7;12;1;1;2
89;02.09.2012;2012;09;08;Sunnuntai;5;9;14;2;4;6
89;02.09.2012;2012;09;09;Sunnuntai;25;32;57;17;25;42
89;02.09.2012;2012;09;10;Sunnuntai;22;48;70;22;36;58
89;02.09.2012;2012;09;11;Sunnuntai;52;82;134;59;65;124
89;02.09.2012;2012;09;12;Sunnuntai;64;101;165;51;67;118
89;02.09.2012;2012;09;13;Sunnuntai;82;68;150;47;44;91
89;02.09.2012;2012;09;14;Sunnuntai;66;55;121;27;34;61
89;02.09.2012;2012;09;15;Sunnuntai;72;56;128;18;38;56
89;02.09.2012;2012;09;16;Sunnuntai;65;44;109;19;12;31
89;02.09.2012;2012;09;17;Sunnuntai;60;29;89;12;18;30
89;02.09.2012;2012;09;18;Sunnuntai;48;37;85;23;22;45
89;02.09.2012;2012;09;19;Sunnuntai;32;32;64;25;30;55
89;02.09.2012;2012;09;20;Sunnuntai;36;18;54;15;15;30
89;02.09.2012;2012;09;21;Sunnuntai;23;25;48;7;9;16
89;02.09.2012;2012;09;22;Sunnuntai;11;6;17;7;5;12
89;02.09.2012;2012;09;23;Sunnuntai;3;9;12;2;1;3
89;03.09.2012;2012;09;00;Maanantai;7;4;11;0;1;1
89;03.09.2012;2012;09;01;Maanantai;1;6;7;2;0;2
89;03.09.2012;2012;09;02;Maanantai;1;0;1;0;0;0
89;03.09.2012;2012;09;03;Maanantai;2;1;3;1;0;1
89;03.09.2012;2012;09;04;Maanantai;2;4;6;0;0;0
89;03.09.2012;2012;09;05;Maanantai;4;17;21;1;2;3
89;03.09.2012;2012;09;06;Maanantai;26;70;96;3;3;6
89;03.09.2012;2012;09;07;Maanantai;60;211;271;5;31;36
89;03.09.2012;2012;09;08;Maanantai;71;285;356;10;40;50
89;03.09.2012;2012;09;09;Maanantai;43;166;209;19;41;60
89;03.09.2012;2012;09;10;Maanantai;54;170;224;13;31;44
89;03.09.2012;2012;09;11;Maanantai;106;113;219;22;28;50
89;03.09.2012;2012;09;12;Maanantai;103;105;208;22;28;50
89;03.09.2012;2012;09;13;Maanantai;125;103;228;19;38;57
89;03.09.2012;2012;09;14;Maanantai;167;146;313;32;34;66
89;03.09.2012;2012;09;15;Maanantai;257;147;404;29;24;53
89;03.09.2012;2012;09;16;Maanantai;320;117;437;37;39;76
89;03.09.2012;2012;09;17;Maanantai;197;104;301;31;35;66
89;03.09.2012;2012;09;18;Maanantai;135;102;237;39;45;84
89;03.09.2012;2012;09;19;Maanantai;126;84;210;53;31;84
89;03.09.2012;2012;09;20;Maanantai;111;63;174;35;20;55
89;03.09.2012;2012;09;21;Maanantai;59;35;94;16;19;35
89;03.09.2012;2012;09;22;Maanantai;28;24;52;4;2;6
89;03.09.2012;2012;09;23;Maanantai;9;14;23;2;4;6
89;04.09.2012;2012;09;00;Tiistai;2;4;6;0;1;1
89;04.09.2012;2012;09;01;Tiistai;7;3;10;1;2;3
89;04.09.2012;2012;09;02;Tiistai;5;4;9;3;2;5
89;04.09.2012;2012;09;03;Tiistai;1;3;4;0;0;0
89;04.09.2012;2012;09;04;Tiistai;6;5;11;1;0;1
89;04.09.2012;2012;09;05;Tiistai;3;11;14;0;0;0
89;04.09.2012;2012;09;06;Tiistai;30;88;118;8;2;10
89;04.09.2012;2012;09;07;Tiistai;72;238;310;7;43;50
89;04.09.2012;2012;09;08;Tiistai;97;293;390;3;39;42
89;04.09.2012;2012;09;09;Tiistai;57;156;213;12;30;42
89;04.09.2012;2012;09;10;Tiistai;66;91;157;17;34;51
89;04.09.2012;2012;09;11;Tiistai;96;117;213;22;36;58
89;04.09.2012;2012;09;12;Tiistai;100;122;222;19;32;51
89;04.09.2012;2012;09;13;Tiistai;125;114;239;25;42;67
89;04.09.2012;2012;09;14;Tiistai;165;106;271;23;28;51
89;04.09.2012;2012;09;15;Tiistai;260;112;372;33;35;68
89;04.09.2012;2012;09;16;Tiistai;339;144;483;27;36;63
89;04.09.2012;2012;09;17;Tiistai;220;151;371;26;52;78
89;04.09.2012;2012;09;18;Tiistai;141;97;238;41;57;98
89;04.09.2012;2012;09;19;Tiistai;131;74;205;39;38;77
89;04.09.2012;2012;09;20;Tiistai;106;44;150;22;35;57
89;04.09.2012;2012;09;21;Tiistai;51;32;83;11;9;20
89;04.09.2012;2012;09;22;Tiistai;29;10;39;2;7;9
89;04.09.2012;2012;09;23;Tiistai;13;13;26;1;2;3
89;05.09.2012;2012;09;00;Keskiviikko;5;2;7;7;4;11
89;05.09.2012;2012;09;01;Keskiviikko;3;1;4;3;0;3
89;05.09.2012;2012;09;02;Keskiviikko;0;0;0;0;1;1
89;05.09.2012;2012;09;03;Keskiviikko;10;1;11;0;2;2
89;05.09.2012;2012;09;04;Keskiviikko;3;3;6;1;0;1
89;05.09.2012;2012;09;05;Keskiviikko;2;22;24;0;2;2
89;05.09.2012;2012;09;06;Keskiviikko;24;62;86;5;5;10
89;05.09.2012;2012;09;07;Keskiviikko;81;233;314;6;17;23
89;05.09.2012;2012;09;08;Keskiviikko;71;282;353;5;46;51
89;05.09.2012;2012;09;09;Keskiviikko;58;168;226;16;26;42
89;05.09.2012;2012;09;10;Keskiviikko;74;107;181;22;28;50
89;05.09.2012;2012;09;11;Keskiviikko;114;89;203;12;19;31
89;05.09.2012;2012;09;12;Keskiviikko;91;111;202;18;22;40
89;05.09.2012;2012;09;13;Keskiviikko;141;113;254;12;20;32
89;05.09.2012;2012;09;14;Keskiviikko;180;130;310;23;24;47
89;05.09.2012;2012;09;15;Keskiviikko;216;142;358;19;19;38
89;05.09.2012;2012;09;16;Keskiviikko;256;155;411;22;14;36
89;05.09.2012;2012;09;17;Keskiviikko;186;114;300;34;24;58
89;05.09.2012;2012;09;18;Keskiviikko;127;115;242;30;28;58
89;05.09.2012;2012;09;19;Keskiviikko;123;77;200;24;28;52
89;05.09.2012;2012;09;20;Keskiviikko;101;63;164;28;25;53
89;05.09.2012;2012;09;21;Keskiviikko;64;40;104;12;10;22
89;05.09.2012;2012;09;22;Keskiviikko;52;28;80;8;8;16
89;05.09.2012;2012;09;23;Keskiviikko;26;10;36;4;2;6
89;06.09.2012;2012;09;00;Torstai;17;7;24;2;0;2
89;06.09.2012;2012;09;01;Torstai;14;13;27;0;2;2
89;06.09.2012;2012;09;02;Torstai;14;4;18;1;0;1
89;06.09.2012;2012;09;03;Torstai;17;2;19;1;0;1
89;06.09.2012;2012;09;04;Torstai;11;2;13;8;1;9
89;06.09.2012;2012;09;05;Torstai;6;15;21;0;1;1
89;06.09.2012;2012;09;06;Torstai;34;71;105;1;5;6
89;06.09.2012;2012;09;07;Torstai;79;250;329;5;19;24
89;06.09.2012;2012;09;08;Torstai;91;304;395;7;19;26
89;06.09.2012;2012;09;09;Torstai;48;144;192;11;21;32
89;06.09.2012;2012;09;10;Torstai;72;105;177;18;43;61
89;06.09.2012;2012;09;11;Torstai;80;110;190;8;23;31
89;06.09.2012;2012;09;12;Torstai;109;134;243;27;30;57
89;06.09.2012;2012;09;13;Torstai;120;112;232;24;22;46
89;06.09.2012;2012;09;14;Torstai;158;115;273;21;19;40
89;06.09.2012;2012;09;15;Torstai;209;132;341;22;28;50
89;06.09.2012;2012;09;16;Torstai;293;148;441;32;25;57
89;06.09.2012;2012;09;17;Torstai;193;147;340;39;45;84
89;06.09.2012;2012;09;18;Torstai;144;102;246;27;39;66
89;06.09.2012;2012;09;19;Torstai;118;79;197;27;40;67
89;06.09.2012;2012;09;20;Torstai;112;63;175;24;36;60
89;06.09.2012;2012;09;21;Torstai;77;30;107;15;16;31
89;06.09.2012;2012;09;22;Torstai;24;22;46;9;6;15
89;06.09.2012;2012;09;23;Torstai;10;4;14;2;4;6
89;07.09.2012;2012;09;00;Perjantai;18;2;20;1;0;1
89;07.09.2012;2012;09;01;Perjantai;6;6;12;1;0;1
89;07.09.2012;2012;09;02;Perjantai;4;4;8;1;1;2
89;07.09.2012;2012;09;03;Perjantai;2;2;4;3;1;4
89;07.09.2012;2012;09;04;Perjantai;2;4;6;1;0;1
89;07.09.2012;2012;09;05;Perjantai;2;16;18;3;1;4
89;07.09.2012;2012;09;06;Perjantai;19;72;91;1;2;3
89;07.09.2012;2012;09;07;Perjantai;66;229;295;5;16;21
89;07.09.2012;2012;09;08;Perjantai;89;264;353;10;23;33
89;07.09.2012;2012;09;09;Perjantai;49;152;201;12;30;42
89;07.09.2012;2012;09;10;Perjantai;69;94;163;10;21;31
89;07.09.2012;2012;09;11;Perjantai;90;115;205;25;29;54
89;07.09.2012;2012;09;12;Perjantai;109;119;228;20;27;47
89;07.09.2012;2012;09;13;Perjantai;161;121;282;19;26;45
89;07.09.2012;2012;09;14;Perjantai;223;142;365;28;23;51
89;07.09.2012;2012;09;15;Perjantai;214;123;337;30;28;58
89;07.09.2012;2012;09;16;Perjantai;200;127;327;28;19;47
89;07.09.2012;2012;09;17;Perjantai;130;94;224;25;25;50
89;07.09.2012;2012;09;18;Perjantai;98;98;196;18;18;36
89;07.09.2012;2012;09;19;Perjantai;77;65;142;13;30;43
89;07.09.2012;2012;09;20;Perjantai;68;50;118;13;20;33
89;07.09.2012;2012;09;21;Perjantai;55;51;106;9;10;19
89;07.09.2012;2012;09;22;Perjantai;31;36;67;5;11;16
89;07.09.2012;2012;09;23;Perjantai;28;28;56;4;13;17
89;08.09.2012;2012;09;00;Lauantai;23;16;39;6;7;13
89;08.09.2012;2012;09;01;Lauantai;25;9;34;4;3;7
89;08.09.2012;2012;09;02;Lauantai;27;6;33;5;5;10
89;08.09.2012;2012;09;03;Lauantai;27;3;30;8;0;8
89;08.09.2012;2012;09;04;Lauantai;17;1;18;3;1;4
89;08.09.2012;2012;09;05;Lauantai;4;3;7;2;0;2
89;08.09.2012;2012;09;06;Lauantai;9;7;16;2;1;3
89;08.09.2012;2012;09;07;Lauantai;7;18;25;2;7;9
89;08.09.2012;2012;09;08;Lauantai;10;26;36;7;15;22
89;08.09.2012;2012;09;09;Lauantai;19;55;74;10;12;22
89;08.09.2012;2012;09;10;Lauantai;43;112;155;21;33;54
89;08.09.2012;2012;09;11;Lauantai;74;96;170;31;33;64
89;08.09.2012;2012;09;12;Lauantai;86;150;236;19;44;63
89;08.09.2012;2012;09;13;Lauantai;106;120;226;35;43;78
89;08.09.2012;2012;09;14;Lauantai;118;102;220;38;28;66
89;08.09.2012;2012;09;15;Lauantai;105;82;187;35;42;77
89;08.09.2012;2012;09;16;Lauantai;114;58;172;25;44;69
89;08.09.2012;2012;09;17;Lauantai;95;70;165;46;41;87
89;08.09.2012;2012;09;18;Lauantai;75;67;142;25;38;63
89;08.09.2012;2012;09;19;Lauantai;56;54;110;24;31;55
89;08.09.2012;2012;09;20;Lauantai;39;58;97;14;18;32
89;08.09.2012;2012;09;21;Lauantai;54;29;83;8;13;21
89;08.09.2012;2012;09;22;Lauantai;26;53;79;3;10;13
89;08.09.2012;2012;09;23;Lauantai;20;47;67;8;7;15
89;09.09.2012;2012;09;00;Sunnuntai;25;22;47;3;10;13
89;09.09.2012;2012;09;01;Sunnuntai;22;14;36;6;6;12
89;09.09.2012;2012;09;02;Sunnuntai;22;5;27;5;5;10
89;09.09.2012;2012;09;03;Sunnuntai;37;1;38;11;1;12
89;09.09.2012;2012;09;04;Sunnuntai;32;2;34;2;1;3
89;09.09.2012;2012;09;05;Sunnuntai;4;2;6;1;1;2
89;09.09.2012;2012;09;06;Sunnuntai;7;2;9;1;0;1
89;09.09.2012;2012;09;07;Sunnuntai;4;5;9;4;6;10
89;09.09.2012;2012;09;08;Sunnuntai;11;13;24;10;11;21
89;09.09.2012;2012;09;09;Sunnuntai;19;42;61;22;18;40
89;09.09.2012;2012;09;10;Sunnuntai;32;50;82;25;39;64
89;09.09.2012;2012;09;11;Sunnuntai;63;99;162;50;72;122
89;09.09.2012;2012;09;12;Sunnuntai;102;97;199;45;53;98
89;09.09.2012;2012;09;13;Sunnuntai;96;115;211;51;92;143
89;09.09.2012;2012;09;14;Sunnuntai;107;105;212;54;49;103
89;09.09.2012;2012;09;15;Sunnuntai;102;100;202;42;58;100
89;09.09.2012;2012;09;16;Sunnuntai;83;100;183;32;40;72
89;09.09.2012;2012;09;17;Sunnuntai;105;59;164;28;40;68
89;09.09.2012;2012;09;18;Sunnuntai;79;67;146;34;44;78
89;09.09.2012;2012;09;19;Sunnuntai;66;51;117;30;31;61
89;09.09.2012;2012;09;20;Sunnuntai;48;31;79;21;22;43
89;09.09.2012;2012;09;21;Sunnuntai;23;16;39;8;8;16
89;09.09.2012;2012;09;22;Sunnuntai;9;8;17;1;8;9
89;09.09.2012;2012;09;23;Sunnuntai;8;5;13;3;3;6
89;10.09.2012;2012;09;00;Maanantai;3;2;5;0;0;0
89;10.09.2012;2012;09;01;Maanantai;8;4;12;1;2;3
89;10.09.2012;2012;09;02;Maanantai;2;4;6;1;2;3
89;10.09.2012;2012;09;03;Maanantai;1;1;2;2;0;2
89;10.09.2012;2012;09;04;Maanantai;2;5;7;1;0;1
89;10.09.2012;2012;09;05;Maanantai;2;14;16;1;3;4
89;10.09.2012;2012;09;06;Maanantai;28;71;99;3;4;7
89;10.09.2012;2012;09;07;Maanantai;74;229;303;4;21;25
89;10.09.2012;2012;09;08;Maanantai;69;283;352;13;32;45
89;10.09.2012;2012;09;09;Maanantai;63;192;255;10;37;47
89;10.09.2012;2012;09;10;Maanantai;47;130;177;17;38;55
89;10.09.2012;2012;09;11;Maanantai;111;150;261;16;23;39
89;10.09.2012;2012;09;12;Maanantai;134;178;312;34;65;99
89;10.09.2012;2012;09;13;Maanantai;130;136;266;19;26;45
89;10.09.2012;2012;09;14;Maanantai;209;141;350;26;23;49
89;10.09.2012;2012;09;15;Maanantai;270;121;391;40;20;60
89;10.09.2012;2012;09;16;Maanantai;332;131;463;32;17;49
89;10.09.2012;2012;09;17;Maanantai;196;131;327;33;23;56
89;10.09.2012;2012;09;18;Maanantai;155;85;240;23;31;54
89;10.09.2012;2012;09;19;Maanantai;107;78;185;27;34;61
89;10.09.2012;2012;09;20;Maanantai;88;45;133;28;34;62
89;10.09.2012;2012;09;21;Maanantai;54;32;86;16;6;22
89;10.09.2012;2012;09;22;Maanantai;11;6;17;5;9;14
89;10.09.2012;2012;09;23;Maanantai;5;8;13;3;0;3
89;11.09.2012;2012;09;00;Tiistai;6;2;8;1;0;1
89;11.09.2012;2012;09;01;Tiistai;3;5;8;0;0;0
89;11.09.2012;2012;09;02;Tiistai;0;6;6;2;0;2
89;11.09.2012;2012;09;03;Tiistai;0;0;0;0;0;0
89;11.09.2012;2012;09;04;Tiistai;0;9;9;0;0;0
89;11.09.2012;2012;09;05;Tiistai;2;15;17;2;2;4
89;11.09.2012;2012;09;06;Tiistai;26;76;102;3;9;12
89;11.09.2012;2012;09;07;Tiistai;67;230;297;6;22;28
89;11.09.2012;2012;09;08;Tiistai;81;265;346;12;40;52
89;11.09.2012;2012;09;09;Tiistai;63;190;253;17;35;52
89;11.09.2012;2012;09;10;Tiistai;57;121;178;23;27;50
89;11.09.2012;2012;09;11;Tiistai;93;119;212;15;25;40
89;11.09.2012;2012;09;12;Tiistai;105;118;223;19;30;49
89;11.09.2012;2012;09;13;Tiistai;110;92;202;21;15;36
89;11.09.2012;2012;09;14;Tiistai;175;117;292;19;28;47
89;11.09.2012;2012;09;15;Tiistai;231;123;354;23;20;43
89;11.09.2012;2012;09;16;Tiistai;354;148;502;37;20;57
89;11.09.2012;2012;09;17;Tiistai;205;122;327;22;34;56
89;11.09.2012;2012;09;18;Tiistai;140;74;214;32;40;72
89;11.09.2012;2012;09;19;Tiistai;99;63;162;35;34;69
89;11.09.2012;2012;09;20;Tiistai;91;43;134;25;19;44
89;11.09.2012;2012;09;21;Tiistai;57;30;87;10;14;24
89;11.09.2012;2012;09;22;Tiistai;20;9;29;5;5;10
89;11.09.2012;2012;09;23;Tiistai;12;8;20;0;2;2
89;12.09.2012;2012;09;00;Keskiviikko;4;4;8;3;2;5
89;12.09.2012;2012;09;01;Keskiviikko;1;6;7;0;1;1
89;12.09.2012;2012;09;02;Keskiviikko;6;1;7;0;0;0
89;12.09.2012;2012;09;03;Keskiviikko;1;2;3;0;1;1
89;12.09.2012;2012;09;04;Keskiviikko;3;4;7;0;3;3
89;12.09.2012;2012;09;05;Keskiviikko;2;12;14;1;2;3
89;12.09.2012;2012;09;06;Keskiviikko;21;87;108;5;5;10
89;12.09.2012;2012;09;07;Keskiviikko;54;212;266;4;20;24
89;12.09.2012;2012;09;08;Keskiviikko;60;275;335;3;19;22
89;12.09.2012;2012;09;09;Keskiviikko;37;120;157;11;24;35
89;12.09.2012;2012;09;10;Keskiviikko;37;72;109;11;18;29
89;12.09.2012;2012;09;11;Keskiviikko;53;55;108;4;18;22
89;12.09.2012;2012;09;12;Keskiviikko;51;75;126;18;16;34
89;12.09.2012;2012;09;13;Keskiviikko;88;80;168;13;24;37
89;12.09.2012;2012;09;14;Keskiviikko;137;93;230;17;26;43
89;12.09.2012;2012;09;15;Keskiviikko;200;128;328;29;23;52
89;12.09.2012;2012;09;16;Keskiviikko;249;135;384;33;26;59
89;12.09.2012;2012;09;17;Keskiviikko;148;131;279;45;49;94
89;12.09.2012;2012;09;18;Keskiviikko;147;117;264;32;49;81
89;12.09.2012;2012;09;19;Keskiviikko;108;77;185;34;38;72
89;12.09.2012;2012;09;20;Keskiviikko;117;56;173;35;30;65
89;12.09.2012;2012;09;21;Keskiviikko;61;27;88;16;21;37
89;12.09.2012;2012;09;22;Keskiviikko;23;12;35;3;9;12
89;12.09.2012;2012;09;23;Keskiviikko;15;8;23;3;7;10
89;13.09.2012;2012;09;00;Torstai;15;2;17;2;3;5
89;13.09.2012;2012;09;01;Torstai;6;4;10;4;2;6
89;13.09.2012;2012;09;02;Torstai;7;4;11;1;4;5
89;13.09.2012;2012;09;03;Torstai;8;0;8;1;0;1
89;13.09.2012;2012;09;04;Torstai;6;4;10;1;1;2
89;13.09.2012;2012;09;05;Torstai;9;14;23;0;2;2
89;13.09.2012;2012;09;06;Torstai;24;68;92;2;6;8
89;13.09.2012;2012;09;07;Torstai;73;233;306;4;20;24
89;13.09.2012;2012;09;08;Torstai;74;257;331;16;39;55
89;13.09.2012;2012;09;09;Torstai;53;152;205;13;33;46
89;13.09.2012;2012;09;10;Torstai;67;103;170;20;25;45
89;13.09.2012;2012;09;11;Torstai;96;137;233;10;33;43
89;13.09.2012;2012;09;12;Torstai;100;114;214;20;40;60
89;13.09.2012;2012;09;13;Torstai;134;111;245;31;30;61
89;13.09.2012;2012;09;14;Torstai;168;123;291;24;24;48
89;13.09.2012;2012;09;15;Torstai;235;137;372;25;29;54
89;13.09.2012;2012;09;16;Torstai;272;108;380;25;18;43
89;13.09.2012;2012;09;17;Torstai;156;77;233;12;18;30
89;13.09.2012;2012;09;18;Torstai;118;100;218;39;50;89
89;13.09.2012;2012;09;19;Torstai;100;59;159;37;39;76
89;13.09.2012;2012;09;20;Torstai;66;47;113;32;28;60
89;13.09.2012;2012;09;21;Torstai;69;35;104;17;4;21
89;13.09.2012;2012;09;22;Torstai;29;27;56;5;6;11
89;13.09.2012;2012;09;23;Torstai;17;13;30;7;4;11
89;14.09.2012;2012;09;00;Perjantai;22;9;31;1;0;1
89;14.09.2012;2012;09;01;Perjantai;25;2;27;0;1;1
89;14.09.2012;2012;09;02;Perjantai;21;3;24;3;0;3
89;14.09.2012;2012;09;03;Perjantai;21;0;21;2;0;2
89;14.09.2012;2012;09;04;Perjantai;10;2;12;4;2;6
89;14.09.2012;2012;09;05;Perjantai;6;8;14;0;1;1
89;14.09.2012;2012;09;06;Perjantai;18;62;80;4;8;12
89;14.09.2012;2012;09;07;Perjantai;60;185;245;7;25;32
89;14.09.2012;2012;09;08;Perjantai;63;254;317;28;33;61
89;14.09.2012;2012;09;09;Perjantai;44;155;199;21;24;45
89;14.09.2012;2012;09;10;Perjantai;45;119;164;16;39;55
89;14.09.2012;2012;09;11;Perjantai;79;95;174;34;20;54
89;14.09.2012;2012;09;12;Perjantai;84;102;186;17;16;33
89;14.09.2012;2012;09;13;Perjantai;154;111;265;15;21;36
89;14.09.2012;2012;09;14;Perjantai;189;121;310;18;26;44
89;14.09.2012;2012;09;15;Perjantai;209;101;310;22;28;50
89;14.09.2012;2012;09;16;Perjantai;194;89;283;16;6;22
89;14.09.2012;2012;09;17;Perjantai;88;64;152;28;20;48
89;14.09.2012;2012;09;18;Perjantai;64;55;119;16;12;28
89;14.09.2012;2012;09;19;Perjantai;62;41;103;17;2;19
89;14.09.2012;2012;09;20;Perjantai;52;37;89;18;10;28
89;14.09.2012;2012;09;21;Perjantai;33;29;62;8;4;12
89;14.09.2012;2012;09;22;Perjantai;16;19;35;5;7;12
89;14.09.2012;2012;09;23;Perjantai;26;9;35;6;5;11
89;15.09.2012;2012;09;00;Lauantai;17;8;25;1;6;7
89;15.09.2012;2012;09;01;Lauantai;17;7;24;3;2;5
89;15.09.2012;2012;09;02;Lauantai;14;13;27;5;1;6
89;15.09.2012;2012;09;03;Lauantai;5;1;6;3;0;3
89;15.09.2012;2012;09;04;Lauantai;11;0;11;3;1;4
89;15.09.2012;2012;09;05;Lauantai;3;3;6;2;0;2
89;15.09.2012;2012;09;06;Lauantai;4;13;17;1;0;1
89;15.09.2012;2012;09;07;Lauantai;5;15;20;3;4;7
89;15.09.2012;2012;09;08;Lauantai;13;22;35;7;9;16
89;15.09.2012;2012;09;09;Lauantai;6;40;46;12;17;29
89;15.09.2012;2012;09;10;Lauantai;21;51;72;10;24;34
89;15.09.2012;2012;09;11;Lauantai;42;76;118;17;19;36
89;15.09.2012;2012;09;12;Lauantai;61;68;129;16;30;46
89;15.09.2012;2012;09;13;Lauantai;59;78;137;12;17;29
89;15.09.2012;2012;09;14;Lauantai;62;79;141;17;29;46
89;15.09.2012;2012;09;15;Lauantai;89;57;146;18;42;60
89;15.09.2012;2012;09;16;Lauantai;76;48;124;26;22;48
89;15.09.2012;2012;09;17;Lauantai;68;80;148;27;28;55
89;15.09.2012;2012;09;18;Lauantai;63;105;168;40;46;86
89;15.09.2012;2012;09;19;Lauantai;57;40;97;21;36;57
89;15.09.2012;2012;09;20;Lauantai;57;66;123;17;19;36
89;15.09.2012;2012;09;21;Lauantai;42;35;77;12;14;26
89;15.09.2012;2012;09;22;Lauantai;22;48;70;6;13;19
89;15.09.2012;2012;09;23;Lauantai;27;35;62;5;11;16
89;16.09.2012;2012;09;00;Sunnuntai;34;22;56;2;15;17
89;16.09.2012;2012;09;01;Sunnuntai;31;20;51;13;2;15
89;16.09.2012;2012;09;02;Sunnuntai;23;10;33;7;1;8
89;16.09.2012;2012;09;03;Sunnuntai;25;5;30;12;0;12
89;16.09.2012;2012;09;04;Sunnuntai;20;3;23;11;1;12
89;16.09.2012;2012;09;05;Sunnuntai;7;9;16;2;2;4
89;16.09.2012;2012;09;06;Sunnuntai;3;9;12;1;2;3
89;16.09.2012;2012;09;07;Sunnuntai;3;7;10;2;3;5
89;16.09.2012;2012;09;08;Sunnuntai;7;16;23;11;10;21
89;16.09.2012;2012;09;09;Sunnuntai;24;38;62;22;27;49
89;16.09.2012;2012;09;10;Sunnuntai;34;63;97;30;40;70
89;16.09.2012;2012;09;11;Sunnuntai;36;116;152;43;50;93
89;16.09.2012;2012;09;12;Sunnuntai;89;131;220;36;49;85
89;16.09.2012;2012;09;13;Sunnuntai;106;126;232;52;68;120
89;16.09.2012;2012;09;14;Sunnuntai;111;110;221;42;47;89
89;16.09.2012;2012;09;15;Sunnuntai;117;116;233;39;43;82
89;16.09.2012;2012;09;16;Sunnuntai;99;96;195;36;39;75
89;16.09.2012;2012;09;17;Sunnuntai;95;79;174;46;41;87
89;16.09.2012;2012;09;18;Sunnuntai;90;84;174;39;37;76
89;16.09.2012;2012;09;19;Sunnuntai;63;35;98;22;38;60
89;16.09.2012;2012;09;20;Sunnuntai;66;32;98;26;16;42
89;16.09.2012;2012;09;21;Sunnuntai;30;19;49;10;10;20
89;16.09.2012;2012;09;22;Sunnuntai;17;28;45;6;4;10
89;16.09.2012;2012;09;23;Sunnuntai;10;9;19;3;2;5
89;17.09.2012;2012;09;00;Maanantai;3;3;6;1;2;3
89;17.09.2012;2012;09;01;Maanantai;5;5;10;1;1;2
89;17.09.2012;2012;09;02;Maanantai;7;0;7;1;0;1
89;17.09.2012;2012;09;03;Maanantai;2;2;4;1;0;1
89;17.09.2012;2012;09;04;Maanantai;1;4;5;0;1;1
89;17.09.2012;2012;09;05;Maanantai;3;13;16;1;0;1
89;17.09.2012;2012;09;06;Maanantai;17;62;79;1;2;3
89;17.09.2012;2012;09;07;Maanantai;42;205;247;5;19;24
89;17.09.2012;2012;09;08;Maanantai;70;270;340;5;29;34
89;17.09.2012;2012;09;09;Maanantai;57;167;224;13;25;38
89;17.09.2012;2012;09;10;Maanantai;56;98;154;21;47;68
89;17.09.2012;2012;09;11;Maanantai;77;92;169;20;20;40
89;17.09.2012;2012;09;12;Maanantai;84;116;200;17;12;29
89;17.09.2012;2012;09;13;Maanantai;97;76;173;25;27;52
89;17.09.2012;2012;09;14;Maanantai;120;54;174;15;15;30
89;17.09.2012;2012;09;15;Maanantai;164;76;240;14;12;26
89;17.09.2012;2012;09;16;Maanantai;253;93;346;20;7;27
89;17.09.2012;2012;09;17;Maanantai;117;50;167;10;5;15
89;17.09.2012;2012;09;18;Maanantai;77;39;116;20;19;39
89;17.09.2012;2012;09;19;Maanantai;50;44;94;13;25;38
89;17.09.2012;2012;09;20;Maanantai;49;29;78;7;17;24
89;17.09.2012;2012;09;21;Maanantai;34;5;39;7;1;8
89;17.09.2012;2012;09;22;Maanantai;13;8;21;4;4;8
89;17.09.2012;2012;09;23;Maanantai;5;0;5;1;2;3
89;18.09.2012;2012;09;00;Tiistai;3;0;3;0;2;2
89;18.09.2012;2012;09;01;Tiistai;0;0;0;1;0;1
89;18.09.2012;2012;09;02;Tiistai;2;3;5;0;0;0
89;18.09.2012;2012;09;03;Tiistai;0;1;1;0;0;0
89;18.09.2012;2012;09;04;Tiistai;1;1;2;0;1;1
89;18.09.2012;2012;09;05;Tiistai;1;9;10;1;0;1
89;18.09.2012;2012;09;06;Tiistai;15;56;71;2;3;5
89;18.09.2012;2012;09;07;Tiistai;54;183;237;8;14;22
89;18.09.2012;2012;09;08;Tiistai;72;247;319;3;29;32
89;18.09.2012;2012;09;09;Tiistai;45;127;172;13;27;40
89;18.09.2012;2012;09;10;Tiistai;61;106;167;16;29;45
89;18.09.2012;2012;09;11;Tiistai;67;111;178;16;38;54
89;18.09.2012;2012;09;12;Tiistai;84;127;211;27;26;53
89;18.09.2012;2012;09;13;Tiistai;97;97;194;26;30;56
89;18.09.2012;2012;09;14;Tiistai;137;105;242;17;26;43
89;18.09.2012;2012;09;15;Tiistai;226;114;340;31;16;47
89;18.09.2012;2012;09;16;Tiistai;255;170;425;30;22;52
89;18.09.2012;2012;09;17;Tiistai;187;131;318;31;36;67
89;18.09.2012;2012;09;18;Tiistai;144;93;237;42;40;82
89;18.09.2012;2012;09;19;Tiistai;125;85;210;37;32;69
89;18.09.2012;2012;09;20;Tiistai;87;50;137;36;34;70
89;18.09.2012;2012;09;21;Tiistai;53;34;87;8;12;20
89;18.09.2012;2012;09;22;Tiistai;23;5;28;5;5;10
89;18.09.2012;2012;09;23;Tiistai;12;6;18;1;1;2
89;19.09.2012;2012;09;00;Keskiviikko;9;4;13;2;2;4
89;19.09.2012;2012;09;01;Keskiviikko;8;5;13;1;0;1
89;19.09.2012;2012;09;02;Keskiviikko;0;2;2;0;0;0
89;19.09.2012;2012;09;03;Keskiviikko;1;2;3;0;0;0
89;19.09.2012;2012;09;04;Keskiviikko;2;2;4;0;0;0
89;19.09.2012;2012;09;05;Keskiviikko;1;17;18;0;3;3
89;19.09.2012;2012;09;06;Keskiviikko;16;77;93;3;5;8
89;19.09.2012;2012;09;07;Keskiviikko;50;217;267;8;27;35
89;19.09.2012;2012;09;08;Keskiviikko;89;262;351;9;31;40
89;19.09.2012;2012;09;09;Keskiviikko;51;153;204;21;27;48
89;19.09.2012;2012;09;10;Keskiviikko;71;123;194;9;28;37
89;19.09.2012;2012;09;11;Keskiviikko;87;100;187;21;42;63
89;19.09.2012;2012;09;12;Keskiviikko;114;110;224;21;23;44
89;19.09.2012;2012;09;13;Keskiviikko;115;101;216;25;36;61
89;19.09.2012;2012;09;14;Keskiviikko;146;107;253;26;19;45
89;19.09.2012;2012;09;15;Keskiviikko;213;113;326;25;17;42
89;19.09.2012;2012;09;16;Keskiviikko;292;136;428;36;23;59
89;19.09.2012;2012;09;17;Keskiviikko;169;123;292;29;16;45
89;19.09.2012;2012;09;18;Keskiviikko;117;92;209;28;31;59
89;19.09.2012;2012;09;19;Keskiviikko;96;46;142;26;29;55
89;19.09.2012;2012;09;20;Keskiviikko;81;39;120;28;28;56
89;19.09.2012;2012;09;21;Keskiviikko;68;26;94;12;6;18
89;19.09.2012;2012;09;22;Keskiviikko;14;4;18;2;7;9
89;19.09.2012;2012;09;23;Keskiviikko;14;29;43;2;7;9
89;20.09.2012;2012;09;00;Torstai;5;5;10;1;2;3
89;20.09.2012;2012;09;01;Torstai;3;3;6;1;1;2
89;20.09.2012;2012;09;02;Torstai;4;1;5;1;0;1
89;20.09.2012;2012;09;03;Torstai;7;5;12;4;0;4
89;20.09.2012;2012;09;04;Torstai;6;2;8;0;0;0
89;20.09.2012;2012;09;05;Torstai;1;16;17;1;1;2
89;20.09.2012;2012;09;06;Torstai;25;53;78;4;9;13
89;20.09.2012;2012;09;07;Torstai;63;197;260;2;25;27
89;20.09.2012;2012;09;08;Torstai;58;256;314;17;26;43
89;20.09.2012;2012;09;09;Torstai;55;151;206;7;32;39
89;20.09.2012;2012;09;10;Torstai;46;105;151;17;21;38
89;20.09.2012;2012;09;11;Torstai;94;83;177;12;17;29
89;20.09.2012;2012;09;12;Torstai;72;52;124;13;21;34
89;20.09.2012;2012;09;13;Torstai;83;101;184;12;13;25
89;20.09.2012;2012;09;14;Torstai;121;67;188;14;12;26
89;20.09.2012;2012;09;15;Torstai;184;78;262;25;14;39
89;20.09.2012;2012;09;16;Torstai;257;94;351;19;7;26
89;20.09.2012;2012;09;17;Torstai;134;96;230;19;15;34
89;20.09.2012;2012;09;18;Torstai;109;86;195;27;17;44
89;20.09.2012;2012;09;19;Torstai;67;50;117;21;23;44
89;20.09.2012;2012;09;20;Torstai;73;48;121;18;21;39
89;20.09.2012;2012;09;21;Torstai;47;39;86;8;14;22
89;20.09.2012;2012;09;22;Torstai;25;12;37;5;2;7
89;20.09.2012;2012;09;23;Torstai;13;13;26;2;2;4
89;21.09.2012;2012;09;00;Perjantai;13;3;16;4;0;4
89;21.09.2012;2012;09;01;Perjantai;3;3;6;4;1;5
89;21.09.2012;2012;09;02;Perjantai;10;1;11;2;0;2
89;21.09.2012;2012;09;03;Perjantai;13;2;15;0;0;0
89;21.09.2012;2012;09;04;Perjantai;6;2;8;1;1;2
89;21.09.2012;2012;09;05;Perjantai;3;16;19;0;0;0
89;21.09.2012;2012;09;06;Perjantai;20;45;65;4;8;12
89;21.09.2012;2012;09;07;Perjantai;39;146;185;3;10;13
89;21.09.2012;2012;09;08;Perjantai;46;186;232;10;26;36
89;21.09.2012;2012;09;09;Perjantai;35;120;155;13;29;42
89;21.09.2012;2012;09;10;Perjantai;42;87;129;14;22;36
89;21.09.2012;2012;09;11;Perjantai;67;93;160;16;24;40
89;21.09.2012;2012;09;12;Perjantai;77;94;171;17;24;41
89;21.09.2012;2012;09;13;Perjantai;134;115;249;12;27;39
89;21.09.2012;2012;09;14;Perjantai;174;120;294;24;27;51
89;21.09.2012;2012;09;15;Perjantai;192;108;300;31;32;63
89;21.09.2012;2012;09;16;Perjantai;154;91;245;18;27;45
89;21.09.2012;2012;09;17;Perjantai;109;133;242;22;31;53
89;21.09.2012;2012;09;18;Perjantai;105;85;190;44;28;72
89;21.09.2012;2012;09;19;Perjantai;84;62;146;24;17;41
89;21.09.2012;2012;09;20;Perjantai;71;43;114;13;15;28
89;21.09.2012;2012;09;21;Perjantai;28;38;66;11;9;20
89;21.09.2012;2012;09;22;Perjantai;35;42;77;4;13;17
89;21.09.2012;2012;09;23;Perjantai;33;41;74;9;5;14
89;22.09.2012;2012;09;00;Lauantai;22;21;43;6;3;9
89;22.09.2012;2012;09;01;Lauantai;26;21;47;2;3;5
89;22.09.2012;2012;09;02;Lauantai;26;2;28;7;3;10
89;22.09.2012;2012;09;03;Lauantai;24;4;28;12;0;12
89;22.09.2012;2012;09;04;Lauantai;16;1;17;6;1;7
89;22.09.2012;2012;09;05;Lauantai;7;6;13;3;2;5
89;22.09.2012;2012;09;06;Lauantai;7;8;15;0;3;3
89;22.09.2012;2012;09;07;Lauantai;10;19;29;5;4;9
89;22.09.2012;2012;09;08;Lauantai;13;50;63;11;16;27
89;22.09.2012;2012;09;09;Lauantai;19;85;104;15;18;33
89;22.09.2012;2012;09;10;Lauantai;27;76;103;17;24;41
89;22.09.2012;2012;09;11;Lauantai;49;95;144;12;37;49
89;22.09.2012;2012;09;12;Lauantai;70;81;151;19;51;70
89;22.09.2012;2012;09;13;Lauantai;81;106;187;20;20;40
89;22.09.2012;2012;09;14;Lauantai;94;84;178;25;33;58
89;22.09.2012;2012;09;15;Lauantai;118;69;187;25;20;45
89;22.09.2012;2012;09;16;Lauantai;89;83;172;33;31;64
89;22.09.2012;2012;09;17;Lauantai;88;67;155;23;41;64
89;22.09.2012;2012;09;18;Lauantai;67;72;139;23;14;37
89;22.09.2012;2012;09;19;Lauantai;57;56;113;17;35;52
89;22.09.2012;2012;09;20;Lauantai;29;42;71;10;18;28
89;22.09.2012;2012;09;21;Lauantai;44;35;79;5;5;10
89;22.09.2012;2012;09;22;Lauantai;21;32;53;4;4;8
89;22.09.2012;2012;09;23;Lauantai;27;48;75;2;8;10
89;23.09.2012;2012;09;00;Sunnuntai;14;29;43;5;8;13
89;23.09.2012;2012;09;01;Sunnuntai;28;10;38;6;3;9
89;23.09.2012;2012;09;02;Sunnuntai;28;7;35;2;0;2
89;23.09.2012;2012;09;03;Sunnuntai;22;1;23;11;0;11
89;23.09.2012;2012;09;04;Sunnuntai;22;1;23;11;1;12
89;23.09.2012;2012;09;05;Sunnuntai;5;2;7;2;0;2
89;23.09.2012;2012;09;06;Sunnuntai;5;9;14;0;2;2
89;23.09.2012;2012;09;07;Sunnuntai;7;4;11;1;3;4
89;23.09.2012;2012;09;08;Sunnuntai;9;17;26;11;13;24
89;23.09.2012;2012;09;09;Sunnuntai;20;26;46;19;19;38
89;23.09.2012;2012;09;10;Sunnuntai;16;39;55;29;37;66
89;23.09.2012;2012;09;11;Sunnuntai;35;92;127;30;54;84
89;23.09.2012;2012;09;12;Sunnuntai;67;117;184;54;70;124
89;23.09.2012;2012;09;13;Sunnuntai;96;113;209;34;61;95
89;23.09.2012;2012;09;14;Sunnuntai;94;94;188;32;65;97
89;23.09.2012;2012;09;15;Sunnuntai;109;95;204;44;35;79
89;23.09.2012;2012;09;16;Sunnuntai;80;83;163;27;33;60
89;23.09.2012;2012;09;17;Sunnuntai;94;69;163;20;26;46
89;23.09.2012;2012;09;18;Sunnuntai;78;52;130;28;36;64
89;23.09.2012;2012;09;19;Sunnuntai;45;34;79;28;31;59
89;23.09.2012;2012;09;20;Sunnuntai;32;32;64;17;17;34
89;23.09.2012;2012;09;21;Sunnuntai;22;11;33;8;11;19
89;23.09.2012;2012;09;22;Sunnuntai;13;12;25;2;4;6
89;23.09.2012;2012;09;23;Sunnuntai;5;7;12;2;2;4
89;24.09.2012;2012;09;00;Maanantai;3;2;5;1;0;1
89;24.09.2012;2012;09;01;Maanantai;7;1;8;0;0;0
89;24.09.2012;2012;09;02;Maanantai;3;0;3;1;0;1
89;24.09.2012;2012;09;03;Maanantai;2;2;4;1;0;1
89;24.09.2012;2012;09;04;Maanantai;0;2;2;1;2;3
89;24.09.2012;2012;09;05;Maanantai;3;14;17;0;1;1
89;24.09.2012;2012;09;06;Maanantai;20;61;81;3;8;11
89;24.09.2012;2012;09;07;Maanantai;55;217;272;7;31;38
89;24.09.2012;2012;09;08;Maanantai;72;282;354;6;33;39
89;24.09.2012;2012;09;09;Maanantai;62;175;237;7;31;38
89;24.09.2012;2012;09;10;Maanantai;50;88;138;16;21;37
89;24.09.2012;2012;09;11;Maanantai;95;118;213;22;37;59
89;24.09.2012;2012;09;12;Maanantai;78;109;187;15;19;34
89;24.09.2012;2012;09;13;Maanantai;98;130;228;17;19;36
89;24.09.2012;2012;09;14;Maanantai;175;86;261;34;27;61
89;24.09.2012;2012;09;15;Maanantai;246;127;373;33;22;55
89;24.09.2012;2012;09;16;Maanantai;297;143;440;33;14;47
89;24.09.2012;2012;09;17;Maanantai;172;111;283;21;19;40
89;24.09.2012;2012;09;18;Maanantai;138;92;230;27;34;61
89;24.09.2012;2012;09;19;Maanantai;112;67;179;29;44;73
89;24.09.2012;2012;09;20;Maanantai;79;40;119;18;26;44
89;24.09.2012;2012;09;21;Maanantai;51;23;74;10;16;26
89;24.09.2012;2012;09;22;Maanantai;20;10;30;2;7;9
89;24.09.2012;2012;09;23;Maanantai;6;6;12;3;1;4
89;25.09.2012;2012;09;00;Tiistai;7;7;14;1;2;3
89;25.09.2012;2012;09;01;Tiistai;1;3;4;1;0;1
89;25.09.2012;2012;09;02;Tiistai;1;0;1;2;0;2
89;25.09.2012;2012;09;03;Tiistai;3;3;6;0;0;0
89;25.09.2012;2012;09;04;Tiistai;1;4;5;0;1;1
89;25.09.2012;2012;09;05;Tiistai;4;14;18;0;1;1
89;25.09.2012;2012;09;06;Tiistai;22;77;99;3;10;13
89;25.09.2012;2012;09;07;Tiistai;70;227;297;5;26;31
89;25.09.2012;2012;09;08;Tiistai;99;287;386;7;39;46
89;25.09.2012;2012;09;09;Tiistai;49;164;213;6;23;29
89;25.09.2012;2012;09;10;Tiistai;58;109;167;14;26;40
89;25.09.2012;2012;09;11;Tiistai;71;102;173;12;17;29
89;25.09.2012;2012;09;12;Tiistai;92;117;209;15;29;44
89;25.09.2012;2012;09;13;Tiistai;124;83;207;22;19;41
89;25.09.2012;2012;09;14;Tiistai;164;124;288;30;27;57
89;25.09.2012;2012;09;15;Tiistai;261;126;387;31;31;62
89;25.09.2012;2012;09;16;Tiistai;271;146;417;37;34;71
89;25.09.2012;2012;09;17;Tiistai;183;106;289;26;29;55
89;25.09.2012;2012;09;18;Tiistai;129;84;213;37;23;60
89;25.09.2012;2012;09;19;Tiistai;105;84;189;33;27;60
89;25.09.2012;2012;09;20;Tiistai;58;43;101;20;21;41
89;25.09.2012;2012;09;21;Tiistai;36;22;58;14;8;22
89;25.09.2012;2012;09;22;Tiistai;30;12;42;6;3;9
89;25.09.2012;2012;09;23;Tiistai;13;3;16;6;0;6
89;26.09.2012;2012;09;00;Keskiviikko;3;1;4;1;0;1
89;26.09.2012;2012;09;01;Keskiviikko;5;1;6;2;0;2
89;26.09.2012;2012;09;02;Keskiviikko;0;2;2;0;0;0
89;26.09.2012;2012;09;03;Keskiviikko;3;5;8;0;0;0
89;26.09.2012;2012;09;04;Keskiviikko;1;2;3;0;2;2
89;26.09.2012;2012;09;05;Keskiviikko;4;18;22;0;5;5
89;26.09.2012;2012;09;06;Keskiviikko;20;66;86;2;4;6
89;26.09.2012;2012;09;07;Keskiviikko;59;214;273;5;19;24
89;26.09.2012;2012;09;08;Keskiviikko;118;262;380;14;32;46
89;26.09.2012;2012;09;09;Keskiviikko;49;156;205;12;34;46
89;26.09.2012;2012;09;10;Keskiviikko;57;94;151;21;31;52
89;26.09.2012;2012;09;11;Keskiviikko;76;112;188;19;25;44
89;26.09.2012;2012;09;12;Keskiviikko;110;122;232;25;26;51
89;26.09.2012;2012;09;13;Keskiviikko;121;108;229;15;27;42
89;26.09.2012;2012;09;14;Keskiviikko;151;85;236;20;23;43
89;26.09.2012;2012;09;15;Keskiviikko;200;106;306;19;15;34
89;26.09.2012;2012;09;16;Keskiviikko;270;125;395;30;32;62
89;26.09.2012;2012;09;17;Keskiviikko;157;112;269;31;22;53
89;26.09.2012;2012;09;18;Keskiviikko;116;101;217;32;26;58
89;26.09.2012;2012;09;19;Keskiviikko;87;44;131;30;32;62
89;26.09.2012;2012;09;20;Keskiviikko;88;45;133;17;23;40
89;26.09.2012;2012;09;21;Keskiviikko;51;33;84;9;20;29
89;26.09.2012;2012;09;22;Keskiviikko;23;12;35;6;3;9
89;26.09.2012;2012;09;23;Keskiviikko;14;14;28;1;5;6
89;27.09.2012;2012;09;00;Torstai;8;12;20;2;1;3
89;27.09.2012;2012;09;01;Torstai;13;2;15;1;1;2
89;27.09.2012;2012;09;02;Torstai;12;0;12;3;0;3
89;27.09.2012;2012;09;03;Torstai;6;1;7;1;0;1
89;27.09.2012;2012;09;04;Torstai;4;5;9;0;2;2
89;27.09.2012;2012;09;05;Torstai;6;11;17;0;1;1
89;27.09.2012;2012;09;06;Torstai;17;51;68;2;5;7
89;27.09.2012;2012;09;07;Torstai;47;182;229;3;21;24
89;27.09.2012;2012;09;08;Torstai;61;232;293;13;25;38
89;27.09.2012;2012;09;09;Torstai;41;85;126;15;20;35
89;27.09.2012;2012;09;10;Torstai;33;44;77;5;11;16
89;27.09.2012;2012;09;11;Torstai;52;62;114;6;17;23
89;27.09.2012;2012;09;12;Torstai;36;48;84;6;11;17
89;27.09.2012;2012;09;13;Torstai;67;47;114;7;8;15
89;27.09.2012;2012;09;14;Torstai;113;62;175;13;12;25
89;27.09.2012;2012;09;15;Torstai;127;50;177;21;9;30
89;27.09.2012;2012;09;16;Torstai;176;71;247;23;12;35
89;27.09.2012;2012;09;17;Torstai;100;86;186;22;21;43
89;27.09.2012;2012;09;18;Torstai;84;63;147;37;23;60
89;27.09.2012;2012;09;19;Torstai;54;48;102;29;21;50
89;27.09.2012;2012;09;20;Torstai;54;38;92;15;24;39
89;27.09.2012;2012;09;21;Torstai;39;31;70;10;23;33
89;27.09.2012;2012;09;22;Torstai;18;7;25;5;7;12
89;27.09.2012;2012;09;23;Torstai;11;11;22;1;1;2
89;28.09.2012;2012;09;00;Perjantai;6;3;9;2;1;3
89;28.09.2012;2012;09;01;Perjantai;8;2;10;4;1;5
89;28.09.2012;2012;09;02;Perjantai;7;1;8;1;0;1
89;28.09.2012;2012;09;03;Perjantai;6;1;7;2;2;4
89;28.09.2012;2012;09;04;Perjantai;4;2;6;1;0;1
89;28.09.2012;2012;09;05;Perjantai;6;10;16;0;1;1
89;28.09.2012;2012;09;06;Perjantai;17;62;79;3;5;8
89;28.09.2012;2012;09;07;Perjantai;55;183;238;4;23;27
89;28.09.2012;2012;09;08;Perjantai;64;223;287;4;23;27
89;28.09.2012;2012;09;09;Perjantai;44;121;165;18;27;45
89;28.09.2012;2012;09;10;Perjantai;55;99;154;12;23;35
89;28.09.2012;2012;09;11;Perjantai;54;98;152;23;24;47
89;28.09.2012;2012;09;12;Perjantai;96;115;211;26;28;54
89;28.09.2012;2012;09;13;Perjantai;139;99;238;75;61;136
89;28.09.2012;2012;09;14;Perjantai;163;94;257;22;17;39
89;28.09.2012;2012;09;15;Perjantai;171;103;274;20;18;38
89;28.09.2012;2012;09;16;Perjantai;186;98;284;18;13;31
89;28.09.2012;2012;09;17;Perjantai;103;69;172;19;25;44
89;28.09.2012;2012;09;18;Perjantai;82;67;149;20;17;37
89;28.09.2012;2012;09;19;Perjantai;62;34;96;13;19;32
89;28.09.2012;2012;09;20;Perjantai;61;36;97;6;11;17
89;28.09.2012;2012;09;21;Perjantai;35;36;71;1;6;7
89;28.09.2012;2012;09;22;Perjantai;26;44;70;8;10;18
89;28.09.2012;2012;09;23;Perjantai;23;14;37;4;8;12
89;29.09.2012;2012;09;00;Lauantai;21;17;38;4;2;6
89;29.09.2012;2012;09;01;Lauantai;20;5;25;6;4;10
89;29.09.2012;2012;09;02;Lauantai;19;6;25;4;1;5
89;29.09.2012;2012;09;03;Lauantai;16;1;17;6;1;7
89;29.09.2012;2012;09;04;Lauantai;13;5;18;6;1;7
89;29.09.2012;2012;09;05;Lauantai;6;5;11;3;1;4
89;29.09.2012;2012;09;06;Lauantai;4;9;13;3;2;5
89;29.09.2012;2012;09;07;Lauantai;5;11;16;1;3;4
89;29.09.2012;2012;09;08;Lauantai;12;28;40;7;15;22
89;29.09.2012;2012;09;09;Lauantai;14;74;88;15;25;40
89;29.09.2012;2012;09;10;Lauantai;23;69;92;18;30;48
89;29.09.2012;2012;09;11;Lauantai;42;104;146;22;27;49
89;29.09.2012;2012;09;12;Lauantai;68;79;147;9;26;35
89;29.09.2012;2012;09;13;Lauantai;76;95;171;28;31;59
89;29.09.2012;2012;09;14;Lauantai;89;65;154;18;22;40
89;29.09.2012;2012;09;15;Lauantai;94;71;165;24;31;55
89;29.09.2012;2012;09;16;Lauantai;79;71;150;29;38;67
89;29.09.2012;2012;09;17;Lauantai;90;75;165;26;43;69
89;29.09.2012;2012;09;18;Lauantai;58;91;149;30;25;55
89;29.09.2012;2012;09;19;Lauantai;59;45;104;22;31;53
89;29.09.2012;2012;09;20;Lauantai;42;42;84;11;14;25
89;29.09.2012;2012;09;21;Lauantai;33;29;62;6;13;19
89;29.09.2012;2012;09;22;Lauantai;19;35;54;5;14;19
89;29.09.2012;2012;09;23;Lauantai;29;31;60;9;10;19
89;30.09.2012;2012;09;00;Sunnuntai;17;25;42;1;4;5
89;30.09.2012;2012;09;01;Sunnuntai;32;16;48;3;7;10
89;30.09.2012;2012;09;02;Sunnuntai;15;2;17;8;0;8
89;30.09.2012;2012;09;03;Sunnuntai;25;3;28;6;0;6
89;30.09.2012;2012;09;04;Sunnuntai;22;2;24;10;0;10
89;30.09.2012;2012;09;05;Sunnuntai;6;2;8;1;1;2
89;30.09.2012;2012;09;06;Sunnuntai;6;8;14;3;1;4
89;30.09.2012;2012;09;07;Sunnuntai;3;8;11;2;4;6
89;30.09.2012;2012;09;08;Sunnuntai;7;9;16;5;7;12
89;30.09.2012;2012;09;09;Sunnuntai;14;16;30;13;16;29
89;30.09.2012;2012;09;10;Sunnuntai;14;34;48;19;30;49
89;30.09.2012;2012;09;11;Sunnuntai;24;57;81;36;24;60
89;30.09.2012;2012;09;12;Sunnuntai;49;67;116;34;37;71
89;30.09.2012;2012;09;13;Sunnuntai;67;79;146;36;33;69
89;30.09.2012;2012;09;14;Sunnuntai;64;66;130;22;33;55
89;30.09.2012;2012;09;15;Sunnuntai;69;55;124;33;48;81
89;30.09.2012;2012;09;16;Sunnuntai;51;44;95;24;30;54
89;30.09.2012;2012;09;17;Sunnuntai;67;60;127;33;19;52
89;30.09.2012;2012;09;18;Sunnuntai;57;49;106;14;34;48
89;30.09.2012;2012;09;19;Sunnuntai;46;33;79;18;27;45
89;30.09.2012;2012;09;20;Sunnuntai;40;38;78;22;15;37
89;30.09.2012;2012;09;21;Sunnuntai;24;9;33;11;8;19
89;30.09.2012;2012;09;22;Sunnuntai;8;4;12;4;3;7
89;30.09.2012;2012;09;23;Sunnuntai;3;8;11;6;2;8
89;01.10.2012;2012;10;00;Maanantai;3;3;6;0;0;0
89;01.10.2012;2012;10;01;Maanantai;3;0;3;0;1;1
89;01.10.2012;2012;10;02;Maanantai;4;2;6;0;0;0
89;01.10.2012;2012;10;03;Maanantai;0;2;2;5;0;5
89;01.10.2012;2012;10;04;Maanantai;4;4;8;0;1;1
89;01.10.2012;2012;10;05;Maanantai;3;12;15;1;2;3
89;01.10.2012;2012;10;06;Maanantai;21;65;86;0;7;7
89;01.10.2012;2012;10;07;Maanantai;47;203;250;5;19;24
89;01.10.2012;2012;10;08;Maanantai;79;283;362;12;21;33
89;01.10.2012;2012;10;09;Maanantai;54;141;195;9;29;38
89;01.10.2012;2012;10;10;Maanantai;60;98;158;9;24;33
89;01.10.2012;2012;10;11;Maanantai;69;118;187;8;22;30
89;01.10.2012;2012;10;12;Maanantai;74;118;192;25;25;50
89;01.10.2012;2012;10;13;Maanantai;137;115;252;16;29;45
89;01.10.2012;2012;10;14;Maanantai;160;116;276;23;22;45
89;01.10.2012;2012;10;15;Maanantai;244;125;369;32;22;54
89;01.10.2012;2012;10;16;Maanantai;273;126;399;36;26;62
89;01.10.2012;2012;10;17;Maanantai;178;132;310;33;38;71
89;01.10.2012;2012;10;18;Maanantai;153;108;261;48;45;93
89;01.10.2012;2012;10;19;Maanantai;89;65;154;48;36;84
89;01.10.2012;2012;10;20;Maanantai;93;53;146;24;32;56
89;01.10.2012;2012;10;21;Maanantai;54;23;77;13;10;23
89;01.10.2012;2012;10;22;Maanantai;26;12;38;7;2;9
89;01.10.2012;2012;10;23;Maanantai;11;4;15;1;4;5
89;02.10.2012;2012;10;00;Tiistai;3;0;3;0;1;1
89;02.10.2012;2012;10;01;Tiistai;3;2;5;0;1;1
89;02.10.2012;2012;10;02;Tiistai;0;2;2;1;0;1
89;02.10.2012;2012;10;03;Tiistai;2;1;3;0;0;0
89;02.10.2012;2012;10;04;Tiistai;1;2;3;0;0;0
89;02.10.2012;2012;10;05;Tiistai;2;15;17;0;0;0
89;02.10.2012;2012;10;06;Tiistai;22;61;83;2;5;7
89;02.10.2012;2012;10;07;Tiistai;55;189;244;5;26;31
89;02.10.2012;2012;10;08;Tiistai;84;246;330;6;30;36
89;02.10.2012;2012;10;09;Tiistai;36;148;184;6;18;24
89;02.10.2012;2012;10;10;Tiistai;53;100;153;14;22;36
89;02.10.2012;2012;10;11;Tiistai;64;41;105;18;24;42
89;02.10.2012;2012;10;12;Tiistai;57;49;106;8;17;25
89;02.10.2012;2012;10;13;Tiistai;76;68;144;19;25;44
89;02.10.2012;2012;10;14;Tiistai;126;100;226;23;17;40
89;02.10.2012;2012;10;15;Tiistai;165;78;243;19;8;27
89;02.10.2012;2012;10;16;Tiistai;229;102;331;41;22;63
89;02.10.2012;2012;10;17;Tiistai;92;76;168;14;11;25
89;02.10.2012;2012;10;18;Tiistai;88;66;154;25;28;53
89;02.10.2012;2012;10;19;Tiistai;76;58;134;28;22;50
89;02.10.2012;2012;10;20;Tiistai;85;25;110;32;21;53
89;02.10.2012;2012;10;21;Tiistai;64;20;84;16;9;25
89;02.10.2012;2012;10;22;Tiistai;12;9;21;8;4;12
89;02.10.2012;2012;10;23;Tiistai;7;3;10;3;3;6
89;03.10.2012;2012;10;00;Keskiviikko;2;1;3;1;1;2
89;03.10.2012;2012;10;01;Keskiviikko;2;0;2;0;0;0
89;03.10.2012;2012;10;02;Keskiviikko;4;1;5;0;0;0
89;03.10.2012;2012;10;03;Keskiviikko;0;1;1;0;0;0
89;03.10.2012;2012;10;04;Keskiviikko;0;1;1;0;1;1
89;03.10.2012;2012;10;05;Keskiviikko;2;19;21;0;3;3
89;03.10.2012;2012;10;06;Keskiviikko;20;71;91;2;4;6
89;03.10.2012;2012;10;07;Keskiviikko;50;196;246;2;26;28
89;03.10.2012;2012;10;08;Keskiviikko;78;237;315;15;26;41
89;03.10.2012;2012;10;09;Keskiviikko;48;136;184;11;28;39
89;03.10.2012;2012;10;10;Keskiviikko;55;99;154;15;29;44
89;03.10.2012;2012;10;11;Keskiviikko;80;107;187;14;27;41
89;03.10.2012;2012;10;12;Keskiviikko;85;127;212;14;24;38
89;03.10.2012;2012;10;13;Keskiviikko;127;87;214;21;25;46
89;03.10.2012;2012;10;14;Keskiviikko;137;108;245;18;30;48
89;03.10.2012;2012;10;15;Keskiviikko;218;109;327;21;22;43
89;03.10.2012;2012;10;16;Keskiviikko;256;133;389;26;31;57
89;03.10.2012;2012;10;17;Keskiviikko;154;137;291;23;26;49
89;03.10.2012;2012;10;18;Keskiviikko;142;110;252;43;48;91
89;03.10.2012;2012;10;19;Keskiviikko;140;51;191;36;40;76
89;03.10.2012;2012;10;20;Keskiviikko;96;54;150;28;19;47
89;03.10.2012;2012;10;21;Keskiviikko;72;29;101;18;18;36
89;03.10.2012;2012;10;22;Keskiviikko;28;14;42;2;5;7
89;03.10.2012;2012;10;23;Keskiviikko;21;16;37;1;0;1
89;04.10.2012;2012;10;00;Torstai;7;3;10;2;0;2
89;04.10.2012;2012;10;01;Torstai;7;2;9;3;0;3
89;04.10.2012;2012;10;02;Torstai;3;2;5;0;2;2
89;04.10.2012;2012;10;03;Torstai;6;2;8;2;0;2
89;04.10.2012;2012;10;04;Torstai;4;3;7;2;0;2
89;04.10.2012;2012;10;05;Torstai;6;12;18;0;0;0
89;04.10.2012;2012;10;06;Torstai;28;70;98;5;8;13
89;04.10.2012;2012;10;07;Torstai;63;212;275;3;20;23
89;04.10.2012;2012;10;08;Torstai;77;242;319;7;36;43
89;04.10.2012;2012;10;09;Torstai;59;109;168;12;38;50
89;04.10.2012;2012;10;10;Torstai;40;76;116;21;33;54
89;04.10.2012;2012;10;11;Torstai;57;61;118;11;14;25
89;04.10.2012;2012;10;12;Torstai;48;52;100;5;8;13
89;04.10.2012;2012;10;13;Torstai;73;54;127;11;10;21
89;04.10.2012;2012;10;14;Torstai;98;81;179;19;21;40
89;04.10.2012;2012;10;15;Torstai;208;98;306;32;12;44
89;04.10.2012;2012;10;16;Torstai;236;120;356;30;23;53
89;04.10.2012;2012;10;17;Torstai;135;116;251;28;25;53
89;04.10.2012;2012;10;18;Torstai;142;76;218;30;31;61
89;04.10.2012;2012;10;19;Torstai;86;63;149;29;26;55
89;04.10.2012;2012;10;20;Torstai;64;44;108;27;27;54
89;04.10.2012;2012;10;21;Torstai;51;21;72;15;14;29
89;04.10.2012;2012;10;22;Torstai;21;31;52;4;6;10
89;04.10.2012;2012;10;23;Torstai;16;18;34;3;1;4
89;05.10.2012;2012;10;00;Perjantai;8;10;18;3;0;3
89;05.10.2012;2012;10;01;Perjantai;10;3;13;2;0;2
89;05.10.2012;2012;10;02;Perjantai;10;3;13;1;0;1
89;05.10.2012;2012;10;03;Perjantai;6;2;8;1;0;1
89;05.10.2012;2012;10;04;Perjantai;11;2;13;1;0;1
89;05.10.2012;2012;10;05;Perjantai;2;13;15;2;1;3
89;05.10.2012;2012;10;06;Perjantai;16;59;75;1;6;7
89;05.10.2012;2012;10;07;Perjantai;41;176;217;6;23;29
89;05.10.2012;2012;10;08;Perjantai;54;196;250;7;31;38
89;05.10.2012;2012;10;09;Perjantai;43;97;140;6;28;34
89;05.10.2012;2012;10;10;Perjantai;33;54;87;7;13;20
89;05.10.2012;2012;10;11;Perjantai;50;71;121;8;16;24
89;05.10.2012;2012;10;12;Perjantai;62;43;105;14;15;29
89;05.10.2012;2012;10;13;Perjantai;86;55;141;18;7;25
89;05.10.2012;2012;10;14;Perjantai;117;57;174;22;17;39
89;05.10.2012;2012;10;15;Perjantai;164;47;211;22;11;33
89;05.10.2012;2012;10;16;Perjantai;131;74;205;19;15;34
89;05.10.2012;2012;10;17;Perjantai;69;64;133;19;21;40
89;05.10.2012;2012;10;18;Perjantai;55;50;105;14;19;33
89;05.10.2012;2012;10;19;Perjantai;47;34;81;9;13;22
89;05.10.2012;2012;10;20;Perjantai;31;21;52;7;6;13
89;05.10.2012;2012;10;21;Perjantai;19;19;38;4;9;13
89;05.10.2012;2012;10;22;Perjantai;15;14;29;2;3;5
89;05.10.2012;2012;10;23;Perjantai;15;13;28;4;3;7
89;06.10.2012;2012;10;00;Lauantai;18;15;33;6;4;10
89;06.10.2012;2012;10;01;Lauantai;6;14;20;6;0;6
89;06.10.2012;2012;10;02;Lauantai;17;4;21;3;2;5
89;06.10.2012;2012;10;03;Lauantai;11;4;15;4;0;4
89;06.10.2012;2012;10;04;Lauantai;14;1;15;9;0;9
89;06.10.2012;2012;10;05;Lauantai;8;1;9;1;2;3
89;06.10.2012;2012;10;06;Lauantai;5;9;14;1;3;4
89;06.10.2012;2012;10;07;Lauantai;6;8;14;2;4;6
89;06.10.2012;2012;10;08;Lauantai;12;25;37;5;7;12
89;06.10.2012;2012;10;09;Lauantai;10;57;67;20;39;59
89;06.10.2012;2012;10;10;Lauantai;22;78;100;16;37;53
89;06.10.2012;2012;10;11;Lauantai;65;76;141;23;38;61
89;06.10.2012;2012;10;12;Lauantai;65;99;164;19;38;57
89;06.10.2012;2012;10;13;Lauantai;65;96;161;22;25;47
89;06.10.2012;2012;10;14;Lauantai;84;68;152;34;27;61
89;06.10.2012;2012;10;15;Lauantai;71;77;148;27;27;54
89;06.10.2012;2012;10;16;Lauantai;71;52;123;13;27;40
89;06.10.2012;2012;10;17;Lauantai;79;61;140;26;27;53
89;06.10.2012;2012;10;18;Lauantai;46;44;90;17;23;40
89;06.10.2012;2012;10;19;Lauantai;34;37;71;16;17;33
89;06.10.2012;2012;10;20;Lauantai;32;36;68;4;5;9
89;06.10.2012;2012;10;21;Lauantai;37;21;58;2;6;8
89;06.10.2012;2012;10;22;Lauantai;26;23;49;4;4;8
89;06.10.2012;2012;10;23;Lauantai;12;20;32;5;7;12
89;07.10.2012;2012;10;00;Sunnuntai;20;19;39;5;6;11
89;07.10.2012;2012;10;01;Sunnuntai;25;12;37;1;1;2
89;07.10.2012;2012;10;02;Sunnuntai;14;8;22;4;1;5
89;07.10.2012;2012;10;03;Sunnuntai;27;2;29;9;6;15
89;07.10.2012;2012;10;04;Sunnuntai;16;3;19;8;0;8
89;07.10.2012;2012;10;05;Sunnuntai;6;3;9;4;0;4
89;07.10.2012;2012;10;06;Sunnuntai;6;8;14;0;6;6
89;07.10.2012;2012;10;07;Sunnuntai;4;7;11;1;5;6
89;07.10.2012;2012;10;08;Sunnuntai;9;14;23;5;7;12
89;07.10.2012;2012;10;09;Sunnuntai;20;25;45;12;24;36
89;07.10.2012;2012;10;10;Sunnuntai;29;36;65;22;31;53
89;07.10.2012;2012;10;11;Sunnuntai;36;58;94;33;44;77
89;07.10.2012;2012;10;12;Sunnuntai;54;68;122;45;54;99
89;07.10.2012;2012;10;13;Sunnuntai;46;61;107;25;32;57
89;07.10.2012;2012;10;14;Sunnuntai;64;46;110;20;30;50
89;07.10.2012;2012;10;15;Sunnuntai;69;72;141;25;33;58
89;07.10.2012;2012;10;16;Sunnuntai;77;46;123;37;34;71
89;07.10.2012;2012;10;17;Sunnuntai;68;58;126;29;30;59
89;07.10.2012;2012;10;18;Sunnuntai;43;50;93;31;37;68
89;07.10.2012;2012;10;19;Sunnuntai;37;54;91;21;25;46
89;07.10.2012;2012;10;20;Sunnuntai;44;23;67;19;16;35
89;07.10.2012;2012;10;21;Sunnuntai;34;13;47;6;8;14
89;07.10.2012;2012;10;22;Sunnuntai;14;5;19;2;1;3
89;07.10.2012;2012;10;23;Sunnuntai;8;0;8;2;2;4
89;08.10.2012;2012;10;00;Maanantai;4;1;5;0;0;0
89;08.10.2012;2012;10;01;Maanantai;2;3;5;1;1;2
89;08.10.2012;2012;10;02;Maanantai;1;1;2;0;0;0
89;08.10.2012;2012;10;03;Maanantai;2;0;2;0;0;0
89;08.10.2012;2012;10;04;Maanantai;2;6;8;0;3;3
89;08.10.2012;2012;10;05;Maanantai;3;10;13;0;0;0
89;08.10.2012;2012;10;06;Maanantai;22;64;86;0;4;4
89;08.10.2012;2012;10;07;Maanantai;67;204;271;7;14;21
89;08.10.2012;2012;10;08;Maanantai;70;251;321;10;36;46
89;08.10.2012;2012;10;09;Maanantai;49;140;189;17;25;42
89;08.10.2012;2012;10;10;Maanantai;54;115;169;20;34;54
89;08.10.2012;2012;10;11;Maanantai;88;99;187;28;30;58
89;08.10.2012;2012;10;12;Maanantai;82;95;177;19;14;33
89;08.10.2012;2012;10;13;Maanantai;72;106;178;19;16;35
89;08.10.2012;2012;10;14;Maanantai;161;96;257;13;12;25
89;08.10.2012;2012;10;15;Maanantai;233;106;339;30;8;38
89;08.10.2012;2012;10;16;Maanantai;256;114;370;20;26;46
89;08.10.2012;2012;10;17;Maanantai;155;118;273;42;23;65
89;08.10.2012;2012;10;18;Maanantai;102;99;201;35;44;79
89;08.10.2012;2012;10;19;Maanantai;103;53;156;44;37;81
89;08.10.2012;2012;10;20;Maanantai;78;30;108;25;33;58
89;08.10.2012;2012;10;21;Maanantai;49;27;76;15;16;31
89;08.10.2012;2012;10;22;Maanantai;18;5;23;5;1;6
89;08.10.2012;2012;10;23;Maanantai;9;6;15;0;4;4
89;09.10.2012;2012;10;00;Tiistai;2;2;4;1;0;1
89;09.10.2012;2012;10;01;Tiistai;5;1;6;0;1;1
89;09.10.2012;2012;10;02;Tiistai;0;0;0;4;0;4
89;09.10.2012;2012;10;03;Tiistai;0;3;3;1;0;1
89;09.10.2012;2012;10;04;Tiistai;3;6;9;0;0;0
89;09.10.2012;2012;10;05;Tiistai;1;11;12;0;0;0
89;09.10.2012;2012;10;06;Tiistai;19;67;86;4;7;11
89;09.10.2012;2012;10;07;Tiistai;62;198;260;7;22;29
89;09.10.2012;2012;10;08;Tiistai;82;241;323;8;31;39
89;09.10.2012;2012;10;09;Tiistai;50;134;184;17;45;62
89;09.10.2012;2012;10;10;Tiistai;44;71;115;16;25;41
89;09.10.2012;2012;10;11;Tiistai;75;72;147;20;21;41
89;09.10.2012;2012;10;12;Tiistai;58;87;145;18;24;42
89;09.10.2012;2012;10;13;Tiistai;86;113;199;18;24;42
89;09.10.2012;2012;10;14;Tiistai;127;102;229;30;20;50
89;09.10.2012;2012;10;15;Tiistai;188;91;279;27;18;45
89;09.10.2012;2012;10;16;Tiistai;244;135;379;28;29;57
89;09.10.2012;2012;10;17;Tiistai;156;110;266;23;30;53
89;09.10.2012;2012;10;18;Tiistai;121;83;204;44;46;90
89;09.10.2012;2012;10;19;Tiistai;82;61;143;31;38;69
89;09.10.2012;2012;10;20;Tiistai;106;39;145;23;32;55
89;09.10.2012;2012;10;21;Tiistai;53;28;81;12;7;19
89;09.10.2012;2012;10;22;Tiistai;17;14;31;11;5;16
89;09.10.2012;2012;10;23;Tiistai;12;3;15;4;3;7
89;10.10.2012;2012;10;00;Keskiviikko;8;1;9;0;0;0
89;10.10.2012;2012;10;01;Keskiviikko;1;2;3;0;0;0
89;10.10.2012;2012;10;02;Keskiviikko;4;2;6;0;0;0
89;10.10.2012;2012;10;03;Keskiviikko;2;1;3;0;0;0
89;10.10.2012;2012;10;04;Keskiviikko;1;5;6;1;0;1
89;10.10.2012;2012;10;05;Keskiviikko;3;10;13;0;1;1
89;10.10.2012;2012;10;06;Keskiviikko;25;62;87;3;3;6
89;10.10.2012;2012;10;07;Keskiviikko;51;219;270;4;15;19
89;10.10.2012;2012;10;08;Keskiviikko;65;269;334;14;35;49
89;10.10.2012;2012;10;09;Keskiviikko;59;145;204;13;32;45
89;10.10.2012;2012;10;10;Keskiviikko;66;112;178;11;27;38
89;10.10.2012;2012;10;11;Keskiviikko;76;102;178;22;26;48
89;10.10.2012;2012;10;12;Keskiviikko;90;131;221;34;37;71
89;10.10.2012;2012;10;13;Keskiviikko;128;118;246;16;20;36
89;10.10.2012;2012;10;14;Keskiviikko;156;132;288;18;23;41
89;10.10.2012;2012;10;15;Keskiviikko;216;132;348;30;33;63
89;10.10.2012;2012;10;16;Keskiviikko;259;110;369;24;28;52
89;10.10.2012;2012;10;17;Keskiviikko;175;129;304;49;37;86
89;10.10.2012;2012;10;18;Keskiviikko;134;120;254;34;62;96
89;10.10.2012;2012;10;19;Keskiviikko;110;61;171;50;40;90
89;10.10.2012;2012;10;20;Keskiviikko;77;48;125;61;36;97
89;10.10.2012;2012;10;21;Keskiviikko;62;22;84;11;13;24
89;10.10.2012;2012;10;22;Keskiviikko;22;21;43;2;1;3
89;10.10.2012;2012;10;23;Keskiviikko;21;5;26;1;4;5
89;11.10.2012;2012;10;00;Torstai;11;11;22;0;3;3
89;11.10.2012;2012;10;01;Torstai;8;1;9;0;0;0
89;11.10.2012;2012;10;02;Torstai;8;2;10;1;0;1
89;11.10.2012;2012;10;03;Torstai;2;2;4;1;0;1
89;11.10.2012;2012;10;04;Torstai;4;4;8;2;0;2
89;11.10.2012;2012;10;05;Torstai;6;16;22;0;1;1
89;11.10.2012;2012;10;06;Torstai;20;60;80;3;5;8
89;11.10.2012;2012;10;07;Torstai;59;200;259;7;24;31
89;11.10.2012;2012;10;08;Torstai;81;275;356;7;28;35
89;11.10.2012;2012;10;09;Torstai;61;138;199;15;34;49
89;11.10.2012;2012;10;10;Torstai;52;109;161;11;23;34
89;11.10.2012;2012;10;11;Torstai;72;92;164;21;23;44
89;11.10.2012;2012;10;12;Torstai;90;122;212;18;24;42
89;11.10.2012;2012;10;13;Torstai;113;97;210;18;29;47
89;11.10.2012;2012;10;14;Torstai;157;122;279;23;25;48
89;11.10.2012;2012;10;15;Torstai;209;108;317;27;35;62
89;11.10.2012;2012;10;16;Torstai;271;109;380;31;26;57
89;11.10.2012;2012;10;17;Torstai;165;107;272;31;33;64
89;11.10.2012;2012;10;18;Torstai;123;106;229;29;41;70
89;11.10.2012;2012;10;19;Torstai;81;76;157;28;27;55
89;11.10.2012;2012;10;20;Torstai;81;58;139;25;19;44
89;11.10.2012;2012;10;21;Torstai;61;31;92;9;17;26
89;11.10.2012;2012;10;22;Torstai;27;15;42;11;6;17
89;11.10.2012;2012;10;23;Torstai;17;8;25;1;1;2
89;12.10.2012;2012;10;00;Perjantai;14;6;20;1;2;3
89;12.10.2012;2012;10;01;Perjantai;12;3;15;1;1;2
89;12.10.2012;2012;10;02;Perjantai;4;3;7;0;0;0
89;12.10.2012;2012;10;03;Perjantai;15;2;17;2;0;2
89;12.10.2012;2012;10;04;Perjantai;10;5;15;0;0;0
89;12.10.2012;2012;10;05;Perjantai;5;13;18;0;1;1
89;12.10.2012;2012;10;06;Perjantai;18;60;78;5;6;11
89;12.10.2012;2012;10;07;Perjantai;55;176;231;7;16;23
89;12.10.2012;2012;10;08;Perjantai;74;219;293;13;32;45
89;12.10.2012;2012;10;09;Perjantai;56;147;203;27;56;83
89;12.10.2012;2012;10;10;Perjantai;63;95;158;24;32;56
89;12.10.2012;2012;10;11;Perjantai;90;100;190;21;24;45
89;12.10.2012;2012;10;12;Perjantai;80;103;183;26;23;49
89;12.10.2012;2012;10;13;Perjantai;127;108;235;22;41;63
89;12.10.2012;2012;10;14;Perjantai;149;127;276;27;28;55
89;12.10.2012;2012;10;15;Perjantai;180;92;272;32;25;57
89;12.10.2012;2012;10;16;Perjantai;209;80;289;32;22;54
89;12.10.2012;2012;10;17;Perjantai;120;104;224;16;27;43
89;12.10.2012;2012;10;18;Perjantai;84;71;155;18;23;41
89;12.10.2012;2012;10;19;Perjantai;71;39;110;15;30;45
89;12.10.2012;2012;10;20;Perjantai;54;43;97;10;14;24
89;12.10.2012;2012;10;21;Perjantai;50;43;93;11;8;19
89;12.10.2012;2012;10;22;Perjantai;22;36;58;3;10;13
89;12.10.2012;2012;10;23;Perjantai;16;21;37;5;7;12
89;13.10.2012;2012;10;00;Lauantai;13;19;32;6;10;16
89;13.10.2012;2012;10;01;Lauantai;20;4;24;7;2;9
89;13.10.2012;2012;10;02;Lauantai;30;4;34;6;2;8
89;13.10.2012;2012;10;03;Lauantai;21;1;22;13;0;13
89;13.10.2012;2012;10;04;Lauantai;23;9;32;7;1;8
89;13.10.2012;2012;10;05;Lauantai;4;6;10;1;1;2
89;13.10.2012;2012;10;06;Lauantai;5;17;22;1;3;4
89;13.10.2012;2012;10;07;Lauantai;7;24;31;3;6;9
89;13.10.2012;2012;10;08;Lauantai;15;48;63;6;10;16
89;13.10.2012;2012;10;09;Lauantai;17;82;99;11;24;35
89;13.10.2012;2012;10;10;Lauantai;36;64;100;21;35;56
89;13.10.2012;2012;10;11;Lauantai;43;53;96;11;18;29
89;13.10.2012;2012;10;12;Lauantai;48;66;114;7;31;38
89;13.10.2012;2012;10;13;Lauantai;41;73;114;21;22;43
89;13.10.2012;2012;10;14;Lauantai;63;59;122;26;19;45
89;13.10.2012;2012;10;15;Lauantai;106;66;172;32;36;68
89;13.10.2012;2012;10;16;Lauantai;85;52;137;50;35;85
89;13.10.2012;2012;10;17;Lauantai;99;69;168;29;38;67
89;13.10.2012;2012;10;18;Lauantai;51;63;114;25;28;53
89;13.10.2012;2012;10;19;Lauantai;45;44;89;9;14;23
89;13.10.2012;2012;10;20;Lauantai;32;26;58;9;13;22
89;13.10.2012;2012;10;21;Lauantai;22;27;49;15;15;30
89;13.10.2012;2012;10;22;Lauantai;27;27;54;6;10;16
89;13.10.2012;2012;10;23;Lauantai;17;20;37;3;1;4
89;14.10.2012;2012;10;00;Sunnuntai;15;26;41;1;8;9
89;14.10.2012;2012;10;01;Sunnuntai;23;12;35;6;7;13
89;14.10.2012;2012;10;02;Sunnuntai;22;5;27;6;0;6
89;14.10.2012;2012;10;03;Sunnuntai;26;1;27;7;1;8
89;14.10.2012;2012;10;04;Sunnuntai;21;1;22;8;0;8
89;14.10.2012;2012;10;05;Sunnuntai;4;4;8;1;2;3
89;14.10.2012;2012;10;06;Sunnuntai;6;8;14;3;4;7
89;14.10.2012;2012;10;07;Sunnuntai;2;8;10;3;4;7
89;14.10.2012;2012;10;08;Sunnuntai;6;15;21;3;5;8
89;14.10.2012;2012;10;09;Sunnuntai;15;20;35;20;20;40
89;14.10.2012;2012;10;10;Sunnuntai;19;57;76;28;42;70
89;14.10.2012;2012;10;11;Sunnuntai;33;85;118;30;54;84
89;14.10.2012;2012;10;12;Sunnuntai;52;111;163;44;70;114
89;14.10.2012;2012;10;13;Sunnuntai;100;88;188;37;55;92
89;14.10.2012;2012;10;14;Sunnuntai;109;78;187;28;36;64
89;14.10.2012;2012;10;15;Sunnuntai;82;73;155;33;34;67
89;14.10.2012;2012;10;16;Sunnuntai;74;78;152;33;30;63
89;14.10.2012;2012;10;17;Sunnuntai;68;60;128;34;49;83
89;14.10.2012;2012;10;18;Sunnuntai;70;40;110;27;33;60
89;14.10.2012;2012;10;19;Sunnuntai;46;28;74;25;22;47
89;14.10.2012;2012;10;20;Sunnuntai;41;17;58;7;13;20
89;14.10.2012;2012;10;21;Sunnuntai;30;15;45;6;12;18
89;14.10.2012;2012;10;22;Sunnuntai;14;11;25;3;2;5
89;14.10.2012;2012;10;23;Sunnuntai;7;5;12;2;2;4
89;15.10.2012;2012;10;00;Maanantai;3;3;6;2;0;2
89;15.10.2012;2012;10;01;Maanantai;3;0;3;0;0;0
89;15.10.2012;2012;10;02;Maanantai;1;2;3;0;0;0
89;15.10.2012;2012;10;03;Maanantai;4;2;6;0;0;0
89;15.10.2012;2012;10;04;Maanantai;5;5;10;0;1;1
89;15.10.2012;2012;10;05;Maanantai;3;14;17;0;0;0
89;15.10.2012;2012;10;06;Maanantai;18;57;75;4;5;9
89;15.10.2012;2012;10;07;Maanantai;50;165;215;4;28;32
89;15.10.2012;2012;10;08;Maanantai;88;229;317;14;32;46
89;15.10.2012;2012;10;09;Maanantai;53;178;231;16;36;52
89;15.10.2012;2012;10;10;Maanantai;51;86;137;14;24;38
89;15.10.2012;2012;10;11;Maanantai;77;75;152;23;27;50
89;15.10.2012;2012;10;12;Maanantai;70;86;156;15;29;44
89;15.10.2012;2012;10;13;Maanantai;89;86;175;17;25;42
89;15.10.2012;2012;10;14;Maanantai;147;98;245;28;18;46
89;15.10.2012;2012;10;15;Maanantai;205;110;315;39;46;85
89;15.10.2012;2012;10;16;Maanantai;281;136;417;40;20;60
89;15.10.2012;2012;10;17;Maanantai;166;114;280;22;24;46
89;15.10.2012;2012;10;18;Maanantai;125;85;210;31;31;62
89;15.10.2012;2012;10;19;Maanantai;75;44;119;36;14;50
89;15.10.2012;2012;10;20;Maanantai;71;39;110;31;21;52
89;15.10.2012;2012;10;21;Maanantai;42;23;65;11;12;23
89;15.10.2012;2012;10;22;Maanantai;26;12;38;6;8;14
89;15.10.2012;2012;10;23;Maanantai;6;5;11;1;0;1
89;16.10.2012;2012;10;00;Tiistai;3;0;3;0;0;0
89;16.10.2012;2012;10;01;Tiistai;7;0;7;1;0;1
89;16.10.2012;2012;10;02;Tiistai;0;1;1;0;0;0
89;16.10.2012;2012;10;03;Tiistai;5;2;7;2;0;2
89;16.10.2012;2012;10;04;Tiistai;0;5;5;0;1;1
89;16.10.2012;2012;10;05;Tiistai;2;13;15;0;1;1
89;16.10.2012;2012;10;06;Tiistai;23;50;73;6;4;10
89;16.10.2012;2012;10;07;Tiistai;42;156;198;8;30;38
89;16.10.2012;2012;10;08;Tiistai;81;245;326;9;45;54
89;16.10.2012;2012;10;09;Tiistai;48;121;169;13;31;44
89;16.10.2012;2012;10;10;Tiistai;35;81;116;7;21;28
89;16.10.2012;2012;10;11;Tiistai;47;49;96;13;11;24
89;16.10.2012;2012;10;12;Tiistai;52;35;87;9;8;17
89;16.10.2012;2012;10;13;Tiistai;62;54;116;6;14;20
89;16.10.2012;2012;10;14;Tiistai;85;48;133;12;11;23
89;16.10.2012;2012;10;15;Tiistai;153;73;226;24;11;35
89;16.10.2012;2012;10;16;Tiistai;196;72;268;23;10;33
89;16.10.2012;2012;10;17;Tiistai;93;92;185;30;15;45
89;16.10.2012;2012;10;18;Tiistai;90;59;149;21;21;42
89;16.10.2012;2012;10;19;Tiistai;77;36;113;26;24;50
89;16.10.2012;2012;10;20;Tiistai;48;29;77;29;21;50
89;16.10.2012;2012;10;21;Tiistai;58;12;70;15;7;22
89;16.10.2012;2012;10;22;Tiistai;14;0;14;2;0;2
89;16.10.2012;2012;10;23;Tiistai;6;1;7;0;0;0
89;17.10.2012;2012;10;00;Keskiviikko;4;3;7;2;1;3
89;17.10.2012;2012;10;01;Keskiviikko;2;0;2;0;2;2
89;17.10.2012;2012;10;02;Keskiviikko;2;0;2;0;0;0
89;17.10.2012;2012;10;03;Keskiviikko;0;3;3;1;0;1
89;17.10.2012;2012;10;04;Keskiviikko;1;5;6;0;0;0
89;17.10.2012;2012;10;05;Keskiviikko;7;11;18;0;2;2
89;17.10.2012;2012;10;06;Keskiviikko;17;67;84;5;6;11
89;17.10.2012;2012;10;07;Keskiviikko;51;164;215;3;27;30
89;17.10.2012;2012;10;08;Keskiviikko;65;253;318;8;22;30
89;17.10.2012;2012;10;09;Keskiviikko;37;121;158;11;40;51
89;17.10.2012;2012;10;10;Keskiviikko;53;104;157;25;44;69
89;17.10.2012;2012;10;11;Keskiviikko;76;83;159;27;41;68
89;17.10.2012;2012;10;12;Keskiviikko;78;95;173;9;33;42
89;17.10.2012;2012;10;13;Keskiviikko;111;102;213;17;32;49
89;17.10.2012;2012;10;14;Keskiviikko;141;96;237;23;24;47
89;17.10.2012;2012;10;15;Keskiviikko;197;98;295;32;22;54
89;17.10.2012;2012;10;16;Keskiviikko;245;92;337;28;21;49
89;17.10.2012;2012;10;17;Keskiviikko;145;128;273;35;37;72
89;17.10.2012;2012;10;18;Keskiviikko;113;95;208;41;22;63
89;17.10.2012;2012;10;19;Keskiviikko;89;54;143;31;28;59
89;17.10.2012;2012;10;20;Keskiviikko;93;47;140;33;18;51
89;17.10.2012;2012;10;21;Keskiviikko;41;19;60;8;10;18
89;17.10.2012;2012;10;22;Keskiviikko;36;7;43;2;8;10
89;17.10.2012;2012;10;23;Keskiviikko;10;6;16;1;3;4
89;18.10.2012;2012;10;00;Torstai;4;1;5;1;2;3
89;18.10.2012;2012;10;01;Torstai;3;1;4;2;0;2
89;18.10.2012;2012;10;02;Torstai;4;0;4;1;0;1
89;18.10.2012;2012;10;03;Torstai;10;2;12;1;0;1
89;18.10.2012;2012;10;04;Torstai;7;4;11;3;1;4
89;18.10.2012;2012;10;05;Torstai;5;12;17;1;2;3
89;18.10.2012;2012;10;06;Torstai;12;50;62;3;7;10
89;18.10.2012;2012;10;07;Torstai;49;149;198;8;23;31
89;18.10.2012;2012;10;08;Torstai;68;219;287;13;17;30
89;18.10.2012;2012;10;09;Torstai;39;110;149;18;30;48
89;18.10.2012;2012;10;10;Torstai;35;89;124;13;37;50
89;18.10.2012;2012;10;11;Torstai;81;81;162;16;30;46
89;18.10.2012;2012;10;12;Torstai;76;101;177;20;27;47
89;18.10.2012;2012;10;13;Torstai;88;104;192;32;27;59
89;18.10.2012;2012;10;14;Torstai;104;88;192;16;27;43
89;18.10.2012;2012;10;15;Torstai;203;92;295;26;38;64
89;18.10.2012;2012;10;16;Torstai;233;84;317;33;17;50
89;18.10.2012;2012;10;17;Torstai;121;109;230;30;28;58
89;18.10.2012;2012;10;18;Torstai;86;74;160;34;27;61
89;18.10.2012;2012;10;19;Torstai;89;50;139;29;16;45
89;18.10.2012;2012;10;20;Torstai;71;36;107;20;20;40
89;18.10.2012;2012;10;21;Torstai;53;23;76;13;10;23
89;18.10.2012;2012;10;22;Torstai;30;17;47;4;8;12
89;18.10.2012;2012;10;23;Torstai;15;8;23;2;4;6
89;19.10.2012;2012;10;00;Perjantai;8;7;15;0;0;0
89;19.10.2012;2012;10;01;Perjantai;4;0;4;1;0;1
89;19.10.2012;2012;10;02;Perjantai;8;1;9;1;1;2
89;19.10.2012;2012;10;03;Perjantai;9;3;12;5;0;5
89;19.10.2012;2012;10;04;Perjantai;3;2;5;1;1;2
89;19.10.2012;2012;10;05;Perjantai;3;8;11;2;1;3
89;19.10.2012;2012;10;06;Perjantai;15;45;60;4;10;14
89;19.10.2012;2012;10;07;Perjantai;33;150;183;9;21;30
89;19.10.2012;2012;10;08;Perjantai;61;173;234;8;15;23
89;19.10.2012;2012;10;09;Perjantai;27;87;114;9;21;30
89;19.10.2012;2012;10;10;Perjantai;30;48;78;10;22;32
89;19.10.2012;2012;10;11;Perjantai;40;55;95;17;15;32
89;19.10.2012;2012;10;12;Perjantai;55;48;103;14;32;46
89;19.10.2012;2012;10;13;Perjantai;88;82;170;27;25;52
89;19.10.2012;2012;10;14;Perjantai;136;65;201;16;21;37
89;19.10.2012;2012;10;15;Perjantai;110;62;172;19;7;26
89;19.10.2012;2012;10;16;Perjantai;133;63;196;15;13;28
89;19.10.2012;2012;10;17;Perjantai;87;58;145;10;11;21
89;19.10.2012;2012;10;18;Perjantai;46;34;80;17;24;41
89;19.10.2012;2012;10;19;Perjantai;27;34;61;21;10;31
89;19.10.2012;2012;10;20;Perjantai;33;28;61;6;14;20
89;19.10.2012;2012;10;21;Perjantai;21;13;34;6;7;13
89;19.10.2012;2012;10;22;Perjantai;27;35;62;5;4;9
89;19.10.2012;2012;10;23;Perjantai;17;19;36;6;6;12
89;20.10.2012;2012;10;00;Lauantai;13;20;33;3;3;6
89;20.10.2012;2012;10;01;Lauantai;17;9;26;2;2;4
89;20.10.2012;2012;10;02;Lauantai;18;3;21;5;1;6
89;20.10.2012;2012;10;03;Lauantai;16;0;16;9;2;11
89;20.10.2012;2012;10;04;Lauantai;17;2;19;4;0;4
89;20.10.2012;2012;10;05;Lauantai;2;6;8;0;2;2
89;20.10.2012;2012;10;06;Lauantai;7;7;14;0;2;2
89;20.10.2012;2012;10;07;Lauantai;5;23;28;6;11;17
89;20.10.2012;2012;10;08;Lauantai;10;33;43;9;8;17
89;20.10.2012;2012;10;09;Lauantai;11;49;60;14;25;39
89;20.10.2012;2012;10;10;Lauantai;21;85;106;15;46;61
89;20.10.2012;2012;10;11;Lauantai;31;88;119;26;51;77
89;20.10.2012;2012;10;12;Lauantai;61;90;151;23;63;86
89;20.10.2012;2012;10;13;Lauantai;77;111;188;39;71;110
89;20.10.2012;2012;10;14;Lauantai;92;72;164;44;61;105
89;20.10.2012;2012;10;15;Lauantai;79;87;166;53;74;127
89;20.10.2012;2012;10;16;Lauantai;108;62;170;58;43;101
89;20.10.2012;2012;10;17;Lauantai;66;43;109;27;20;47
89;20.10.2012;2012;10;18;Lauantai;54;45;99;26;21;47
89;20.10.2012;2012;10;19;Lauantai;31;35;66;15;9;24
89;20.10.2012;2012;10;20;Lauantai;35;21;56;9;13;22
89;20.10.2012;2012;10;21;Lauantai;30;27;57;5;8;13
89;20.10.2012;2012;10;22;Lauantai;14;28;42;8;3;11
89;20.10.2012;2012;10;23;Lauantai;19;14;33;2;4;6
89;21.10.2012;2012;10;00;Sunnuntai;14;14;28;5;5;10
89;21.10.2012;2012;10;01;Sunnuntai;17;14;31;2;2;4
89;21.10.2012;2012;10;02;Sunnuntai;16;8;24;10;1;11
89;21.10.2012;2012;10;03;Sunnuntai;12;2;14;4;1;5
89;21.10.2012;2012;10;04;Sunnuntai;19;2;21;5;1;6
89;21.10.2012;2012;10;05;Sunnuntai;7;1;8;0;3;3
89;21.10.2012;2012;10;06;Sunnuntai;6;8;14;3;2;5
89;21.10.2012;2012;10;07;Sunnuntai;3;7;10;3;6;9
89;21.10.2012;2012;10;08;Sunnuntai;4;8;12;11;6;17
89;21.10.2012;2012;10;09;Sunnuntai;15;18;33;11;24;35
89;21.10.2012;2012;10;10;Sunnuntai;17;31;48;31;39;70
89;21.10.2012;2012;10;11;Sunnuntai;24;56;80;25;31;56
89;21.10.2012;2012;10;12;Sunnuntai;32;54;86;48;63;111
89;21.10.2012;2012;10;13;Sunnuntai;36;70;106;44;47;91
89;21.10.2012;2012;10;14;Sunnuntai;60;37;97;46;51;97
89;21.10.2012;2012;10;15;Sunnuntai;67;27;94;32;27;59
89;21.10.2012;2012;10;16;Sunnuntai;45;48;93;35;33;68
89;21.10.2012;2012;10;17;Sunnuntai;48;58;106;30;37;67
89;21.10.2012;2012;10;18;Sunnuntai;39;29;68;18;27;45
89;21.10.2012;2012;10;19;Sunnuntai;30;28;58;17;18;35
89;21.10.2012;2012;10;20;Sunnuntai;24;16;40;16;11;27
89;21.10.2012;2012;10;21;Sunnuntai;17;13;30;8;11;19
89;21.10.2012;2012;10;22;Sunnuntai;11;17;28;7;8;15
89;21.10.2012;2012;10;23;Sunnuntai;4;4;8;4;3;7
89;22.10.2012;2012;10;00;Maanantai;9;1;10;3;4;7
89;22.10.2012;2012;10;01;Maanantai;2;4;6;0;2;2
89;22.10.2012;2012;10;02;Maanantai;0;2;2;1;0;1
89;22.10.2012;2012;10;03;Maanantai;4;0;4;5;0;5
89;22.10.2012;2012;10;04;Maanantai;2;1;3;0;1;1
89;22.10.2012;2012;10;05;Maanantai;4;12;16;1;3;4
89;22.10.2012;2012;10;06;Maanantai;16;29;45;1;12;13
89;22.10.2012;2012;10;07;Maanantai;28;91;119;3;19;22
89;22.10.2012;2012;10;08;Maanantai;27;106;133;8;26;34
89;22.10.2012;2012;10;09;Maanantai;24;80;104;6;31;37
89;22.10.2012;2012;10;10;Maanantai;35;65;100;19;23;42
89;22.10.2012;2012;10;11;Maanantai;52;73;125;13;30;43
89;22.10.2012;2012;10;12;Maanantai;48;69;117;27;41;68
89;22.10.2012;2012;10;13;Maanantai;57;72;129;33;32;65
89;22.10.2012;2012;10;14;Maanantai;84;64;148;23;27;50
89;22.10.2012;2012;10;15;Maanantai;126;67;193;42;17;59
89;22.10.2012;2012;10;16;Maanantai;116;79;195;35;12;47
89;22.10.2012;2012;10;17;Maanantai;85;58;143;29;26;55
89;22.10.2012;2012;10;18;Maanantai;65;52;117;29;38;67
89;22.10.2012;2012;10;19;Maanantai;52;31;83;26;27;53
89;22.10.2012;2012;10;20;Maanantai;45;26;71;20;16;36
89;22.10.2012;2012;10;21;Maanantai;31;23;54;9;6;15
89;22.10.2012;2012;10;22;Maanantai;11;2;13;7;10;17
89;22.10.2012;2012;10;23;Maanantai;5;5;10;2;1;3
89;23.10.2012;2012;10;00;Tiistai;3;1;4;1;0;1
89;23.10.2012;2012;10;01;Tiistai;6;1;7;1;2;3
89;23.10.2012;2012;10;02;Tiistai;5;1;6;1;0;1
89;23.10.2012;2012;10;03;Tiistai;0;1;1;0;0;0
89;23.10.2012;2012;10;04;Tiistai;2;5;7;1;1;2
89;23.10.2012;2012;10;05;Tiistai;3;11;14;0;2;2
89;23.10.2012;2012;10;06;Tiistai;11;44;55;2;8;10
89;23.10.2012;2012;10;07;Tiistai;29;113;142;3;16;19
89;23.10.2012;2012;10;08;Tiistai;26;128;154;6;20;26
89;23.10.2012;2012;10;09;Tiistai;30;65;95;12;14;26
89;23.10.2012;2012;10;10;Tiistai;26;82;108;18;28;46
89;23.10.2012;2012;10;11;Tiistai;39;81;120;17;31;48
89;23.10.2012;2012;10;12;Tiistai;50;79;129;16;28;44
89;23.10.2012;2012;10;13;Tiistai;72;89;161;27;30;57
89;23.10.2012;2012;10;14;Tiistai;96;72;168;34;34;68
89;23.10.2012;2012;10;15;Tiistai;126;70;196;32;27;59
89;23.10.2012;2012;10;16;Tiistai;150;57;207;30;28;58
89;23.10.2012;2012;10;17;Tiistai;104;64;168;37;41;78
89;23.10.2012;2012;10;18;Tiistai;81;52;133;38;35;73
89;23.10.2012;2012;10;19;Tiistai;50;38;88;25;26;51
89;23.10.2012;2012;10;20;Tiistai;30;20;50;23;14;37
89;23.10.2012;2012;10;21;Tiistai;32;15;47;8;3;11
89;23.10.2012;2012;10;22;Tiistai;7;6;13;8;1;9
89;23.10.2012;2012;10;23;Tiistai;4;10;14;5;2;7
89;24.10.2012;2012;10;00;Keskiviikko;5;8;13;1;0;1
89;24.10.2012;2012;10;01;Keskiviikko;5;3;8;3;0;3
89;24.10.2012;2012;10;02;Keskiviikko;2;1;3;0;0;0
89;24.10.2012;2012;10;03;Keskiviikko;5;0;5;0;0;0
89;24.10.2012;2012;10;04;Keskiviikko;1;2;3;0;1;1
89;24.10.2012;2012;10;05;Keskiviikko;5;7;12;1;1;2
89;24.10.2012;2012;10;06;Keskiviikko;15;31;46;0;3;3
89;24.10.2012;2012;10;07;Keskiviikko;25;84;109;4;14;18
89;24.10.2012;2012;10;08;Keskiviikko;30;89;119;5;17;22
89;24.10.2012;2012;10;09;Keskiviikko;28;83;111;3;25;28
89;24.10.2012;2012;10;10;Keskiviikko;29;65;94;16;27;43
89;24.10.2012;2012;10;11;Keskiviikko;48;57;105;10;22;32
89;24.10.2012;2012;10;12;Keskiviikko;54;71;125;19;33;52
89;24.10.2012;2012;10;13;Keskiviikko;57;52;109;16;35;51
89;24.10.2012;2012;10;14;Keskiviikko;73;70;143;21;23;44
89;24.10.2012;2012;10;15;Keskiviikko;116;82;198;28;20;48
89;24.10.2012;2012;10;16;Keskiviikko;153;78;231;32;19;51
89;24.10.2012;2012;10;17;Keskiviikko;101;78;179;20;11;31
89;24.10.2012;2012;10;18;Keskiviikko;65;37;102;30;18;48
89;24.10.2012;2012;10;19;Keskiviikko;62;32;94;20;23;43
89;24.10.2012;2012;10;20;Keskiviikko;35;22;57;15;13;28
89;24.10.2012;2012;10;21;Keskiviikko;32;17;49;11;11;22
89;24.10.2012;2012;10;22;Keskiviikko;27;15;42;2;9;11
89;24.10.2012;2012;10;23;Keskiviikko;13;8;21;3;3;6
89;25.10.2012;2012;10;00;Torstai;11;8;19;1;5;6
89;25.10.2012;2012;10;01;Torstai;2;1;3;1;1;2
89;25.10.2012;2012;10;02;Torstai;6;1;7;2;0;2
89;25.10.2012;2012;10;03;Torstai;2;1;3;1;3;4
89;25.10.2012;2012;10;04;Torstai;4;3;7;2;1;3
89;25.10.2012;2012;10;05;Torstai;3;12;15;0;1;1
89;25.10.2012;2012;10;06;Torstai;14;37;51;0;6;6
89;25.10.2012;2012;10;07;Torstai;24;93;117;4;14;18
89;25.10.2012;2012;10;08;Torstai;30;103;133;9;22;31
89;25.10.2012;2012;10;09;Torstai;20;66;86;6;23;29
89;25.10.2012;2012;10;10;Torstai;30;68;98;11;22;33
89;25.10.2012;2012;10;11;Torstai;45;65;110;15;37;52
89;25.10.2012;2012;10;12;Torstai;53;79;132;28;31;59
89;25.10.2012;2012;10;13;Torstai;59;76;135;27;34;61
89;25.10.2012;2012;10;14;Torstai;70;70;140;19;26;45
89;25.10.2012;2012;10;15;Torstai;98;77;175;34;38;72
89;25.10.2012;2012;10;16;Torstai;151;80;231;28;15;43
89;25.10.2012;2012;10;17;Torstai;99;67;166;31;30;61
89;25.10.2012;2012;10;18;Torstai;77;35;112;27;26;53
89;25.10.2012;2012;10;19;Torstai;51;30;81;29;30;59
89;25.10.2012;2012;10;20;Torstai;40;18;58;13;17;30
89;25.10.2012;2012;10;21;Torstai;46;25;71;13;9;22
89;25.10.2012;2012;10;22;Torstai;15;14;29;4;2;6
89;25.10.2012;2012;10;23;Torstai;16;9;25;0;11;11
89;26.10.2012;2012;10;00;Perjantai;10;4;14;3;3;6
89;26.10.2012;2012;10;01;Perjantai;3;4;7;1;0;1
89;26.10.2012;2012;10;02;Perjantai;10;2;12;2;1;3
89;26.10.2012;2012;10;03;Perjantai;4;1;5;0;0;0
89;26.10.2012;2012;10;04;Perjantai;5;2;7;1;1;2
89;26.10.2012;2012;10;05;Perjantai;3;11;14;1;2;3
89;26.10.2012;2012;10;06;Perjantai;10;41;51;4;6;10
89;26.10.2012;2012;10;07;Perjantai;12;73;85;7;16;23
89;26.10.2012;2012;10;08;Perjantai;20;82;102;12;30;42
89;26.10.2012;2012;10;09;Perjantai;28;51;79;16;20;36
89;26.10.2012;2012;10;10;Perjantai;19;36;55;12;36;48
89;26.10.2012;2012;10;11;Perjantai;28;48;76;25;39;64
89;26.10.2012;2012;10;12;Perjantai;36;52;88;32;40;72
89;26.10.2012;2012;10;13;Perjantai;49;60;109;22;38;60
89;26.10.2012;2012;10;14;Perjantai;48;63;111;28;27;55
89;26.10.2012;2012;10;15;Perjantai;122;47;169;34;31;65
89;26.10.2012;2012;10;16;Perjantai;87;57;144;27;31;58
89;26.10.2012;2012;10;17;Perjantai;63;55;118;23;21;44
89;26.10.2012;2012;10;18;Perjantai;52;31;83;30;16;46
89;26.10.2012;2012;10;19;Perjantai;40;20;60;22;23;45
89;26.10.2012;2012;10;20;Perjantai;36;24;60;10;13;23
89;26.10.2012;2012;10;21;Perjantai;33;30;63;10;12;22
89;26.10.2012;2012;10;22;Perjantai;14;15;29;3;9;12
89;26.10.2012;2012;10;23;Perjantai;13;13;26;4;8;12
89;27.10.2012;2012;10;00;Lauantai;13;29;42;6;8;14
89;27.10.2012;2012;10;01;Lauantai;13;15;28;5;3;8
89;27.10.2012;2012;10;02;Lauantai;8;5;13;6;2;8
89;27.10.2012;2012;10;03;Lauantai;17;2;19;6;0;6
89;27.10.2012;2012;10;04;Lauantai;14;2;16;11;1;12
89;27.10.2012;2012;10;05;Lauantai;5;4;9;0;1;1
89;27.10.2012;2012;10;06;Lauantai;5;3;8;2;3;5
89;27.10.2012;2012;10;07;Lauantai;3;9;12;3;5;8
89;27.10.2012;2012;10;08;Lauantai;4;16;20;4;11;15
89;27.10.2012;2012;10;09;Lauantai;6;35;41;17;25;42
89;27.10.2012;2012;10;10;Lauantai;15;41;56;16;38;54
89;27.10.2012;2012;10;11;Lauantai;23;63;86;20;42;62
89;27.10.2012;2012;10;12;Lauantai;29;38;67;26;49;75
89;27.10.2012;2012;10;13;Lauantai;42;69;111;35;37;72
89;27.10.2012;2012;10;14;Lauantai;52;48;100;42;32;74
89;27.10.2012;2012;10;15;Lauantai;50;37;87;47;28;75
89;27.10.2012;2012;10;16;Lauantai;46;33;79;28;28;56
89;27.10.2012;2012;10;17;Lauantai;31;32;63;33;26;59
89;27.10.2012;2012;10;18;Lauantai;29;24;53;24;20;44
89;27.10.2012;2012;10;19;Lauantai;22;21;43;11;17;28
89;27.10.2012;2012;10;20;Lauantai;24;24;48;12;13;25
89;27.10.2012;2012;10;21;Lauantai;14;25;39;7;3;10
89;27.10.2012;2012;10;22;Lauantai;14;17;31;2;14;16
89;27.10.2012;2012;10;23;Lauantai;15;18;33;2;4;6
89;28.10.2012;2012;10;00;Sunnuntai;13;15;28;5;6;11
89;28.10.2012;2012;10;01;Sunnuntai;10;5;15;4;5;9
89;28.10.2012;2012;10;02;Sunnuntai;15;5;20;5;2;7
89;28.10.2012;2012;10;03;Sunnuntai;14;1;15;6;0;6
89;28.10.2012;2012;10;04;Sunnuntai;10;3;13;2;1;3
89;28.10.2012;2012;10;05;Sunnuntai;2;0;2;0;3;3
89;28.10.2012;2012;10;06;Sunnuntai;1;1;2;2;3;5
89;28.10.2012;2012;10;07;Sunnuntai;3;4;7;2;6;8
89;28.10.2012;2012;10;08;Sunnuntai;9;8;17;12;17;29
89;28.10.2012;2012;10;09;Sunnuntai;9;14;23;21;24;45
89;28.10.2012;2012;10;10;Sunnuntai;10;30;40;31;43;74
89;28.10.2012;2012;10;11;Sunnuntai;14;17;31;38;49;87
89;28.10.2012;2012;10;12;Sunnuntai;23;40;63;45;60;105
89;28.10.2012;2012;10;13;Sunnuntai;30;41;71;31;52;83
89;28.10.2012;2012;10;14;Sunnuntai;37;31;68;34;35;69
89;28.10.2012;2012;10;15;Sunnuntai;38;35;73;27;28;55
89;28.10.2012;2012;10;16;Sunnuntai;33;37;70;19;33;52
89;28.10.2012;2012;10;17;Sunnuntai;26;40;66;27;20;47
89;28.10.2012;2012;10;18;Sunnuntai;44;23;67;20;21;41
89;28.10.2012;2012;10;19;Sunnuntai;19;32;51;24;12;36
89;28.10.2012;2012;10;20;Sunnuntai;35;14;49;16;3;19
89;28.10.2012;2012;10;21;Sunnuntai;28;16;44;7;9;16
89;28.10.2012;2012;10;22;Sunnuntai;11;4;15;2;4;6
89;28.10.2012;2012;10;23;Sunnuntai;5;1;6;2;0;2
89;29.10.2012;2012;10;00;Maanantai;7;6;13;3;1;4
89;29.10.2012;2012;10;01;Maanantai;3;0;3;0;0;0
89;29.10.2012;2012;10;02;Maanantai;1;0;1;1;1;2
89;29.10.2012;2012;10;03;Maanantai;2;1;3;1;1;2
89;29.10.2012;2012;10;04;Maanantai;3;4;7;0;1;1
89;29.10.2012;2012;10;05;Maanantai;3;15;18;0;1;1
89;29.10.2012;2012;10;06;Maanantai;13;46;59;3;7;10
89;29.10.2012;2012;10;07;Maanantai;31;135;166;7;36;43
89;29.10.2012;2012;10;08;Maanantai;63;205;268;11;54;65
89;29.10.2012;2012;10;09;Maanantai;41;105;146;22;56;78
89;29.10.2012;2012;10;10;Maanantai;39;82;121;21;38;59
89;29.10.2012;2012;10;11;Maanantai;38;61;99;30;57;87
89;29.10.2012;2012;10;12;Maanantai;40;93;133;31;38;69
89;29.10.2012;2012;10;13;Maanantai;58;70;128;23;35;58
89;29.10.2012;2012;10;14;Maanantai;96;59;155;33;27;60
89;29.10.2012;2012;10;15;Maanantai;178;77;255;46;30;76
89;29.10.2012;2012;10;16;Maanantai;209;88;297;48;15;63
89;29.10.2012;2012;10;17;Maanantai;112;75;187;45;33;78
89;29.10.2012;2012;10;18;Maanantai;61;63;124;37;29;66
89;29.10.2012;2012;10;19;Maanantai;61;35;96;26;26;52
89;29.10.2012;2012;10;20;Maanantai;58;29;87;25;12;37
89;29.10.2012;2012;10;21;Maanantai;32;14;46;13;10;23
89;29.10.2012;2012;10;22;Maanantai;10;8;18;9;4;13
89;29.10.2012;2012;10;23;Maanantai;9;7;16;1;1;2
89;30.10.2012;2012;10;00;Tiistai;8;4;12;0;1;1
89;30.10.2012;2012;10;01;Tiistai;4;0;4;0;1;1
89;30.10.2012;2012;10;02;Tiistai;2;0;2;2;0;2
89;30.10.2012;2012;10;03;Tiistai;1;5;6;0;0;0
89;30.10.2012;2012;10;04;Tiistai;0;2;2;0;1;1
89;30.10.2012;2012;10;05;Tiistai;7;6;13;1;1;2
89;30.10.2012;2012;10;06;Tiistai;22;44;66;7;14;21
89;30.10.2012;2012;10;07;Tiistai;29;162;191;3;33;36
89;30.10.2012;2012;10;08;Tiistai;66;177;243;12;42;54
89;30.10.2012;2012;10;09;Tiistai;33;113;146;9;36;45
89;30.10.2012;2012;10;10;Tiistai;28;51;79;17;26;43
89;30.10.2012;2012;10;11;Tiistai;36;47;83;13;14;27
89;30.10.2012;2012;10;12;Tiistai;29;27;56;15;11;26
89;30.10.2012;2012;10;13;Tiistai;41;55;96;18;14;32
89;30.10.2012;2012;10;14;Tiistai;55;53;108;13;27;40
89;30.10.2012;2012;10;15;Tiistai;134;66;200;29;14;43
89;30.10.2012;2012;10;16;Tiistai;159;74;233;29;21;50
89;30.10.2012;2012;10;17;Tiistai;74;55;129;38;15;53
89;30.10.2012;2012;10;18;Tiistai;56;42;98;28;19;47
89;30.10.2012;2012;10;19;Tiistai;38;34;72;16;21;37
89;30.10.2012;2012;10;20;Tiistai;39;20;59;23;14;37
89;30.10.2012;2012;10;21;Tiistai;34;15;49;11;7;18
89;30.10.2012;2012;10;22;Tiistai;16;4;20;1;4;5
89;30.10.2012;2012;10;23;Tiistai;3;3;6;1;2;3
89;31.10.2012;2012;10;00;Keskiviikko;4;4;8;2;1;3
89;31.10.2012;2012;10;01;Keskiviikko;1;2;3;0;1;1
89;31.10.2012;2012;10;02;Keskiviikko;5;1;6;0;0;0
89;31.10.2012;2012;10;03;Keskiviikko;1;2;3;0;1;1
89;31.10.2012;2012;10;04;Keskiviikko;5;10;15;0;0;0
89;31.10.2012;2012;10;05;Keskiviikko;11;13;24;1;2;3
89;31.10.2012;2012;10;06;Keskiviikko;11;41;52;1;6;7
89;31.10.2012;2012;10;07;Keskiviikko;18;119;137;7;42;49
89;31.10.2012;2012;10;08;Keskiviikko;43;176;219;7;47;54
89;31.10.2012;2012;10;09;Keskiviikko;22;79;101;17;40;57
89;31.10.2012;2012;10;10;Keskiviikko;27;63;90;11;35;46
89;31.10.2012;2012;10;11;Keskiviikko;27;50;77;23;26;49
89;31.10.2012;2012;10;12;Keskiviikko;39;60;99;23;40;63
89;31.10.2012;2012;10;13;Keskiviikko;41;68;109;29;26;55
89;31.10.2012;2012;10;14;Keskiviikko;80;51;131;29;28;57
89;31.10.2012;2012;10;15;Keskiviikko;124;40;164;36;25;61
89;31.10.2012;2012;10;16;Keskiviikko;166;98;264;50;23;73
89;31.10.2012;2012;10;17;Keskiviikko;91;56;147;44;41;85
89;31.10.2012;2012;10;18;Keskiviikko;61;49;110;40;31;71
89;31.10.2012;2012;10;19;Keskiviikko;64;26;90;23;17;40
89;31.10.2012;2012;10;20;Keskiviikko;46;27;73;36;15;51
89;31.10.2012;2012;10;21;Keskiviikko;45;10;55;15;6;21
89;31.10.2012;2012;10;22;Keskiviikko;14;8;22;7;3;10
89;31.10.2012;2012;10;23;Keskiviikko;10;2;12;0;3;3
89;01.11.2012;2012;11;00;Torstai;4;5;9;4;2;6
89;01.11.2012;2012;11;01;Torstai;3;1;4;1;0;1
89;01.11.2012;2012;11;02;Torstai;1;1;2;0;0;0
89;01.11.2012;2012;11;03;Torstai;0;1;1;4;3;7
89;01.11.2012;2012;11;04;Torstai;4;6;10;3;1;4
89;01.11.2012;2012;11;05;Torstai;2;10;12;1;1;2
89;01.11.2012;2012;11;06;Torstai;10;39;49;5;13;18
89;01.11.2012;2012;11;07;Torstai;29;129;158;5;31;36
89;01.11.2012;2012;11;08;Torstai;47;183;230;17;38;55
89;01.11.2012;2012;11;09;Torstai;44;91;135;18;38;56
89;01.11.2012;2012;11;10;Torstai;26;69;95;21;30;51
89;01.11.2012;2012;11;11;Torstai;39;56;95;20;23;43
89;01.11.2012;2012;11;12;Torstai;41;66;107;24;23;47
89;01.11.2012;2012;11;13;Torstai;79;48;127;15;19;34
89;01.11.2012;2012;11;14;Torstai;77;71;148;23;24;47
89;01.11.2012;2012;11;15;Torstai;136;54;190;43;24;67
89;01.11.2012;2012;11;16;Torstai;162;80;242;39;22;61
89;01.11.2012;2012;11;17;Torstai;75;56;131;27;16;43
89;01.11.2012;2012;11;18;Torstai;54;45;99;33;25;58
89;01.11.2012;2012;11;19;Torstai;41;29;70;16;16;32
89;01.11.2012;2012;11;20;Torstai;44;25;69;16;9;25
89;01.11.2012;2012;11;21;Torstai;46;17;63;6;7;13
89;01.11.2012;2012;11;22;Torstai;10;14;24;4;5;9
89;01.11.2012;2012;11;23;Torstai;5;7;12;7;6;13
89;02.11.2012;2012;11;00;Perjantai;6;4;10;3;0;3
89;02.11.2012;2012;11;01;Perjantai;3;0;3;1;0;1
89;02.11.2012;2012;11;02;Perjantai;5;2;7;5;0;5
89;02.11.2012;2012;11;03;Perjantai;7;1;8;5;0;5
89;02.11.2012;2012;11;04;Perjantai;5;3;8;2;0;2
89;02.11.2012;2012;11;05;Perjantai;3;9;12;1;4;5
89;02.11.2012;2012;11;06;Perjantai;6;46;52;5;5;10
89;02.11.2012;2012;11;07;Perjantai;19;103;122;3;35;38
89;02.11.2012;2012;11;08;Perjantai;35;171;206;14;36;50
89;02.11.2012;2012;11;09;Perjantai;29;96;125;6;23;29
89;02.11.2012;2012;11;10;Perjantai;38;56;94;21;33;54
89;02.11.2012;2012;11;11;Perjantai;37;69;106;10;33;43
89;02.11.2012;2012;11;12;Perjantai;62;59;121;22;33;55
89;02.11.2012;2012;11;13;Perjantai;66;70;136;21;20;41
89;02.11.2012;2012;11;14;Perjantai;114;89;203;34;29;63
89;02.11.2012;2012;11;15;Perjantai;146;82;228;36;23;59
89;02.11.2012;2012;11;16;Perjantai;96;49;145;27;23;50
89;02.11.2012;2012;11;17;Perjantai;72;62;134;24;27;51
89;02.11.2012;2012;11;18;Perjantai;54;40;94;14;12;26
89;02.11.2012;2012;11;19;Perjantai;32;22;54;16;5;21
89;02.11.2012;2012;11;20;Perjantai;32;17;49;12;5;17
89;02.11.2012;2012;11;21;Perjantai;23;17;40;9;14;23
89;02.11.2012;2012;11;22;Perjantai;14;18;32;3;11;14
89;02.11.2012;2012;11;23;Perjantai;12;12;24;1;6;7
89;03.11.2012;2012;11;00;Lauantai;9;12;21;3;4;7
89;03.11.2012;2012;11;01;Lauantai;14;11;25;6;5;11
89;03.11.2012;2012;11;02;Lauantai;16;5;21;8;1;9
89;03.11.2012;2012;11;03;Lauantai;13;2;15;9;1;10
89;03.11.2012;2012;11;04;Lauantai;14;3;17;6;0;6
89;03.11.2012;2012;11;05;Lauantai;4;1;5;2;0;2
89;03.11.2012;2012;11;06;Lauantai;4;6;10;2;4;6
89;03.11.2012;2012;11;07;Lauantai;2;11;13;1;1;2
89;03.11.2012;2012;11;08;Lauantai;5;7;12;7;8;15
89;03.11.2012;2012;11;09;Lauantai;7;22;29;22;28;50
89;03.11.2012;2012;11;10;Lauantai;19;17;36;24;26;50
89;03.11.2012;2012;11;11;Lauantai;28;25;53;29;25;54
89;03.11.2012;2012;11;12;Lauantai;19;26;45;22;24;46
89;03.11.2012;2012;11;13;Lauantai;31;29;60;23;35;58
89;03.11.2012;2012;11;14;Lauantai;25;36;61;26;36;62
89;03.11.2012;2012;11;15;Lauantai;27;25;52;21;15;36
89;03.11.2012;2012;11;16;Lauantai;27;27;54;11;25;36
89;03.11.2012;2012;11;17;Lauantai;20;32;52;18;13;31
89;03.11.2012;2012;11;18;Lauantai;17;33;50;15;24;39
89;03.11.2012;2012;11;19;Lauantai;23;22;45;11;14;25
89;03.11.2012;2012;11;20;Lauantai;18;24;42;15;10;25
89;03.11.2012;2012;11;21;Lauantai;16;21;37;6;7;13
89;03.11.2012;2012;11;22;Lauantai;14;20;34;3;3;6
89;03.11.2012;2012;11;23;Lauantai;9;15;24;1;7;8
89;04.11.2012;2012;11;00;Sunnuntai;9;20;29;5;13;18
89;04.11.2012;2012;11;01;Sunnuntai;19;0;19;3;2;5
89;04.11.2012;2012;11;02;Sunnuntai;21;2;23;7;2;9
89;04.11.2012;2012;11;03;Sunnuntai;20;2;22;7;2;9
89;04.11.2012;2012;11;04;Sunnuntai;10;2;12;13;0;13
89;04.11.2012;2012;11;05;Sunnuntai;3;4;7;0;2;2
89;04.11.2012;2012;11;06;Sunnuntai;8;7;15;4;0;4
89;04.11.2012;2012;11;07;Sunnuntai;1;5;6;0;3;3
89;04.11.2012;2012;11;08;Sunnuntai;5;17;22;6;9;15
89;04.11.2012;2012;11;09;Sunnuntai;12;13;25;12;10;22
89;04.11.2012;2012;11;10;Sunnuntai;14;20;34;21;27;48
89;04.11.2012;2012;11;11;Sunnuntai;11;21;32;27;28;55
89;04.11.2012;2012;11;12;Sunnuntai;24;57;81;27;37;64
89;04.11.2012;2012;11;13;Sunnuntai;30;51;81;43;27;70
89;04.11.2012;2012;11;14;Sunnuntai;57;58;115;26;44;70
89;04.11.2012;2012;11;15;Sunnuntai;58;37;95;34;50;84
89;04.11.2012;2012;11;16;Sunnuntai;55;30;85;28;29;57
89;04.11.2012;2012;11;17;Sunnuntai;32;29;61;22;25;47
89;04.11.2012;2012;11;18;Sunnuntai;33;32;65;27;21;48
89;04.11.2012;2012;11;19;Sunnuntai;41;19;60;19;23;42
89;04.11.2012;2012;11;20;Sunnuntai;23;15;38;19;13;32
89;04.11.2012;2012;11;21;Sunnuntai;32;9;41;10;1;11
89;04.11.2012;2012;11;22;Sunnuntai;4;8;12;2;2;4
89;04.11.2012;2012;11;23;Sunnuntai;6;25;31;1;2;3
89;05.11.2012;2012;11;00;Maanantai;6;3;9;1;0;1
89;05.11.2012;2012;11;01;Maanantai;2;0;2;0;1;1
89;05.11.2012;2012;11;02;Maanantai;4;0;4;1;0;1
89;05.11.2012;2012;11;03;Maanantai;1;0;1;1;0;1
89;05.11.2012;2012;11;04;Maanantai;2;4;6;1;1;2
89;05.11.2012;2012;11;05;Maanantai;4;10;14;0;3;3
89;05.11.2012;2012;11;06;Maanantai;12;41;53;1;4;5
89;05.11.2012;2012;11;07;Maanantai;35;135;170;8;27;35
89;05.11.2012;2012;11;08;Maanantai;48;192;240;11;36;47
89;05.11.2012;2012;11;09;Maanantai;32;118;150;7;28;35
89;05.11.2012;2012;11;10;Maanantai;42;78;120;13;31;44
89;05.11.2012;2012;11;11;Maanantai;66;70;136;27;19;46
89;05.11.2012;2012;11;12;Maanantai;58;78;136;32;28;60
89;05.11.2012;2012;11;13;Maanantai;62;73;135;35;35;70
89;05.11.2012;2012;11;14;Maanantai;114;92;206;24;15;39
89;05.11.2012;2012;11;15;Maanantai;174;93;267;28;18;46
89;05.11.2012;2012;11;16;Maanantai;197;79;276;46;22;68
89;05.11.2012;2012;11;17;Maanantai;121;86;207;38;27;65
89;05.11.2012;2012;11;18;Maanantai;91;66;157;28;35;63
89;05.11.2012;2012;11;19;Maanantai;59;38;97;29;28;57
89;05.11.2012;2012;11;20;Maanantai;65;29;94;27;20;47
89;05.11.2012;2012;11;21;Maanantai;33;18;51;13;15;28
89;05.11.2012;2012;11;22;Maanantai;19;3;22;6;3;9
89;05.11.2012;2012;11;23;Maanantai;7;4;11;0;1;1
89;06.11.2012;2012;11;00;Tiistai;5;4;9;0;1;1
89;06.11.2012;2012;11;01;Tiistai;1;2;3;1;0;1
89;06.11.2012;2012;11;02;Tiistai;2;6;8;0;0;0
89;06.11.2012;2012;11;03;Tiistai;2;1;3;3;0;3
89;06.11.2012;2012;11;04;Tiistai;1;4;5;0;2;2
89;06.11.2012;2012;11;05;Tiistai;2;13;15;1;1;2
89;06.11.2012;2012;11;06;Tiistai;9;54;63;5;6;11
89;06.11.2012;2012;11;07;Tiistai;34;145;179;9;31;40
89;06.11.2012;2012;11;08;Tiistai;54;220;274;6;47;53
89;06.11.2012;2012;11;09;Tiistai;43;118;161;13;27;40
89;06.11.2012;2012;11;10;Tiistai;29;104;133;11;37;48
89;06.11.2012;2012;11;11;Tiistai;52;74;126;24;23;47
89;06.11.2012;2012;11;12;Tiistai;55;71;126;19;30;49
89;06.11.2012;2012;11;13;Tiistai;78;68;146;28;27;55
89;06.11.2012;2012;11;14;Tiistai;84;60;144;31;21;52
89;06.11.2012;2012;11;15;Tiistai;167;87;254;32;28;60
89;06.11.2012;2012;11;16;Tiistai;226;93;319;36;16;52
89;06.11.2012;2012;11;17;Tiistai;108;71;179;45;27;72
89;06.11.2012;2012;11;18;Tiistai;74;53;127;43;20;63
89;06.11.2012;2012;11;19;Tiistai;55;54;109;27;33;60
89;06.11.2012;2012;11;20;Tiistai;75;29;104;30;24;54
89;06.11.2012;2012;11;21;Tiistai;40;24;64;21;11;32
89;06.11.2012;2012;11;22;Tiistai;22;14;36;3;4;7
89;06.11.2012;2012;11;23;Tiistai;7;2;9;0;3;3
89;07.11.2012;2012;11;00;Keskiviikko;5;3;8;0;1;1
89;07.11.2012;2012;11;01;Keskiviikko;4;5;9;0;0;0
89;07.11.2012;2012;11;02;Keskiviikko;1;2;3;1;0;1
89;07.11.2012;2012;11;03;Keskiviikko;4;2;6;0;0;0
89;07.11.2012;2012;11;04;Keskiviikko;8;2;10;1;1;2
89;07.11.2012;2012;11;05;Keskiviikko;3;11;14;2;5;7
89;07.11.2012;2012;11;06;Keskiviikko;10;44;54;3;6;9
89;07.11.2012;2012;11;07;Keskiviikko;48;126;174;3;30;33
89;07.11.2012;2012;11;08;Keskiviikko;46;206;252;11;47;58
89;07.11.2012;2012;11;09;Keskiviikko;35;92;127;14;35;49
89;07.11.2012;2012;11;10;Keskiviikko;26;78;104;16;32;48
89;07.11.2012;2012;11;11;Keskiviikko;49;67;116;18;36;54
89;07.11.2012;2012;11;12;Keskiviikko;60;59;119;29;31;60
89;07.11.2012;2012;11;13;Keskiviikko;71;84;155;18;27;45
89;07.11.2012;2012;11;14;Keskiviikko;94;78;172;41;22;63
89;07.11.2012;2012;11;15;Keskiviikko;128;63;191;37;14;51
89;07.11.2012;2012;11;16;Keskiviikko;210;89;299;38;38;76
89;07.11.2012;2012;11;17;Keskiviikko;109;73;182;36;36;72
89;07.11.2012;2012;11;18;Keskiviikko;73;77;150;36;34;70
89;07.11.2012;2012;11;19;Keskiviikko;60;35;95;27;29;56
89;07.11.2012;2012;11;20;Keskiviikko;75;34;109;32;24;56
89;07.11.2012;2012;11;21;Keskiviikko;57;24;81;11;8;19
89;07.11.2012;2012;11;22;Keskiviikko;16;17;33;3;7;10
89;07.11.2012;2012;11;23;Keskiviikko;14;1;15;1;2;3
89;08.11.2012;2012;11;00;Torstai;4;3;7;1;1;2
89;08.11.2012;2012;11;01;Torstai;5;2;7;2;1;3
89;08.11.2012;2012;11;02;Torstai;5;2;7;4;1;5
89;08.11.2012;2012;11;03;Torstai;4;3;7;2;2;4
89;08.11.2012;2012;11;04;Torstai;6;3;9;1;0;1
89;08.11.2012;2012;11;05;Torstai;5;10;15;1;2;3
89;08.11.2012;2012;11;06;Torstai;10;45;55;4;8;12
89;08.11.2012;2012;11;07;Torstai;41;139;180;5;32;37
89;08.11.2012;2012;11;08;Torstai;65;199;264;14;35;49
89;08.11.2012;2012;11;09;Torstai;33;123;156;16;34;50
89;08.11.2012;2012;11;10;Torstai;37;91;128;20;37;57
89;08.11.2012;2012;11;11;Torstai;59;61;120;20;28;48
89;08.11.2012;2012;11;12;Torstai;53;72;125;21;31;52
89;08.11.2012;2012;11;13;Torstai;59;91;150;39;41;80
89;08.11.2012;2012;11;14;Torstai;100;78;178;39;15;54
89;08.11.2012;2012;11;15;Torstai;181;68;249;34;29;63
89;08.11.2012;2012;11;16;Torstai;164;75;239;40;22;62
89;08.11.2012;2012;11;17;Torstai;112;80;192;23;31;54
89;08.11.2012;2012;11;18;Torstai;71;54;125;32;15;47
89;08.11.2012;2012;11;19;Torstai;63;41;104;27;17;44
89;08.11.2012;2012;11;20;Torstai;72;30;102;21;22;43
89;08.11.2012;2012;11;21;Torstai;38;28;66;9;15;24
89;08.11.2012;2012;11;22;Torstai;18;17;35;6;7;13
89;08.11.2012;2012;11;23;Torstai;15;1;16;0;2;2
89;09.11.2012;2012;11;00;Perjantai;4;8;12;0;1;1
89;09.11.2012;2012;11;01;Perjantai;3;1;4;4;0;4
89;09.11.2012;2012;11;02;Perjantai;6;0;6;0;0;0
89;09.11.2012;2012;11;03;Perjantai;8;2;10;2;0;2
89;09.11.2012;2012;11;04;Perjantai;7;4;11;0;0;0
89;09.11.2012;2012;11;05;Perjantai;2;12;14;2;5;7
89;09.11.2012;2012;11;06;Perjantai;11;38;49;0;6;6
89;09.11.2012;2012;11;07;Perjantai;30;118;148;5;25;30
89;09.11.2012;2012;11;08;Perjantai;51;169;220;9;21;30
89;09.11.2012;2012;11;09;Perjantai;34;91;125;19;35;54
89;09.11.2012;2012;11;10;Perjantai;34;74;108;22;27;49
89;09.11.2012;2012;11;11;Perjantai;42;71;113;26;34;60
89;09.11.2012;2012;11;12;Perjantai;69;69;138;23;28;51
89;09.11.2012;2012;11;13;Perjantai;105;75;180;28;34;62
89;09.11.2012;2012;11;14;Perjantai;127;77;204;43;25;68
89;09.11.2012;2012;11;15;Perjantai;134;73;207;41;26;67
89;09.11.2012;2012;11;16;Perjantai;136;58;194;33;21;54
89;09.11.2012;2012;11;17;Perjantai;64;73;137;18;30;48
89;09.11.2012;2012;11;18;Perjantai;57;42;99;24;29;53
89;09.11.2012;2012;11;19;Perjantai;41;41;82;19;11;30
89;09.11.2012;2012;11;20;Perjantai;38;24;62;8;10;18
89;09.11.2012;2012;11;21;Perjantai;36;19;55;6;4;10
89;09.11.2012;2012;11;22;Perjantai;21;32;53;9;4;13
89;09.11.2012;2012;11;23;Perjantai;8;14;22;7;4;11
89;10.11.2012;2012;11;00;Lauantai;14;13;27;1;5;6
89;10.11.2012;2012;11;01;Lauantai;20;1;21;5;3;8
89;10.11.2012;2012;11;02;Lauantai;8;1;9;2;0;2
89;10.11.2012;2012;11;03;Lauantai;16;4;20;3;2;5
89;10.11.2012;2012;11;04;Lauantai;13;1;14;6;1;7
89;10.11.2012;2012;11;05;Lauantai;4;5;9;4;4;8
89;10.11.2012;2012;11;06;Lauantai;8;5;13;0;2;2
89;10.11.2012;2012;11;07;Lauantai;4;17;21;3;6;9
89;10.11.2012;2012;11;08;Lauantai;3;20;23;9;7;16
89;10.11.2012;2012;11;09;Lauantai;9;51;60;12;22;34
89;10.11.2012;2012;11;10;Lauantai;10;42;52;18;28;46
89;10.11.2012;2012;11;11;Lauantai;23;34;57;26;42;68
89;10.11.2012;2012;11;12;Lauantai;28;45;73;15;34;49
89;10.11.2012;2012;11;13;Lauantai;40;55;95;23;20;43
89;10.11.2012;2012;11;14;Lauantai;43;27;70;25;26;51
89;10.11.2012;2012;11;15;Lauantai;45;31;76;20;20;40
89;10.11.2012;2012;11;16;Lauantai;43;23;66;25;10;35
89;10.11.2012;2012;11;17;Lauantai;26;19;45;26;19;45
89;10.11.2012;2012;11;18;Lauantai;31;30;61;10;12;22
89;10.11.2012;2012;11;19;Lauantai;14;20;34;14;14;28
89;10.11.2012;2012;11;20;Lauantai;26;27;53;11;8;19
89;10.11.2012;2012;11;21;Lauantai;23;16;39;4;13;17
89;10.11.2012;2012;11;22;Lauantai;12;10;22;6;7;13
89;10.11.2012;2012;11;23;Lauantai;13;12;25;2;3;5
89;11.11.2012;2012;11;00;Sunnuntai;15;24;39;7;7;14
89;11.11.2012;2012;11;01;Sunnuntai;13;12;25;4;2;6
89;11.11.2012;2012;11;02;Sunnuntai;20;8;28;2;1;3
89;11.11.2012;2012;11;03;Sunnuntai;17;1;18;14;1;15
89;11.11.2012;2012;11;04;Sunnuntai;15;2;17;3;1;4
89;11.11.2012;2012;11;05;Sunnuntai;3;2;5;2;1;3
89;11.11.2012;2012;11;06;Sunnuntai;5;5;10;1;4;5
89;11.11.2012;2012;11;07;Sunnuntai;2;7;9;0;0;0
89;11.11.2012;2012;11;08;Sunnuntai;1;7;8;3;3;6
89;11.11.2012;2012;11;09;Sunnuntai;4;8;12;5;2;7
89;11.11.2012;2012;11;10;Sunnuntai;8;22;30;13;14;27
89;11.11.2012;2012;11;11;Sunnuntai;15;25;40;22;23;45
89;11.11.2012;2012;11;12;Sunnuntai;14;20;34;16;27;43
89;11.11.2012;2012;11;13;Sunnuntai;30;44;74;30;26;56
89;11.11.2012;2012;11;14;Sunnuntai;28;15;43;29;29;58
89;11.11.2012;2012;11;15;Sunnuntai;22;26;48;16;25;41
89;11.11.2012;2012;11;16;Sunnuntai;29;29;58;13;23;36
89;11.11.2012;2012;11;17;Sunnuntai;28;26;54;22;19;41
89;11.11.2012;2012;11;18;Sunnuntai;22;15;37;18;13;31
89;11.11.2012;2012;11;19;Sunnuntai;21;14;35;22;14;36
89;11.11.2012;2012;11;20;Sunnuntai;20;8;28;13;12;25
89;11.11.2012;2012;11;21;Sunnuntai;23;9;32;6;3;9
89;11.11.2012;2012;11;22;Sunnuntai;7;5;12;4;4;8
89;11.11.2012;2012;11;23;Sunnuntai;7;2;9;1;0;1
89;12.11.2012;2012;11;00;Maanantai;0;1;1;2;0;2
89;12.11.2012;2012;11;01;Maanantai;2;1;3;0;0;0
89;12.11.2012;2012;11;02;Maanantai;0;1;1;0;1;1
89;12.11.2012;2012;11;03;Maanantai;1;2;3;0;0;0
89;12.11.2012;2012;11;04;Maanantai;0;1;1;0;2;2
89;12.11.2012;2012;11;05;Maanantai;2;9;11;0;2;2
89;12.11.2012;2012;11;06;Maanantai;10;34;44;2;4;6
89;12.11.2012;2012;11;07;Maanantai;20;112;132;4;15;19
89;12.11.2012;2012;11;08;Maanantai;48;156;204;9;23;32
89;12.11.2012;2012;11;09;Maanantai;35;108;143;8;28;36
89;12.11.2012;2012;11;10;Maanantai;32;77;109;22;23;45
89;12.11.2012;2012;11;11;Maanantai;53;56;109;19;28;47
89;12.11.2012;2012;11;12;Maanantai;37;61;98;16;43;59
89;12.11.2012;2012;11;13;Maanantai;53;71;124;29;23;52
89;12.11.2012;2012;11;14;Maanantai;120;51;171;27;23;50
89;12.11.2012;2012;11;15;Maanantai;128;56;184;35;25;60
89;12.11.2012;2012;11;16;Maanantai;133;65;198;28;16;44
89;12.11.2012;2012;11;17;Maanantai;89;65;154;24;13;37
89;12.11.2012;2012;11;18;Maanantai;62;36;98;21;21;42
89;12.11.2012;2012;11;19;Maanantai;48;27;75;19;22;41
89;12.11.2012;2012;11;20;Maanantai;55;30;85;15;12;27
89;12.11.2012;2012;11;21;Maanantai;36;19;55;15;5;20
89;12.11.2012;2012;11;22;Maanantai;17;3;20;3;2;5
89;12.11.2012;2012;11;23;Maanantai;8;7;15;2;3;5
89;13.11.2012;2012;11;00;Tiistai;2;3;5;2;1;3
89;13.11.2012;2012;11;01;Tiistai;3;1;4;0;0;0
89;13.11.2012;2012;11;02;Tiistai;3;1;4;0;0;0
89;13.11.2012;2012;11;03;Tiistai;0;1;1;1;0;1
89;13.11.2012;2012;11;04;Tiistai;1;1;2;0;1;1
89;13.11.2012;2012;11;05;Tiistai;3;17;20;0;1;1
89;13.11.2012;2012;11;06;Tiistai;16;32;48;3;6;9
89;13.11.2012;2012;11;07;Tiistai;35;133;168;2;32;34
89;13.11.2012;2012;11;08;Tiistai;57;180;237;9;24;33
89;13.11.2012;2012;11;09;Tiistai;32;129;161;5;26;31
89;13.11.2012;2012;11;10;Tiistai;36;75;111;11;34;45
89;13.11.2012;2012;11;11;Tiistai;54;70;124;18;26;44
89;13.11.2012;2012;11;12;Tiistai;57;46;103;20;28;48
89;13.11.2012;2012;11;13;Tiistai;64;67;131;23;28;51
89;13.11.2012;2012;11;14;Tiistai;104;84;188;32;28;60
89;13.11.2012;2012;11;15;Tiistai;161;92;253;36;25;61
89;13.11.2012;2012;11;16;Tiistai;194;89;283;32;19;51
89;13.11.2012;2012;11;17;Tiistai;91;84;175;49;33;82
89;13.11.2012;2012;11;18;Tiistai;76;66;142;31;30;61
89;13.11.2012;2012;11;19;Tiistai;69;42;111;30;23;53
89;13.11.2012;2012;11;20;Tiistai;59;25;84;21;26;47
89;13.11.2012;2012;11;21;Tiistai;56;14;70;17;11;28
89;13.11.2012;2012;11;22;Tiistai;23;10;33;5;8;13
89;13.11.2012;2012;11;23;Tiistai;12;4;16;7;1;8
89;14.11.2012;2012;11;00;Keskiviikko;4;4;8;3;1;4
89;14.11.2012;2012;11;01;Keskiviikko;6;1;7;0;0;0
89;14.11.2012;2012;11;02;Keskiviikko;1;0;1;0;0;0
89;14.11.2012;2012;11;03;Keskiviikko;2;1;3;2;0;2
89;14.11.2012;2012;11;04;Keskiviikko;2;3;5;0;1;1
89;14.11.2012;2012;11;05;Keskiviikko;2;13;15;8;3;11
89;14.11.2012;2012;11;06;Keskiviikko;11;38;49;2;10;12
89;14.11.2012;2012;11;07;Keskiviikko;38;131;169;6;31;37
89;14.11.2012;2012;11;08;Keskiviikko;55;218;273;7;29;36
89;14.11.2012;2012;11;09;Keskiviikko;40;102;142;9;31;40
89;14.11.2012;2012;11;10;Keskiviikko;35;62;97;14;33;47
89;14.11.2012;2012;11;11;Keskiviikko;47;59;106;20;29;49
89;14.11.2012;2012;11;12;Keskiviikko;48;63;111;14;29;43
89;14.11.2012;2012;11;13;Keskiviikko;57;74;131;16;29;45
89;14.11.2012;2012;11;14;Keskiviikko;95;60;155;29;21;50
89;14.11.2012;2012;11;15;Keskiviikko;137;80;217;33;20;53
89;14.11.2012;2012;11;16;Keskiviikko;189;84;273;37;24;61
89;14.11.2012;2012;11;17;Keskiviikko;99;77;176;36;40;76
89;14.11.2012;2012;11;18;Keskiviikko;73;75;148;28;20;48
89;14.11.2012;2012;11;19;Keskiviikko;62;31;93;24;36;60
89;14.11.2012;2012;11;20;Keskiviikko;74;31;105;22;15;37
89;14.11.2012;2012;11;21;Keskiviikko;36;26;62;11;9;20
89;14.11.2012;2012;11;22;Keskiviikko;31;17;48;6;7;13
89;14.11.2012;2012;11;23;Keskiviikko;11;5;16;3;1;4
89;15.11.2012;2012;11;00;Torstai;9;3;12;2;0;2
89;15.11.2012;2012;11;01;Torstai;7;5;12;0;1;1
89;15.11.2012;2012;11;02;Torstai;10;1;11;1;1;2
89;15.11.2012;2012;11;03;Torstai;13;1;14;1;1;2
89;15.11.2012;2012;11;04;Torstai;3;3;6;1;1;2
89;15.11.2012;2012;11;05;Torstai;5;10;15;2;1;3
89;15.11.2012;2012;11;06;Torstai;15;37;52;2;3;5
89;15.11.2012;2012;11;07;Torstai;27;140;167;5;36;41
89;15.11.2012;2012;11;08;Torstai;51;190;241;15;27;42
89;15.11.2012;2012;11;09;Torstai;48;105;153;13;36;49
89;15.11.2012;2012;11;10;Torstai;50;67;117;20;30;50
89;15.11.2012;2012;11;11;Torstai;46;83;129;18;34;52
89;15.11.2012;2012;11;12;Torstai;55;83;138;23;34;57
89;15.11.2012;2012;11;13;Torstai;76;86;162;22;38;60
89;15.11.2012;2012;11;14;Torstai;91;81;172;32;26;58
89;15.11.2012;2012;11;15;Torstai;162;62;224;39;22;61
89;15.11.2012;2012;11;16;Torstai;183;86;269;46;28;74
89;15.11.2012;2012;11;17;Torstai;103;68;171;26;35;61
89;15.11.2012;2012;11;18;Torstai;74;62;136;25;33;58
89;15.11.2012;2012;11;19;Torstai;65;45;110;31;20;51
89;15.11.2012;2012;11;20;Torstai;68;43;111;19;18;37
89;15.11.2012;2012;11;21;Torstai;30;24;54;8;8;16
89;15.11.2012;2012;11;22;Torstai;19;18;37;6;13;19
89;15.11.2012;2012;11;23;Torstai;15;17;32;2;5;7
89;16.11.2012;2012;11;00;Perjantai;12;1;13;2;0;2
89;16.11.2012;2012;11;01;Perjantai;7;0;7;2;1;3
89;16.11.2012;2012;11;02;Perjantai;10;3;13;1;2;3
89;16.11.2012;2012;11;03;Perjantai;6;5;11;1;0;1
89;16.11.2012;2012;11;04;Perjantai;2;3;5;2;1;3
89;16.11.2012;2012;11;05;Perjantai;3;9;12;1;4;5
89;16.11.2012;2012;11;06;Perjantai;13;37;50;1;7;8
89;16.11.2012;2012;11;07;Perjantai;30;125;155;5;28;33
89;16.11.2012;2012;11;08;Perjantai;42;163;205;6;36;42
89;16.11.2012;2012;11;09;Perjantai;26;97;123;14;31;45
89;16.11.2012;2012;11;10;Perjantai;41;57;98;16;33;49
89;16.11.2012;2012;11;11;Perjantai;44;64;108;23;29;52
89;16.11.2012;2012;11;12;Perjantai;46;58;104;21;21;42
89;16.11.2012;2012;11;13;Perjantai;70;47;117;20;20;40
89;16.11.2012;2012;11;14;Perjantai;85;64;149;23;18;41
89;16.11.2012;2012;11;15;Perjantai;115;69;184;22;20;42
89;16.11.2012;2012;11;16;Perjantai;110;52;162;29;14;43
89;16.11.2012;2012;11;17;Perjantai;71;40;111;27;17;44
89;16.11.2012;2012;11;18;Perjantai;44;38;82;27;31;58
89;16.11.2012;2012;11;19;Perjantai;33;32;65;9;23;32
89;16.11.2012;2012;11;20;Perjantai;39;23;62;13;17;30
89;16.11.2012;2012;11;21;Perjantai;18;20;38;9;14;23
89;16.11.2012;2012;11;22;Perjantai;16;15;31;7;7;14
89;16.11.2012;2012;11;23;Perjantai;15;7;22;6;9;15
89;17.11.2012;2012;11;00;Lauantai;3;10;13;10;8;18
89;17.11.2012;2012;11;01;Lauantai;13;9;22;7;7;14
89;17.11.2012;2012;11;02;Lauantai;15;3;18;10;3;13
89;17.11.2012;2012;11;03;Lauantai;20;2;22;16;1;17
89;17.11.2012;2012;11;04;Lauantai;11;5;16;9;1;10
89;17.11.2012;2012;11;05;Lauantai;6;3;9;2;2;4
89;17.11.2012;2012;11;06;Lauantai;1;4;5;4;2;6
89;17.11.2012;2012;11;07;Lauantai;3;8;11;1;6;7
89;17.11.2012;2012;11;08;Lauantai;3;18;21;7;13;20
89;17.11.2012;2012;11;09;Lauantai;13;38;51;27;19;46
89;17.11.2012;2012;11;10;Lauantai;18;56;74;16;47;63
89;17.11.2012;2012;11;11;Lauantai;39;62;101;29;53;82
89;17.11.2012;2012;11;12;Lauantai;35;71;106;17;60;77
89;17.11.2012;2012;11;13;Lauantai;36;61;97;42;43;85
89;17.11.2012;2012;11;14;Lauantai;55;56;111;41;31;72
89;17.11.2012;2012;11;15;Lauantai;52;34;86;24;32;56
89;17.11.2012;2012;11;16;Lauantai;48;49;97;32;24;56
89;17.11.2012;2012;11;17;Lauantai;54;39;93;24;20;44
89;17.11.2012;2012;11;18;Lauantai;27;24;51;22;24;46
89;17.11.2012;2012;11;19;Lauantai;33;34;67;11;14;25
89;17.11.2012;2012;11;20;Lauantai;29;17;46;8;10;18
89;17.11.2012;2012;11;21;Lauantai;22;23;45;12;6;18
89;17.11.2012;2012;11;22;Lauantai;13;33;46;7;9;16
89;17.11.2012;2012;11;23;Lauantai;17;15;32;3;9;12
89;18.11.2012;2012;11;00;Sunnuntai;23;18;41;3;6;9
89;18.11.2012;2012;11;01;Sunnuntai;22;11;33;6;2;8
89;18.11.2012;2012;11;02;Sunnuntai;23;7;30;7;0;7
89;18.11.2012;2012;11;03;Sunnuntai;26;3;29;9;2;11
89;18.11.2012;2012;11;04;Sunnuntai;18;3;21;7;1;8
89;18.11.2012;2012;11;05;Sunnuntai;7;3;10;6;1;7
89;18.11.2012;2012;11;06;Sunnuntai;3;6;9;3;1;4
89;18.11.2012;2012;11;07;Sunnuntai;0;4;4;1;4;5
89;18.11.2012;2012;11;08;Sunnuntai;3;9;12;3;5;8
89;18.11.2012;2012;11;09;Sunnuntai;10;18;28;10;7;17
89;18.11.2012;2012;11;10;Sunnuntai;10;30;40;30;11;41
89;18.11.2012;2012;11;11;Sunnuntai;14;37;51;40;32;72
89;18.11.2012;2012;11;12;Sunnuntai;24;50;74;39;45;84
89;18.11.2012;2012;11;13;Sunnuntai;44;65;109;35;45;80
89;18.11.2012;2012;11;14;Sunnuntai;62;40;102;27;27;54
89;18.11.2012;2012;11;15;Sunnuntai;45;38;83;39;29;68
89;18.11.2012;2012;11;16;Sunnuntai;37;27;64;18;17;35
89;18.11.2012;2012;11;17;Sunnuntai;31;27;58;23;27;50
89;18.11.2012;2012;11;18;Sunnuntai;23;20;43;24;14;38
89;18.11.2012;2012;11;19;Sunnuntai;20;22;42;17;11;28
89;18.11.2012;2012;11;20;Sunnuntai;30;9;39;6;11;17
89;18.11.2012;2012;11;21;Sunnuntai;15;9;24;5;4;9
89;18.11.2012;2012;11;22;Sunnuntai;7;4;11;1;3;4
89;18.11.2012;2012;11;23;Sunnuntai;4;2;6;2;1;3
89;19.11.2012;2012;11;00;Maanantai;3;2;5;3;0;3
89;19.11.2012;2012;11;01;Maanantai;4;3;7;0;2;2
89;19.11.2012;2012;11;02;Maanantai;2;1;3;0;0;0
89;19.11.2012;2012;11;03;Maanantai;3;2;5;0;0;0
89;19.11.2012;2012;11;04;Maanantai;6;1;7;0;1;1
89;19.11.2012;2012;11;05;Maanantai;4;17;21;1;1;2
89;19.11.2012;2012;11;06;Maanantai;16;39;55;2;3;5
89;19.11.2012;2012;11;07;Maanantai;21;138;159;3;32;35
89;19.11.2012;2012;11;08;Maanantai;54;188;242;12;35;47
89;19.11.2012;2012;11;09;Maanantai;37;135;172;14;35;49
89;19.11.2012;2012;11;10;Maanantai;37;80;117;19;34;53
89;19.11.2012;2012;11;11;Maanantai;53;61;114;20;41;61
89;19.11.2012;2012;11;12;Maanantai;60;70;130;18;54;72
89;19.11.2012;2012;11;13;Maanantai;69;78;147;31;27;58
89;19.11.2012;2012;11;14;Maanantai;109;55;164;33;38;71
89;19.11.2012;2012;11;15;Maanantai;131;63;194;37;38;75
89;19.11.2012;2012;11;16;Maanantai;193;78;271;37;17;54
89;19.11.2012;2012;11;17;Maanantai;96;50;146;37;32;69
89;19.11.2012;2012;11;18;Maanantai;68;42;110;37;28;65
89;19.11.2012;2012;11;19;Maanantai;66;39;105;37;34;71
89;19.11.2012;2012;11;20;Maanantai;47;39;86;29;20;49
89;19.11.2012;2012;11;21;Maanantai;36;17;53;11;4;15
89;19.11.2012;2012;11;22;Maanantai;19;4;23;7;4;11
89;19.11.2012;2012;11;23;Maanantai;7;3;10;3;2;5
89;20.11.2012;2012;11;00;Tiistai;3;5;8;0;2;2
89;20.11.2012;2012;11;01;Tiistai;0;5;5;1;0;1
89;20.11.2012;2012;11;02;Tiistai;1;1;2;0;0;0
89;20.11.2012;2012;11;03;Tiistai;0;1;1;1;1;2
89;20.11.2012;2012;11;04;Tiistai;1;3;4;0;2;2
89;20.11.2012;2012;11;05;Tiistai;4;12;16;2;1;3
89;20.11.2012;2012;11;06;Tiistai;14;40;54;2;7;9
89;20.11.2012;2012;11;07;Tiistai;25;134;159;11;42;53
89;20.11.2012;2012;11;08;Tiistai;46;190;236;16;26;42
89;20.11.2012;2012;11;09;Tiistai;35;103;138;17;41;58
89;20.11.2012;2012;11;10;Tiistai;34;70;104;26;35;61
89;20.11.2012;2012;11;11;Tiistai;48;46;94;26;23;49
89;20.11.2012;2012;11;12;Tiistai;39;50;89;26;18;44
89;20.11.2012;2012;11;13;Tiistai;56;45;101;15;34;49
89;20.11.2012;2012;11;14;Tiistai;73;67;140;28;26;54
89;20.11.2012;2012;11;15;Tiistai;145;74;219;27;18;45
89;20.11.2012;2012;11;16;Tiistai;145;78;223;41;30;71
89;20.11.2012;2012;11;17;Tiistai;103;70;173;30;19;49
89;20.11.2012;2012;11;18;Tiistai;61;49;110;41;34;75
89;20.11.2012;2012;11;19;Tiistai;63;44;107;35;35;70
89;20.11.2012;2012;11;20;Tiistai;64;29;93;31;21;52
89;20.11.2012;2012;11;21;Tiistai;46;20;66;13;8;21
89;20.11.2012;2012;11;22;Tiistai;15;9;24;4;4;8
89;20.11.2012;2012;11;23;Tiistai;12;5;17;1;1;2
89;21.11.2012;2012;11;00;Keskiviikko;0;1;1;1;1;2
89;21.11.2012;2012;11;01;Keskiviikko;4;1;5;0;0;0
89;21.11.2012;2012;11;02;Keskiviikko;1;2;3;0;2;2
89;21.11.2012;2012;11;03;Keskiviikko;2;2;4;0;0;0
89;21.11.2012;2012;11;04;Keskiviikko;2;2;4;0;1;1
89;21.11.2012;2012;11;05;Keskiviikko;6;13;19;2;3;5
89;21.11.2012;2012;11;06;Keskiviikko;13;41;54;3;5;8
89;21.11.2012;2012;11;07;Keskiviikko;29;145;174;13;28;41
89;21.11.2012;2012;11;08;Keskiviikko;53;197;250;10;40;50
89;21.11.2012;2012;11;09;Keskiviikko;28;104;132;12;36;48
89;21.11.2012;2012;11;10;Keskiviikko;37;65;102;17;29;46
89;21.11.2012;2012;11;11;Keskiviikko;45;40;85;28;22;50
89;21.11.2012;2012;11;12;Keskiviikko;41;61;102;13;24;37
89;21.11.2012;2012;11;13;Keskiviikko;64;68;132;14;22;36
89;21.11.2012;2012;11;14;Keskiviikko;111;69;180;22;13;35
89;21.11.2012;2012;11;15;Keskiviikko;126;56;182;20;22;42
89;21.11.2012;2012;11;16;Keskiviikko;162;71;233;26;21;47
89;21.11.2012;2012;11;17;Keskiviikko;84;62;146;33;18;51
89;21.11.2012;2012;11;18;Keskiviikko;76;48;124;22;27;49
89;21.11.2012;2012;11;19;Keskiviikko;70;38;108;28;24;52
89;21.11.2012;2012;11;20;Keskiviikko;54;29;83;27;20;47
89;21.11.2012;2012;11;21;Keskiviikko;40;15;55;8;5;13
89;21.11.2012;2012;11;22;Keskiviikko;19;18;37;3;1;4
89;21.11.2012;2012;11;23;Keskiviikko;8;3;11;2;1;3
89;22.11.2012;2012;11;00;Torstai;2;5;7;1;0;1
89;22.11.2012;2012;11;01;Torstai;1;1;2;1;3;4
89;22.11.2012;2012;11;02;Torstai;6;1;7;4;1;5
89;22.11.2012;2012;11;03;Torstai;6;1;7;1;0;1
89;22.11.2012;2012;11;04;Torstai;5;3;8;1;0;1
89;22.11.2012;2012;11;05;Torstai;5;11;16;1;1;2
89;22.11.2012;2012;11;06;Torstai;16;39;55;5;7;12
89;22.11.2012;2012;11;07;Torstai;25;143;168;7;31;38
89;22.11.2012;2012;11;08;Torstai;50;169;219;7;17;24
89;22.11.2012;2012;11;09;Torstai;33;88;121;12;26;38
89;22.11.2012;2012;11;10;Torstai;38;63;101;23;25;48
89;22.11.2012;2012;11;11;Torstai;43;66;109;9;18;27
89;22.11.2012;2012;11;12;Torstai;54;65;119;26;25;51
89;22.11.2012;2012;11;13;Torstai;70;61;131;21;31;52
89;22.11.2012;2012;11;14;Torstai;78;60;138;21;31;52
89;22.11.2012;2012;11;15;Torstai;157;69;226;24;25;49
89;22.11.2012;2012;11;16;Torstai;169;67;236;41;20;61
89;22.11.2012;2012;11;17;Torstai;94;55;149;26;22;48
89;22.11.2012;2012;11;18;Torstai;62;46;108;19;18;37
89;22.11.2012;2012;11;19;Torstai;58;28;86;20;24;44
89;22.11.2012;2012;11;20;Torstai;41;27;68;14;16;30
89;22.11.2012;2012;11;21;Torstai;34;12;46;14;7;21
89;22.11.2012;2012;11;22;Torstai;21;13;34;2;0;2
89;22.11.2012;2012;11;23;Torstai;12;10;22;1;2;3
89;23.11.2012;2012;11;00;Perjantai;6;0;6;0;3;3
89;23.11.2012;2012;11;01;Perjantai;1;2;3;1;0;1
89;23.11.2012;2012;11;02;Perjantai;4;1;5;3;0;3
89;23.11.2012;2012;11;03;Perjantai;1;3;4;1;0;1
89;23.11.2012;2012;11;04;Perjantai;2;3;5;1;2;3
89;23.11.2012;2012;11;05;Perjantai;6;8;14;2;3;5
89;23.11.2012;2012;11;06;Perjantai;18;41;59;3;6;9
89;23.11.2012;2012;11;07;Perjantai;27;115;142;9;23;32
89;23.11.2012;2012;11;08;Perjantai;42;142;184;6;32;38
89;23.11.2012;2012;11;09;Perjantai;33;76;109;12;27;39
89;23.11.2012;2012;11;10;Perjantai;34;54;88;19;22;41
89;23.11.2012;2012;11;11;Perjantai;34;43;77;11;24;35
89;23.11.2012;2012;11;12;Perjantai;41;62;103;8;25;33
89;23.11.2012;2012;11;13;Perjantai;83;52;135;17;17;34
89;23.11.2012;2012;11;14;Perjantai;101;63;164;17;20;37
89;23.11.2012;2012;11;15;Perjantai;123;69;192;16;26;42
89;23.11.2012;2012;11;16;Perjantai;93;58;151;33;23;56
89;23.11.2012;2012;11;17;Perjantai;69;55;124;16;33;49
89;23.11.2012;2012;11;18;Perjantai;56;59;115;26;34;60
89;23.11.2012;2012;11;19;Perjantai;40;39;79;28;15;43
89;23.11.2012;2012;11;20;Perjantai;41;21;62;14;19;33
89;23.11.2012;2012;11;21;Perjantai;40;30;70;6;14;20
89;23.11.2012;2012;11;22;Perjantai;27;29;56;8;7;15
89;23.11.2012;2012;11;23;Perjantai;13;15;28;7;6;13
89;24.11.2012;2012;11;00;Lauantai;13;15;28;10;3;13
89;24.11.2012;2012;11;01;Lauantai;27;15;42;5;6;11
89;24.11.2012;2012;11;02;Lauantai;17;10;27;8;3;11
89;24.11.2012;2012;11;03;Lauantai;24;3;27;13;0;13
89;24.11.2012;2012;11;04;Lauantai;20;2;22;4;0;4
89;24.11.2012;2012;11;05;Lauantai;5;4;9;1;3;4
89;24.11.2012;2012;11;06;Lauantai;2;6;8;5;2;7
89;24.11.2012;2012;11;07;Lauantai;2;14;16;1;2;3
89;24.11.2012;2012;11;08;Lauantai;10;32;42;5;10;15
89;24.11.2012;2012;11;09;Lauantai;11;48;59;8;25;33
89;24.11.2012;2012;11;10;Lauantai;27;48;75;18;27;45
89;24.11.2012;2012;11;11;Lauantai;40;65;105;20;53;73
89;24.11.2012;2012;11;12;Lauantai;58;66;124;31;33;64
89;24.11.2012;2012;11;13;Lauantai;60;73;133;33;43;76
89;24.11.2012;2012;11;14;Lauantai;64;46;110;33;33;66
89;24.11.2012;2012;11;15;Lauantai;55;54;109;31;26;57
89;24.11.2012;2012;11;16;Lauantai;58;36;94;29;21;50
89;24.11.2012;2012;11;17;Lauantai;41;33;74;28;31;59
89;24.11.2012;2012;11;18;Lauantai;36;32;68;16;13;29
89;24.11.2012;2012;11;19;Lauantai;31;32;63;14;18;32
89;24.11.2012;2012;11;20;Lauantai;24;32;56;21;16;37
89;24.11.2012;2012;11;21;Lauantai;28;26;54;6;10;16
89;24.11.2012;2012;11;22;Lauantai;23;20;43;6;13;19
89;24.11.2012;2012;11;23;Lauantai;16;16;32;5;4;9
89;25.11.2012;2012;11;00;Sunnuntai;21;11;32;5;6;11
89;25.11.2012;2012;11;01;Sunnuntai;16;7;23;6;8;14
89;25.11.2012;2012;11;02;Sunnuntai;27;10;37;6;0;6
89;25.11.2012;2012;11;03;Sunnuntai;24;2;26;9;1;10
89;25.11.2012;2012;11;04;Sunnuntai;12;1;13;9;2;11
89;25.11.2012;2012;11;05;Sunnuntai;8;2;10;1;0;1
89;25.11.2012;2012;11;06;Sunnuntai;5;4;9;1;3;4
89;25.11.2012;2012;11;07;Sunnuntai;2;3;5;1;4;5
89;25.11.2012;2012;11;08;Sunnuntai;7;8;15;5;4;9
89;25.11.2012;2012;11;09;Sunnuntai;13;22;35;17;11;28
89;25.11.2012;2012;11;10;Sunnuntai;14;38;52;33;37;70
89;25.11.2012;2012;11;11;Sunnuntai;38;53;91;37;54;91
89;25.11.2012;2012;11;12;Sunnuntai;39;69;108;44;49;93
89;25.11.2012;2012;11;13;Sunnuntai;50;63;113;33;57;90
89;25.11.2012;2012;11;14;Sunnuntai;44;43;87;41;44;85
89;25.11.2012;2012;11;15;Sunnuntai;52;53;105;37;32;69
89;25.11.2012;2012;11;16;Sunnuntai;46;18;64;29;26;55
89;25.11.2012;2012;11;17;Sunnuntai;39;34;73;37;21;58
89;25.11.2012;2012;11;18;Sunnuntai;27;40;67;25;16;41
89;25.11.2012;2012;11;19;Sunnuntai;39;20;59;23;20;43
89;25.11.2012;2012;11;20;Sunnuntai;33;11;44;12;12;24
89;25.11.2012;2012;11;21;Sunnuntai;21;9;30;16;6;22
89;25.11.2012;2012;11;22;Sunnuntai;13;5;18;4;2;6
89;25.11.2012;2012;11;23;Sunnuntai;2;4;6;0;1;1
89;26.11.2012;2012;11;00;Maanantai;3;0;3;0;1;1
89;26.11.2012;2012;11;01;Maanantai;1;4;5;1;1;2
89;26.11.2012;2012;11;02;Maanantai;5;0;5;0;0;0
89;26.11.2012;2012;11;03;Maanantai;0;1;1;1;0;1
89;26.11.2012;2012;11;04;Maanantai;2;3;5;0;1;1
89;26.11.2012;2012;11;05;Maanantai;4;13;17;1;1;2
89;26.11.2012;2012;11;06;Maanantai;12;44;56;2;8;10
89;26.11.2012;2012;11;07;Maanantai;30;119;149;8;29;37
89;26.11.2012;2012;11;08;Maanantai;58;183;241;11;35;46
89;26.11.2012;2012;11;09;Maanantai;33;114;147;7;33;40
89;26.11.2012;2012;11;10;Maanantai;43;89;132;13;35;48
89;26.11.2012;2012;11;11;Maanantai;71;65;136;13;24;37
89;26.11.2012;2012;11;12;Maanantai;47;71;118;21;35;56
89;26.11.2012;2012;11;13;Maanantai;80;53;133;26;17;43
89;26.11.2012;2012;11;14;Maanantai;86;63;149;33;17;50
89;26.11.2012;2012;11;15;Maanantai;158;73;231;36;30;66
89;26.11.2012;2012;11;16;Maanantai;171;72;243;28;11;39
89;26.11.2012;2012;11;17;Maanantai;99;59;158;27;28;55
89;26.11.2012;2012;11;18;Maanantai;76;48;124;27;30;57
89;26.11.2012;2012;11;19;Maanantai;53;29;82;37;39;76
89;26.11.2012;2012;11;20;Maanantai;60;24;84;30;21;51
89;26.11.2012;2012;11;21;Maanantai;42;19;61;11;10;21
89;26.11.2012;2012;11;22;Maanantai;22;5;27;6;4;10
89;26.11.2012;2012;11;23;Maanantai;7;7;14;2;1;3
89;27.11.2012;2012;11;00;Tiistai;4;2;6;2;2;4
89;27.11.2012;2012;11;01;Tiistai;2;2;4;1;2;3
89;27.11.2012;2012;11;02;Tiistai;0;2;2;2;0;2
89;27.11.2012;2012;11;03;Tiistai;2;2;4;0;0;0
89;27.11.2012;2012;11;04;Tiistai;0;4;4;0;2;2
89;27.11.2012;2012;11;05;Tiistai;3;11;14;1;2;3
89;27.11.2012;2012;11;06;Tiistai;14;38;52;4;11;15
89;27.11.2012;2012;11;07;Tiistai;38;147;185;6;25;31
89;27.11.2012;2012;11;08;Tiistai;56;163;219;5;34;39
89;27.11.2012;2012;11;09;Tiistai;23;104;127;12;47;59
89;27.11.2012;2012;11;10;Tiistai;31;82;113;22;38;60
89;27.11.2012;2012;11;11;Tiistai;56;50;106;24;29;53
89;27.11.2012;2012;11;12;Tiistai;44;61;105;16;24;40
89;27.11.2012;2012;11;13;Tiistai;63;54;117;18;19;37
89;27.11.2012;2012;11;14;Tiistai;91;64;155;26;29;55
89;27.11.2012;2012;11;15;Tiistai;152;85;237;38;24;62
89;27.11.2012;2012;11;16;Tiistai;173;49;222;30;17;47
89;27.11.2012;2012;11;17;Tiistai;94;66;160;29;23;52
89;27.11.2012;2012;11;18;Tiistai;75;52;127;40;31;71
89;27.11.2012;2012;11;19;Tiistai;56;38;94;24;25;49
89;27.11.2012;2012;11;20;Tiistai;48;26;74;22;22;44
89;27.11.2012;2012;11;21;Tiistai;42;15;57;10;14;24
89;27.11.2012;2012;11;22;Tiistai;17;8;25;8;4;12
89;27.11.2012;2012;11;23;Tiistai;10;3;13;1;1;2
89;28.11.2012;2012;11;00;Keskiviikko;3;1;4;3;1;4
89;28.11.2012;2012;11;01;Keskiviikko;1;4;5;1;0;1
89;28.11.2012;2012;11;02;Keskiviikko;3;1;4;0;0;0
89;28.11.2012;2012;11;03;Keskiviikko;0;1;1;2;0;2
89;28.11.2012;2012;11;04;Keskiviikko;0;3;3;0;1;1
89;28.11.2012;2012;11;05;Keskiviikko;3;14;17;1;3;4
89;28.11.2012;2012;11;06;Keskiviikko;17;36;53;3;9;12
89;28.11.2012;2012;11;07;Keskiviikko;25;126;151;4;29;33
89;28.11.2012;2012;11;08;Keskiviikko;50;165;215;9;33;42
89;28.11.2012;2012;11;09;Keskiviikko;36;94;130;6;25;31
89;28.11.2012;2012;11;10;Keskiviikko;29;69;98;11;32;43
89;28.11.2012;2012;11;11;Keskiviikko;38;72;110;18;26;44
89;28.11.2012;2012;11;12;Keskiviikko;43;62;105;11;31;42
89;28.11.2012;2012;11;13;Keskiviikko;55;57;112;21;32;53
89;28.11.2012;2012;11;14;Keskiviikko;90;66;156;28;27;55
89;28.11.2012;2012;11;15;Keskiviikko;131;72;203;32;11;43
89;28.11.2012;2012;11;16;Keskiviikko;162;71;233;38;16;54
89;28.11.2012;2012;11;17;Keskiviikko;89;57;146;24;19;43
89;28.11.2012;2012;11;18;Keskiviikko;53;54;107;24;32;56
89;28.11.2012;2012;11;19;Keskiviikko;52;28;80;21;19;40
89;28.11.2012;2012;11;20;Keskiviikko;49;20;69;15;15;30
89;28.11.2012;2012;11;21;Keskiviikko;47;10;57;9;6;15
89;28.11.2012;2012;11;22;Keskiviikko;20;9;29;2;2;4
89;28.11.2012;2012;11;23;Keskiviikko;12;1;13;1;2;3
89;29.11.2012;2012;11;00;Torstai;5;4;9;2;0;2
89;29.11.2012;2012;11;01;Torstai;4;5;9;1;1;2
89;29.11.2012;2012;11;02;Torstai;3;0;3;0;0;0
89;29.11.2012;2012;11;03;Torstai;2;3;5;0;0;0
89;29.11.2012;2012;11;04;Torstai;1;2;3;2;1;3
89;29.11.2012;2012;11;05;Torstai;9;10;19;0;1;1
89;29.11.2012;2012;11;06;Torstai;15;38;53;1;8;9
89;29.11.2012;2012;11;07;Torstai;22;121;143;3;18;21
89;29.11.2012;2012;11;08;Torstai;40;159;199;10;33;43
89;29.11.2012;2012;11;09;Torstai;35;92;127;7;26;33
89;29.11.2012;2012;11;10;Torstai;28;67;95;11;20;31
89;29.11.2012;2012;11;11;Torstai;38;47;85;20;26;46
89;29.11.2012;2012;11;12;Torstai;52;62;114;12;28;40
89;29.11.2012;2012;11;13;Torstai;54;54;108;19;20;39
89;29.11.2012;2012;11;14;Torstai;94;52;146;21;29;50
89;29.11.2012;2012;11;15;Torstai;120;48;168;21;17;38
89;29.11.2012;2012;11;16;Torstai;126;49;175;26;15;41
89;29.11.2012;2012;11;17;Torstai;79;51;130;29;18;47
89;29.11.2012;2012;11;18;Torstai;72;37;109;13;20;33
89;29.11.2012;2012;11;19;Torstai;44;32;76;17;21;38
89;29.11.2012;2012;11;20;Torstai;45;40;85;14;11;25
89;29.11.2012;2012;11;21;Torstai;28;9;37;16;6;22
89;29.11.2012;2012;11;22;Torstai;15;6;21;3;4;7
89;29.11.2012;2012;11;23;Torstai;12;6;18;0;5;5
89;30.11.2012;2012;11;00;Perjantai;3;4;7;3;0;3
89;30.11.2012;2012;11;01;Perjantai;8;2;10;1;0;1
89;30.11.2012;2012;11;02;Perjantai;4;2;6;0;0;0
89;30.11.2012;2012;11;03;Perjantai;3;2;5;1;0;1
89;30.11.2012;2012;11;04;Perjantai;3;4;7;1;1;2
89;30.11.2012;2012;11;05;Perjantai;4;11;15;1;1;2
89;30.11.2012;2012;11;06;Perjantai;12;35;47;2;11;13
89;30.11.2012;2012;11;07;Perjantai;26;86;112;5;26;31
89;30.11.2012;2012;11;08;Perjantai;34;129;163;5;29;34
89;30.11.2012;2012;11;09;Perjantai;19;83;102;4;22;26
89;30.11.2012;2012;11;10;Perjantai;25;61;86;11;26;37
89;30.11.2012;2012;11;11;Perjantai;39;26;65;12;28;40
89;30.11.2012;2012;11;12;Perjantai;38;62;100;19;35;54
89;30.11.2012;2012;11;13;Perjantai;79;60;139;26;24;50
89;30.11.2012;2012;11;14;Perjantai;85;62;147;18;10;28
89;30.11.2012;2012;11;15;Perjantai;109;41;150;13;24;37
89;30.11.2012;2012;11;16;Perjantai;93;50;143;27;15;42
89;30.11.2012;2012;11;17;Perjantai;52;44;96;15;20;35
89;30.11.2012;2012;11;18;Perjantai;34;40;74;11;14;25
89;30.11.2012;2012;11;19;Perjantai;44;21;65;7;10;17
89;30.11.2012;2012;11;20;Perjantai;24;17;41;7;7;14
89;30.11.2012;2012;11;21;Perjantai;17;14;31;10;6;16
89;30.11.2012;2012;11;22;Perjantai;24;17;41;1;2;3
89;30.11.2012;2012;11;23;Perjantai;10;15;25;3;5;8
89;01.12.2012;2012;12;00;Lauantai;12;9;21;3;1;4
89;01.12.2012;2012;12;01;Lauantai;9;3;12;7;1;8
89;01.12.2012;2012;12;02;Lauantai;14;4;18;4;1;5
89;01.12.2012;2012;12;03;Lauantai;8;2;10;8;0;8
89;01.12.2012;2012;12;04;Lauantai;13;1;14;9;3;12
89;01.12.2012;2012;12;05;Lauantai;7;2;9;0;1;1
89;01.12.2012;2012;12;06;Lauantai;4;6;10;0;3;3
89;01.12.2012;2012;12;07;Lauantai;3;8;11;2;6;8
89;01.12.2012;2012;12;08;Lauantai;4;23;27;2;9;11
89;01.12.2012;2012;12;09;Lauantai;10;35;45;11;17;28
89;01.12.2012;2012;12;10;Lauantai;13;41;54;13;22;35
89;01.12.2012;2012;12;11;Lauantai;24;43;67;12;23;35
89;01.12.2012;2012;12;12;Lauantai;26;45;71;24;26;50
89;01.12.2012;2012;12;13;Lauantai;39;56;95;14;23;37
89;01.12.2012;2012;12;14;Lauantai;35;34;69;21;36;57
89;01.12.2012;2012;12;15;Lauantai;46;27;73;23;20;43
89;01.12.2012;2012;12;16;Lauantai;50;28;78;14;12;26
89;01.12.2012;2012;12;17;Lauantai;25;28;53;14;26;40
89;01.12.2012;2012;12;18;Lauantai;32;31;63;7;16;23
89;01.12.2012;2012;12;19;Lauantai;27;20;47;13;8;21
89;01.12.2012;2012;12;20;Lauantai;17;10;27;5;13;18
89;01.12.2012;2012;12;21;Lauantai;16;12;28;6;5;11
89;01.12.2012;2012;12;22;Lauantai;12;13;25;5;4;9
89;01.12.2012;2012;12;23;Lauantai;6;5;11;4;7;11
89;02.12.2012;2012;12;00;Sunnuntai;11;18;29;3;10;13
89;02.12.2012;2012;12;01;Sunnuntai;11;6;17;4;5;9
89;02.12.2012;2012;12;02;Sunnuntai;8;4;12;6;5;11
89;02.12.2012;2012;12;03;Sunnuntai;9;0;9;7;1;8
89;02.12.2012;2012;12;04;Sunnuntai;15;1;16;4;1;5
89;02.12.2012;2012;12;05;Sunnuntai;6;0;6;0;0;0
89;02.12.2012;2012;12;06;Sunnuntai;2;2;4;3;2;5
89;02.12.2012;2012;12;07;Sunnuntai;1;1;2;2;4;6
89;02.12.2012;2012;12;08;Sunnuntai;1;6;7;5;2;7
89;02.12.2012;2012;12;09;Sunnuntai;7;9;16;15;12;27
89;02.12.2012;2012;12;10;Sunnuntai;8;17;25;13;25;38
89;02.12.2012;2012;12;11;Sunnuntai;6;25;31;17;30;47
89;02.12.2012;2012;12;12;Sunnuntai;8;36;44;28;37;65
89;02.12.2012;2012;12;13;Sunnuntai;16;42;58;40;46;86
89;02.12.2012;2012;12;14;Sunnuntai;24;38;62;46;43;89
89;02.12.2012;2012;12;15;Sunnuntai;27;29;56;37;46;83
89;02.12.2012;2012;12;16;Sunnuntai;36;19;55;34;19;53
89;02.12.2012;2012;12;17;Sunnuntai;31;23;54;13;9;22
89;02.12.2012;2012;12;18;Sunnuntai;22;13;35;21;23;44
89;02.12.2012;2012;12;19;Sunnuntai;23;19;42;12;19;31
89;02.12.2012;2012;12;20;Sunnuntai;19;11;30;12;11;23
89;02.12.2012;2012;12;21;Sunnuntai;15;7;22;7;4;11
89;02.12.2012;2012;12;22;Sunnuntai;9;4;13;4;1;5
89;02.12.2012;2012;12;23;Sunnuntai;2;3;5;1;1;2
89;03.12.2012;2012;12;00;Maanantai;4;0;4;0;1;1
89;03.12.2012;2012;12;01;Maanantai;3;1;4;1;0;1
89;03.12.2012;2012;12;02;Maanantai;0;1;1;1;0;1
89;03.12.2012;2012;12;03;Maanantai;2;1;3;2;5;7
89;03.12.2012;2012;12;04;Maanantai;2;0;2;2;1;3
89;03.12.2012;2012;12;05;Maanantai;1;9;10;0;3;3
89;03.12.2012;2012;12;06;Maanantai;10;21;31;2;6;8
89;03.12.2012;2012;12;07;Maanantai;24;67;91;2;16;18
89;03.12.2012;2012;12;08;Maanantai;33;135;168;6;41;47
89;03.12.2012;2012;12;09;Maanantai;21;95;116;9;40;49
89;03.12.2012;2012;12;10;Maanantai;26;62;88;19;28;47
89;03.12.2012;2012;12;11;Maanantai;30;53;83;16;26;42
89;03.12.2012;2012;12;12;Maanantai;26;26;52;21;38;59
89;03.12.2012;2012;12;13;Maanantai;33;34;67;19;23;42
89;03.12.2012;2012;12;14;Maanantai;61;60;121;18;20;38
89;03.12.2012;2012;12;15;Maanantai;99;49;148;37;19;56
89;03.12.2012;2012;12;16;Maanantai;109;48;157;38;13;51
89;03.12.2012;2012;12;17;Maanantai;66;38;104;41;12;53
89;03.12.2012;2012;12;18;Maanantai;65;27;92;13;19;32
89;03.12.2012;2012;12;19;Maanantai;33;26;59;15;16;31
89;03.12.2012;2012;12;20;Maanantai;37;13;50;10;10;20
89;03.12.2012;2012;12;21;Maanantai;26;18;44;10;9;19
89;03.12.2012;2012;12;22;Maanantai;18;2;20;1;1;2
89;03.12.2012;2012;12;23;Maanantai;2;4;6;0;0;0
89;04.12.2012;2012;12;00;Tiistai;5;2;7;1;0;1
89;04.12.2012;2012;12;01;Tiistai;4;0;4;0;0;0
89;04.12.2012;2012;12;02;Tiistai;3;0;3;0;0;0
89;04.12.2012;2012;12;03;Tiistai;0;2;2;0;0;0
89;04.12.2012;2012;12;04;Tiistai;0;0;0;1;1;2
89;04.12.2012;2012;12;05;Tiistai;2;13;15;1;1;2
89;04.12.2012;2012;12;06;Tiistai;11;32;43;2;8;10
89;04.12.2012;2012;12;07;Tiistai;22;94;116;4;31;35
89;04.12.2012;2012;12;08;Tiistai;22;136;158;11;51;62
89;04.12.2012;2012;12;09;Tiistai;23;84;107;6;25;31
89;04.12.2012;2012;12;10;Tiistai;20;46;66;5;23;28
89;04.12.2012;2012;12;11;Tiistai;21;35;56;15;17;32
89;04.12.2012;2012;12;12;Tiistai;31;41;72;20;25;45
89;04.12.2012;2012;12;13;Tiistai;38;43;81;27;21;48
89;04.12.2012;2012;12;14;Tiistai;49;43;92;25;21;46
89;04.12.2012;2012;12;15;Tiistai;87;36;123;25;22;47
89;04.12.2012;2012;12;16;Tiistai;117;38;155;35;16;51
89;04.12.2012;2012;12;17;Tiistai;62;46;108;27;19;46
89;04.12.2012;2012;12;18;Tiistai;52;14;66;22;21;43
89;04.12.2012;2012;12;19;Tiistai;30;25;55;18;10;28
89;04.12.2012;2012;12;20;Tiistai;33;14;47;12;7;19
89;04.12.2012;2012;12;21;Tiistai;25;12;37;12;3;15
89;04.12.2012;2012;12;22;Tiistai;12;4;16;4;3;7
89;04.12.2012;2012;12;23;Tiistai;6;0;6;0;4;4
89;05.12.2012;2012;12;00;Keskiviikko;8;4;12;1;0;1
89;05.12.2012;2012;12;01;Keskiviikko;0;1;1;0;0;0
89;05.12.2012;2012;12;02;Keskiviikko;2;0;2;1;0;1
89;05.12.2012;2012;12;03;Keskiviikko;0;2;2;3;0;3
89;05.12.2012;2012;12;04;Keskiviikko;5;0;5;0;1;1
89;05.12.2012;2012;12;05;Keskiviikko;2;12;14;0;2;2
89;05.12.2012;2012;12;06;Keskiviikko;16;30;46;4;4;8
89;05.12.2012;2012;12;07;Keskiviikko;19;99;118;8;30;38
89;05.12.2012;2012;12;08;Keskiviikko;24;118;142;10;54;64
89;05.12.2012;2012;12;09;Keskiviikko;25;68;93;11;25;36
89;05.12.2012;2012;12;10;Keskiviikko;20;55;75;10;25;35
89;05.12.2012;2012;12;11;Keskiviikko;28;50;78;17;39;56
89;05.12.2012;2012;12;12;Keskiviikko;46;51;97;29;27;56
89;05.12.2012;2012;12;13;Keskiviikko;46;44;90;19;24;43
89;05.12.2012;2012;12;14;Keskiviikko;79;42;121;27;24;51
89;05.12.2012;2012;12;15;Keskiviikko;90;64;154;20;29;49
89;05.12.2012;2012;12;16;Keskiviikko;108;44;152;25;17;42
89;05.12.2012;2012;12;17;Keskiviikko;72;45;117;16;21;37
89;05.12.2012;2012;12;18;Keskiviikko;34;41;75;24;17;41
89;05.12.2012;2012;12;19;Keskiviikko;32;19;51;20;15;35
89;05.12.2012;2012;12;20;Keskiviikko;37;22;59;11;6;17
89;05.12.2012;2012;12;21;Keskiviikko;18;11;29;10;11;21
89;05.12.2012;2012;12;22;Keskiviikko;5;3;8;1;1;2
89;05.12.2012;2012;12;23;Keskiviikko;9;11;20;2;8;10
89;06.12.2012;2012;12;00;Torstai;10;9;19;2;4;6
89;06.12.2012;2012;12;01;Torstai;4;4;8;4;0;4
89;06.12.2012;2012;12;02;Torstai;20;1;21;4;3;7
89;06.12.2012;2012;12;03;Torstai;11;0;11;6;0;6
89;06.12.2012;2012;12;04;Torstai;12;1;13;16;0;16
89;06.12.2012;2012;12;05;Torstai;2;1;3;0;1;1
89;06.12.2012;2012;12;06;Torstai;3;7;10;0;3;3
89;06.12.2012;2012;12;07;Torstai;4;11;15;3;4;7
89;06.12.2012;2012;12;08;Torstai;4;7;11;3;7;10
89;06.12.2012;2012;12;09;Torstai;4;10;14;7;13;20
89;06.12.2012;2012;12;10;Torstai;10;7;17;6;8;14
89;06.12.2012;2012;12;11;Torstai;11;13;24;26;36;62
89;06.12.2012;2012;12;12;Torstai;12;18;30;21;30;51
89;06.12.2012;2012;12;13;Torstai;11;23;34;24;31;55
89;06.12.2012;2012;12;14;Torstai;18;16;34;19;36;55
89;06.12.2012;2012;12;15;Torstai;14;15;29;15;15;30
89;06.12.2012;2012;12;16;Torstai;14;7;21;21;11;32
89;06.12.2012;2012;12;17;Torstai;13;11;24;8;8;16
89;06.12.2012;2012;12;18;Torstai;10;17;27;7;13;20
89;06.12.2012;2012;12;19;Torstai;9;4;13;5;4;9
89;06.12.2012;2012;12;20;Torstai;8;4;12;3;8;11
89;06.12.2012;2012;12;21;Torstai;10;11;21;7;4;11
89;06.12.2012;2012;12;22;Torstai;11;9;20;4;1;5
89;06.12.2012;2012;12;23;Torstai;3;4;7;3;3;6
89;07.12.2012;2012;12;00;Perjantai;6;0;6;0;2;2
89;07.12.2012;2012;12;01;Perjantai;3;0;3;0;0;0
89;07.12.2012;2012;12;02;Perjantai;1;0;1;2;0;2
89;07.12.2012;2012;12;03;Perjantai;2;2;4;4;1;5
89;07.12.2012;2012;12;04;Perjantai;3;2;5;0;1;1
89;07.12.2012;2012;12;05;Perjantai;1;11;12;0;2;2
89;07.12.2012;2012;12;06;Perjantai;6;22;28;0;3;3
89;07.12.2012;2012;12;07;Perjantai;8;41;49;2;15;17
89;07.12.2012;2012;12;08;Perjantai;12;50;62;5;21;26
89;07.12.2012;2012;12;09;Perjantai;8;45;53;7;21;28
89;07.12.2012;2012;12;10;Perjantai;12;41;53;9;17;26
89;07.12.2012;2012;12;11;Perjantai;29;41;70;12;44;56
89;07.12.2012;2012;12;12;Perjantai;22;48;70;23;38;61
89;07.12.2012;2012;12;13;Perjantai;44;47;91;20;22;42
89;07.12.2012;2012;12;14;Perjantai;52;50;102;25;33;58
89;07.12.2012;2012;12;15;Perjantai;62;33;95;20;36;56
89;07.12.2012;2012;12;16;Perjantai;63;43;106;23;16;39
89;07.12.2012;2012;12;17;Perjantai;50;27;77;22;18;40
89;07.12.2012;2012;12;18;Perjantai;43;32;75;11;23;34
89;07.12.2012;2012;12;19;Perjantai;32;14;46;15;4;19
89;07.12.2012;2012;12;20;Perjantai;27;8;35;11;8;19
89;07.12.2012;2012;12;21;Perjantai;25;19;44;2;0;2
89;07.12.2012;2012;12;22;Perjantai;16;8;24;1;0;1
89;07.12.2012;2012;12;23;Perjantai;19;5;24;6;0;6
89;08.12.2012;2012;12;00;Lauantai;14;0;14;8;0;8
89;08.12.2012;2012;12;01;Lauantai;17;1;18;1;0;1
89;08.12.2012;2012;12;02;Lauantai;9;0;9;11;0;11
89;08.12.2012;2012;12;03;Lauantai;12;0;12;7;0;7
89;08.12.2012;2012;12;04;Lauantai;17;0;17;7;0;7
89;08.12.2012;2012;12;05;Lauantai;5;0;5;2;0;2
89;08.12.2012;2012;12;06;Lauantai;14;0;14;3;0;3
89;08.12.2012;2012;12;07;Lauantai;11;0;11;7;0;7
89;08.12.2012;2012;12;08;Lauantai;12;0;12;18;0;18
89;08.12.2012;2012;12;09;Lauantai;35;0;35;32;0;32
89;08.12.2012;2012;12;10;Lauantai;45;0;45;52;0;52
89;08.12.2012;2012;12;11;Lauantai;47;0;47;78;0;78
89;08.12.2012;2012;12;12;Lauantai;47;1;48;90;0;90
89;08.12.2012;2012;12;13;Lauantai;66;0;66;49;0;49
89;08.12.2012;2012;12;14;Lauantai;60;1;61;60;0;60
89;08.12.2012;2012;12;15;Lauantai;60;0;60;65;0;65
89;08.12.2012;2012;12;16;Lauantai;49;0;49;40;0;40
89;08.12.2012;2012;12;17;Lauantai;54;0;54;40;0;40
89;08.12.2012;2012;12;18;Lauantai;49;0;49;44;0;44
89;08.12.2012;2012;12;19;Lauantai;33;0;33;38;0;38
89;08.12.2012;2012;12;20;Lauantai;36;0;36;28;0;28
89;08.12.2012;2012;12;21;Lauantai;37;0;37;21;0;21
89;08.12.2012;2012;12;22;Lauantai;16;0;16;9;0;9
89;08.12.2012;2012;12;23;Lauantai;33;0;33;9;0;9
89;09.12.2012;2012;12;00;Sunnuntai;15;0;15;12;0;12
89;09.12.2012;2012;12;01;Sunnuntai;15;0;15;8;0;8
89;09.12.2012;2012;12;02;Sunnuntai;12;0;12;11;0;11
89;09.12.2012;2012;12;03;Sunnuntai;16;0;16;6;0;6
89;09.12.2012;2012;12;04;Sunnuntai;16;0;16;10;0;10
89;09.12.2012;2012;12;05;Sunnuntai;7;0;7;4;0;4
89;09.12.2012;2012;12;06;Sunnuntai;5;0;5;4;0;4
89;09.12.2012;2012;12;07;Sunnuntai;7;0;7;12;0;12
89;09.12.2012;2012;12;08;Sunnuntai;8;0;8;9;0;9
89;09.12.2012;2012;12;09;Sunnuntai;19;0;19;25;0;25
89;09.12.2012;2012;12;10;Sunnuntai;23;0;23;55;0;55
89;09.12.2012;2012;12;11;Sunnuntai;33;0;33;84;0;84
89;09.12.2012;2012;12;12;Sunnuntai;43;0;43;96;0;96
89;09.12.2012;2012;12;13;Sunnuntai;67;0;67;90;0;90
89;09.12.2012;2012;12;14;Sunnuntai;54;0;54;81;0;81
89;09.12.2012;2012;12;15;Sunnuntai;57;1;58;79;0;79
89;09.12.2012;2012;12;16;Sunnuntai;47;0;47;57;0;57
89;09.12.2012;2012;12;17;Sunnuntai;49;0;49;48;0;48
89;09.12.2012;2012;12;18;Sunnuntai;44;0;44;53;0;53
89;09.12.2012;2012;12;19;Sunnuntai;40;0;40;37;0;37
89;09.12.2012;2012;12;20;Sunnuntai;27;0;27;31;0;31
89;09.12.2012;2012;12;21;Sunnuntai;31;0;31;9;0;9
89;09.12.2012;2012;12;22;Sunnuntai;14;0;14;2;0;2
89;09.12.2012;2012;12;23;Sunnuntai;11;0;11;4;0;4
89;10.12.2012;2012;12;00;Maanantai;5;0;5;1;0;1
89;10.12.2012;2012;12;01;Maanantai;2;0;2;1;0;1
89;10.12.2012;2012;12;02;Maanantai;4;0;4;0;0;0
89;10.12.2012;2012;12;03;Maanantai;3;0;3;7;0;7
89;10.12.2012;2012;12;04;Maanantai;4;0;4;0;0;0
89;10.12.2012;2012;12;05;Maanantai;13;0;13;7;0;7
89;10.12.2012;2012;12;06;Maanantai;52;0;52;12;0;12
89;10.12.2012;2012;12;07;Maanantai;132;0;132;34;0;34
89;10.12.2012;2012;12;08;Maanantai;177;0;177;52;0;52
89;10.12.2012;2012;12;09;Maanantai;128;0;128;59;0;59
89;10.12.2012;2012;12;10;Maanantai;75;0;75;48;0;48
89;10.12.2012;2012;12;11;Maanantai;98;0;98;45;0;45
89;10.12.2012;2012;12;12;Maanantai;113;0;113;58;0;58
89;10.12.2012;2012;12;13;Maanantai;110;0;110;60;0;60
89;10.12.2012;2012;12;14;Maanantai;143;0;143;78;0;78
89;10.12.2012;2012;12;15;Maanantai;173;0;173;78;0;78
89;10.12.2012;2012;12;16;Maanantai;220;0;220;81;0;81
89;10.12.2012;2012;12;17;Maanantai;130;0;130;75;0;75
89;10.12.2012;2012;12;18;Maanantai;106;0;106;50;0;50
89;10.12.2012;2012;12;19;Maanantai;63;0;63;50;0;50
89;10.12.2012;2012;12;20;Maanantai;68;0;68;41;0;41
89;10.12.2012;2012;12;21;Maanantai;42;0;42;16;0;16
89;10.12.2012;2012;12;22;Maanantai;10;0;10;6;0;6
89;10.12.2012;2012;12;23;Maanantai;10;0;10;5;0;5
89;11.12.2012;2012;12;00;Tiistai;3;0;3;1;0;1
89;11.12.2012;2012;12;01;Tiistai;2;0;2;2;0;2
89;11.12.2012;2012;12;02;Tiistai;4;0;4;0;0;0
89;11.12.2012;2012;12;03;Tiistai;4;0;4;0;0;0
89;11.12.2012;2012;12;04;Tiistai;3;0;3;2;0;2
89;11.12.2012;2012;12;05;Tiistai;15;0;15;4;0;4
89;11.12.2012;2012;12;06;Tiistai;77;0;77;22;0;22
89;11.12.2012;2012;12;07;Tiistai;174;0;174;45;0;45
89;11.12.2012;2012;12;08;Tiistai;141;0;141;69;0;69
89;11.12.2012;2012;12;09;Tiistai;103;1;104;54;0;54
89;11.12.2012;2012;12;10;Tiistai;89;0;89;49;0;49
89;11.12.2012;2012;12;11;Tiistai;93;0;93;46;0;46
89;11.12.2012;2012;12;12;Tiistai;109;0;109;64;0;64
89;11.12.2012;2012;12;13;Tiistai;106;0;106;55;0;55
89;11.12.2012;2012;12;14;Tiistai;128;0;128;69;0;69
89;11.12.2012;2012;12;15;Tiistai;201;0;201;70;0;70
89;11.12.2012;2012;12;16;Tiistai;192;0;192;78;0;78
89;11.12.2012;2012;12;17;Tiistai;108;0;108;55;0;55
89;11.12.2012;2012;12;18;Tiistai;98;0;98;72;0;72
89;11.12.2012;2012;12;19;Tiistai;80;0;80;51;0;51
89;11.12.2012;2012;12;20;Tiistai;62;0;62;32;0;32
89;11.12.2012;2012;12;21;Tiistai;45;0;45;21;0;21
89;11.12.2012;2012;12;22;Tiistai;16;0;16;4;0;4
89;11.12.2012;2012;12;23;Tiistai;12;0;12;6;0;6
89;12.12.2012;2012;12;00;Keskiviikko;3;0;3;4;0;4
89;12.12.2012;2012;12;01;Keskiviikko;1;0;1;3;0;3
89;12.12.2012;2012;12;02;Keskiviikko;1;0;1;2;0;2
89;12.12.2012;2012;12;03;Keskiviikko;6;0;6;1;0;1
89;12.12.2012;2012;12;04;Keskiviikko;5;0;5;2;0;2
89;12.12.2012;2012;12;05;Keskiviikko;21;0;21;2;0;2
89;12.12.2012;2012;12;06;Keskiviikko;68;0;68;16;0;16
89;12.12.2012;2012;12;07;Keskiviikko;195;1;196;55;0;55
89;12.12.2012;2012;12;08;Keskiviikko;148;1;149;45;0;45
89;12.12.2012;2012;12;09;Keskiviikko;106;0;106;48;0;48
89;12.12.2012;2012;12;10;Keskiviikko;92;0;92;51;0;51
89;12.12.2012;2012;12;11;Keskiviikko;76;0;76;63;0;63
89;12.12.2012;2012;12;12;Keskiviikko;105;0;105;56;0;56
89;12.12.2012;2012;12;13;Keskiviikko;138;0;138;66;0;66
89;12.12.2012;2012;12;14;Keskiviikko;153;0;153;71;0;71
89;12.12.2012;2012;12;15;Keskiviikko;204;0;204;75;0;75
89;12.12.2012;2012;12;16;Keskiviikko;200;0;200;63;0;63
89;12.12.2012;2012;12;17;Keskiviikko;121;0;121;60;0;60
89;12.12.2012;2012;12;18;Keskiviikko;110;0;110;61;0;61
89;12.12.2012;2012;12;19;Keskiviikko;85;0;85;68;0;68
89;12.12.2012;2012;12;20;Keskiviikko;80;0;80;45;0;45
89;12.12.2012;2012;12;21;Keskiviikko;33;0;33;9;0;9
89;12.12.2012;2012;12;22;Keskiviikko;25;0;25;10;0;10
89;12.12.2012;2012;12;23;Keskiviikko;19;0;19;5;0;5
89;13.12.2012;2012;12;00;Torstai;3;0;3;5;0;5
89;13.12.2012;2012;12;01;Torstai;3;0;3;2;0;2
89;13.12.2012;2012;12;02;Torstai;0;0;0;4;0;4
89;13.12.2012;2012;12;03;Torstai;13;0;13;2;0;2
89;13.12.2012;2012;12;04;Torstai;7;0;7;1;0;1
89;13.12.2012;2012;12;05;Torstai;17;0;17;3;0;3
89;13.12.2012;2012;12;06;Torstai;59;0;59;11;0;11
89;13.12.2012;2012;12;07;Torstai;175;0;175;60;0;60
89;13.12.2012;2012;12;08;Torstai;157;0;157;70;0;70
89;13.12.2012;2012;12;09;Torstai;92;0;92;96;0;96
89;13.12.2012;2012;12;10;Torstai;81;0;81;100;0;100
89;13.12.2012;2012;12;11;Torstai;84;0;84;57;0;57
89;13.12.2012;2012;12;12;Torstai;93;0;93;72;0;72
89;13.12.2012;2012;12;13;Torstai;112;0;112;61;0;61
89;13.12.2012;2012;12;14;Torstai;130;0;130;65;0;65
89;13.12.2012;2012;12;15;Torstai;182;0;182;71;0;71
89;13.12.2012;2012;12;16;Torstai;184;0;184;64;0;64
89;13.12.2012;2012;12;17;Torstai;123;0;123;47;0;47
89;13.12.2012;2012;12;18;Torstai;81;0;81;47;0;47
89;13.12.2012;2012;12;19;Torstai;72;0;72;60;0;60
89;13.12.2012;2012;12;20;Torstai;70;0;70;27;0;27
89;13.12.2012;2012;12;21;Torstai;50;0;50;16;0;16
89;13.12.2012;2012;12;22;Torstai;22;0;22;8;0;8
89;13.12.2012;2012;12;23;Torstai;12;0;12;7;0;7
89;14.12.2012;2012;12;00;Perjantai;11;0;11;4;0;4
89;14.12.2012;2012;12;01;Perjantai;3;0;3;1;0;1
89;14.12.2012;2012;12;02;Perjantai;4;0;4;0;0;0
89;14.12.2012;2012;12;03;Perjantai;2;0;2;6;0;6
89;14.12.2012;2012;12;04;Perjantai;7;0;7;3;0;3
89;14.12.2012;2012;12;05;Perjantai;21;0;21;5;0;5
89;14.12.2012;2012;12;06;Perjantai;70;0;70;16;0;16
89;14.12.2012;2012;12;07;Perjantai;149;1;150;47;0;47
89;14.12.2012;2012;12;08;Perjantai;137;0;137;47;0;47
89;14.12.2012;2012;12;09;Perjantai;104;0;104;49;0;49
89;14.12.2012;2012;12;10;Perjantai;82;0;82;58;0;58
89;14.12.2012;2012;12;11;Perjantai;78;0;78;70;0;70
89;14.12.2012;2012;12;12;Perjantai;100;0;100;47;0;47
89;14.12.2012;2012;12;13;Perjantai;113;0;113;52;0;52
89;14.12.2012;2012;12;14;Perjantai;136;0;136;62;0;62
89;14.12.2012;2012;12;15;Perjantai;156;0;156;67;0;67
89;14.12.2012;2012;12;16;Perjantai;126;1;127;73;0;73
89;14.12.2012;2012;12;17;Perjantai;121;0;121;57;0;57
89;14.12.2012;2012;12;18;Perjantai;75;0;75;40;0;40
89;14.12.2012;2012;12;19;Perjantai;64;0;64;47;0;47
89;14.12.2012;2012;12;20;Perjantai;48;0;48;30;0;30
89;14.12.2012;2012;12;21;Perjantai;47;0;47;23;0;23
89;14.12.2012;2012;12;22;Perjantai;24;0;24;10;0;10
89;14.12.2012;2012;12;23;Perjantai;26;0;26;14;0;14
89;15.12.2012;2012;12;00;Lauantai;16;0;16;18;0;18
89;15.12.2012;2012;12;01;Lauantai;24;0;24;11;0;11
89;15.12.2012;2012;12;02;Lauantai;13;0;13;17;0;17
89;15.12.2012;2012;12;03;Lauantai;15;0;15;15;0;15
89;15.12.2012;2012;12;04;Lauantai;9;0;9;7;0;7
89;15.12.2012;2012;12;05;Lauantai;5;0;5;1;0;1
89;15.12.2012;2012;12;06;Lauantai;9;0;9;5;0;5
89;15.12.2012;2012;12;07;Lauantai;17;0;17;11;0;11
89;15.12.2012;2012;12;08;Lauantai;35;0;35;19;0;19
89;15.12.2012;2012;12;09;Lauantai;47;0;47;51;0;51
89;15.12.2012;2012;12;10;Lauantai;72;0;72;61;0;61
89;15.12.2012;2012;12;11;Lauantai;85;0;85;53;0;53
89;15.12.2012;2012;12;12;Lauantai;77;0;77;58;0;58
89;15.12.2012;2012;12;13;Lauantai;79;0;79;94;0;94
89;15.12.2012;2012;12;14;Lauantai;87;0;87;79;0;79
89;15.12.2012;2012;12;15;Lauantai;71;0;71;54;0;54
89;15.12.2012;2012;12;16;Lauantai;70;0;70;56;0;56
89;15.12.2012;2012;12;17;Lauantai;64;0;64;45;0;45
89;15.12.2012;2012;12;18;Lauantai;52;0;52;22;0;22
89;15.12.2012;2012;12;19;Lauantai;38;0;38;29;0;29
89;15.12.2012;2012;12;20;Lauantai;55;0;55;19;0;19
89;15.12.2012;2012;12;21;Lauantai;40;0;40;16;0;16
89;15.12.2012;2012;12;22;Lauantai;29;0;29;5;0;5
89;15.12.2012;2012;12;23;Lauantai;24;0;24;7;0;7
89;16.12.2012;2012;12;00;Sunnuntai;33;0;33;7;0;7
89;16.12.2012;2012;12;01;Sunnuntai;23;0;23;8;0;8
89;16.12.2012;2012;12;02;Sunnuntai;13;0;13;16;0;16
89;16.12.2012;2012;12;03;Sunnuntai;13;0;13;11;0;11
89;16.12.2012;2012;12;04;Sunnuntai;10;0;10;7;0;7
89;16.12.2012;2012;12;05;Sunnuntai;7;0;7;1;0;1
89;16.12.2012;2012;12;06;Sunnuntai;11;0;11;2;0;2
89;16.12.2012;2012;12;07;Sunnuntai;10;0;10;6;0;6
89;16.12.2012;2012;12;08;Sunnuntai;10;0;10;35;0;35
89;16.12.2012;2012;12;09;Sunnuntai;14;0;14;34;0;34
89;16.12.2012;2012;12;10;Sunnuntai;19;0;19;47;0;47
89;16.12.2012;2012;12;11;Sunnuntai;40;0;40;86;0;86
89;16.12.2012;2012;12;12;Sunnuntai;60;0;60;74;0;74
89;16.12.2012;2012;12;13;Sunnuntai;54;0;54;84;0;84
89;16.12.2012;2012;12;14;Sunnuntai;53;0;53;66;0;66
89;16.12.2012;2012;12;15;Sunnuntai;74;0;74;60;0;60
89;16.12.2012;2012;12;16;Sunnuntai;41;0;41;51;0;51
89;16.12.2012;2012;12;17;Sunnuntai;59;0;59;54;0;54
89;16.12.2012;2012;12;18;Sunnuntai;34;0;34;40;0;40
89;16.12.2012;2012;12;19;Sunnuntai;33;0;33;27;0;27
89;16.12.2012;2012;12;20;Sunnuntai;42;0;42;33;0;33
89;16.12.2012;2012;12;21;Sunnuntai;18;0;18;10;0;10
89;16.12.2012;2012;12;22;Sunnuntai;13;0;13;3;0;3
89;16.12.2012;2012;12;23;Sunnuntai;7;0;7;2;0;2
89;17.12.2012;2012;12;00;Maanantai;6;0;6;0;0;0
89;17.12.2012;2012;12;01;Maanantai;1;0;1;0;0;0
89;17.12.2012;2012;12;02;Maanantai;3;0;3;2;0;2
89;17.12.2012;2012;12;03;Maanantai;3;0;3;0;0;0
89;17.12.2012;2012;12;04;Maanantai;4;0;4;1;0;1
89;17.12.2012;2012;12;05;Maanantai;20;0;20;5;0;5
89;17.12.2012;2012;12;06;Maanantai;61;0;61;14;0;14
89;17.12.2012;2012;12;07;Maanantai;168;12;180;55;0;55
89;17.12.2012;2012;12;08;Maanantai;128;8;136;41;3;44
89;17.12.2012;2012;12;09;Maanantai;97;14;111;38;2;40
89;17.12.2012;2012;12;10;Maanantai;57;9;66;46;2;48
89;17.12.2012;2012;12;11;Maanantai;72;16;88;51;14;65
89;17.12.2012;2012;12;12;Maanantai;84;25;109;53;12;65
89;17.12.2012;2012;12;13;Maanantai;77;22;99;50;5;55
89;17.12.2012;2012;12;14;Maanantai;111;23;134;69;12;81
89;17.12.2012;2012;12;15;Maanantai;124;33;157;60;12;72
89;17.12.2012;2012;12;16;Maanantai;141;35;176;39;14;53
89;17.12.2012;2012;12;17;Maanantai;93;26;119;44;15;59
89;17.12.2012;2012;12;18;Maanantai;63;35;98;34;22;56
89;17.12.2012;2012;12;19;Maanantai;47;16;63;32;16;48
89;17.12.2012;2012;12;20;Maanantai;54;9;63;23;6;29
89;17.12.2012;2012;12;21;Maanantai;18;11;29;10;9;19
89;17.12.2012;2012;12;22;Maanantai;9;5;14;4;5;9
89;17.12.2012;2012;12;23;Maanantai;1;1;2;1;0;1
89;18.12.2012;2012;12;00;Tiistai;2;2;4;0;0;0
89;18.12.2012;2012;12;01;Tiistai;1;0;1;2;0;2
89;18.12.2012;2012;12;02;Tiistai;0;1;1;0;1;1
89;18.12.2012;2012;12;03;Tiistai;0;3;3;4;5;9
89;18.12.2012;2012;12;04;Tiistai;3;2;5;1;0;1
89;18.12.2012;2012;12;05;Tiistai;7;10;17;2;3;5
89;18.12.2012;2012;12;06;Tiistai;16;52;68;4;12;16
89;18.12.2012;2012;12;07;Tiistai;30;118;148;8;32;40
89;18.12.2012;2012;12;08;Tiistai;30;99;129;10;37;47
89;18.12.2012;2012;12;09;Tiistai;24;76;100;14;37;51
89;18.12.2012;2012;12;10;Tiistai;20;49;69;14;32;46
89;18.12.2012;2012;12;11;Tiistai;35;51;86;22;26;48
89;18.12.2012;2012;12;12;Tiistai;34;37;71;16;27;43
89;18.12.2012;2012;12;13;Tiistai;64;38;102;25;28;53
89;18.12.2012;2012;12;14;Tiistai;62;44;106;32;26;58
89;18.12.2012;2012;12;15;Tiistai;95;44;139;29;24;53
89;18.12.2012;2012;12;16;Tiistai;119;47;166;40;25;65
89;18.12.2012;2012;12;17;Tiistai;76;51;127;29;23;52
89;18.12.2012;2012;12;18;Tiistai;55;43;98;23;19;42
89;18.12.2012;2012;12;19;Tiistai;36;21;57;38;19;57
89;18.12.2012;2012;12;20;Tiistai;56;11;67;12;13;25
89;18.12.2012;2012;12;21;Tiistai;34;14;48;7;6;13
89;18.12.2012;2012;12;22;Tiistai;10;5;15;3;0;3
89;18.12.2012;2012;12;23;Tiistai;7;2;9;3;2;5
89;19.12.2012;2012;12;00;Keskiviikko;1;0;1;1;3;4
89;19.12.2012;2012;12;01;Keskiviikko;2;2;4;1;0;1
89;19.12.2012;2012;12;02;Keskiviikko;1;0;1;2;1;3
89;19.12.2012;2012;12;03;Keskiviikko;1;1;2;0;0;0
89;19.12.2012;2012;12;04;Keskiviikko;2;2;4;0;0;0
89;19.12.2012;2012;12;05;Keskiviikko;4;14;18;2;4;6
89;19.12.2012;2012;12;06;Keskiviikko;14;28;42;4;11;15
89;19.12.2012;2012;12;07;Keskiviikko;19;83;102;4;33;37
89;19.12.2012;2012;12;08;Keskiviikko;19;111;130;10;37;47
89;19.12.2012;2012;12;09;Keskiviikko;20;66;86;6;28;34
89;19.12.2012;2012;12;10;Keskiviikko;16;43;59;15;19;34
89;19.12.2012;2012;12;11;Keskiviikko;29;53;82;11;17;28
89;19.12.2012;2012;12;12;Keskiviikko;39;31;70;21;27;48
89;19.12.2012;2012;12;13;Keskiviikko;40;47;87;16;21;37
89;19.12.2012;2012;12;14;Keskiviikko;59;42;101;33;34;67
89;19.12.2012;2012;12;15;Keskiviikko;59;45;104;30;22;52
89;19.12.2012;2012;12;16;Keskiviikko;103;42;145;37;19;56
89;19.12.2012;2012;12;17;Keskiviikko;70;33;103;31;17;48
89;19.12.2012;2012;12;18;Keskiviikko;41;23;64;19;15;34
89;19.12.2012;2012;12;19;Keskiviikko;35;14;49;12;10;22
89;19.12.2012;2012;12;20;Keskiviikko;34;9;43;19;8;27
89;19.12.2012;2012;12;21;Keskiviikko;27;8;35;8;5;13
89;19.12.2012;2012;12;22;Keskiviikko;15;5;20;6;1;7
89;19.12.2012;2012;12;23;Keskiviikko;6;8;14;2;4;6
89;20.12.2012;2012;12;00;Torstai;6;1;7;4;1;5
89;20.12.2012;2012;12;01;Torstai;1;0;1;2;0;2
89;20.12.2012;2012;12;02;Torstai;4;2;6;1;0;1
89;20.12.2012;2012;12;03;Torstai;1;4;5;0;0;0
89;20.12.2012;2012;12;04;Torstai;3;0;3;1;0;1
89;20.12.2012;2012;12;05;Torstai;3;11;14;1;2;3
89;20.12.2012;2012;12;06;Torstai;10;30;40;2;5;7
89;20.12.2012;2012;12;07;Torstai;11;66;77;3;33;36
89;20.12.2012;2012;12;08;Torstai;22;90;112;12;34;46
89;20.12.2012;2012;12;09;Torstai;12;71;83;14;34;48
89;20.12.2012;2012;12;10;Torstai;19;29;48;11;26;37
89;20.12.2012;2012;12;11;Torstai;29;42;71;16;19;35
89;20.12.2012;2012;12;12;Torstai;45;44;89;20;19;39
89;20.12.2012;2012;12;13;Torstai;38;39;77;19;24;43
89;20.12.2012;2012;12;14;Torstai;52;55;107;20;31;51
89;20.12.2012;2012;12;15;Torstai;75;48;123;31;20;51
89;20.12.2012;2012;12;16;Torstai;86;41;127;36;20;56
89;20.12.2012;2012;12;17;Torstai;59;27;86;30;10;40
89;20.12.2012;2012;12;18;Torstai;45;22;67;15;13;28
89;20.12.2012;2012;12;19;Torstai;25;19;44;13;13;26
89;20.12.2012;2012;12;20;Torstai;27;12;39;17;7;24
89;20.12.2012;2012;12;21;Torstai;31;16;47;7;3;10
89;20.12.2012;2012;12;22;Torstai;7;11;18;3;3;6
89;20.12.2012;2012;12;23;Torstai;5;3;8;1;2;3
89;21.12.2012;2012;12;00;Perjantai;10;1;11;1;0;1
89;21.12.2012;2012;12;01;Perjantai;4;0;4;0;0;0
89;21.12.2012;2012;12;02;Perjantai;1;1;2;2;0;2
89;21.12.2012;2012;12;03;Perjantai;2;1;3;0;0;0
89;21.12.2012;2012;12;04;Perjantai;5;2;7;1;1;2
89;21.12.2012;2012;12;05;Perjantai;3;12;15;0;3;3
89;21.12.2012;2012;12;06;Perjantai;9;26;35;2;7;9
89;21.12.2012;2012;12;07;Perjantai;11;50;61;2;20;22
89;21.12.2012;2012;12;08;Perjantai;22;66;88;5;37;42
89;21.12.2012;2012;12;09;Perjantai;10;44;54;6;24;30
89;21.12.2012;2012;12;10;Perjantai;18;31;49;12;30;42
89;21.12.2012;2012;12;11;Perjantai;20;38;58;21;31;52
89;21.12.2012;2012;12;12;Perjantai;26;33;59;20;32;52
89;21.12.2012;2012;12;13;Perjantai;44;38;82;29;29;58
89;21.12.2012;2012;12;14;Perjantai;57;34;91;23;18;41
89;21.12.2012;2012;12;15;Perjantai;49;33;82;28;13;41
89;21.12.2012;2012;12;16;Perjantai;51;22;73;22;10;32
89;21.12.2012;2012;12;17;Perjantai;24;22;46;16;8;24
89;21.12.2012;2012;12;18;Perjantai;26;19;45;12;15;27
89;21.12.2012;2012;12;19;Perjantai;31;11;42;12;10;22
89;21.12.2012;2012;12;20;Perjantai;16;6;22;5;3;8
89;21.12.2012;2012;12;21;Perjantai;18;11;29;5;1;6
89;21.12.2012;2012;12;22;Perjantai;14;4;18;0;4;4
89;21.12.2012;2012;12;23;Perjantai;6;6;12;3;0;3
89;22.12.2012;2012;12;00;Lauantai;8;9;17;5;2;7
89;22.12.2012;2012;12;01;Lauantai;5;1;6;1;1;2
89;22.12.2012;2012;12;02;Lauantai;3;2;5;3;2;5
89;22.12.2012;2012;12;03;Lauantai;4;2;6;7;0;7
89;22.12.2012;2012;12;04;Lauantai;3;2;5;2;2;4
89;22.12.2012;2012;12;05;Lauantai;7;2;9;1;0;1
89;22.12.2012;2012;12;06;Lauantai;3;4;7;1;3;4
89;22.12.2012;2012;12;07;Lauantai;2;6;8;0;0;0
89;22.12.2012;2012;12;08;Lauantai;5;9;14;13;14;27
89;22.12.2012;2012;12;09;Lauantai;5;13;18;1;12;13
89;22.12.2012;2012;12;10;Lauantai;4;21;25;3;15;18
89;22.12.2012;2012;12;11;Lauantai;12;20;32;14;16;30
89;22.12.2012;2012;12;12;Lauantai;15;26;41;13;19;32
89;22.12.2012;2012;12;13;Lauantai;12;23;35;18;21;39
89;22.12.2012;2012;12;14;Lauantai;18;26;44;21;23;44
89;22.12.2012;2012;12;15;Lauantai;29;16;45;8;19;27
89;22.12.2012;2012;12;16;Lauantai;21;11;32;22;11;33
89;22.12.2012;2012;12;17;Lauantai;11;13;24;8;12;20
89;22.12.2012;2012;12;18;Lauantai;19;8;27;7;7;14
89;22.12.2012;2012;12;19;Lauantai;3;3;6;6;6;12
89;22.12.2012;2012;12;20;Lauantai;7;3;10;7;10;17
89;22.12.2012;2012;12;21;Lauantai;4;8;12;4;1;5
89;22.12.2012;2012;12;22;Lauantai;3;5;8;3;2;5
89;22.12.2012;2012;12;23;Lauantai;2;3;5;1;1;2
89;23.12.2012;2012;12;00;Sunnuntai;6;3;9;2;0;2
89;23.12.2012;2012;12;01;Sunnuntai;1;0;1;3;1;4
89;23.12.2012;2012;12;02;Sunnuntai;1;0;1;0;0;0
89;23.12.2012;2012;12;03;Sunnuntai;6;0;6;3;0;3
89;23.12.2012;2012;12;04;Sunnuntai;5;0;5;3;0;3
89;23.12.2012;2012;12;05;Sunnuntai;2;1;3;2;0;2
89;23.12.2012;2012;12;06;Sunnuntai;5;0;5;0;0;0
89;23.12.2012;2012;12;07;Sunnuntai;0;2;2;0;1;1
89;23.12.2012;2012;12;08;Sunnuntai;1;0;1;1;2;3
89;23.12.2012;2012;12;09;Sunnuntai;1;8;9;3;16;19
89;23.12.2012;2012;12;10;Sunnuntai;0;4;4;13;13;26
89;23.12.2012;2012;12;11;Sunnuntai;4;13;17;16;24;40
89;23.12.2012;2012;12;12;Sunnuntai;11;9;20;43;23;66
89;23.12.2012;2012;12;13;Sunnuntai;8;20;28;13;16;29
89;23.12.2012;2012;12;14;Sunnuntai;10;13;23;15;29;44
89;23.12.2012;2012;12;15;Sunnuntai;12;13;25;15;10;25
89;23.12.2012;2012;12;16;Sunnuntai;18;9;27;15;12;27
89;23.12.2012;2012;12;17;Sunnuntai;10;8;18;8;12;20
89;23.12.2012;2012;12;18;Sunnuntai;11;7;18;14;11;25
89;23.12.2012;2012;12;19;Sunnuntai;2;2;4;2;6;8
89;23.12.2012;2012;12;20;Sunnuntai;5;7;12;9;8;17
89;23.12.2012;2012;12;21;Sunnuntai;6;2;8;3;4;7
89;23.12.2012;2012;12;22;Sunnuntai;6;0;6;5;4;9
89;23.12.2012;2012;12;23;Sunnuntai;2;0;2;3;1;4
89;24.12.2012;2012;12;00;Maanantai;1;1;2;1;0;1
89;24.12.2012;2012;12;01;Maanantai;0;0;0;1;0;1
89;24.12.2012;2012;12;02;Maanantai;1;0;1;0;0;0
89;24.12.2012;2012;12;03;Maanantai;0;0;0;0;0;0
89;24.12.2012;2012;12;04;Maanantai;0;0;0;2;2;4
89;24.12.2012;2012;12;05;Maanantai;2;0;2;1;3;4
89;24.12.2012;2012;12;06;Maanantai;5;4;9;3;3;6
89;24.12.2012;2012;12;07;Maanantai;3;5;8;1;3;4
89;24.12.2012;2012;12;08;Maanantai;3;11;14;7;14;21
89;24.12.2012;2012;12;09;Maanantai;2;18;20;4;10;14
89;24.12.2012;2012;12;10;Maanantai;9;17;26;10;16;26
89;24.12.2012;2012;12;11;Maanantai;19;5;24;16;21;37
89;24.12.2012;2012;12;12;Maanantai;10;7;17;43;14;57
89;24.12.2012;2012;12;13;Maanantai;7;15;22;17;14;31
89;24.12.2012;2012;12;14;Maanantai;5;3;8;12;7;19
89;24.12.2012;2012;12;15;Maanantai;9;4;13;7;16;23
89;24.12.2012;2012;12;16;Maanantai;5;1;6;5;1;6
89;24.12.2012;2012;12;17;Maanantai;6;1;7;8;3;11
89;24.12.2012;2012;12;18;Maanantai;1;5;6;2;9;11
89;24.12.2012;2012;12;19;Maanantai;4;1;5;5;1;6
89;24.12.2012;2012;12;20;Maanantai;1;1;2;3;3;6
89;24.12.2012;2012;12;21;Maanantai;4;5;9;4;0;4
89;24.12.2012;2012;12;22;Maanantai;4;4;8;2;9;11
89;24.12.2012;2012;12;23;Maanantai;0;2;2;3;0;3
89;25.12.2012;2012;12;00;Tiistai;2;0;2;5;1;6
89;25.12.2012;2012;12;01;Tiistai;6;2;8;2;1;3
89;25.12.2012;2012;12;02;Tiistai;2;0;2;2;1;3
89;25.12.2012;2012;12;03;Tiistai;0;0;0;0;0;0
89;25.12.2012;2012;12;04;Tiistai;1;0;1;0;1;1
89;25.12.2012;2012;12;05;Tiistai;3;2;5;0;1;1
89;25.12.2012;2012;12;06;Tiistai;2;4;6;0;4;4
89;25.12.2012;2012;12;07;Tiistai;0;0;0;1;1;2
89;25.12.2012;2012;12;08;Tiistai;1;0;1;3;4;7
89;25.12.2012;2012;12;09;Tiistai;1;2;3;2;12;14
89;25.12.2012;2012;12;10;Tiistai;0;3;3;16;11;27
89;25.12.2012;2012;12;11;Tiistai;4;5;9;17;24;41
89;25.12.2012;2012;12;12;Tiistai;5;17;22;30;19;49
89;25.12.2012;2012;12;13;Tiistai;6;13;19;43;29;72
89;25.12.2012;2012;12;14;Tiistai;4;3;7;25;30;55
89;25.12.2012;2012;12;15;Tiistai;4;3;7;20;17;37
89;25.12.2012;2012;12;16;Tiistai;4;3;7;4;10;14
89;25.12.2012;2012;12;17;Tiistai;9;5;14;9;11;20
89;25.12.2012;2012;12;18;Tiistai;5;5;10;10;4;14
89;25.12.2012;2012;12;19;Tiistai;4;5;9;10;11;21
89;25.12.2012;2012;12;20;Tiistai;2;4;6;1;5;6
89;25.12.2012;2012;12;21;Tiistai;6;3;9;2;7;9
89;25.12.2012;2012;12;22;Tiistai;1;0;1;2;5;7
89;25.12.2012;2012;12;23;Tiistai;0;10;10;1;4;5
89;26.12.2012;2012;12;00;Keskiviikko;0;3;3;3;2;5
89;26.12.2012;2012;12;01;Keskiviikko;4;0;4;2;1;3
89;26.12.2012;2012;12;02;Keskiviikko;0;1;1;1;0;1
89;26.12.2012;2012;12;03;Keskiviikko;3;1;4;3;0;3
89;26.12.2012;2012;12;04;Keskiviikko;6;1;7;7;1;8
89;26.12.2012;2012;12;05;Keskiviikko;2;1;3;2;1;3
89;26.12.2012;2012;12;06;Keskiviikko;3;3;6;4;3;7
89;26.12.2012;2012;12;07;Keskiviikko;1;3;4;4;4;8
89;26.12.2012;2012;12;08;Keskiviikko;1;1;2;3;5;8
89;26.12.2012;2012;12;09;Keskiviikko;0;3;3;8;10;18
89;26.12.2012;2012;12;10;Keskiviikko;4;4;8;18;20;38
89;26.12.2012;2012;12;11;Keskiviikko;5;7;12;19;35;54
89;26.12.2012;2012;12;12;Keskiviikko;12;10;22;38;41;79
89;26.12.2012;2012;12;13;Keskiviikko;11;7;18;33;23;56
89;26.12.2012;2012;12;14;Keskiviikko;10;9;19;22;31;53
89;26.12.2012;2012;12;15;Keskiviikko;8;11;19;26;21;47
89;26.12.2012;2012;12;16;Keskiviikko;8;14;22;18;15;33
89;26.12.2012;2012;12;17;Keskiviikko;10;8;18;17;9;26
89;26.12.2012;2012;12;18;Keskiviikko;6;14;20;17;11;28
89;26.12.2012;2012;12;19;Keskiviikko;12;14;26;9;17;26
89;26.12.2012;2012;12;20;Keskiviikko;8;6;14;12;4;16
89;26.12.2012;2012;12;21;Keskiviikko;10;8;18;3;15;18
89;26.12.2012;2012;12;22;Keskiviikko;9;7;16;3;8;11
89;26.12.2012;2012;12;23;Keskiviikko;5;12;17;3;3;6
89;27.12.2012;2012;12;00;Torstai;3;2;5;2;6;8
89;27.12.2012;2012;12;01;Torstai;3;0;3;0;1;1
89;27.12.2012;2012;12;02;Torstai;4;3;7;4;0;4
89;27.12.2012;2012;12;03;Torstai;7;1;8;3;0;3
89;27.12.2012;2012;12;04;Torstai;6;4;10;15;1;16
89;27.12.2012;2012;12;05;Torstai;9;6;15;2;0;2
89;27.12.2012;2012;12;06;Torstai;17;0;17;10;0;10
89;27.12.2012;2012;12;07;Torstai;32;0;32;32;0;32
89;27.12.2012;2012;12;08;Torstai;33;0;33;20;0;20
89;27.12.2012;2012;12;09;Torstai;35;0;35;27;0;27
89;27.12.2012;2012;12;10;Torstai;28;0;28;53;0;53
89;27.12.2012;2012;12;11;Torstai;38;0;38;49;0;49
89;27.12.2012;2012;12;12;Torstai;49;0;49;56;0;56
89;27.12.2012;2012;12;13;Torstai;51;2;53;50;0;50
89;27.12.2012;2012;12;14;Torstai;53;0;53;58;0;58
89;27.12.2012;2012;12;15;Torstai;70;1;71;57;0;57
89;27.12.2012;2012;12;16;Torstai;54;0;54;59;0;59
89;27.12.2012;2012;12;17;Torstai;46;1;47;59;0;59
89;27.12.2012;2012;12;18;Torstai;33;0;33;46;0;46
89;27.12.2012;2012;12;19;Torstai;35;0;35;57;0;57
89;27.12.2012;2012;12;20;Torstai;25;0;25;39;0;39
89;27.12.2012;2012;12;21;Torstai;27;0;27;20;0;20
89;27.12.2012;2012;12;22;Torstai;10;0;10;16;0;16
89;27.12.2012;2012;12;23;Torstai;4;0;4;6;0;6
89;28.12.2012;2012;12;00;Perjantai;8;0;8;5;0;5
89;28.12.2012;2012;12;01;Perjantai;5;0;5;5;0;5
89;28.12.2012;2012;12;02;Perjantai;6;0;6;6;0;6
89;28.12.2012;2012;12;03;Perjantai;2;0;2;8;0;8
89;28.12.2012;2012;12;04;Perjantai;8;0;8;6;0;6
89;28.12.2012;2012;12;05;Perjantai;9;0;9;4;0;4
89;28.12.2012;2012;12;06;Perjantai;20;0;20;10;0;10
89;28.12.2012;2012;12;07;Perjantai;37;3;40;19;0;19
89;28.12.2012;2012;12;08;Perjantai;37;0;37;21;0;21
89;28.12.2012;2012;12;09;Perjantai;45;1;46;32;0;32
89;28.12.2012;2012;12;10;Perjantai;52;0;52;53;0;53
89;28.12.2012;2012;12;11;Perjantai;52;0;52;76;0;76
89;28.12.2012;2012;12;12;Perjantai;69;1;70;86;0;86
89;28.12.2012;2012;12;13;Perjantai;66;0;66;63;0;63
89;28.12.2012;2012;12;14;Perjantai;77;0;77;56;0;56
89;28.12.2012;2012;12;15;Perjantai;77;1;78;55;0;55
89;28.12.2012;2012;12;16;Perjantai;77;0;77;66;0;66
89;28.12.2012;2012;12;17;Perjantai;56;0;56;48;0;48
89;28.12.2012;2012;12;18;Perjantai;42;0;42;51;0;51
89;28.12.2012;2012;12;19;Perjantai;38;0;38;35;0;35
89;28.12.2012;2012;12;20;Perjantai;39;0;39;29;0;29
89;28.12.2012;2012;12;21;Perjantai;28;0;28;26;0;26
89;28.12.2012;2012;12;22;Perjantai;22;0;22;12;0;12
89;28.12.2012;2012;12;23;Perjantai;20;0;20;7;0;7
89;29.12.2012;2012;12;00;Lauantai;12;0;12;10;0;10
89;29.12.2012;2012;12;01;Lauantai;14;0;14;5;0;5
89;29.12.2012;2012;12;02;Lauantai;10;0;10;4;0;4
89;29.12.2012;2012;12;03;Lauantai;2;0;2;8;0;8
89;29.12.2012;2012;12;04;Lauantai;9;0;9;7;0;7
89;29.12.2012;2012;12;05;Lauantai;4;0;4;0;0;0
89;29.12.2012;2012;12;06;Lauantai;13;0;13;4;0;4
89;29.12.2012;2012;12;07;Lauantai;11;0;11;9;0;9
89;29.12.2012;2012;12;08;Lauantai;13;0;13;9;0;9
89;29.12.2012;2012;12;09;Lauantai;21;0;21;27;0;27
89;29.12.2012;2012;12;10;Lauantai;31;0;31;51;0;51
89;29.12.2012;2012;12;11;Lauantai;44;0;44;54;0;54
89;29.12.2012;2012;12;12;Lauantai;64;0;64;79;0;79
89;29.12.2012;2012;12;13;Lauantai;53;0;53;83;0;83
89;29.12.2012;2012;12;14;Lauantai;56;0;56;58;0;58
89;29.12.2012;2012;12;15;Lauantai;39;0;39;67;0;67
89;29.12.2012;2012;12;16;Lauantai;40;0;40;52;0;52
89;29.12.2012;2012;12;17;Lauantai;37;0;37;37;0;37
89;29.12.2012;2012;12;18;Lauantai;33;0;33;31;0;31
89;29.12.2012;2012;12;19;Lauantai;36;0;36;33;0;33
89;29.12.2012;2012;12;20;Lauantai;30;0;30;22;0;22
89;29.12.2012;2012;12;21;Lauantai;18;0;18;16;0;16
89;29.12.2012;2012;12;22;Lauantai;12;0;12;12;0;12
89;29.12.2012;2012;12;23;Lauantai;20;0;20;7;0;7
89;30.12.2012;2012;12;00;Sunnuntai;15;0;15;8;0;8
89;30.12.2012;2012;12;01;Sunnuntai;7;0;7;8;0;8
89;30.12.2012;2012;12;02;Sunnuntai;4;0;4;6;0;6
89;30.12.2012;2012;12;03;Sunnuntai;16;0;16;6;0;6
89;30.12.2012;2012;12;04;Sunnuntai;9;0;9;2;0;2
89;30.12.2012;2012;12;05;Sunnuntai;7;1;8;0;0;0
89;30.12.2012;2012;12;06;Sunnuntai;4;2;6;3;0;3
89;30.12.2012;2012;12;07;Sunnuntai;2;0;2;0;0;0
89;30.12.2012;2012;12;08;Sunnuntai;5;0;5;1;0;1
89;30.12.2012;2012;12;09;Sunnuntai;4;0;4;9;0;9
89;30.12.2012;2012;12;10;Sunnuntai;17;4;21;10;0;10
89;30.12.2012;2012;12;11;Sunnuntai;24;8;32;16;0;16
89;30.12.2012;2012;12;12;Sunnuntai;38;12;50;29;0;29
89;30.12.2012;2012;12;13;Sunnuntai;40;9;49;29;0;29
89;30.12.2012;2012;12;14;Sunnuntai;44;11;55;31;0;31
89;30.12.2012;2012;12;15;Sunnuntai;37;5;42;35;0;35
89;30.12.2012;2012;12;16;Sunnuntai;33;4;37;28;0;28
89;30.12.2012;2012;12;17;Sunnuntai;27;5;32;28;0;28
89;30.12.2012;2012;12;18;Sunnuntai;26;4;30;27;0;27
89;30.12.2012;2012;12;19;Sunnuntai;25;2;27;28;0;28
89;30.12.2012;2012;12;20;Sunnuntai;20;2;22;20;0;20
89;30.12.2012;2012;12;21;Sunnuntai;13;2;15;10;0;10
89;30.12.2012;2012;12;22;Sunnuntai;5;0;5;6;0;6
89;30.12.2012;2012;12;23;Sunnuntai;7;0;7;4;0;4
89;31.12.2012;2012;12;00;Maanantai;5;0;5;4;0;4
89;31.12.2012;2012;12;01;Maanantai;3;0;3;4;0;4
89;31.12.2012;2012;12;02;Maanantai;3;0;3;3;0;3
89;31.12.2012;2012;12;03;Maanantai;1;0;1;6;0;6
89;31.12.2012;2012;12;04;Maanantai;5;0;5;1;0;1
89;31.12.2012;2012;12;05;Maanantai;10;0;10;3;0;3
89;31.12.2012;2012;12;06;Maanantai;19;2;21;6;0;6
89;31.12.2012;2012;12;07;Maanantai;31;4;35;17;0;17
89;31.12.2012;2012;12;08;Maanantai;40;5;45;15;0;15
89;31.12.2012;2012;12;09;Maanantai;32;1;33;26;0;26
89;31.12.2012;2012;12;10;Maanantai;38;5;43;35;0;35
89;31.12.2012;2012;12;11;Maanantai;34;3;37;43;0;43
89;31.12.2012;2012;12;12;Maanantai;58;6;64;54;0;54
89;31.12.2012;2012;12;13;Maanantai;51;3;54;54;0;54
89;31.12.2012;2012;12;14;Maanantai;66;3;69;51;0;51
89;31.12.2012;2012;12;15;Maanantai;61;2;63;41;0;41
89;31.12.2012;2012;12;16;Maanantai;68;0;68;51;0;51
89;31.12.2012;2012;12;17;Maanantai;49;1;50;28;0;28
89;31.12.2012;2012;12;18;Maanantai;38;1;39;36;0;36
89;31.12.2012;2012;12;19;Maanantai;39;1;40;39;0;39
89;31.12.2012;2012;12;20;Maanantai;35;0;35;37;0;37
89;31.12.2012;2012;12;21;Maanantai;43;1;44;70;0;70
89;31.12.2012;2012;12;22;Maanantai;16;0;16;24;0;24
89;31.12.2012;2012;12;23;Maanantai;25;0;25;26;0;26
89;01.01.2013;2013;01;00;Tiistai;22;0;22;54;0;54
89;01.01.2013;2013;01;01;Tiistai;31;0;31;31;0;31
89;01.01.2013;2013;01;02;Tiistai;32;0;32;16;0;16
89;01.01.2013;2013;01;03;Tiistai;15;0;15;22;0;22
89;01.01.2013;2013;01;04;Tiistai;17;0;17;38;0;38
89;01.01.2013;2013;01;05;Tiistai;14;0;14;12;0;12
89;01.01.2013;2013;01;06;Tiistai;9;0;9;4;0;4
89;01.01.2013;2013;01;07;Tiistai;13;0;13;9;0;9
89;01.01.2013;2013;01;08;Tiistai;5;0;5;10;0;10
89;01.01.2013;2013;01;09;Tiistai;7;3;10;6;5;11
89;01.01.2013;2013;01;10;Tiistai;8;4;12;12;20;32
89;01.01.2013;2013;01;11;Tiistai;7;4;11;18;23;41
89;01.01.2013;2013;01;12;Tiistai;9;8;17;23;24;47
89;01.01.2013;2013;01;13;Tiistai;11;10;21;33;26;59
89;01.01.2013;2013;01;14;Tiistai;19;10;29;30;26;56
89;01.01.2013;2013;01;15;Tiistai;17;16;33;31;35;66
89;01.01.2013;2013;01;16;Tiistai;12;6;18;19;28;47
89;01.01.2013;2013;01;17;Tiistai;15;13;28;17;25;42
89;01.01.2013;2013;01;18;Tiistai;11;7;18;29;23;52
89;01.01.2013;2013;01;19;Tiistai;9;10;19;33;21;54
89;01.01.2013;2013;01;20;Tiistai;15;7;22;28;15;43
89;01.01.2013;2013;01;21;Tiistai;10;3;13;6;3;9
89;01.01.2013;2013;01;22;Tiistai;4;4;8;6;2;8
89;01.01.2013;2013;01;23;Tiistai;8;2;10;3;3;6
89;02.01.2013;2013;01;00;Keskiviikko;1;0;1;2;2;4
89;02.01.2013;2013;01;01;Keskiviikko;0;1;1;1;1;2
89;02.01.2013;2013;01;02;Keskiviikko;1;2;3;0;1;1
89;02.01.2013;2013;01;03;Keskiviikko;3;2;5;4;2;6
89;02.01.2013;2013;01;04;Keskiviikko;3;2;5;0;2;2
89;02.01.2013;2013;01;05;Keskiviikko;5;9;14;2;0;2
89;02.01.2013;2013;01;06;Keskiviikko;10;22;32;1;7;8
89;02.01.2013;2013;01;07;Keskiviikko;23;62;85;3;26;29
89;02.01.2013;2013;01;08;Keskiviikko;16;87;103;13;27;40
89;02.01.2013;2013;01;09;Keskiviikko;19;57;76;5;28;33
89;02.01.2013;2013;01;10;Keskiviikko;12;25;37;15;26;41
89;02.01.2013;2013;01;11;Keskiviikko;20;30;50;20;20;40
89;02.01.2013;2013;01;12;Keskiviikko;27;35;62;20;34;54
89;02.01.2013;2013;01;13;Keskiviikko;41;39;80;20;39;59
89;02.01.2013;2013;01;14;Keskiviikko;69;34;103;37;33;70
89;02.01.2013;2013;01;15;Keskiviikko;63;34;97;29;14;43
89;02.01.2013;2013;01;16;Keskiviikko;97;33;130;37;19;56
89;02.01.2013;2013;01;17;Keskiviikko;48;27;75;33;18;51
89;02.01.2013;2013;01;18;Keskiviikko;31;26;57;12;27;39
89;02.01.2013;2013;01;19;Keskiviikko;26;12;38;23;22;45
89;02.01.2013;2013;01;20;Keskiviikko;32;6;38;28;12;40
89;02.01.2013;2013;01;21;Keskiviikko;16;13;29;15;10;25
89;02.01.2013;2013;01;22;Keskiviikko;10;3;13;6;6;12
89;02.01.2013;2013;01;23;Keskiviikko;6;3;9;2;1;3
89;03.01.2013;2013;01;00;Torstai;3;0;3;2;0;2
89;03.01.2013;2013;01;01;Torstai;0;0;0;1;0;1
89;03.01.2013;2013;01;02;Torstai;2;0;2;2;0;2
89;03.01.2013;2013;01;03;Torstai;0;0;0;0;0;0
89;03.01.2013;2013;01;04;Torstai;1;7;8;2;1;3
89;03.01.2013;2013;01;05;Torstai;11;12;23;7;1;8
89;03.01.2013;2013;01;06;Torstai;9;27;36;3;4;7
89;03.01.2013;2013;01;07;Torstai;13;73;86;7;41;48
89;03.01.2013;2013;01;08;Torstai;18;87;105;10;37;47
89;03.01.2013;2013;01;09;Torstai;19;54;73;12;33;45
89;03.01.2013;2013;01;10;Torstai;14;40;54;14;26;40
89;03.01.2013;2013;01;11;Torstai;15;41;56;32;35;67
89;03.01.2013;2013;01;12;Torstai;31;35;66;27;41;68
89;03.01.2013;2013;01;13;Torstai;41;30;71;33;34;67
89;03.01.2013;2013;01;14;Torstai;54;40;94;28;41;69
89;03.01.2013;2013;01;15;Torstai;85;37;122;47;43;90
89;03.01.2013;2013;01;16;Torstai;96;32;128;71;23;94
89;03.01.2013;2013;01;17;Torstai;58;37;95;45;23;68
89;03.01.2013;2013;01;18;Torstai;32;21;53;41;38;79
89;03.01.2013;2013;01;19;Torstai;45;19;64;30;33;63
89;03.01.2013;2013;01;20;Torstai;28;7;35;33;19;52
89;03.01.2013;2013;01;21;Torstai;19;6;25;12;12;24
89;03.01.2013;2013;01;22;Torstai;15;10;25;7;3;10
89;03.01.2013;2013;01;23;Torstai;6;4;10;2;2;4
89;04.01.2013;2013;01;00;Perjantai;2;1;3;4;1;5
89;04.01.2013;2013;01;01;Perjantai;0;0;0;0;0;0
89;04.01.2013;2013;01;02;Perjantai;1;0;1;1;0;1
89;04.01.2013;2013;01;03;Perjantai;1;1;2;2;0;2
89;04.01.2013;2013;01;04;Perjantai;3;4;7;0;0;0
89;04.01.2013;2013;01;05;Perjantai;2;9;11;3;0;3
89;04.01.2013;2013;01;06;Perjantai;7;29;36;4;5;9
89;04.01.2013;2013;01;07;Perjantai;16;79;95;4;28;32
89;04.01.2013;2013;01;08;Perjantai;22;94;116;9;36;45
89;04.01.2013;2013;01;09;Perjantai;22;45;67;15;28;43
89;04.01.2013;2013;01;10;Perjantai;18;30;48;22;34;56
89;04.01.2013;2013;01;11;Perjantai;26;36;62;36;48;84
89;04.01.2013;2013;01;12;Perjantai;39;51;90;32;46;78
89;04.01.2013;2013;01;13;Perjantai;46;38;84;18;43;61
89;04.01.2013;2013;01;14;Perjantai;68;56;124;41;31;72
89;04.01.2013;2013;01;15;Perjantai;86;34;120;31;22;53
89;04.01.2013;2013;01;16;Perjantai;91;39;130;45;24;69
89;04.01.2013;2013;01;17;Perjantai;49;42;91;24;18;42
89;04.01.2013;2013;01;18;Perjantai;44;26;70;37;15;52
89;04.01.2013;2013;01;19;Perjantai;29;20;49;18;19;37
89;04.01.2013;2013;01;20;Perjantai;33;17;50;10;5;15
89;04.01.2013;2013;01;21;Perjantai;26;10;36;9;3;12
89;04.01.2013;2013;01;22;Perjantai;12;13;25;5;11;16
89;04.01.2013;2013;01;23;Perjantai;7;6;13;4;8;12
89;05.01.2013;2013;01;00;Lauantai;4;4;8;5;3;8
89;05.01.2013;2013;01;01;Lauantai;9;4;13;3;4;7
89;05.01.2013;2013;01;02;Lauantai;5;0;5;6;1;7
89;05.01.2013;2013;01;03;Lauantai;11;2;13;5;0;5
89;05.01.2013;2013;01;04;Lauantai;7;2;9;4;1;5
89;05.01.2013;2013;01;05;Lauantai;6;2;8;0;1;1
89;05.01.2013;2013;01;06;Lauantai;2;9;11;0;1;1
89;05.01.2013;2013;01;07;Lauantai;0;7;7;2;3;5
89;05.01.2013;2013;01;08;Lauantai;2;10;12;8;13;21
89;05.01.2013;2013;01;09;Lauantai;10;17;27;11;17;28
89;05.01.2013;2013;01;10;Lauantai;10;27;37;11;22;33
89;05.01.2013;2013;01;11;Lauantai;20;31;51;26;40;66
89;05.01.2013;2013;01;12;Lauantai;26;39;65;44;56;100
89;05.01.2013;2013;01;13;Lauantai;21;35;56;38;59;97
89;05.01.2013;2013;01;14;Lauantai;42;37;79;51;52;103
89;05.01.2013;2013;01;15;Lauantai;34;29;63;32;24;56
89;05.01.2013;2013;01;16;Lauantai;33;13;46;29;19;48
89;05.01.2013;2013;01;17;Lauantai;28;14;42;26;20;46
89;05.01.2013;2013;01;18;Lauantai;24;10;34;31;18;49
89;05.01.2013;2013;01;19;Lauantai;18;17;35;21;20;41
89;05.01.2013;2013;01;20;Lauantai;20;11;31;9;8;17
89;05.01.2013;2013;01;21;Lauantai;14;13;27;9;6;15
89;05.01.2013;2013;01;22;Lauantai;5;4;9;12;7;19
89;05.01.2013;2013;01;23;Lauantai;3;6;9;7;4;11
89;06.01.2013;2013;01;00;Sunnuntai;11;4;15;6;8;14
89;06.01.2013;2013;01;01;Sunnuntai;6;6;12;4;6;10
89;06.01.2013;2013;01;02;Sunnuntai;3;1;4;3;3;6
89;06.01.2013;2013;01;03;Sunnuntai;8;3;11;5;1;6
89;06.01.2013;2013;01;04;Sunnuntai;11;1;12;5;1;6
89;06.01.2013;2013;01;05;Sunnuntai;1;1;2;3;0;3
89;06.01.2013;2013;01;06;Sunnuntai;1;2;3;2;2;4
89;06.01.2013;2013;01;07;Sunnuntai;2;2;4;1;0;1
89;06.01.2013;2013;01;08;Sunnuntai;3;12;15;5;6;11
89;06.01.2013;2013;01;09;Sunnuntai;6;4;10;9;10;19
89;06.01.2013;2013;01;10;Sunnuntai;3;13;16;21;17;38
89;06.01.2013;2013;01;11;Sunnuntai;5;14;19;26;32;58
89;06.01.2013;2013;01;12;Sunnuntai;13;15;28;43;41;84
89;06.01.2013;2013;01;13;Sunnuntai;24;20;44;62;51;113
89;06.01.2013;2013;01;14;Sunnuntai;18;23;41;50;46;96
89;06.01.2013;2013;01;15;Sunnuntai;14;13;27;37;32;69
89;06.01.2013;2013;01;16;Sunnuntai;18;33;51;31;28;59
89;06.01.2013;2013;01;17;Sunnuntai;20;21;41;26;30;56
89;06.01.2013;2013;01;18;Sunnuntai;17;19;36;32;37;69
89;06.01.2013;2013;01;19;Sunnuntai;16;9;25;30;22;52
89;06.01.2013;2013;01;20;Sunnuntai;18;12;30;19;10;29
89;06.01.2013;2013;01;21;Sunnuntai;6;7;13;9;10;19
89;06.01.2013;2013;01;22;Sunnuntai;8;9;17;4;2;6
89;06.01.2013;2013;01;23;Sunnuntai;7;2;9;2;2;4
89;07.01.2013;2013;01;00;Maanantai;2;3;5;1;0;1
89;07.01.2013;2013;01;01;Maanantai;0;0;0;0;0;0
89;07.01.2013;2013;01;02;Maanantai;1;1;2;1;0;1
89;07.01.2013;2013;01;03;Maanantai;2;3;5;2;0;2
89;07.01.2013;2013;01;04;Maanantai;2;1;3;0;1;1
89;07.01.2013;2013;01;05;Maanantai;2;13;15;2;2;4
89;07.01.2013;2013;01;06;Maanantai;13;33;46;5;6;11
89;07.01.2013;2013;01;07;Maanantai;29;121;150;10;42;52
89;07.01.2013;2013;01;08;Maanantai;35;134;169;11;35;46
89;07.01.2013;2013;01;09;Maanantai;17;66;83;18;30;48
89;07.01.2013;2013;01;10;Maanantai;20;49;69;12;38;50
89;07.01.2013;2013;01;11;Maanantai;30;38;68;20;28;48
89;07.01.2013;2013;01;12;Maanantai;26;45;71;27;25;52
89;07.01.2013;2013;01;13;Maanantai;53;27;80;37;45;82
89;07.01.2013;2013;01;14;Maanantai;72;48;120;54;30;84
89;07.01.2013;2013;01;15;Maanantai;107;53;160;41;36;77
89;07.01.2013;2013;01;16;Maanantai;135;61;196;54;23;77
89;07.01.2013;2013;01;17;Maanantai;65;47;112;38;25;63
89;07.01.2013;2013;01;18;Maanantai;53;31;84;36;37;73
89;07.01.2013;2013;01;19;Maanantai;59;18;77;48;28;76
89;07.01.2013;2013;01;20;Maanantai;39;18;57;22;26;48
89;07.01.2013;2013;01;21;Maanantai;18;14;32;17;10;27
89;07.01.2013;2013;01;22;Maanantai;11;2;13;6;3;9
89;07.01.2013;2013;01;23;Maanantai;8;1;9;0;4;4
89;08.01.2013;2013;01;00;Tiistai;3;0;3;0;0;0
89;08.01.2013;2013;01;01;Tiistai;0;2;2;2;0;2
89;08.01.2013;2013;01;02;Tiistai;0;0;0;1;1;2
89;08.01.2013;2013;01;03;Tiistai;0;3;3;1;0;1
89;08.01.2013;2013;01;04;Tiistai;0;4;4;3;1;4
89;08.01.2013;2013;01;05;Tiistai;6;13;19;3;1;4
89;08.01.2013;2013;01;06;Tiistai;16;35;51;3;9;12
89;08.01.2013;2013;01;07;Tiistai;35;113;148;11;41;52
89;08.01.2013;2013;01;08;Tiistai;34;144;178;20;35;55
89;08.01.2013;2013;01;09;Tiistai;21;69;90;20;35;55
89;08.01.2013;2013;01;10;Tiistai;26;59;85;23;39;62
89;08.01.2013;2013;01;11;Tiistai;38;44;82;24;47;71
89;08.01.2013;2013;01;12;Tiistai;28;42;70;20;42;62
89;08.01.2013;2013;01;13;Tiistai;53;52;105;40;44;84
89;08.01.2013;2013;01;14;Tiistai;58;53;111;40;30;70
89;08.01.2013;2013;01;15;Tiistai;122;52;174;46;26;72
89;08.01.2013;2013;01;16;Tiistai;140;66;206;62;29;91
89;08.01.2013;2013;01;17;Tiistai;89;46;135;34;25;59
89;08.01.2013;2013;01;18;Tiistai;57;29;86;36;35;71
89;08.01.2013;2013;01;19;Tiistai;53;24;77;27;30;57
89;08.01.2013;2013;01;20;Tiistai;46;22;68;31;27;58
89;08.01.2013;2013;01;21;Tiistai;25;14;39;15;12;27
89;08.01.2013;2013;01;22;Tiistai;14;3;17;10;2;12
89;08.01.2013;2013;01;23;Tiistai;3;1;4;4;3;7
89;09.01.2013;2013;01;00;Keskiviikko;3;1;4;2;2;4
89;09.01.2013;2013;01;01;Keskiviikko;1;1;2;1;0;1
89;09.01.2013;2013;01;02;Keskiviikko;1;0;1;2;0;2
89;09.01.2013;2013;01;03;Keskiviikko;0;0;0;0;0;0
89;09.01.2013;2013;01;04;Keskiviikko;0;8;8;0;1;1
89;09.01.2013;2013;01;05;Keskiviikko;4;13;17;2;1;3
89;09.01.2013;2013;01;06;Keskiviikko;15;34;49;4;10;14
89;09.01.2013;2013;01;07;Keskiviikko;29;106;135;15;36;51
89;09.01.2013;2013;01;08;Keskiviikko;38;137;175;12;56;68
89;09.01.2013;2013;01;09;Keskiviikko;28;75;103;12;31;43
89;09.01.2013;2013;01;10;Keskiviikko;27;41;68;25;26;51
89;09.01.2013;2013;01;11;Keskiviikko;34;47;81;27;37;64
89;09.01.2013;2013;01;12;Keskiviikko;48;49;97;27;28;55
89;09.01.2013;2013;01;13;Keskiviikko;56;51;107;32;32;64
89;09.01.2013;2013;01;14;Keskiviikko;79;52;131;41;33;74
89;09.01.2013;2013;01;15;Keskiviikko;108;54;162;37;25;62
89;09.01.2013;2013;01;16;Keskiviikko;135;46;181;53;18;71
89;09.01.2013;2013;01;17;Keskiviikko;84;47;131;45;30;75
89;09.01.2013;2013;01;18;Keskiviikko;52;26;78;44;23;67
89;09.01.2013;2013;01;19;Keskiviikko;33;25;58;35;34;69
89;09.01.2013;2013;01;20;Keskiviikko;40;23;63;27;32;59
89;09.01.2013;2013;01;21;Keskiviikko;28;9;37;8;8;16
89;09.01.2013;2013;01;22;Keskiviikko;10;4;14;11;2;13
89;09.01.2013;2013;01;23;Keskiviikko;8;4;12;0;0;0
89;10.01.2013;2013;01;00;Torstai;5;2;7;0;2;2
89;10.01.2013;2013;01;01;Torstai;3;0;3;1;1;2
89;10.01.2013;2013;01;02;Torstai;0;0;0;2;0;2
89;10.01.2013;2013;01;03;Torstai;1;3;4;6;0;6
89;10.01.2013;2013;01;04;Torstai;2;6;8;0;0;0
89;10.01.2013;2013;01;05;Torstai;2;5;7;1;2;3
89;10.01.2013;2013;01;06;Torstai;17;37;54;5;8;13
89;10.01.2013;2013;01;07;Torstai;29;98;127;6;33;39
89;10.01.2013;2013;01;08;Torstai;38;136;174;9;46;55
89;10.01.2013;2013;01;09;Torstai;23;81;104;13;37;50
89;10.01.2013;2013;01;10;Torstai;30;51;81;27;64;91
89;10.01.2013;2013;01;11;Torstai;25;38;63;19;38;57
89;10.01.2013;2013;01;12;Torstai;36;51;87;32;37;69
89;10.01.2013;2013;01;13;Torstai;51;52;103;36;39;75
89;10.01.2013;2013;01;14;Torstai;65;40;105;32;40;72
89;10.01.2013;2013;01;15;Torstai;96;55;151;35;28;63
89;10.01.2013;2013;01;16;Torstai;116;51;167;47;22;69
89;10.01.2013;2013;01;17;Torstai;97;40;137;50;27;77
89;10.01.2013;2013;01;18;Torstai;51;37;88;35;36;71
89;10.01.2013;2013;01;19;Torstai;44;30;74;32;28;60
89;10.01.2013;2013;01;20;Torstai;38;13;51;29;17;46
89;10.01.2013;2013;01;21;Torstai;30;8;38;21;8;29
89;10.01.2013;2013;01;22;Torstai;22;8;30;8;5;13
89;10.01.2013;2013;01;23;Torstai;4;3;7;0;2;2
89;11.01.2013;2013;01;00;Perjantai;0;0;0;2;3;5
89;11.01.2013;2013;01;01;Perjantai;0;1;1;0;0;0
89;11.01.2013;2013;01;02;Perjantai;5;0;5;4;0;4
89;11.01.2013;2013;01;03;Perjantai;1;1;2;0;1;1
89;11.01.2013;2013;01;04;Perjantai;1;3;4;1;1;2
89;11.01.2013;2013;01;05;Perjantai;4;10;14;1;3;4
89;11.01.2013;2013;01;06;Perjantai;12;31;43;3;6;9
89;11.01.2013;2013;01;07;Perjantai;26;113;139;5;37;42
89;11.01.2013;2013;01;08;Perjantai;25;99;124;9;33;42
89;11.01.2013;2013;01;09;Perjantai;27;54;81;15;20;35
89;11.01.2013;2013;01;10;Perjantai;20;45;65;19;30;49
89;11.01.2013;2013;01;11;Perjantai;25;46;71;16;28;44
89;11.01.2013;2013;01;12;Perjantai;31;50;81;30;36;66
89;11.01.2013;2013;01;13;Perjantai;62;48;110;38;28;66
89;11.01.2013;2013;01;14;Perjantai;64;42;106;34;30;64
89;11.01.2013;2013;01;15;Perjantai;106;43;149;37;21;58
89;11.01.2013;2013;01;16;Perjantai;110;39;149;39;20;59
89;11.01.2013;2013;01;17;Perjantai;67;41;108;22;20;42
89;11.01.2013;2013;01;18;Perjantai;35;29;64;22;18;40
89;11.01.2013;2013;01;19;Perjantai;37;19;56;24;20;44
89;11.01.2013;2013;01;20;Perjantai;39;16;55;16;9;25
89;11.01.2013;2013;01;21;Perjantai;22;10;32;7;11;18
89;11.01.2013;2013;01;22;Perjantai;12;15;27;2;9;11
89;11.01.2013;2013;01;23;Perjantai;17;8;25;6;2;8
89;12.01.2013;2013;01;00;Lauantai;4;7;11;4;4;8
89;12.01.2013;2013;01;01;Lauantai;4;4;8;5;2;7
89;12.01.2013;2013;01;02;Lauantai;8;2;10;8;2;10
89;12.01.2013;2013;01;03;Lauantai;8;2;10;5;0;5
89;12.01.2013;2013;01;04;Lauantai;7;4;11;10;1;11
89;12.01.2013;2013;01;05;Lauantai;5;2;7;2;2;4
89;12.01.2013;2013;01;06;Lauantai;3;3;6;2;3;5
89;12.01.2013;2013;01;07;Lauantai;2;10;12;9;2;11
89;12.01.2013;2013;01;08;Lauantai;5;16;21;8;10;18
89;12.01.2013;2013;01;09;Lauantai;10;23;33;18;22;40
89;12.01.2013;2013;01;10;Lauantai;10;47;57;20;33;53
89;12.01.2013;2013;01;11;Lauantai;22;43;65;40;45;85
89;12.01.2013;2013;01;12;Lauantai;45;54;99;44;72;116
89;12.01.2013;2013;01;13;Lauantai;58;42;100;65;67;132
89;12.01.2013;2013;01;14;Lauantai;40;43;83;60;54;114
89;12.01.2013;2013;01;15;Lauantai;49;33;82;48;46;94
89;12.01.2013;2013;01;16;Lauantai;35;28;63;28;20;48
89;12.01.2013;2013;01;17;Lauantai;31;21;52;28;19;47
89;12.01.2013;2013;01;18;Lauantai;28;21;49;19;25;44
89;12.01.2013;2013;01;19;Lauantai;18;19;37;27;18;45
89;12.01.2013;2013;01;20;Lauantai;18;18;36;12;13;25
89;12.01.2013;2013;01;21;Lauantai;18;15;33;10;9;19
89;12.01.2013;2013;01;22;Lauantai;8;11;19;2;8;10
89;12.01.2013;2013;01;23;Lauantai;16;20;36;2;3;5
89;13.01.2013;2013;01;00;Sunnuntai;9;12;21;6;3;9
89;13.01.2013;2013;01;01;Sunnuntai;12;4;16;8;1;9
89;13.01.2013;2013;01;02;Sunnuntai;3;0;3;6;2;8
89;13.01.2013;2013;01;03;Sunnuntai;20;0;20;3;0;3
89;13.01.2013;2013;01;04;Sunnuntai;8;2;10;5;0;5
89;13.01.2013;2013;01;05;Sunnuntai;2;1;3;0;1;1
89;13.01.2013;2013;01;06;Sunnuntai;4;3;7;2;1;3
89;13.01.2013;2013;01;07;Sunnuntai;0;3;3;5;4;9
89;13.01.2013;2013;01;08;Sunnuntai;3;6;9;7;6;13
89;13.01.2013;2013;01;09;Sunnuntai;5;6;11;20;19;39
89;13.01.2013;2013;01;10;Sunnuntai;8;15;23;33;34;67
89;13.01.2013;2013;01;11;Sunnuntai;14;15;29;29;42;71
89;13.01.2013;2013;01;12;Sunnuntai;13;39;52;50;51;101
89;13.01.2013;2013;01;13;Sunnuntai;32;37;69;48;61;109
89;13.01.2013;2013;01;14;Sunnuntai;24;40;64;51;62;113
89;13.01.2013;2013;01;15;Sunnuntai;33;31;64;55;46;101
89;13.01.2013;2013;01;16;Sunnuntai;30;17;47;32;31;63
89;13.01.2013;2013;01;17;Sunnuntai;22;26;48;32;20;52
89;13.01.2013;2013;01;18;Sunnuntai;23;19;42;27;27;54
89;13.01.2013;2013;01;19;Sunnuntai;20;17;37;40;27;67
89;13.01.2013;2013;01;20;Sunnuntai;16;13;29;25;18;43
89;13.01.2013;2013;01;21;Sunnuntai;12;7;19;8;10;18
89;13.01.2013;2013;01;22;Sunnuntai;5;2;7;3;4;7
89;13.01.2013;2013;01;23;Sunnuntai;6;2;8;5;3;8
89;14.01.2013;2013;01;00;Maanantai;5;0;5;2;2;4
89;14.01.2013;2013;01;01;Maanantai;0;0;0;1;1;2
89;14.01.2013;2013;01;02;Maanantai;2;1;3;0;1;1
89;14.01.2013;2013;01;03;Maanantai;2;2;4;1;0;1
89;14.01.2013;2013;01;04;Maanantai;0;2;2;1;1;2
89;14.01.2013;2013;01;05;Maanantai;4;11;15;2;3;5
89;14.01.2013;2013;01;06;Maanantai;13;39;52;4;7;11
89;14.01.2013;2013;01;07;Maanantai;35;115;150;15;33;48
89;14.01.2013;2013;01;08;Maanantai;35;138;173;11;51;62
89;14.01.2013;2013;01;09;Maanantai;25;71;96;18;40;58
89;14.01.2013;2013;01;10;Maanantai;27;54;81;25;47;72
89;14.01.2013;2013;01;11;Maanantai;32;44;76;19;36;55
89;14.01.2013;2013;01;12;Maanantai;41;67;108;22;34;56
89;14.01.2013;2013;01;13;Maanantai;45;57;102;26;49;75
89;14.01.2013;2013;01;14;Maanantai;78;39;117;49;28;77
89;14.01.2013;2013;01;15;Maanantai;114;42;156;42;27;69
89;14.01.2013;2013;01;16;Maanantai;133;50;183;63;26;89
89;14.01.2013;2013;01;17;Maanantai;80;53;133;45;22;67
89;14.01.2013;2013;01;18;Maanantai;52;42;94;47;37;84
89;14.01.2013;2013;01;19;Maanantai;57;29;86;37;39;76
89;14.01.2013;2013;01;20;Maanantai;48;25;73;20;20;40
89;14.01.2013;2013;01;21;Maanantai;29;14;43;17;6;23
89;14.01.2013;2013;01;22;Maanantai;8;3;11;5;3;8
89;14.01.2013;2013;01;23;Maanantai;10;0;10;1;2;3
89;15.01.2013;2013;01;00;Tiistai;1;0;1;3;2;5
89;15.01.2013;2013;01;01;Tiistai;1;0;1;2;0;2
89;15.01.2013;2013;01;02;Tiistai;1;2;3;1;0;1
89;15.01.2013;2013;01;03;Tiistai;2;3;5;0;0;0
89;15.01.2013;2013;01;04;Tiistai;2;5;7;2;1;3
89;15.01.2013;2013;01;05;Tiistai;3;11;14;2;2;4
89;15.01.2013;2013;01;06;Tiistai;17;32;49;7;8;15
89;15.01.2013;2013;01;07;Tiistai;37;114;151;8;43;51
89;15.01.2013;2013;01;08;Tiistai;38;135;173;7;45;52
89;15.01.2013;2013;01;09;Tiistai;28;80;108;11;42;53
89;15.01.2013;2013;01;10;Tiistai;32;53;85;16;35;51
89;15.01.2013;2013;01;11;Tiistai;24;41;65;28;25;53
89;15.01.2013;2013;01;12;Tiistai;32;48;80;40;44;84
89;15.01.2013;2013;01;13;Tiistai;45;46;91;28;30;58
89;15.01.2013;2013;01;14;Tiistai;66;53;119;42;36;78
89;15.01.2013;2013;01;15;Tiistai;100;43;143;37;27;64
89;15.01.2013;2013;01;16;Tiistai;139;62;201;65;28;93
89;15.01.2013;2013;01;17;Tiistai;88;55;143;49;23;72
89;15.01.2013;2013;01;18;Tiistai;57;47;104;29;27;56
89;15.01.2013;2013;01;19;Tiistai;47;30;77;28;24;52
89;15.01.2013;2013;01;20;Tiistai;49;35;84;21;18;39
89;15.01.2013;2013;01;21;Tiistai;43;14;57;15;10;25
89;15.01.2013;2013;01;22;Tiistai;11;5;16;2;1;3
89;15.01.2013;2013;01;23;Tiistai;9;4;13;2;5;7
89;16.01.2013;2013;01;00;Keskiviikko;7;4;11;6;1;7
89;16.01.2013;2013;01;01;Keskiviikko;3;1;4;2;0;2
89;16.01.2013;2013;01;02;Keskiviikko;0;0;0;0;0;0
89;16.01.2013;2013;01;03;Keskiviikko;0;1;1;1;0;1
89;16.01.2013;2013;01;04;Keskiviikko;2;5;7;1;0;1
89;16.01.2013;2013;01;05;Keskiviikko;3;11;14;1;1;2
89;16.01.2013;2013;01;06;Keskiviikko;12;31;43;7;8;15
89;16.01.2013;2013;01;07;Keskiviikko;22;99;121;7;35;42
89;16.01.2013;2013;01;08;Keskiviikko;18;122;140;12;47;59
89;16.01.2013;2013;01;09;Keskiviikko;22;50;72;8;27;35
89;16.01.2013;2013;01;10;Keskiviikko;20;31;51;11;23;34
89;16.01.2013;2013;01;11;Keskiviikko;14;32;46;10;19;29
89;16.01.2013;2013;01;12;Keskiviikko;30;29;59;18;27;45
89;16.01.2013;2013;01;13;Keskiviikko;36;31;67;26;25;51
89;16.01.2013;2013;01;14;Keskiviikko;60;38;98;28;18;46
89;16.01.2013;2013;01;15;Keskiviikko;72;33;105;27;16;43
89;16.01.2013;2013;01;16;Keskiviikko;122;40;162;38;16;54
89;16.01.2013;2013;01;17;Keskiviikko;69;36;105;32;18;50
89;16.01.2013;2013;01;18;Keskiviikko;44;27;71;14;14;28
89;16.01.2013;2013;01;19;Keskiviikko;32;14;46;16;19;35
89;16.01.2013;2013;01;20;Keskiviikko;36;23;59;11;9;20
89;16.01.2013;2013;01;21;Keskiviikko;18;6;24;4;6;10
89;16.01.2013;2013;01;22;Keskiviikko;8;9;17;3;1;4
89;16.01.2013;2013;01;23;Keskiviikko;0;1;1;0;2;2
89;17.01.2013;2013;01;00;Torstai;3;5;8;1;1;2
89;17.01.2013;2013;01;01;Torstai;2;1;3;4;1;5
89;17.01.2013;2013;01;02;Torstai;0;0;0;0;0;0
89;17.01.2013;2013;01;03;Torstai;2;2;4;0;0;0
89;17.01.2013;2013;01;04;Torstai;1;4;5;0;1;1
89;17.01.2013;2013;01;05;Torstai;3;6;9;1;2;3
89;17.01.2013;2013;01;06;Torstai;13;24;37;6;5;11
89;17.01.2013;2013;01;07;Torstai;15;82;97;10;30;40
89;17.01.2013;2013;01;08;Torstai;29;126;155;14;33;47
89;17.01.2013;2013;01;09;Torstai;17;67;84;5;23;28
89;17.01.2013;2013;01;10;Torstai;11;24;35;12;25;37
89;17.01.2013;2013;01;11;Torstai;17;22;39;16;23;39
89;17.01.2013;2013;01;12;Torstai;15;31;46;11;19;30
89;17.01.2013;2013;01;13;Torstai;26;21;47;24;17;41
89;17.01.2013;2013;01;14;Torstai;58;28;86;28;26;54
89;17.01.2013;2013;01;15;Torstai;72;41;113;27;21;48
89;17.01.2013;2013;01;16;Torstai;94;33;127;45;18;63
89;17.01.2013;2013;01;17;Torstai;56;33;89;36;16;52
89;17.01.2013;2013;01;18;Torstai;47;25;72;16;12;28
89;17.01.2013;2013;01;19;Torstai;23;30;53;15;11;26
89;17.01.2013;2013;01;20;Torstai;32;15;47;11;8;19
89;17.01.2013;2013;01;21;Torstai;27;9;36;11;3;14
89;17.01.2013;2013;01;22;Torstai;11;1;12;5;2;7
89;17.01.2013;2013;01;23;Torstai;5;1;6;0;1;1
89;18.01.2013;2013;01;00;Perjantai;1;2;3;1;1;2
89;18.01.2013;2013;01;01;Perjantai;0;0;0;1;3;4
89;18.01.2013;2013;01;02;Perjantai;2;0;2;2;0;2
89;18.01.2013;2013;01;03;Perjantai;0;2;2;1;0;1
89;18.01.2013;2013;01;04;Perjantai;1;5;6;0;0;0
89;18.01.2013;2013;01;05;Perjantai;5;4;9;2;4;6
89;18.01.2013;2013;01;06;Perjantai;16;27;43;5;6;11
89;18.01.2013;2013;01;07;Perjantai;20;98;118;6;45;51
89;18.01.2013;2013;01;08;Perjantai;27;104;131;16;37;53
89;18.01.2013;2013;01;09;Perjantai;20;74;94;14;25;39
89;18.01.2013;2013;01;10;Perjantai;23;32;55;22;26;48
89;18.01.2013;2013;01;11;Perjantai;22;65;87;22;44;66
89;18.01.2013;2013;01;12;Perjantai;42;56;98;27;42;69
89;18.01.2013;2013;01;13;Perjantai;64;52;116;39;20;59
89;18.01.2013;2013;01;14;Perjantai;82;44;126;33;28;61
89;18.01.2013;2013;01;15;Perjantai;90;44;134;38;30;68
89;18.01.2013;2013;01;16;Perjantai;86;33;119;53;26;79
89;18.01.2013;2013;01;17;Perjantai;65;43;108;26;16;42
89;18.01.2013;2013;01;18;Perjantai;33;36;69;24;24;48
89;18.01.2013;2013;01;19;Perjantai;31;18;49;26;17;43
89;18.01.2013;2013;01;20;Perjantai;36;21;57;21;9;30
89;18.01.2013;2013;01;21;Perjantai;17;15;32;6;12;18
89;18.01.2013;2013;01;22;Perjantai;16;15;31;4;3;7
89;18.01.2013;2013;01;23;Perjantai;8;9;17;7;10;17
89;19.01.2013;2013;01;00;Lauantai;15;12;27;7;3;10
89;19.01.2013;2013;01;01;Lauantai;7;10;17;2;1;3
89;19.01.2013;2013;01;02;Lauantai;11;2;13;4;3;7
89;19.01.2013;2013;01;03;Lauantai;8;3;11;7;1;8
89;19.01.2013;2013;01;04;Lauantai;12;2;14;3;1;4
89;19.01.2013;2013;01;05;Lauantai;4;2;6;1;1;2
89;19.01.2013;2013;01;06;Lauantai;3;5;8;1;1;2
89;19.01.2013;2013;01;07;Lauantai;0;1;1;2;4;6
89;19.01.2013;2013;01;08;Lauantai;3;9;12;7;10;17
89;19.01.2013;2013;01;09;Lauantai;6;15;21;6;17;23
89;19.01.2013;2013;01;10;Lauantai;5;26;31;14;33;47
89;19.01.2013;2013;01;11;Lauantai;18;35;53;23;50;73
89;19.01.2013;2013;01;12;Lauantai;21;43;64;34;49;83
89;19.01.2013;2013;01;13;Lauantai;33;44;77;54;64;118
89;19.01.2013;2013;01;14;Lauantai;34;36;70;58;52;110
89;19.01.2013;2013;01;15;Lauantai;38;34;72;50;38;88
89;19.01.2013;2013;01;16;Lauantai;38;24;62;35;18;53
89;19.01.2013;2013;01;17;Lauantai;26;26;52;20;16;36
89;19.01.2013;2013;01;18;Lauantai;31;21;52;26;18;44
89;19.01.2013;2013;01;19;Lauantai;20;13;33;19;2;21
89;19.01.2013;2013;01;20;Lauantai;11;14;25;8;8;16
89;19.01.2013;2013;01;21;Lauantai;10;19;29;8;11;19
89;19.01.2013;2013;01;22;Lauantai;10;23;33;7;11;18
89;19.01.2013;2013;01;23;Lauantai;4;26;30;4;10;14
89;20.01.2013;2013;01;00;Sunnuntai;9;11;20;6;4;10
89;20.01.2013;2013;01;01;Sunnuntai;12;6;18;3;6;9
89;20.01.2013;2013;01;02;Sunnuntai;11;1;12;8;0;8
89;20.01.2013;2013;01;03;Sunnuntai;13;0;13;2;1;3
89;20.01.2013;2013;01;04;Sunnuntai;9;3;12;2;1;3
89;20.01.2013;2013;01;05;Sunnuntai;8;3;11;4;1;5
89;20.01.2013;2013;01;06;Sunnuntai;2;3;5;1;0;1
89;20.01.2013;2013;01;07;Sunnuntai;4;5;9;2;3;5
89;20.01.2013;2013;01;08;Sunnuntai;4;6;10;8;4;12
89;20.01.2013;2013;01;09;Sunnuntai;6;10;16;16;18;34
89;20.01.2013;2013;01;10;Sunnuntai;5;14;19;31;27;58
89;20.01.2013;2013;01;11;Sunnuntai;24;31;55;25;35;60
89;20.01.2013;2013;01;12;Sunnuntai;15;33;48;40;57;97
89;20.01.2013;2013;01;13;Sunnuntai;22;28;50;48;57;105
89;20.01.2013;2013;01;14;Sunnuntai;30;35;65;44;42;86
89;20.01.2013;2013;01;15;Sunnuntai;21;21;42;34;33;67
89;20.01.2013;2013;01;16;Sunnuntai;20;21;41;29;28;57
89;20.01.2013;2013;01;17;Sunnuntai;27;14;41;12;16;28
89;20.01.2013;2013;01;18;Sunnuntai;25;15;40;16;18;34
89;20.01.2013;2013;01;19;Sunnuntai;12;12;24;26;15;41
89;20.01.2013;2013;01;20;Sunnuntai;23;16;39;10;9;19
89;20.01.2013;2013;01;21;Sunnuntai;14;5;19;13;14;27
89;20.01.2013;2013;01;22;Sunnuntai;11;1;12;9;1;10
89;20.01.2013;2013;01;23;Sunnuntai;1;0;1;2;0;2
89;21.01.2013;2013;01;00;Maanantai;0;1;1;3;1;4
89;21.01.2013;2013;01;01;Maanantai;2;1;3;2;1;3
89;21.01.2013;2013;01;02;Maanantai;2;2;4;2;0;2
89;21.01.2013;2013;01;03;Maanantai;1;2;3;0;0;0
89;21.01.2013;2013;01;04;Maanantai;2;1;3;0;2;2
89;21.01.2013;2013;01;05;Maanantai;2;18;20;2;2;4
89;21.01.2013;2013;01;06;Maanantai;13;32;45;4;8;12
89;21.01.2013;2013;01;07;Maanantai;15;92;107;6;41;47
89;21.01.2013;2013;01;08;Maanantai;31;119;150;17;34;51
89;21.01.2013;2013;01;09;Maanantai;27;70;97;9;45;54
89;21.01.2013;2013;01;10;Maanantai;27;46;73;25;25;50
89;21.01.2013;2013;01;11;Maanantai;42;44;86;25;47;72
89;21.01.2013;2013;01;12;Maanantai;33;53;86;29;39;68
89;21.01.2013;2013;01;13;Maanantai;43;43;86;49;41;90
89;21.01.2013;2013;01;14;Maanantai;72;40;112;45;18;63
89;21.01.2013;2013;01;15;Maanantai;80;52;132;45;27;72
89;21.01.2013;2013;01;16;Maanantai;136;48;184;42;26;68
89;21.01.2013;2013;01;17;Maanantai;74;48;122;52;26;78
89;21.01.2013;2013;01;18;Maanantai;52;37;89;44;31;75
89;21.01.2013;2013;01;19;Maanantai;57;21;78;35;28;63
89;21.01.2013;2013;01;20;Maanantai;39;20;59;25;12;37
89;21.01.2013;2013;01;21;Maanantai;32;8;40;12;7;19
89;21.01.2013;2013;01;22;Maanantai;16;4;20;3;6;9
89;21.01.2013;2013;01;23;Maanantai;3;1;4;1;3;4
89;22.01.2013;2013;01;00;Tiistai;1;2;3;2;1;3
89;22.01.2013;2013;01;01;Tiistai;3;0;3;1;2;3
89;22.01.2013;2013;01;02;Tiistai;0;0;0;0;0;0
89;22.01.2013;2013;01;03;Tiistai;3;0;3;0;0;0
89;22.01.2013;2013;01;04;Tiistai;0;5;5;0;1;1
89;22.01.2013;2013;01;05;Tiistai;2;10;12;1;0;1
89;22.01.2013;2013;01;06;Tiistai;11;25;36;6;7;13
89;22.01.2013;2013;01;07;Tiistai;28;112;140;5;44;49
89;22.01.2013;2013;01;08;Tiistai;41;142;183;19;46;65
89;22.01.2013;2013;01;09;Tiistai;28;84;112;12;39;51
89;22.01.2013;2013;01;10;Tiistai;23;55;78;33;36;69
89;22.01.2013;2013;01;11;Tiistai;28;54;82;24;49;73
89;22.01.2013;2013;01;12;Tiistai;45;50;95;28;37;65
89;22.01.2013;2013;01;13;Tiistai;57;54;111;28;33;61
89;22.01.2013;2013;01;14;Tiistai;70;55;125;37;33;70
89;22.01.2013;2013;01;15;Tiistai;113;45;158;49;27;76
89;22.01.2013;2013;01;16;Tiistai;145;48;193;68;29;97
89;22.01.2013;2013;01;17;Tiistai;95;49;144;49;32;81
89;22.01.2013;2013;01;18;Tiistai;42;38;80;51;33;84
89;22.01.2013;2013;01;19;Tiistai;41;21;62;37;21;58
89;22.01.2013;2013;01;20;Tiistai;36;21;57;32;14;46
89;22.01.2013;2013;01;21;Tiistai;32;10;42;16;12;28
89;22.01.2013;2013;01;22;Tiistai;18;4;22;3;3;6
89;22.01.2013;2013;01;23;Tiistai;3;0;3;0;1;1
89;23.01.2013;2013;01;00;Keskiviikko;2;1;3;1;0;1
89;23.01.2013;2013;01;01;Keskiviikko;1;1;2;3;1;4
89;23.01.2013;2013;01;02;Keskiviikko;1;0;1;0;1;1
89;23.01.2013;2013;01;03;Keskiviikko;1;3;4;1;0;1
89;23.01.2013;2013;01;04;Keskiviikko;1;2;3;0;3;3
89;23.01.2013;2013;01;05;Keskiviikko;4;11;15;2;1;3
89;23.01.2013;2013;01;06;Keskiviikko;11;29;40;6;10;16
89;23.01.2013;2013;01;07;Keskiviikko;32;101;133;9;37;46
89;23.01.2013;2013;01;08;Keskiviikko;31;116;147;10;44;54
89;23.01.2013;2013;01;09;Keskiviikko;14;75;89;7;47;54
89;23.01.2013;2013;01;10;Keskiviikko;23;33;56;18;20;38
89;23.01.2013;2013;01;11;Keskiviikko;28;43;71;20;25;45
89;23.01.2013;2013;01;12;Keskiviikko;29;49;78;44;41;85
89;23.01.2013;2013;01;13;Keskiviikko;52;34;86;36;33;69
89;23.01.2013;2013;01;14;Keskiviikko;70;52;122;40;29;69
89;23.01.2013;2013;01;15;Keskiviikko;96;57;153;42;29;71
89;23.01.2013;2013;01;16;Keskiviikko;138;48;186;45;30;75
89;23.01.2013;2013;01;17;Keskiviikko;92;42;134;42;24;66
89;23.01.2013;2013;01;18;Keskiviikko;49;32;81;28;19;47
89;23.01.2013;2013;01;19;Keskiviikko;39;29;68;17;25;42
89;23.01.2013;2013;01;20;Keskiviikko;54;25;79;16;20;36
89;23.01.2013;2013;01;21;Keskiviikko;30;13;43;10;2;12
89;23.01.2013;2013;01;22;Keskiviikko;11;4;15;8;4;12
89;23.01.2013;2013;01;23;Keskiviikko;7;4;11;2;5;7
89;24.01.2013;2013;01;00;Torstai;5;1;6;1;1;2
89;24.01.2013;2013;01;01;Torstai;3;4;7;4;0;4
89;24.01.2013;2013;01;02;Torstai;1;0;1;1;1;2
89;24.01.2013;2013;01;03;Torstai;5;0;5;0;1;1
89;24.01.2013;2013;01;04;Torstai;1;3;4;0;1;1
89;24.01.2013;2013;01;05;Torstai;2;11;13;4;0;4
89;24.01.2013;2013;01;06;Torstai;14;28;42;5;8;13
89;24.01.2013;2013;01;07;Torstai;22;101;123;9;35;44
89;24.01.2013;2013;01;08;Torstai;45;122;167;12;46;58
89;24.01.2013;2013;01;09;Torstai;21;68;89;15;37;52
89;24.01.2013;2013;01;10;Torstai;25;33;58;18;36;54
89;24.01.2013;2013;01;11;Torstai;30;33;63;24;21;45
89;24.01.2013;2013;01;12;Torstai;26;45;71;32;48;80
89;24.01.2013;2013;01;13;Torstai;32;31;63;29;23;52
89;24.01.2013;2013;01;14;Torstai;66;38;104;26;24;50
89;24.01.2013;2013;01;15;Torstai;89;48;137;26;23;49
89;24.01.2013;2013;01;16;Torstai;126;48;174;49;14;63
89;24.01.2013;2013;01;17;Torstai;86;30;116;28;18;46
89;24.01.2013;2013;01;18;Torstai;42;26;68;24;23;47
89;24.01.2013;2013;01;19;Torstai;32;23;55;19;12;31
89;24.01.2013;2013;01;20;Torstai;29;15;44;19;12;31
89;24.01.2013;2013;01;21;Torstai;43;12;55;8;7;15
89;24.01.2013;2013;01;22;Torstai;20;8;28;4;0;4
89;24.01.2013;2013;01;23;Torstai;3;0;3;1;4;5
89;25.01.2013;2013;01;00;Perjantai;3;0;3;2;1;3
89;25.01.2013;2013;01;01;Perjantai;2;2;4;1;0;1
89;25.01.2013;2013;01;02;Perjantai;1;0;1;1;1;2
89;25.01.2013;2013;01;03;Perjantai;1;2;3;1;0;1
89;25.01.2013;2013;01;04;Perjantai;0;5;5;1;3;4
89;25.01.2013;2013;01;05;Perjantai;3;14;17;1;0;1
89;25.01.2013;2013;01;06;Perjantai;14;27;41;5;10;15
89;25.01.2013;2013;01;07;Perjantai;24;81;105;6;31;37
89;25.01.2013;2013;01;08;Perjantai;24;119;143;13;45;58
89;25.01.2013;2013;01;09;Perjantai;20;56;76;16;33;49
89;25.01.2013;2013;01;10;Perjantai;17;40;57;21;30;51
89;25.01.2013;2013;01;11;Perjantai;30;47;77;28;35;63
89;25.01.2013;2013;01;12;Perjantai;45;40;85;28;36;64
89;25.01.2013;2013;01;13;Perjantai;65;57;122;46;32;78
89;25.01.2013;2013;01;14;Perjantai;72;59;131;37;23;60
89;25.01.2013;2013;01;15;Perjantai;96;52;148;40;27;67
89;25.01.2013;2013;01;16;Perjantai;111;38;149;45;12;57
89;25.01.2013;2013;01;17;Perjantai;53;36;89;20;22;42
89;25.01.2013;2013;01;18;Perjantai;28;18;46;25;21;46
89;25.01.2013;2013;01;19;Perjantai;39;27;66;17;9;26
89;25.01.2013;2013;01;20;Perjantai;40;16;56;16;10;26
89;25.01.2013;2013;01;21;Perjantai;28;12;40;14;9;23
89;25.01.2013;2013;01;22;Perjantai;11;13;24;11;8;19
89;25.01.2013;2013;01;23;Perjantai;7;9;16;3;7;10
89;26.01.2013;2013;01;00;Lauantai;12;7;19;4;4;8
89;26.01.2013;2013;01;01;Lauantai;12;3;15;6;4;10
89;26.01.2013;2013;01;02;Lauantai;15;5;20;4;0;4
89;26.01.2013;2013;01;03;Lauantai;12;2;14;5;3;8
89;26.01.2013;2013;01;04;Lauantai;5;3;8;6;1;7
89;26.01.2013;2013;01;05;Lauantai;5;2;7;2;2;4
89;26.01.2013;2013;01;06;Lauantai;1;5;6;3;1;4
89;26.01.2013;2013;01;07;Lauantai;6;6;12;3;6;9
89;26.01.2013;2013;01;08;Lauantai;6;11;17;11;12;23
89;26.01.2013;2013;01;09;Lauantai;10;36;46;19;19;38
89;26.01.2013;2013;01;10;Lauantai;17;36;53;26;29;55
89;26.01.2013;2013;01;11;Lauantai;21;42;63;26;57;83
89;26.01.2013;2013;01;12;Lauantai;37;38;75;30;48;78
89;26.01.2013;2013;01;13;Lauantai;27;37;64;33;51;84
89;26.01.2013;2013;01;14;Lauantai;42;32;74;46;44;90
89;26.01.2013;2013;01;15;Lauantai;44;19;63;26;33;59
89;26.01.2013;2013;01;16;Lauantai;27;18;45;32;22;54
89;26.01.2013;2013;01;17;Lauantai;40;35;75;37;30;67
89;26.01.2013;2013;01;18;Lauantai;23;36;59;25;18;43
89;26.01.2013;2013;01;19;Lauantai;13;20;33;18;17;35
89;26.01.2013;2013;01;20;Lauantai;28;19;47;8;13;21
89;26.01.2013;2013;01;21;Lauantai;17;17;34;8;9;17
89;26.01.2013;2013;01;22;Lauantai;17;14;31;6;4;10
89;26.01.2013;2013;01;23;Lauantai;11;14;25;3;10;13
89;27.01.2013;2013;01;00;Sunnuntai;13;14;27;1;16;17
89;27.01.2013;2013;01;01;Sunnuntai;9;3;12;1;1;2
89;27.01.2013;2013;01;02;Sunnuntai;13;2;15;3;4;7
89;27.01.2013;2013;01;03;Sunnuntai;10;1;11;12;1;13
89;27.01.2013;2013;01;04;Sunnuntai;12;2;14;2;0;2
89;27.01.2013;2013;01;05;Sunnuntai;2;1;3;1;0;1
89;27.01.2013;2013;01;06;Sunnuntai;1;3;4;1;2;3
89;27.01.2013;2013;01;07;Sunnuntai;2;1;3;1;2;3
89;27.01.2013;2013;01;08;Sunnuntai;2;2;4;3;7;10
89;27.01.2013;2013;01;09;Sunnuntai;2;11;13;22;22;44
89;27.01.2013;2013;01;10;Sunnuntai;4;14;18;28;27;55
89;27.01.2013;2013;01;11;Sunnuntai;14;25;39;41;37;78
89;27.01.2013;2013;01;12;Sunnuntai;23;37;60;40;49;89
89;27.01.2013;2013;01;13;Sunnuntai;17;29;46;39;51;90
89;27.01.2013;2013;01;14;Sunnuntai;39;26;65;40;35;75
89;27.01.2013;2013;01;15;Sunnuntai;36;23;59;42;32;74
89;27.01.2013;2013;01;16;Sunnuntai;25;22;47;30;27;57
89;27.01.2013;2013;01;17;Sunnuntai;29;17;46;22;26;48
89;27.01.2013;2013;01;18;Sunnuntai;26;24;50;27;26;53
89;27.01.2013;2013;01;19;Sunnuntai;26;22;48;24;16;40
89;27.01.2013;2013;01;20;Sunnuntai;22;3;25;16;18;34
89;27.01.2013;2013;01;21;Sunnuntai;11;9;20;9;11;20
89;27.01.2013;2013;01;22;Sunnuntai;12;2;14;6;3;9
89;27.01.2013;2013;01;23;Sunnuntai;5;0;5;2;2;4
89;28.01.2013;2013;01;00;Maanantai;3;3;6;1;1;2
89;28.01.2013;2013;01;01;Maanantai;2;1;3;0;2;2
89;28.01.2013;2013;01;02;Maanantai;1;1;2;0;0;0
89;28.01.2013;2013;01;03;Maanantai;1;2;3;0;0;0
89;28.01.2013;2013;01;04;Maanantai;1;3;4;1;2;3
89;28.01.2013;2013;01;05;Maanantai;4;16;20;2;0;2
89;28.01.2013;2013;01;06;Maanantai;11;31;42;3;6;9
89;28.01.2013;2013;01;07;Maanantai;29;104;133;19;52;71
89;28.01.2013;2013;01;08;Maanantai;35;126;161;16;38;54
89;28.01.2013;2013;01;09;Maanantai;22;80;102;9;37;46
89;28.01.2013;2013;01;10;Maanantai;21;35;56;27;21;48
89;28.01.2013;2013;01;11;Maanantai;41;29;70;22;35;57
89;28.01.2013;2013;01;12;Maanantai;26;38;64;30;31;61
89;28.01.2013;2013;01;13;Maanantai;27;45;72;29;22;51
89;28.01.2013;2013;01;14;Maanantai;79;25;104;36;19;55
89;28.01.2013;2013;01;15;Maanantai;95;50;145;34;29;63
89;28.01.2013;2013;01;16;Maanantai;135;41;176;53;16;69
89;28.01.2013;2013;01;17;Maanantai;61;38;99;48;22;70
89;28.01.2013;2013;01;18;Maanantai;52;27;79;35;39;74
89;28.01.2013;2013;01;19;Maanantai;55;26;81;21;21;42
89;28.01.2013;2013;01;20;Maanantai;40;24;64;22;11;33
89;28.01.2013;2013;01;21;Maanantai;21;7;28;10;8;18
89;28.01.2013;2013;01;22;Maanantai;12;2;14;3;3;6
89;28.01.2013;2013;01;23;Maanantai;3;1;4;3;1;4
89;29.01.2013;2013;01;00;Tiistai;0;1;1;1;2;3
89;29.01.2013;2013;01;01;Tiistai;1;2;3;0;0;0
89;29.01.2013;2013;01;02;Tiistai;0;0;0;0;1;1
89;29.01.2013;2013;01;03;Tiistai;0;0;0;3;6;9
89;29.01.2013;2013;01;04;Tiistai;0;4;4;0;1;1
89;29.01.2013;2013;01;05;Tiistai;6;9;15;4;1;5
89;29.01.2013;2013;01;06;Tiistai;13;31;44;3;7;10
89;29.01.2013;2013;01;07;Tiistai;25;105;130;8;35;43
89;29.01.2013;2013;01;08;Tiistai;35;144;179;10;35;45
89;29.01.2013;2013;01;09;Tiistai;24;80;104;20;32;52
89;29.01.2013;2013;01;10;Tiistai;32;66;98;22;30;52
89;29.01.2013;2013;01;11;Tiistai;32;39;71;32;21;53
89;29.01.2013;2013;01;12;Tiistai;36;42;78;28;36;64
89;29.01.2013;2013;01;13;Tiistai;50;53;103;34;39;73
89;29.01.2013;2013;01;14;Tiistai;68;48;116;29;39;68
89;29.01.2013;2013;01;15;Tiistai;112;50;162;41;13;54
89;29.01.2013;2013;01;16;Tiistai;114;66;180;60;25;85
89;29.01.2013;2013;01;17;Tiistai;70;59;129;40;30;70
89;29.01.2013;2013;01;18;Tiistai;61;34;95;46;29;75
89;29.01.2013;2013;01;19;Tiistai;40;26;66;37;40;77
89;29.01.2013;2013;01;20;Tiistai;35;25;60;30;15;45
89;29.01.2013;2013;01;21;Tiistai;36;21;57;20;13;33
89;29.01.2013;2013;01;22;Tiistai;18;4;22;7;3;10
89;29.01.2013;2013;01;23;Tiistai;7;2;9;4;2;6
89;30.01.2013;2013;01;00;Keskiviikko;8;1;9;3;1;4
89;30.01.2013;2013;01;01;Keskiviikko;0;0;0;2;1;3
89;30.01.2013;2013;01;02;Keskiviikko;0;0;0;0;0;0
89;30.01.2013;2013;01;03;Keskiviikko;3;5;8;0;0;0
89;30.01.2013;2013;01;04;Keskiviikko;0;2;2;0;3;3
89;30.01.2013;2013;01;05;Keskiviikko;6;8;14;3;1;4
89;30.01.2013;2013;01;06;Keskiviikko;16;34;50;4;11;15
89;30.01.2013;2013;01;07;Keskiviikko;23;93;116;15;38;53
89;30.01.2013;2013;01;08;Keskiviikko;38;118;156;19;47;66
89;30.01.2013;2013;01;09;Keskiviikko;23;55;78;13;40;53
89;30.01.2013;2013;01;10;Keskiviikko;15;40;55;19;23;42
89;30.01.2013;2013;01;11;Keskiviikko;34;35;69;19;34;53
89;30.01.2013;2013;01;12;Keskiviikko;37;47;84;28;22;50
89;30.01.2013;2013;01;13;Keskiviikko;43;27;70;21;22;43
89;30.01.2013;2013;01;14;Keskiviikko;77;48;125;38;28;66
89;30.01.2013;2013;01;15;Keskiviikko;89;54;143;35;23;58
89;30.01.2013;2013;01;16;Keskiviikko;119;45;164;59;23;82
89;30.01.2013;2013;01;17;Keskiviikko;72;38;110;46;20;66
89;30.01.2013;2013;01;18;Keskiviikko;35;27;62;31;23;54
89;30.01.2013;2013;01;19;Keskiviikko;46;14;60;16;6;22
89;30.01.2013;2013;01;20;Keskiviikko;40;14;54;18;0;18
89;30.01.2013;2013;01;21;Keskiviikko;22;9;31;8;0;8
89;30.01.2013;2013;01;22;Keskiviikko;14;0;14;7;0;7
89;30.01.2013;2013;01;23;Keskiviikko;10;2;12;4;0;4
89;31.01.2013;2013;01;00;Torstai;1;0;1;0;0;0
89;31.01.2013;2013;01;01;Torstai;2;0;2;2;0;2
89;31.01.2013;2013;01;02;Torstai;4;0;4;2;0;2
89;31.01.2013;2013;01;03;Torstai;2;0;2;9;0;9
89;31.01.2013;2013;01;04;Torstai;3;0;3;3;0;3
89;31.01.2013;2013;01;05;Torstai;10;2;12;9;0;9
89;31.01.2013;2013;01;06;Torstai;37;3;40;14;0;14
89;31.01.2013;2013;01;07;Torstai;111;4;115;43;1;44
89;31.01.2013;2013;01;08;Torstai;133;8;141;59;0;59
89;31.01.2013;2013;01;09;Torstai;71;6;77;44;2;46
89;31.01.2013;2013;01;10;Torstai;65;3;68;34;4;38
89;31.01.2013;2013;01;11;Torstai;49;1;50;64;6;70
89;31.01.2013;2013;01;12;Torstai;80;4;84;49;1;50
89;31.01.2013;2013;01;13;Torstai;90;5;95;66;6;72
89;31.01.2013;2013;01;14;Torstai;124;8;132;53;7;60
89;31.01.2013;2013;01;15;Torstai;121;11;132;57;8;65
89;31.01.2013;2013;01;16;Torstai;134;31;165;71;12;83
89;31.01.2013;2013;01;17;Torstai;71;34;105;43;10;53
89;31.01.2013;2013;01;18;Torstai;58;25;83;31;22;53
89;31.01.2013;2013;01;19;Torstai;33;19;52;22;24;46
89;31.01.2013;2013;01;20;Torstai;31;26;57;26;10;36
89;31.01.2013;2013;01;21;Torstai;27;13;40;13;9;22
89;31.01.2013;2013;01;22;Torstai;16;4;20;2;3;5
89;31.01.2013;2013;01;23;Torstai;12;3;15;2;3;5
89;01.02.2013;2013;02;00;Perjantai;4;5;9;0;0;0
89;01.02.2013;2013;02;01;Perjantai;3;1;4;1;2;3
89;01.02.2013;2013;02;02;Perjantai;5;4;9;2;1;3
89;01.02.2013;2013;02;03;Perjantai;1;0;1;0;0;0
89;01.02.2013;2013;02;04;Perjantai;2;7;9;3;1;4
89;01.02.2013;2013;02;05;Perjantai;2;5;7;2;2;4
89;01.02.2013;2013;02;06;Perjantai;13;26;39;3;9;12
89;01.02.2013;2013;02;07;Perjantai;21;80;101;9;43;52
89;01.02.2013;2013;02;08;Perjantai;30;105;135;17;49;66
89;01.02.2013;2013;02;09;Perjantai;20;69;89;19;25;44
89;01.02.2013;2013;02;10;Perjantai;26;55;81;19;37;56
89;01.02.2013;2013;02;11;Perjantai;33;35;68;18;32;50
89;01.02.2013;2013;02;12;Perjantai;47;52;99;43;30;73
89;01.02.2013;2013;02;13;Perjantai;49;58;107;46;32;78
89;01.02.2013;2013;02;14;Perjantai;75;57;132;39;26;65
89;01.02.2013;2013;02;15;Perjantai;98;39;137;46;27;73
89;01.02.2013;2013;02;16;Perjantai;106;34;140;48;18;66
89;01.02.2013;2013;02;17;Perjantai;45;34;79;42;21;63
89;01.02.2013;2013;02;18;Perjantai;35;25;60;26;27;53
89;01.02.2013;2013;02;19;Perjantai;34;17;51;23;23;46
89;01.02.2013;2013;02;20;Perjantai;35;12;47;17;4;21
89;01.02.2013;2013;02;21;Perjantai;12;16;28;17;12;29
89;01.02.2013;2013;02;22;Perjantai;17;12;29;5;8;13
89;01.02.2013;2013;02;23;Perjantai;6;4;10;5;7;12
89;02.02.2013;2013;02;00;Lauantai;7;12;19;5;3;8
89;02.02.2013;2013;02;01;Lauantai;16;2;18;5;3;8
89;02.02.2013;2013;02;02;Lauantai;7;1;8;8;0;8
89;02.02.2013;2013;02;03;Lauantai;7;1;8;7;2;9
89;02.02.2013;2013;02;04;Lauantai;5;0;5;11;1;12
89;02.02.2013;2013;02;05;Lauantai;3;2;5;4;0;4
89;02.02.2013;2013;02;06;Lauantai;6;0;6;1;3;4
89;02.02.2013;2013;02;07;Lauantai;2;10;12;1;2;3
89;02.02.2013;2013;02;08;Lauantai;5;21;26;8;9;17
89;02.02.2013;2013;02;09;Lauantai;11;26;37;18;28;46
89;02.02.2013;2013;02;10;Lauantai;8;44;52;21;43;64
89;02.02.2013;2013;02;11;Lauantai;29;40;69;42;54;96
89;02.02.2013;2013;02;12;Lauantai;27;32;59;27;33;60
89;02.02.2013;2013;02;13;Lauantai;33;37;70;31;38;69
89;02.02.2013;2013;02;14;Lauantai;35;26;61;41;28;69
89;02.02.2013;2013;02;15;Lauantai;42;25;67;39;29;68
89;02.02.2013;2013;02;16;Lauantai;29;28;57;30;21;51
89;02.02.2013;2013;02;17;Lauantai;23;21;44;29;33;62
89;02.02.2013;2013;02;18;Lauantai;18;17;35;18;25;43
89;02.02.2013;2013;02;19;Lauantai;20;14;34;22;13;35
89;02.02.2013;2013;02;20;Lauantai;23;15;38;6;13;19
89;02.02.2013;2013;02;21;Lauantai;15;11;26;8;15;23
89;02.02.2013;2013;02;22;Lauantai;15;6;21;7;8;15
89;02.02.2013;2013;02;23;Lauantai;7;12;19;6;7;13
89;03.02.2013;2013;02;00;Sunnuntai;11;5;16;5;6;11
89;03.02.2013;2013;02;01;Sunnuntai;13;2;15;3;1;4
89;03.02.2013;2013;02;02;Sunnuntai;14;4;18;4;0;4
89;03.02.2013;2013;02;03;Sunnuntai;9;2;11;6;5;11
89;03.02.2013;2013;02;04;Sunnuntai;11;2;13;21;1;22
89;03.02.2013;2013;02;05;Sunnuntai;1;3;4;3;0;3
89;03.02.2013;2013;02;06;Sunnuntai;2;1;3;1;1;2
89;03.02.2013;2013;02;07;Sunnuntai;1;4;5;6;2;8
89;03.02.2013;2013;02;08;Sunnuntai;0;8;8;4;5;9
89;03.02.2013;2013;02;09;Sunnuntai;7;11;18;15;10;25
89;03.02.2013;2013;02;10;Sunnuntai;4;14;18;36;25;61
89;03.02.2013;2013;02;11;Sunnuntai;10;16;26;43;31;74
89;03.02.2013;2013;02;12;Sunnuntai;16;28;44;49;47;96
89;03.02.2013;2013;02;13;Sunnuntai;28;39;67;42;48;90
89;03.02.2013;2013;02;14;Sunnuntai;26;24;50;49;56;105
89;03.02.2013;2013;02;15;Sunnuntai;33;21;54;51;39;90
89;03.02.2013;2013;02;16;Sunnuntai;36;23;59;34;24;58
89;03.02.2013;2013;02;17;Sunnuntai;30;24;54;26;22;48
89;03.02.2013;2013;02;18;Sunnuntai;25;20;45;43;23;66
89;03.02.2013;2013;02;19;Sunnuntai;25;11;36;26;24;50
89;03.02.2013;2013;02;20;Sunnuntai;15;6;21;11;14;25
89;03.02.2013;2013;02;21;Sunnuntai;13;7;20;10;5;15
89;03.02.2013;2013;02;22;Sunnuntai;5;4;9;6;2;8
89;03.02.2013;2013;02;23;Sunnuntai;2;5;7;2;2;4
89;04.02.2013;2013;02;00;Maanantai;3;1;4;2;0;2
89;04.02.2013;2013;02;01;Maanantai;1;0;1;1;1;2
89;04.02.2013;2013;02;02;Maanantai;2;2;4;0;0;0
89;04.02.2013;2013;02;03;Maanantai;3;1;4;1;0;1
89;04.02.2013;2013;02;04;Maanantai;9;3;12;18;0;18
89;04.02.2013;2013;02;05;Maanantai;12;0;12;5;0;5
89;04.02.2013;2013;02;06;Maanantai;42;0;42;14;0;14
89;04.02.2013;2013;02;07;Maanantai;116;0;116;50;0;50
89;04.02.2013;2013;02;08;Maanantai;159;0;159;62;0;62
89;04.02.2013;2013;02;09;Maanantai;99;0;99;79;0;79
89;04.02.2013;2013;02;10;Maanantai;91;0;91;58;0;58
89;04.02.2013;2013;02;11;Maanantai;91;0;91;70;0;70
89;04.02.2013;2013;02;12;Maanantai;86;0;86;103;11;114
89;04.02.2013;2013;02;13;Maanantai;87;3;90;49;15;64
89;04.02.2013;2013;02;14;Maanantai;110;1;111;72;8;80
89;04.02.2013;2013;02;15;Maanantai;150;2;152;62;16;78
89;04.02.2013;2013;02;16;Maanantai;193;0;193;83;9;92
89;04.02.2013;2013;02;17;Maanantai;111;5;116;75;13;88
89;04.02.2013;2013;02;18;Maanantai;70;1;71;80;17;97
89;04.02.2013;2013;02;19;Maanantai;63;4;67;59;8;67
89;04.02.2013;2013;02;20;Maanantai;56;2;58;52;6;58
89;04.02.2013;2013;02;21;Maanantai;30;1;31;23;7;30
89;04.02.2013;2013;02;22;Maanantai;9;1;10;14;3;17
89;04.02.2013;2013;02;23;Maanantai;5;0;5;3;0;3
89;05.02.2013;2013;02;00;Tiistai;0;0;0;1;0;1
89;05.02.2013;2013;02;01;Tiistai;1;0;1;2;1;3
89;05.02.2013;2013;02;02;Tiistai;3;0;3;2;1;3
89;05.02.2013;2013;02;03;Tiistai;1;0;1;1;0;1
89;05.02.2013;2013;02;04;Tiistai;2;0;2;5;0;5
89;05.02.2013;2013;02;05;Tiistai;8;0;8;7;1;8
89;05.02.2013;2013;02;06;Tiistai;41;0;41;10;11;21
89;05.02.2013;2013;02;07;Tiistai;109;11;120;44;29;73
89;05.02.2013;2013;02;08;Tiistai;128;14;142;37;29;66
89;05.02.2013;2013;02;09;Tiistai;74;16;90;39;27;66
89;05.02.2013;2013;02;10;Tiistai;70;14;84;29;32;61
89;05.02.2013;2013;02;11;Tiistai;63;10;73;36;39;75
89;05.02.2013;2013;02;12;Tiistai;66;22;88;32;33;65
89;05.02.2013;2013;02;13;Tiistai;72;21;93;40;29;69
89;05.02.2013;2013;02;14;Tiistai;116;28;144;40;38;78
89;05.02.2013;2013;02;15;Tiistai;157;20;177;61;33;94
89;05.02.2013;2013;02;16;Tiistai;176;21;197;59;16;75
89;05.02.2013;2013;02;17;Tiistai;111;14;125;44;29;73
89;05.02.2013;2013;02;18;Tiistai;76;14;90;44;31;75
89;05.02.2013;2013;02;19;Tiistai;62;16;78;35;30;65
89;05.02.2013;2013;02;20;Tiistai;53;10;63;32;16;48
89;05.02.2013;2013;02;21;Tiistai;36;7;43;16;9;25
89;05.02.2013;2013;02;22;Tiistai;15;2;17;6;3;9
89;05.02.2013;2013;02;23;Tiistai;11;0;11;0;0;0
89;06.02.2013;2013;02;00;Keskiviikko;4;1;5;2;0;2
89;06.02.2013;2013;02;01;Keskiviikko;5;0;5;2;0;2
89;06.02.2013;2013;02;02;Keskiviikko;1;1;2;0;0;0
89;06.02.2013;2013;02;03;Keskiviikko;6;0;6;0;0;0
89;06.02.2013;2013;02;04;Keskiviikko;4;1;5;1;1;2
89;06.02.2013;2013;02;05;Keskiviikko;11;2;13;1;1;2
89;06.02.2013;2013;02;06;Keskiviikko;33;5;38;6;6;12
89;06.02.2013;2013;02;07;Keskiviikko;91;33;124;13;32;45
89;06.02.2013;2013;02;08;Keskiviikko;106;54;160;18;41;59
89;06.02.2013;2013;02;09;Keskiviikko;66;37;103;21;36;57
89;06.02.2013;2013;02;10;Keskiviikko;49;14;63;21;34;55
89;06.02.2013;2013;02;11;Keskiviikko;42;19;61;19;35;54
89;06.02.2013;2013;02;12;Keskiviikko;50;17;67;33;27;60
89;06.02.2013;2013;02;13;Keskiviikko;58;13;71;35;32;67
89;06.02.2013;2013;02;14;Keskiviikko;92;29;121;46;27;73
89;06.02.2013;2013;02;15;Keskiviikko;116;17;133;41;21;62
89;06.02.2013;2013;02;16;Keskiviikko;173;32;205;65;28;93
89;06.02.2013;2013;02;17;Keskiviikko;107;36;143;40;14;54
89;06.02.2013;2013;02;18;Keskiviikko;67;22;89;29;23;52
89;06.02.2013;2013;02;19;Keskiviikko;52;20;72;28;17;45
89;06.02.2013;2013;02;20;Keskiviikko;50;10;60;20;17;37
89;06.02.2013;2013;02;21;Keskiviikko;43;9;52;13;10;23
89;06.02.2013;2013;02;22;Keskiviikko;15;3;18;4;1;5
89;06.02.2013;2013;02;23;Keskiviikko;12;2;14;2;3;5
89;07.02.2013;2013;02;00;Torstai;7;2;9;4;2;6
89;07.02.2013;2013;02;01;Torstai;0;1;1;0;0;0
89;07.02.2013;2013;02;02;Torstai;2;0;2;1;0;1
89;07.02.2013;2013;02;03;Torstai;1;1;2;4;0;4
89;07.02.2013;2013;02;04;Torstai;10;1;11;3;1;4
89;07.02.2013;2013;02;05;Torstai;11;3;14;3;2;5
89;07.02.2013;2013;02;06;Torstai;28;6;34;6;8;14
89;07.02.2013;2013;02;07;Torstai;101;33;134;13;38;51
89;07.02.2013;2013;02;08;Torstai;88;40;128;17;43;60
89;07.02.2013;2013;02;09;Torstai;56;33;89;13;25;38
89;07.02.2013;2013;02;10;Torstai;51;19;70;21;7;28
89;07.02.2013;2013;02;11;Torstai;60;15;75;19;24;43
89;07.02.2013;2013;02;12;Torstai;57;24;81;24;30;54
89;07.02.2013;2013;02;13;Torstai;59;19;78;26;22;48
89;07.02.2013;2013;02;14;Torstai;92;21;113;34;27;61
89;07.02.2013;2013;02;15;Torstai;112;22;134;52;19;71
89;07.02.2013;2013;02;16;Torstai;133;22;155;58;23;81
89;07.02.2013;2013;02;17;Torstai;104;15;119;41;22;63
89;07.02.2013;2013;02;18;Torstai;70;14;84;32;32;64
89;07.02.2013;2013;02;19;Torstai;51;13;64;46;22;68
89;07.02.2013;2013;02;20;Torstai;55;5;60;19;8;27
89;07.02.2013;2013;02;21;Torstai;29;6;35;19;9;28
89;07.02.2013;2013;02;22;Torstai;12;9;21;7;5;12
89;07.02.2013;2013;02;23;Torstai;9;3;12;2;0;2
89;08.02.2013;2013;02;00;Perjantai;9;4;13;1;1;2
89;08.02.2013;2013;02;01;Perjantai;0;1;1;2;0;2
89;08.02.2013;2013;02;02;Perjantai;6;1;7;1;0;1
89;08.02.2013;2013;02;03;Perjantai;3;3;6;2;0;2
89;08.02.2013;2013;02;04;Perjantai;6;1;7;1;1;2
89;08.02.2013;2013;02;05;Perjantai;9;2;11;2;1;3
89;08.02.2013;2013;02;06;Perjantai;28;6;34;5;8;13
89;08.02.2013;2013;02;07;Perjantai;77;30;107;13;31;44
89;08.02.2013;2013;02;08;Perjantai;86;61;147;28;38;66
89;08.02.2013;2013;02;09;Perjantai;60;21;81;16;38;54
89;08.02.2013;2013;02;10;Perjantai;42;20;62;13;27;40
89;08.02.2013;2013;02;11;Perjantai;40;19;59;35;34;69
89;08.02.2013;2013;02;12;Perjantai;67;37;104;33;39;72
89;08.02.2013;2013;02;13;Perjantai;83;20;103;48;24;72
89;08.02.2013;2013;02;14;Perjantai;76;20;96;31;27;58
89;08.02.2013;2013;02;15;Perjantai;115;19;134;44;29;73
89;08.02.2013;2013;02;16;Perjantai;114;25;139;55;23;78
89;08.02.2013;2013;02;17;Perjantai;74;18;92;39;15;54
89;08.02.2013;2013;02;18;Perjantai;63;16;79;20;18;38
89;08.02.2013;2013;02;19;Perjantai;40;7;47;15;10;25
89;08.02.2013;2013;02;20;Perjantai;39;7;46;17;9;26
89;08.02.2013;2013;02;21;Perjantai;16;11;27;10;19;29
89;08.02.2013;2013;02;22;Perjantai;19;7;26;5;1;6
89;08.02.2013;2013;02;23;Perjantai;18;3;21;4;2;6
89;09.02.2013;2013;02;00;Lauantai;7;3;10;4;3;7
89;09.02.2013;2013;02;01;Lauantai;9;5;14;9;2;11
89;09.02.2013;2013;02;02;Lauantai;9;0;9;8;0;8
89;09.02.2013;2013;02;03;Lauantai;13;1;14;5;0;5
89;09.02.2013;2013;02;04;Lauantai;8;0;8;5;1;6
89;09.02.2013;2013;02;05;Lauantai;5;0;5;1;0;1
89;09.02.2013;2013;02;06;Lauantai;6;0;6;4;3;7
89;09.02.2013;2013;02;07;Lauantai;10;4;14;0;4;4
89;09.02.2013;2013;02;08;Lauantai;7;4;11;10;14;24
89;09.02.2013;2013;02;09;Lauantai;19;11;30;22;16;38
89;09.02.2013;2013;02;10;Lauantai;30;11;41;22;28;50
89;09.02.2013;2013;02;11;Lauantai;38;20;58;29;35;64
89;09.02.2013;2013;02;12;Lauantai;27;18;45;38;46;84
89;09.02.2013;2013;02;13;Lauantai;48;26;74;33;52;85
89;09.02.2013;2013;02;14;Lauantai;39;22;61;31;44;75
89;09.02.2013;2013;02;15;Lauantai;48;19;67;46;25;71
89;09.02.2013;2013;02;16;Lauantai;31;3;34;35;18;53
89;09.02.2013;2013;02;17;Lauantai;47;6;53;25;16;41
89;09.02.2013;2013;02;18;Lauantai;33;9;42;22;18;40
89;09.02.2013;2013;02;19;Lauantai;26;9;35;17;16;33
89;09.02.2013;2013;02;20;Lauantai;30;13;43;13;18;31
89;09.02.2013;2013;02;21;Lauantai;16;5;21;10;12;22
89;09.02.2013;2013;02;22;Lauantai;20;4;24;6;3;9
89;09.02.2013;2013;02;23;Lauantai;11;12;23;5;10;15
89;10.02.2013;2013;02;00;Sunnuntai;9;4;13;3;2;5
89;10.02.2013;2013;02;01;Sunnuntai;17;2;19;2;3;5
89;10.02.2013;2013;02;02;Sunnuntai;16;0;16;10;3;13
89;10.02.2013;2013;02;03;Sunnuntai;9;0;9;8;1;9
89;10.02.2013;2013;02;04;Sunnuntai;6;1;7;9;0;9
89;10.02.2013;2013;02;05;Sunnuntai;2;0;2;0;0;0
89;10.02.2013;2013;02;06;Sunnuntai;6;2;8;5;0;5
89;10.02.2013;2013;02;07;Sunnuntai;10;0;10;4;4;8
89;10.02.2013;2013;02;08;Sunnuntai;6;1;7;6;5;11
89;10.02.2013;2013;02;09;Sunnuntai;14;6;20;19;14;33
89;10.02.2013;2013;02;10;Sunnuntai;16;3;19;31;28;59
89;10.02.2013;2013;02;11;Sunnuntai;27;16;43;40;45;85
89;10.02.2013;2013;02;12;Sunnuntai;36;23;59;50;51;101
89;10.02.2013;2013;02;13;Sunnuntai;34;15;49;52;44;96
89;10.02.2013;2013;02;14;Sunnuntai;30;7;37;32;45;77
89;10.02.2013;2013;02;15;Sunnuntai;42;17;59;44;35;79
89;10.02.2013;2013;02;16;Sunnuntai;35;7;42;31;26;57
89;10.02.2013;2013;02;17;Sunnuntai;23;16;39;36;25;61
89;10.02.2013;2013;02;18;Sunnuntai;32;10;42;19;29;48
89;10.02.2013;2013;02;19;Sunnuntai;33;9;42;23;23;46
89;10.02.2013;2013;02;20;Sunnuntai;28;4;32;20;11;31
89;10.02.2013;2013;02;21;Sunnuntai;13;4;17;16;6;22
89;10.02.2013;2013;02;22;Sunnuntai;10;0;10;5;0;5
89;10.02.2013;2013;02;23;Sunnuntai;8;1;9;5;0;5
89;11.02.2013;2013;02;00;Maanantai;6;2;8;0;0;0
89;11.02.2013;2013;02;01;Maanantai;3;0;3;0;0;0
89;11.02.2013;2013;02;02;Maanantai;1;1;2;0;0;0
89;11.02.2013;2013;02;03;Maanantai;2;1;3;2;0;2
89;11.02.2013;2013;02;04;Maanantai;5;1;6;0;1;1
89;11.02.2013;2013;02;05;Maanantai;15;2;17;3;0;3
89;11.02.2013;2013;02;06;Maanantai;38;10;48;3;5;8
89;11.02.2013;2013;02;07;Maanantai;92;46;138;23;32;55
89;11.02.2013;2013;02;08;Maanantai;106;63;169;11;40;51
89;11.02.2013;2013;02;09;Maanantai;52;55;107;13;41;54
89;11.02.2013;2013;02;10;Maanantai;52;33;85;21;27;48
89;11.02.2013;2013;02;11;Maanantai;44;25;69;21;32;53
89;11.02.2013;2013;02;12;Maanantai;50;34;84;28;27;55
89;11.02.2013;2013;02;13;Maanantai;55;33;88;29;30;59
89;11.02.2013;2013;02;14;Maanantai;72;32;104;47;28;75
89;11.02.2013;2013;02;15;Maanantai;119;45;164;42;28;70
89;11.02.2013;2013;02;16;Maanantai;167;34;201;65;29;94
89;11.02.2013;2013;02;17;Maanantai;103;26;129;53;21;74
89;11.02.2013;2013;02;18;Maanantai;66;31;97;38;25;63
89;11.02.2013;2013;02;19;Maanantai;51;11;62;27;15;42
89;11.02.2013;2013;02;20;Maanantai;52;17;69;24;20;44
89;11.02.2013;2013;02;21;Maanantai;38;8;46;11;3;14
89;11.02.2013;2013;02;22;Maanantai;8;0;8;6;2;8
89;11.02.2013;2013;02;23;Maanantai;3;1;4;2;3;5
89;12.02.2013;2013;02;00;Tiistai;2;1;3;1;0;1
89;12.02.2013;2013;02;01;Tiistai;0;0;0;1;0;1
89;12.02.2013;2013;02;02;Tiistai;0;0;0;0;0;0
89;12.02.2013;2013;02;03;Tiistai;2;0;2;1;1;2
89;12.02.2013;2013;02;04;Tiistai;4;2;6;0;1;1
89;12.02.2013;2013;02;05;Tiistai;10;5;15;4;0;4
89;12.02.2013;2013;02;06;Tiistai;27;14;41;6;9;15
89;12.02.2013;2013;02;07;Tiistai;89;47;136;15;35;50
89;12.02.2013;2013;02;08;Tiistai;92;70;162;11;37;48
89;12.02.2013;2013;02;09;Tiistai;58;53;111;23;39;62
89;12.02.2013;2013;02;10;Tiistai;36;21;57;23;31;54
89;12.02.2013;2013;02;11;Tiistai;56;38;94;23;33;56
89;12.02.2013;2013;02;12;Tiistai;51;35;86;32;26;58
89;12.02.2013;2013;02;13;Tiistai;79;37;116;58;63;121
89;12.02.2013;2013;02;14;Tiistai;130;39;169;35;47;82
89;12.02.2013;2013;02;15;Tiistai;129;24;153;31;18;49
89;12.02.2013;2013;02;16;Tiistai;175;33;208;61;37;98
89;12.02.2013;2013;02;17;Tiistai;116;36;152;54;22;76
89;12.02.2013;2013;02;18;Tiistai;67;11;78;39;24;63
89;12.02.2013;2013;02;19;Tiistai;55;20;75;33;29;62
89;12.02.2013;2013;02;20;Tiistai;65;11;76;25;19;44
89;12.02.2013;2013;02;21;Tiistai;38;10;48;16;11;27
89;12.02.2013;2013;02;22;Tiistai;21;6;27;8;7;15
89;12.02.2013;2013;02;23;Tiistai;9;4;13;5;4;9
89;13.02.2013;2013;02;00;Keskiviikko;4;1;5;3;1;4
89;13.02.2013;2013;02;01;Keskiviikko;13;0;13;2;2;4
89;13.02.2013;2013;02;02;Keskiviikko;11;0;11;0;1;1
89;13.02.2013;2013;02;03;Keskiviikko;9;3;12;2;0;2
89;13.02.2013;2013;02;04;Keskiviikko;5;2;7;1;1;2
89;13.02.2013;2013;02;05;Keskiviikko;14;0;14;3;2;5
89;13.02.2013;2013;02;06;Keskiviikko;24;12;36;5;4;9
89;13.02.2013;2013;02;07;Keskiviikko;98;48;146;14;33;47
89;13.02.2013;2013;02;08;Keskiviikko;96;77;173;15;39;54
89;13.02.2013;2013;02;09;Keskiviikko;59;41;100;16;31;47
89;13.02.2013;2013;02;10;Keskiviikko;46;30;76;20;28;48
89;13.02.2013;2013;02;11;Keskiviikko;47;31;78;35;39;74
89;13.02.2013;2013;02;12;Keskiviikko;53;38;91;30;44;74
89;13.02.2013;2013;02;13;Keskiviikko;74;29;103;40;28;68
89;13.02.2013;2013;02;14;Keskiviikko;98;36;134;37;28;65
89;13.02.2013;2013;02;15;Keskiviikko;126;24;150;37;28;65
89;13.02.2013;2013;02;16;Keskiviikko;187;45;232;58;15;73
89;13.02.2013;2013;02;17;Keskiviikko;100;47;147;52;26;78
89;13.02.2013;2013;02;18;Keskiviikko;70;19;89;37;31;68
89;13.02.2013;2013;02;19;Keskiviikko;55;10;65;41;26;67
89;13.02.2013;2013;02;20;Keskiviikko;51;16;67;25;30;55
89;13.02.2013;2013;02;21;Keskiviikko;38;8;46;15;11;26
89;13.02.2013;2013;02;22;Keskiviikko;15;9;24;3;7;10
89;13.02.2013;2013;02;23;Keskiviikko;4;6;10;5;4;9
89;14.02.2013;2013;02;00;Torstai;6;2;8;8;2;10
89;14.02.2013;2013;02;01;Torstai;6;4;10;0;1;1
89;14.02.2013;2013;02;02;Torstai;3;0;3;3;0;3
89;14.02.2013;2013;02;03;Torstai;4;2;6;2;0;2
89;14.02.2013;2013;02;04;Torstai;6;2;8;0;1;1
89;14.02.2013;2013;02;05;Torstai;8;3;11;1;0;1
89;14.02.2013;2013;02;06;Torstai;23;15;38;8;8;16
89;14.02.2013;2013;02;07;Torstai;89;59;148;8;40;48
89;14.02.2013;2013;02;08;Torstai;81;99;180;27;41;68
89;14.02.2013;2013;02;09;Torstai;57;55;112;12;30;42
89;14.02.2013;2013;02;10;Torstai;41;38;79;26;25;51
89;14.02.2013;2013;02;11;Torstai;33;27;60;16;24;40
89;14.02.2013;2013;02;12;Torstai;35;35;70;36;31;67
89;14.02.2013;2013;02;13;Torstai;50;45;95;31;38;69
89;14.02.2013;2013;02;14;Torstai;86;37;123;57;25;82
89;14.02.2013;2013;02;15;Torstai;120;40;160;59;23;82
89;14.02.2013;2013;02;16;Torstai;133;42;175;50;25;75
89;14.02.2013;2013;02;17;Torstai;78;25;103;54;13;67
89;14.02.2013;2013;02;18;Torstai;71;29;100;36;30;66
89;14.02.2013;2013;02;19;Torstai;49;16;65;31;30;61
89;14.02.2013;2013;02;20;Torstai;51;17;68;23;26;49
89;14.02.2013;2013;02;21;Torstai;23;15;38;23;13;36
89;14.02.2013;2013;02;22;Torstai;8;8;16;10;9;19
89;14.02.2013;2013;02;23;Torstai;12;4;16;2;3;5
89;15.02.2013;2013;02;00;Perjantai;8;1;9;4;3;7
89;15.02.2013;2013;02;01;Perjantai;1;0;1;1;0;1
89;15.02.2013;2013;02;02;Perjantai;4;0;4;2;1;3
89;15.02.2013;2013;02;03;Perjantai;2;2;4;4;4;8
89;15.02.2013;2013;02;04;Perjantai;8;2;10;4;2;6
89;15.02.2013;2013;02;05;Perjantai;8;4;12;1;1;2
89;15.02.2013;2013;02;06;Perjantai;20;20;40;6;9;15
89;15.02.2013;2013;02;07;Perjantai;47;49;96;14;34;48
89;15.02.2013;2013;02;08;Perjantai;71;69;140;17;36;53
89;15.02.2013;2013;02;09;Perjantai;38;47;85;15;24;39
89;15.02.2013;2013;02;10;Perjantai;33;46;79;21;48;69
89;15.02.2013;2013;02;11;Perjantai;54;31;85;29;23;52
89;15.02.2013;2013;02;12;Perjantai;45;32;77;47;39;86
89;15.02.2013;2013;02;13;Perjantai;76;33;109;36;28;64
89;15.02.2013;2013;02;14;Perjantai;72;34;106;34;28;62
89;15.02.2013;2013;02;15;Perjantai;96;19;115;44;32;76
89;15.02.2013;2013;02;16;Perjantai;107;38;145;64;20;84
89;15.02.2013;2013;02;17;Perjantai;59;32;91;37;32;69
89;15.02.2013;2013;02;18;Perjantai;42;20;62;37;23;60
89;15.02.2013;2013;02;19;Perjantai;32;23;55;32;19;51
89;15.02.2013;2013;02;20;Perjantai;30;14;44;27;15;42
89;15.02.2013;2013;02;21;Perjantai;25;20;45;10;20;30
89;15.02.2013;2013;02;22;Perjantai;15;15;30;5;7;12
89;15.02.2013;2013;02;23;Perjantai;9;10;19;5;9;14
89;16.02.2013;2013;02;00;Lauantai;10;6;16;5;2;7
89;16.02.2013;2013;02;01;Lauantai;6;2;8;15;3;18
89;16.02.2013;2013;02;02;Lauantai;8;3;11;10;1;11
89;16.02.2013;2013;02;03;Lauantai;15;1;16;8;0;8
89;16.02.2013;2013;02;04;Lauantai;6;0;6;16;2;18
89;16.02.2013;2013;02;05;Lauantai;2;1;3;1;0;1
89;16.02.2013;2013;02;06;Lauantai;4;5;9;3;5;8
89;16.02.2013;2013;02;07;Lauantai;9;9;18;1;8;9
89;16.02.2013;2013;02;08;Lauantai;11;13;24;8;9;17
89;16.02.2013;2013;02;09;Lauantai;14;12;26;26;25;51
89;16.02.2013;2013;02;10;Lauantai;24;30;54;23;42;65
89;16.02.2013;2013;02;11;Lauantai;28;32;60;38;47;85
89;16.02.2013;2013;02;12;Lauantai;44;36;80;44;62;106
89;16.02.2013;2013;02;13;Lauantai;38;35;73;45;48;93
89;16.02.2013;2013;02;14;Lauantai;44;37;81;34;46;80
89;16.02.2013;2013;02;15;Lauantai;41;23;64;44;21;65
89;16.02.2013;2013;02;16;Lauantai;38;29;67;33;19;52
89;16.02.2013;2013;02;17;Lauantai;30;19;49;25;29;54
89;16.02.2013;2013;02;18;Lauantai;26;16;42;39;25;64
89;16.02.2013;2013;02;19;Lauantai;22;9;31;27;16;43
89;16.02.2013;2013;02;20;Lauantai;20;14;34;12;19;31
89;16.02.2013;2013;02;21;Lauantai;17;10;27;10;8;18
89;16.02.2013;2013;02;22;Lauantai;8;8;16;5;10;15
89;16.02.2013;2013;02;23;Lauantai;14;9;23;8;7;15
89;17.02.2013;2013;02;00;Sunnuntai;5;6;11;6;3;9
89;17.02.2013;2013;02;01;Sunnuntai;8;4;12;10;2;12
89;17.02.2013;2013;02;02;Sunnuntai;14;5;19;11;3;14
89;17.02.2013;2013;02;03;Sunnuntai;6;6;12;9;1;10
89;17.02.2013;2013;02;04;Sunnuntai;12;3;15;7;1;8
89;17.02.2013;2013;02;05;Sunnuntai;5;1;6;5;0;5
89;17.02.2013;2013;02;06;Sunnuntai;8;2;10;6;3;9
89;17.02.2013;2013;02;07;Sunnuntai;1;1;2;4;8;12
89;17.02.2013;2013;02;08;Sunnuntai;5;5;10;7;8;15
89;17.02.2013;2013;02;09;Sunnuntai;12;4;16;20;13;33
89;17.02.2013;2013;02;10;Sunnuntai;14;10;24;34;27;61
89;17.02.2013;2013;02;11;Sunnuntai;20;20;40;40;45;85
89;17.02.2013;2013;02;12;Sunnuntai;27;27;54;43;54;97
89;17.02.2013;2013;02;13;Sunnuntai;27;22;49;47;39;86
89;17.02.2013;2013;02;14;Sunnuntai;30;18;48;44;39;83
89;17.02.2013;2013;02;15;Sunnuntai;34;18;52;37;32;69
89;17.02.2013;2013;02;16;Sunnuntai;27;14;41;28;18;46
89;17.02.2013;2013;02;17;Sunnuntai;24;14;38;38;37;75
89;17.02.2013;2013;02;18;Sunnuntai;14;8;22;26;14;40
89;17.02.2013;2013;02;19;Sunnuntai;19;7;26;28;12;40
89;17.02.2013;2013;02;20;Sunnuntai;15;6;21;26;13;39
89;17.02.2013;2013;02;21;Sunnuntai;14;3;17;16;4;20
89;17.02.2013;2013;02;22;Sunnuntai;3;0;3;2;2;4
89;17.02.2013;2013;02;23;Sunnuntai;8;1;9;3;1;4
89;18.02.2013;2013;02;00;Maanantai;3;1;4;1;1;2
89;18.02.2013;2013;02;01;Maanantai;1;0;1;3;0;3
89;18.02.2013;2013;02;02;Maanantai;1;1;2;1;0;1
89;18.02.2013;2013;02;03;Maanantai;0;2;2;5;4;9
89;18.02.2013;2013;02;04;Maanantai;7;4;11;1;1;2
89;18.02.2013;2013;02;05;Maanantai;7;8;15;1;0;1
89;18.02.2013;2013;02;06;Maanantai;17;18;35;6;11;17
89;18.02.2013;2013;02;07;Maanantai;46;89;135;10;35;45
89;18.02.2013;2013;02;08;Maanantai;42;110;152;17;45;62
89;18.02.2013;2013;02;09;Maanantai;35;71;106;26;47;73
89;18.02.2013;2013;02;10;Maanantai;18;37;55;22;44;66
89;18.02.2013;2013;02;11;Maanantai;35;50;85;33;32;65
89;18.02.2013;2013;02;12;Maanantai;37;43;80;44;41;85
89;18.02.2013;2013;02;13;Maanantai;35;45;80;58;49;107
89;18.02.2013;2013;02;14;Maanantai;61;39;100;55;38;93
89;18.02.2013;2013;02;15;Maanantai;87;58;145;79;37;116
89;18.02.2013;2013;02;16;Maanantai;118;53;171;74;37;111
89;18.02.2013;2013;02;17;Maanantai;86;40;126;74;39;113
89;18.02.2013;2013;02;18;Maanantai;45;22;67;31;27;58
89;18.02.2013;2013;02;19;Maanantai;42;12;54;48;25;73
89;18.02.2013;2013;02;20;Maanantai;40;18;58;27;23;50
89;18.02.2013;2013;02;21;Maanantai;21;15;36;33;12;45
89;18.02.2013;2013;02;22;Maanantai;5;2;7;9;3;12
89;18.02.2013;2013;02;23;Maanantai;0;2;2;1;0;1
89;19.02.2013;2013;02;00;Tiistai;1;2;3;3;0;3
89;19.02.2013;2013;02;01;Tiistai;1;0;1;1;2;3
89;19.02.2013;2013;02;02;Tiistai;1;1;2;0;1;1
89;19.02.2013;2013;02;03;Tiistai;1;2;3;0;1;1
89;19.02.2013;2013;02;04;Tiistai;4;1;5;0;1;1
89;19.02.2013;2013;02;05;Tiistai;6;4;10;4;1;5
89;19.02.2013;2013;02;06;Tiistai;16;14;30;9;11;20
89;19.02.2013;2013;02;07;Tiistai;55;86;141;15;39;54
89;19.02.2013;2013;02;08;Tiistai;73;83;156;17;55;72
89;19.02.2013;2013;02;09;Tiistai;30;66;96;23;33;56
89;19.02.2013;2013;02;10;Tiistai;16;43;59;32;40;72
89;19.02.2013;2013;02;11;Tiistai;43;31;74;26;33;59
89;19.02.2013;2013;02;12;Tiistai;37;67;104;41;37;78
89;19.02.2013;2013;02;13;Tiistai;47;38;85;37;29;66
89;19.02.2013;2013;02;14;Tiistai;80;37;117;55;33;88
89;19.02.2013;2013;02;15;Tiistai;94;49;143;53;30;83
89;19.02.2013;2013;02;16;Tiistai;117;66;183;75;25;100
89;19.02.2013;2013;02;17;Tiistai;60;47;107;56;33;89
89;19.02.2013;2013;02;18;Tiistai;45;41;86;49;37;86
89;19.02.2013;2013;02;19;Tiistai;30;22;52;45;24;69
89;19.02.2013;2013;02;20;Tiistai;36;19;55;34;22;56
89;19.02.2013;2013;02;21;Tiistai;19;13;32;15;10;25
89;19.02.2013;2013;02;22;Tiistai;16;7;23;7;3;10
89;19.02.2013;2013;02;23;Tiistai;9;2;11;6;2;8
89;20.02.2013;2013;02;00;Keskiviikko;6;4;10;1;1;2
89;20.02.2013;2013;02;01;Keskiviikko;1;0;1;0;0;0
89;20.02.2013;2013;02;02;Keskiviikko;1;0;1;0;0;0
89;20.02.2013;2013;02;03;Keskiviikko;0;2;2;0;0;0
89;20.02.2013;2013;02;04;Keskiviikko;0;4;4;0;2;2
89;20.02.2013;2013;02;05;Keskiviikko;4;9;13;0;0;0
89;20.02.2013;2013;02;06;Keskiviikko;9;29;38;6;9;15
89;20.02.2013;2013;02;07;Keskiviikko;38;84;122;9;32;41
89;20.02.2013;2013;02;08;Keskiviikko;38;120;158;16;44;60
89;20.02.2013;2013;02;09;Keskiviikko;18;58;76;14;36;50
89;20.02.2013;2013;02;10;Keskiviikko;17;43;60;16;28;44
89;20.02.2013;2013;02;11;Keskiviikko;29;47;76;30;57;87
89;20.02.2013;2013;02;12;Keskiviikko;38;39;77;30;40;70
89;20.02.2013;2013;02;13;Keskiviikko;43;42;85;43;41;84
89;20.02.2013;2013;02;14;Keskiviikko;72;40;112;43;26;69
89;20.02.2013;2013;02;15;Keskiviikko;97;42;139;51;28;79
89;20.02.2013;2013;02;16;Keskiviikko;127;43;170;67;24;91
89;20.02.2013;2013;02;17;Keskiviikko;73;56;129;54;23;77
89;20.02.2013;2013;02;18;Keskiviikko;52;27;79;38;26;64
89;20.02.2013;2013;02;19;Keskiviikko;39;31;70;28;26;54
89;20.02.2013;2013;02;20;Keskiviikko;41;29;70;22;24;46
89;20.02.2013;2013;02;21;Keskiviikko;44;9;53;12;8;20
89;20.02.2013;2013;02;22;Keskiviikko;15;2;17;3;6;9
89;20.02.2013;2013;02;23;Keskiviikko;5;1;6;2;4;6
89;21.02.2013;2013;02;00;Torstai;0;1;1;2;0;2
89;21.02.2013;2013;02;01;Torstai;0;1;1;0;2;2
89;21.02.2013;2013;02;02;Torstai;0;1;1;3;1;4
89;21.02.2013;2013;02;03;Torstai;3;1;4;2;0;2
89;21.02.2013;2013;02;04;Torstai;2;2;4;2;2;4
89;21.02.2013;2013;02;05;Torstai;2;8;10;0;1;1
89;21.02.2013;2013;02;06;Torstai;11;25;36;9;9;18
89;21.02.2013;2013;02;07;Torstai;51;94;145;8;43;51
89;21.02.2013;2013;02;08;Torstai;61;113;174;16;38;54
89;21.02.2013;2013;02;09;Torstai;30;66;96;14;39;53
89;21.02.2013;2013;02;10;Torstai;35;37;72;20;33;53
89;21.02.2013;2013;02;11;Torstai;35;50;85;25;32;57
89;21.02.2013;2013;02;12;Torstai;41;50;91;28;30;58
89;21.02.2013;2013;02;13;Torstai;61;47;108;26;25;51
89;21.02.2013;2013;02;14;Torstai;83;58;141;35;24;59
89;21.02.2013;2013;02;15;Torstai;120;31;151;47;26;73
89;21.02.2013;2013;02;16;Torstai;132;60;192;51;32;83
89;21.02.2013;2013;02;17;Torstai;82;42;124;55;29;84
89;21.02.2013;2013;02;18;Torstai;66;24;90;42;28;70
89;21.02.2013;2013;02;19;Torstai;39;24;63;36;32;68
89;21.02.2013;2013;02;20;Torstai;48;15;63;29;21;50
89;21.02.2013;2013;02;21;Torstai;45;11;56;12;5;17
89;21.02.2013;2013;02;22;Torstai;15;5;20;10;2;12
89;21.02.2013;2013;02;23;Torstai;12;5;17;2;5;7
89;22.02.2013;2013;02;00;Perjantai;3;1;4;0;5;5
89;22.02.2013;2013;02;01;Perjantai;2;3;5;1;1;2
89;22.02.2013;2013;02;02;Perjantai;5;5;10;3;1;4
89;22.02.2013;2013;02;03;Perjantai;1;2;3;2;0;2
89;22.02.2013;2013;02;04;Perjantai;2;3;5;0;2;2
89;22.02.2013;2013;02;05;Perjantai;4;8;12;2;1;3
89;22.02.2013;2013;02;06;Perjantai;13;24;37;5;7;12
89;22.02.2013;2013;02;07;Perjantai;40;84;124;3;43;46
89;22.02.2013;2013;02;08;Perjantai;52;118;170;13;41;54
89;22.02.2013;2013;02;09;Perjantai;39;73;112;19;31;50
89;22.02.2013;2013;02;10;Perjantai;29;46;75;19;31;50
89;22.02.2013;2013;02;11;Perjantai;29;51;80;24;36;60
89;22.02.2013;2013;02;12;Perjantai;54;63;117;38;47;85
89;22.02.2013;2013;02;13;Perjantai;72;48;120;52;46;98
89;22.02.2013;2013;02;14;Perjantai;62;45;107;47;31;78
89;22.02.2013;2013;02;15;Perjantai;95;44;139;47;36;83
89;22.02.2013;2013;02;16;Perjantai;107;47;154;52;26;78
89;22.02.2013;2013;02;17;Perjantai;60;51;111;37;30;67
89;22.02.2013;2013;02;18;Perjantai;45;35;80;31;28;59
89;22.02.2013;2013;02;19;Perjantai;46;19;65;18;22;40
89;22.02.2013;2013;02;20;Perjantai;38;22;60;14;11;25
89;22.02.2013;2013;02;21;Perjantai;26;15;41;9;9;18
89;22.02.2013;2013;02;22;Perjantai;9;17;26;8;9;17
89;22.02.2013;2013;02;23;Perjantai;11;3;14;3;6;9
89;23.02.2013;2013;02;00;Lauantai;6;5;11;10;7;17
89;23.02.2013;2013;02;01;Lauantai;11;4;15;3;0;3
89;23.02.2013;2013;02;02;Lauantai;13;3;16;5;3;8
89;23.02.2013;2013;02;03;Lauantai;10;2;12;15;0;15
89;23.02.2013;2013;02;04;Lauantai;10;1;11;6;2;8
89;23.02.2013;2013;02;05;Lauantai;3;2;5;3;3;6
89;23.02.2013;2013;02;06;Lauantai;6;4;10;2;2;4
89;23.02.2013;2013;02;07;Lauantai;6;15;21;5;5;10
89;23.02.2013;2013;02;08;Lauantai;13;12;25;9;11;20
89;23.02.2013;2013;02;09;Lauantai;19;22;41;13;21;34
89;23.02.2013;2013;02;10;Lauantai;21;38;59;21;33;54
89;23.02.2013;2013;02;11;Lauantai;41;37;78;29;51;80
89;23.02.2013;2013;02;12;Lauantai;30;40;70;30;47;77
89;23.02.2013;2013;02;13;Lauantai;42;41;83;39;50;89
89;23.02.2013;2013;02;14;Lauantai;49;35;84;37;20;57
89;23.02.2013;2013;02;15;Lauantai;35;28;63;47;27;74
89;23.02.2013;2013;02;16;Lauantai;40;17;57;38;21;59
89;23.02.2013;2013;02;17;Lauantai;26;23;49;54;23;77
89;23.02.2013;2013;02;18;Lauantai;26;37;63;28;29;57
89;23.02.2013;2013;02;19;Lauantai;18;21;39;22;15;37
89;23.02.2013;2013;02;20;Lauantai;14;16;30;16;7;23
89;23.02.2013;2013;02;21;Lauantai;10;16;26;14;11;25
89;23.02.2013;2013;02;22;Lauantai;10;17;27;6;7;13
89;23.02.2013;2013;02;23;Lauantai;14;15;29;10;19;29
89;24.02.2013;2013;02;00;Sunnuntai;7;16;23;5;7;12
89;24.02.2013;2013;02;01;Sunnuntai;8;5;13;5;5;10
89;24.02.2013;2013;02;02;Sunnuntai;23;1;24;8;1;9
89;24.02.2013;2013;02;03;Sunnuntai;20;2;22;10;0;10
89;24.02.2013;2013;02;04;Sunnuntai;17;2;19;14;1;15
89;24.02.2013;2013;02;05;Sunnuntai;2;2;4;0;0;0
89;24.02.2013;2013;02;06;Sunnuntai;2;1;3;6;2;8
89;24.02.2013;2013;02;07;Sunnuntai;1;1;2;3;6;9
89;24.02.2013;2013;02;08;Sunnuntai;3;6;9;8;10;18
89;24.02.2013;2013;02;09;Sunnuntai;11;15;26;20;20;40
89;24.02.2013;2013;02;10;Sunnuntai;12;15;27;35;37;72
89;24.02.2013;2013;02;11;Sunnuntai;20;23;43;57;55;112
89;24.02.2013;2013;02;12;Sunnuntai;19;30;49;79;74;153
89;24.02.2013;2013;02;13;Sunnuntai;35;46;81;86;87;173
89;24.02.2013;2013;02;14;Sunnuntai;42;51;93;78;77;155
89;24.02.2013;2013;02;15;Sunnuntai;42;42;84;71;66;137
89;24.02.2013;2013;02;16;Sunnuntai;38;36;74;61;53;114
89;24.02.2013;2013;02;17;Sunnuntai;27;33;60;52;31;83
89;24.02.2013;2013;02;18;Sunnuntai;34;19;53;25;24;49
89;24.02.2013;2013;02;19;Sunnuntai;23;17;40;26;17;43
89;24.02.2013;2013;02;20;Sunnuntai;15;12;27;26;15;41
89;24.02.2013;2013;02;21;Sunnuntai;11;6;17;9;2;11
89;24.02.2013;2013;02;22;Sunnuntai;4;2;6;9;1;10
89;24.02.2013;2013;02;23;Sunnuntai;3;1;4;0;2;2
89;25.02.2013;2013;02;00;Maanantai;5;1;6;2;4;6
89;25.02.2013;2013;02;01;Maanantai;2;0;2;1;0;1
89;25.02.2013;2013;02;02;Maanantai;2;0;2;0;1;1
89;25.02.2013;2013;02;03;Maanantai;0;1;1;1;0;1
89;25.02.2013;2013;02;04;Maanantai;2;6;8;0;3;3
89;25.02.2013;2013;02;05;Maanantai;1;6;7;1;1;2
89;25.02.2013;2013;02;06;Maanantai;12;29;41;6;9;15
89;25.02.2013;2013;02;07;Maanantai;19;111;130;13;41;54
89;25.02.2013;2013;02;08;Maanantai;30;114;144;24;41;65
89;25.02.2013;2013;02;09;Maanantai;28;93;121;24;54;78
89;25.02.2013;2013;02;10;Maanantai;19;58;77;29;48;77
89;25.02.2013;2013;02;11;Maanantai;41;54;95;42;43;85
89;25.02.2013;2013;02;12;Maanantai;25;57;82;60;47;107
89;25.02.2013;2013;02;13;Maanantai;40;61;101;50;48;98
89;25.02.2013;2013;02;14;Maanantai;80;54;134;57;27;84
89;25.02.2013;2013;02;15;Maanantai;102;41;143;54;40;94
89;25.02.2013;2013;02;16;Maanantai;138;54;192;95;29;124
89;25.02.2013;2013;02;17;Maanantai;78;48;126;58;24;82
89;25.02.2013;2013;02;18;Maanantai;45;40;85;51;23;74
89;25.02.2013;2013;02;19;Maanantai;37;17;54;29;27;56
89;25.02.2013;2013;02;20;Maanantai;44;31;75;27;19;46
89;25.02.2013;2013;02;21;Maanantai;30;12;42;16;12;28
89;25.02.2013;2013;02;22;Maanantai;7;3;10;6;3;9
89;25.02.2013;2013;02;23;Maanantai;6;3;9;3;4;7
89;26.02.2013;2013;02;00;Tiistai;0;1;1;2;0;2
89;26.02.2013;2013;02;01;Tiistai;1;1;2;1;1;2
89;26.02.2013;2013;02;02;Tiistai;1;0;1;1;0;1
89;26.02.2013;2013;02;03;Tiistai;2;2;4;1;0;1
89;26.02.2013;2013;02;04;Tiistai;0;4;4;0;1;1
89;26.02.2013;2013;02;05;Tiistai;0;9;9;1;1;2
89;26.02.2013;2013;02;06;Tiistai;6;26;32;3;13;16
89;26.02.2013;2013;02;07;Tiistai;27;86;113;10;37;47
89;26.02.2013;2013;02;08;Tiistai;31;129;160;19;44;63
89;26.02.2013;2013;02;09;Tiistai;24;59;83;24;48;72
89;26.02.2013;2013;02;10;Tiistai;18;45;63;32;35;67
89;26.02.2013;2013;02;11;Tiistai;27;35;62;25;36;61
89;26.02.2013;2013;02;12;Tiistai;43;37;80;36;43;79
89;26.02.2013;2013;02;13;Tiistai;48;47;95;42;35;77
89;26.02.2013;2013;02;14;Tiistai;57;41;98;60;32;92
89;26.02.2013;2013;02;15;Tiistai;91;49;140;69;41;110
89;26.02.2013;2013;02;16;Tiistai;109;56;165;83;52;135
89;26.02.2013;2013;02;17;Tiistai;69;53;122;67;32;99
89;26.02.2013;2013;02;18;Tiistai;36;29;65;51;28;79
89;26.02.2013;2013;02;19;Tiistai;37;29;66;44;20;64
89;26.02.2013;2013;02;20;Tiistai;36;25;61;39;14;53
89;26.02.2013;2013;02;21;Tiistai;28;12;40;21;8;29
89;26.02.2013;2013;02;22;Tiistai;2;7;9;13;6;19
89;26.02.2013;2013;02;23;Tiistai;8;7;15;4;6;10
89;27.02.2013;2013;02;00;Keskiviikko;1;0;1;4;0;4
89;27.02.2013;2013;02;01;Keskiviikko;4;0;4;2;1;3
89;27.02.2013;2013;02;02;Keskiviikko;2;2;4;1;3;4
89;27.02.2013;2013;02;03;Keskiviikko;4;5;9;2;0;2
89;27.02.2013;2013;02;04;Keskiviikko;1;4;5;3;0;3
89;27.02.2013;2013;02;05;Keskiviikko;3;13;16;2;2;4
89;27.02.2013;2013;02;06;Keskiviikko;9;29;38;11;13;24
89;27.02.2013;2013;02;07;Keskiviikko;34;103;137;17;48;65
89;27.02.2013;2013;02;08;Keskiviikko;23;140;163;18;44;62
89;27.02.2013;2013;02;09;Keskiviikko;26;80;106;31;66;97
89;27.02.2013;2013;02;10;Keskiviikko;23;51;74;39;44;83
89;27.02.2013;2013;02;11;Keskiviikko;35;38;73;34;32;66
89;27.02.2013;2013;02;12;Keskiviikko;41;51;92;27;47;74
89;27.02.2013;2013;02;13;Keskiviikko;55;54;109;41;31;72
89;27.02.2013;2013;02;14;Keskiviikko;64;38;102;52;30;82
89;27.02.2013;2013;02;15;Keskiviikko;90;51;141;43;21;64
89;27.02.2013;2013;02;16;Keskiviikko;137;58;195;61;33;94
89;27.02.2013;2013;02;17;Keskiviikko;75;49;124;49;40;89
89;27.02.2013;2013;02;18;Keskiviikko;41;34;75;51;29;80
89;27.02.2013;2013;02;19;Keskiviikko;44;24;68;28;22;50
89;27.02.2013;2013;02;20;Keskiviikko;37;23;60;26;30;56
89;27.02.2013;2013;02;21;Keskiviikko;24;9;33;20;11;31
89;27.02.2013;2013;02;22;Keskiviikko;11;3;14;9;3;12
89;27.02.2013;2013;02;23;Keskiviikko;4;0;4;5;2;7
89;28.02.2013;2013;02;00;Torstai;1;1;2;5;1;6
89;28.02.2013;2013;02;01;Torstai;3;0;3;3;2;5
89;28.02.2013;2013;02;02;Torstai;1;0;1;0;0;0
89;28.02.2013;2013;02;03;Torstai;3;2;5;0;1;1
89;28.02.2013;2013;02;04;Torstai;2;5;7;1;3;4
89;28.02.2013;2013;02;05;Torstai;5;17;22;3;2;5
89;28.02.2013;2013;02;06;Torstai;7;25;32;3;8;11
89;28.02.2013;2013;02;07;Torstai;29;110;139;12;43;55
89;28.02.2013;2013;02;08;Torstai;33;121;154;18;50;68
89;28.02.2013;2013;02;09;Torstai;19;61;80;18;45;63
89;28.02.2013;2013;02;10;Torstai;17;51;68;34;53;87
89;28.02.2013;2013;02;11;Torstai;30;55;85;38;44;82
89;28.02.2013;2013;02;12;Torstai;28;41;69;39;39;78
89;28.02.2013;2013;02;13;Torstai;51;49;100;33;39;72
89;28.02.2013;2013;02;14;Torstai;58;41;99;37;26;63
89;28.02.2013;2013;02;15;Torstai;89;51;140;56;15;71
89;28.02.2013;2013;02;16;Torstai;98;41;139;35;11;46
89;28.02.2013;2013;02;17;Torstai;47;38;85;31;20;51
89;28.02.2013;2013;02;18;Torstai;42;28;70;28;14;42
89;28.02.2013;2013;02;19;Torstai;33;20;53;29;25;54
89;28.02.2013;2013;02;20;Torstai;25;16;41;24;14;38
89;28.02.2013;2013;02;21;Torstai;30;11;41;26;5;31
89;28.02.2013;2013;02;22;Torstai;11;7;18;1;8;9
89;28.02.2013;2013;02;23;Torstai;8;4;12;5;3;8
89;01.03.2013;2013;03;00;Perjantai;3;1;4;3;0;3
89;01.03.2013;2013;03;01;Perjantai;6;2;8;4;0;4
89;01.03.2013;2013;03;02;Perjantai;3;0;3;2;2;4
89;01.03.2013;2013;03;03;Perjantai;1;3;4;3;3;6
89;01.03.2013;2013;03;04;Perjantai;2;4;6;3;1;4
89;01.03.2013;2013;03;05;Perjantai;1;8;9;1;2;3
89;01.03.2013;2013;03;06;Perjantai;6;23;29;7;11;18
89;01.03.2013;2013;03;07;Perjantai;12;85;97;13;30;43
89;01.03.2013;2013;03;08;Perjantai;26;91;117;15;49;64
89;01.03.2013;2013;03;09;Perjantai;20;60;80;18;34;52
89;01.03.2013;2013;03;10;Perjantai;21;55;76;24;35;59
89;01.03.2013;2013;03;11;Perjantai;24;36;60;27;34;61
89;01.03.2013;2013;03;12;Perjantai;37;43;80;45;39;84
89;01.03.2013;2013;03;13;Perjantai;49;46;95;53;25;78
89;01.03.2013;2013;03;14;Perjantai;53;47;100;57;30;87
89;01.03.2013;2013;03;15;Perjantai;56;42;98;47;38;85
89;01.03.2013;2013;03;16;Perjantai;72;29;101;54;21;75
89;01.03.2013;2013;03;17;Perjantai;44;38;82;50;34;84
89;01.03.2013;2013;03;18;Perjantai;33;22;55;25;17;42
89;01.03.2013;2013;03;19;Perjantai;32;19;51;14;15;29
89;01.03.2013;2013;03;20;Perjantai;24;13;37;12;6;18
89;01.03.2013;2013;03;21;Perjantai;14;12;26;14;15;29
89;01.03.2013;2013;03;22;Perjantai;16;9;25;1;5;6
89;01.03.2013;2013;03;23;Perjantai;6;4;10;3;4;7
89;02.03.2013;2013;03;00;Lauantai;5;5;10;2;3;5
89;02.03.2013;2013;03;01;Lauantai;4;2;6;8;1;9
89;02.03.2013;2013;03;02;Lauantai;5;1;6;7;2;9
89;02.03.2013;2013;03;03;Lauantai;5;1;6;3;0;3
89;02.03.2013;2013;03;04;Lauantai;9;2;11;9;4;13
89;02.03.2013;2013;03;05;Lauantai;3;1;4;1;1;2
89;02.03.2013;2013;03;06;Lauantai;3;7;10;3;5;8
89;02.03.2013;2013;03;07;Lauantai;0;6;6;1;9;10
89;02.03.2013;2013;03;08;Lauantai;5;9;14;12;16;28
89;02.03.2013;2013;03;09;Lauantai;1;29;30;15;15;30
89;02.03.2013;2013;03;10;Lauantai;13;24;37;23;35;58
89;02.03.2013;2013;03;11;Lauantai;22;25;47;25;41;66
89;02.03.2013;2013;03;12;Lauantai;23;35;58;36;53;89
89;02.03.2013;2013;03;13;Lauantai;27;25;52;36;33;69
89;02.03.2013;2013;03;14;Lauantai;21;26;47;28;27;55
89;02.03.2013;2013;03;15;Lauantai;32;18;50;32;32;64
89;02.03.2013;2013;03;16;Lauantai;27;21;48;21;25;46
89;02.03.2013;2013;03;17;Lauantai;22;22;44;27;21;48
89;02.03.2013;2013;03;18;Lauantai;20;14;34;17;10;27
89;02.03.2013;2013;03;19;Lauantai;12;11;23;13;13;26
89;02.03.2013;2013;03;20;Lauantai;9;7;16;5;6;11
89;02.03.2013;2013;03;21;Lauantai;2;9;11;6;6;12
89;02.03.2013;2013;03;22;Lauantai;7;16;23;7;8;15
89;02.03.2013;2013;03;23;Lauantai;8;6;14;2;4;6
89;03.03.2013;2013;03;00;Sunnuntai;4;6;10;0;12;12
89;03.03.2013;2013;03;01;Sunnuntai;4;7;11;5;5;10
89;03.03.2013;2013;03;02;Sunnuntai;6;0;6;3;3;6
89;03.03.2013;2013;03;03;Sunnuntai;5;0;5;6;1;7
89;03.03.2013;2013;03;04;Sunnuntai;8;2;10;6;1;7
89;03.03.2013;2013;03;05;Sunnuntai;2;1;3;1;2;3
89;03.03.2013;2013;03;06;Sunnuntai;2;6;8;1;1;2
89;03.03.2013;2013;03;07;Sunnuntai;1;4;5;2;7;9
89;03.03.2013;2013;03;08;Sunnuntai;2;2;4;8;10;18
89;03.03.2013;2013;03;09;Sunnuntai;8;16;24;14;12;26
89;03.03.2013;2013;03;10;Sunnuntai;5;10;15;22;42;64
89;03.03.2013;2013;03;11;Sunnuntai;14;30;44;46;40;86
89;03.03.2013;2013;03;12;Sunnuntai;18;39;57;36;59;95
89;03.03.2013;2013;03;13;Sunnuntai;21;26;47;71;70;141
89;03.03.2013;2013;03;14;Sunnuntai;29;22;51;54;61;115
89;03.03.2013;2013;03;15;Sunnuntai;26;17;43;59;37;96
89;03.03.2013;2013;03;16;Sunnuntai;29;15;44;39;31;70
89;03.03.2013;2013;03;17;Sunnuntai;22;17;39;39;22;61
89;03.03.2013;2013;03;18;Sunnuntai;19;15;34;18;10;28
89;03.03.2013;2013;03;19;Sunnuntai;6;7;13;13;13;26
89;03.03.2013;2013;03;20;Sunnuntai;13;8;21;11;5;16
89;03.03.2013;2013;03;21;Sunnuntai;15;6;21;5;4;9
89;03.03.2013;2013;03;22;Sunnuntai;7;2;9;8;2;10
89;03.03.2013;2013;03;23;Sunnuntai;5;1;6;3;2;5
89;04.03.2013;2013;03;00;Maanantai;1;1;2;1;1;2
89;04.03.2013;2013;03;01;Maanantai;0;0;0;0;1;1
89;04.03.2013;2013;03;02;Maanantai;1;1;2;0;0;0
89;04.03.2013;2013;03;03;Maanantai;0;1;1;0;0;0
89;04.03.2013;2013;03;04;Maanantai;0;6;6;2;1;3
89;04.03.2013;2013;03;05;Maanantai;4;11;15;2;0;2
89;04.03.2013;2013;03;06;Maanantai;9;30;39;1;6;7
89;04.03.2013;2013;03;07;Maanantai;24;62;86;7;26;33
89;04.03.2013;2013;03;08;Maanantai;16;68;84;5;35;40
89;04.03.2013;2013;03;09;Maanantai;17;39;56;10;34;44
89;04.03.2013;2013;03;10;Maanantai;17;32;49;18;31;49
89;04.03.2013;2013;03;11;Maanantai;23;31;54;23;32;55
89;04.03.2013;2013;03;12;Maanantai;21;37;58;26;24;50
89;04.03.2013;2013;03;13;Maanantai;29;45;74;61;50;111
89;04.03.2013;2013;03;14;Maanantai;51;36;87;41;45;86
89;04.03.2013;2013;03;15;Maanantai;71;37;108;41;30;71
89;04.03.2013;2013;03;16;Maanantai;90;40;130;45;20;65
89;04.03.2013;2013;03;17;Maanantai;56;38;94;41;18;59
89;04.03.2013;2013;03;18;Maanantai;42;21;63;32;23;55
89;04.03.2013;2013;03;19;Maanantai;36;17;53;18;15;33
89;04.03.2013;2013;03;20;Maanantai;35;10;45;21;6;27
89;04.03.2013;2013;03;21;Maanantai;21;13;34;10;12;22
89;04.03.2013;2013;03;22;Maanantai;6;6;12;2;5;7
89;04.03.2013;2013;03;23;Maanantai;5;3;8;1;1;2
89;05.03.2013;2013;03;00;Tiistai;0;1;1;2;0;2
89;05.03.2013;2013;03;01;Tiistai;2;3;5;2;1;3
89;05.03.2013;2013;03;02;Tiistai;1;0;1;2;2;4
89;05.03.2013;2013;03;03;Tiistai;0;3;3;1;0;1
89;05.03.2013;2013;03;04;Tiistai;0;4;4;2;1;3
89;05.03.2013;2013;03;05;Tiistai;3;10;13;3;0;3
89;05.03.2013;2013;03;06;Tiistai;11;29;40;4;8;12
89;05.03.2013;2013;03;07;Tiistai;29;74;103;3;32;35
89;05.03.2013;2013;03;08;Tiistai;19;86;105;8;29;37
89;05.03.2013;2013;03;09;Tiistai;23;44;67;15;23;38
89;05.03.2013;2013;03;10;Tiistai;18;36;54;21;37;58
89;05.03.2013;2013;03;11;Tiistai;27;35;62;27;46;73
89;05.03.2013;2013;03;12;Tiistai;26;39;65;39;30;69
89;05.03.2013;2013;03;13;Tiistai;35;39;74;21;25;46
89;05.03.2013;2013;03;14;Tiistai;45;35;80;24;31;55
89;05.03.2013;2013;03;15;Tiistai;66;41;107;29;19;48
89;05.03.2013;2013;03;16;Tiistai;87;38;125;41;17;58
89;05.03.2013;2013;03;17;Tiistai;62;21;83;25;20;45
89;05.03.2013;2013;03;18;Tiistai;38;36;74;22;18;40
89;05.03.2013;2013;03;19;Tiistai;22;34;56;18;17;35
89;05.03.2013;2013;03;20;Tiistai;34;13;47;22;13;35
89;05.03.2013;2013;03;21;Tiistai;34;6;40;12;6;18
89;05.03.2013;2013;03;22;Tiistai;9;4;13;7;5;12
89;05.03.2013;2013;03;23;Tiistai;5;1;6;2;1;3
89;06.03.2013;2013;03;00;Keskiviikko;6;0;6;3;0;3
89;06.03.2013;2013;03;01;Keskiviikko;2;1;3;0;1;1
89;06.03.2013;2013;03;02;Keskiviikko;3;1;4;1;0;1
89;06.03.2013;2013;03;03;Keskiviikko;0;3;3;5;3;8
89;06.03.2013;2013;03;04;Keskiviikko;0;5;5;0;1;1
89;06.03.2013;2013;03;05;Keskiviikko;4;11;15;1;0;1
89;06.03.2013;2013;03;06;Keskiviikko;10;27;37;7;3;10
89;06.03.2013;2013;03;07;Keskiviikko;19;63;82;5;28;33
89;06.03.2013;2013;03;08;Keskiviikko;13;75;88;8;34;42
89;06.03.2013;2013;03;09;Keskiviikko;18;40;58;10;37;47
89;06.03.2013;2013;03;10;Keskiviikko;17;30;47;9;25;34
89;06.03.2013;2013;03;11;Keskiviikko;21;26;47;27;44;71
89;06.03.2013;2013;03;12;Keskiviikko;18;29;47;26;23;49
89;06.03.2013;2013;03;13;Keskiviikko;21;26;47;23;22;45
89;06.03.2013;2013;03;14;Keskiviikko;35;16;51;43;17;60
89;06.03.2013;2013;03;15;Keskiviikko;47;9;56;18;6;24
89;06.03.2013;2013;03;16;Keskiviikko;58;15;73;15;1;16
89;06.03.2013;2013;03;17;Keskiviikko;45;15;60;6;0;6
89;06.03.2013;2013;03;18;Keskiviikko;27;7;34;11;0;11
89;06.03.2013;2013;03;19;Keskiviikko;26;5;31;11;0;11
89;06.03.2013;2013;03;20;Keskiviikko;18;1;19;17;0;17
89;06.03.2013;2013;03;21;Keskiviikko;13;2;15;6;2;8
89;06.03.2013;2013;03;22;Keskiviikko;8;0;8;3;0;3
89;06.03.2013;2013;03;23;Keskiviikko;6;2;8;1;1;2
89;07.03.2013;2013;03;00;Torstai;2;0;2;6;0;6
89;07.03.2013;2013;03;01;Torstai;3;0;3;2;0;2
89;07.03.2013;2013;03;02;Torstai;2;1;3;1;0;1
89;07.03.2013;2013;03;03;Torstai;2;0;2;3;0;3
89;07.03.2013;2013;03;04;Torstai;4;1;5;2;0;2
89;07.03.2013;2013;03;05;Torstai;13;2;15;1;0;1
89;07.03.2013;2013;03;06;Torstai;33;6;39;4;0;4
89;07.03.2013;2013;03;07;Torstai;58;16;74;24;4;28
89;07.03.2013;2013;03;08;Torstai;85;9;94;19;8;27
89;07.03.2013;2013;03;09;Torstai;44;5;49;18;13;31
89;07.03.2013;2013;03;10;Torstai;45;11;56;16;17;33
89;07.03.2013;2013;03;11;Torstai;38;11;49;29;19;48
89;07.03.2013;2013;03;12;Torstai;44;22;66;48;19;67
89;07.03.2013;2013;03;13;Torstai;50;16;66;48;29;77
89;07.03.2013;2013;03;14;Torstai;65;20;85;45;38;83
89;07.03.2013;2013;03;15;Torstai;96;21;117;42;31;73
89;07.03.2013;2013;03;16;Torstai;89;23;112;50;27;77
89;07.03.2013;2013;03;17;Torstai;75;20;95;45;21;66
89;07.03.2013;2013;03;18;Torstai;56;11;67;32;20;52
89;07.03.2013;2013;03;19;Torstai;24;12;36;15;8;23
89;07.03.2013;2013;03;20;Torstai;29;6;35;14;11;25
89;07.03.2013;2013;03;21;Torstai;24;7;31;6;7;13
89;07.03.2013;2013;03;22;Torstai;14;3;17;8;8;16
89;07.03.2013;2013;03;23;Torstai;0;11;11;4;2;6
89;08.03.2013;2013;03;00;Perjantai;1;1;2;0;1;1
89;08.03.2013;2013;03;01;Perjantai;2;0;2;6;0;6
89;08.03.2013;2013;03;02;Perjantai;3;0;3;0;0;0
89;08.03.2013;2013;03;03;Perjantai;2;2;4;2;0;2
89;08.03.2013;2013;03;04;Perjantai;7;0;7;4;1;5
89;08.03.2013;2013;03;05;Perjantai;4;7;11;3;2;5
89;08.03.2013;2013;03;06;Perjantai;21;16;37;5;1;6
89;08.03.2013;2013;03;07;Perjantai;48;32;80;12;18;30
89;08.03.2013;2013;03;08;Perjantai;40;48;88;20;27;47
89;08.03.2013;2013;03;09;Perjantai;28;34;62;15;30;45
89;08.03.2013;2013;03;10;Perjantai;24;30;54;20;23;43
89;08.03.2013;2013;03;11;Perjantai;30;39;69;28;36;64
89;08.03.2013;2013;03;12;Perjantai;26;43;69;18;43;61
89;08.03.2013;2013;03;13;Perjantai;45;42;87;26;26;52
89;08.03.2013;2013;03;14;Perjantai;50;48;98;33;40;73
89;08.03.2013;2013;03;15;Perjantai;61;32;93;46;32;78
89;08.03.2013;2013;03;16;Perjantai;76;36;112;43;31;74
89;08.03.2013;2013;03;17;Perjantai;52;24;76;22;16;38
89;08.03.2013;2013;03;18;Perjantai;37;23;60;31;24;55
89;08.03.2013;2013;03;19;Perjantai;29;19;48;13;16;29
89;08.03.2013;2013;03;20;Perjantai;22;15;37;5;12;17
89;08.03.2013;2013;03;21;Perjantai;15;9;24;6;5;11
89;08.03.2013;2013;03;22;Perjantai;13;9;22;3;5;8
89;08.03.2013;2013;03;23;Perjantai;9;11;20;5;5;10
89;09.03.2013;2013;03;00;Lauantai;5;4;9;8;1;9
89;09.03.2013;2013;03;01;Lauantai;5;1;6;6;0;6
89;09.03.2013;2013;03;02;Lauantai;6;2;8;6;0;6
89;09.03.2013;2013;03;03;Lauantai;2;0;2;4;1;5
89;09.03.2013;2013;03;04;Lauantai;7;3;10;5;1;6
89;09.03.2013;2013;03;05;Lauantai;2;7;9;2;1;3
89;09.03.2013;2013;03;06;Lauantai;3;5;8;2;4;6
89;09.03.2013;2013;03;07;Lauantai;5;9;14;8;1;9
89;09.03.2013;2013;03;08;Lauantai;1;14;15;6;8;14
89;09.03.2013;2013;03;09;Lauantai;7;15;22;18;14;32
89;09.03.2013;2013;03;10;Lauantai;10;35;45;23;31;54
89;09.03.2013;2013;03;11;Lauantai;21;29;50;24;28;52
89;09.03.2013;2013;03;12;Lauantai;14;34;48;55;49;104
89;09.03.2013;2013;03;13;Lauantai;27;21;48;40;45;85
89;09.03.2013;2013;03;14;Lauantai;33;34;67;47;43;90
89;09.03.2013;2013;03;15;Lauantai;35;24;59;53;50;103
89;09.03.2013;2013;03;16;Lauantai;28;21;49;35;19;54
89;09.03.2013;2013;03;17;Lauantai;25;23;48;27;18;45
89;09.03.2013;2013;03;18;Lauantai;30;14;44;13;15;28
89;09.03.2013;2013;03;19;Lauantai;12;14;26;11;16;27
89;09.03.2013;2013;03;20;Lauantai;11;12;23;4;10;14
89;09.03.2013;2013;03;21;Lauantai;6;7;13;6;3;9
89;09.03.2013;2013;03;22;Lauantai;11;6;17;2;7;9
89;09.03.2013;2013;03;23;Lauantai;3;8;11;2;1;3
89;10.03.2013;2013;03;00;Sunnuntai;8;10;18;6;5;11
89;10.03.2013;2013;03;01;Sunnuntai;10;3;13;4;1;5
89;10.03.2013;2013;03;02;Sunnuntai;10;6;16;5;2;7
89;10.03.2013;2013;03;03;Sunnuntai;10;1;11;4;1;5
89;10.03.2013;2013;03;04;Sunnuntai;3;1;4;5;0;5
89;10.03.2013;2013;03;05;Sunnuntai;1;3;4;0;1;1
89;10.03.2013;2013;03;06;Sunnuntai;3;2;5;1;3;4
89;10.03.2013;2013;03;07;Sunnuntai;2;3;5;4;5;9
89;10.03.2013;2013;03;08;Sunnuntai;3;2;5;11;6;17
89;10.03.2013;2013;03;09;Sunnuntai;3;12;15;22;19;41
89;10.03.2013;2013;03;10;Sunnuntai;3;11;14;22;25;47
89;10.03.2013;2013;03;11;Sunnuntai;14;25;39;40;38;78
89;10.03.2013;2013;03;12;Sunnuntai;18;28;46;44;47;91
89;10.03.2013;2013;03;13;Sunnuntai;22;17;39;54;53;107
89;10.03.2013;2013;03;14;Sunnuntai;28;21;49;49;51;100
89;10.03.2013;2013;03;15;Sunnuntai;28;17;45;71;29;100
89;10.03.2013;2013;03;16;Sunnuntai;21;17;38;31;19;50
89;10.03.2013;2013;03;17;Sunnuntai;30;19;49;31;24;55
89;10.03.2013;2013;03;18;Sunnuntai;24;14;38;30;24;54
89;10.03.2013;2013;03;19;Sunnuntai;21;7;28;24;21;45
89;10.03.2013;2013;03;20;Sunnuntai;10;7;17;17;13;30
89;10.03.2013;2013;03;21;Sunnuntai;13;8;21;11;7;18
89;10.03.2013;2013;03;22;Sunnuntai;5;0;5;7;3;10
89;10.03.2013;2013;03;23;Sunnuntai;3;1;4;9;1;10
89;11.03.2013;2013;03;00;Maanantai;1;3;4;0;1;1
89;11.03.2013;2013;03;01;Maanantai;0;2;2;0;0;0
89;11.03.2013;2013;03;02;Maanantai;0;0;0;0;0;0
89;11.03.2013;2013;03;03;Maanantai;0;1;1;1;1;2
89;11.03.2013;2013;03;04;Maanantai;0;5;5;0;1;1
89;11.03.2013;2013;03;05;Maanantai;0;13;13;0;2;2
89;11.03.2013;2013;03;06;Maanantai;7;19;26;2;1;3
89;11.03.2013;2013;03;07;Maanantai;24;74;98;15;28;43
89;11.03.2013;2013;03;08;Maanantai;37;177;214;14;53;67
89;11.03.2013;2013;03;09;Maanantai;30;81;111;18;47;65
89;11.03.2013;2013;03;10;Maanantai;15;51;66;19;43;62
89;11.03.2013;2013;03;11;Maanantai;28;42;70;30;41;71
89;11.03.2013;2013;03;12;Maanantai;28;43;71;38;41;79
89;11.03.2013;2013;03;13;Maanantai;47;57;104;37;42;79
89;11.03.2013;2013;03;14;Maanantai;69;44;113;55;44;99
89;11.03.2013;2013;03;15;Maanantai;90;50;140;55;44;99
89;11.03.2013;2013;03;16;Maanantai;146;52;198;60;34;94
89;11.03.2013;2013;03;17;Maanantai;89;53;142;49;23;72
89;11.03.2013;2013;03;18;Maanantai;47;32;79;37;32;69
89;11.03.2013;2013;03;19;Maanantai;43;38;81;29;31;60
89;11.03.2013;2013;03;20;Maanantai;38;18;56;32;15;47
89;11.03.2013;2013;03;21;Maanantai;36;20;56;6;6;12
89;11.03.2013;2013;03;22;Maanantai;16;2;18;4;1;5
89;11.03.2013;2013;03;23;Maanantai;3;0;3;4;3;7
89;12.03.2013;2013;03;00;Tiistai;2;0;2;1;2;3
89;12.03.2013;2013;03;01;Tiistai;4;2;6;2;1;3
89;12.03.2013;2013;03;02;Tiistai;2;0;2;1;0;1
89;12.03.2013;2013;03;03;Tiistai;1;1;2;0;0;0
89;12.03.2013;2013;03;04;Tiistai;0;5;5;0;1;1
89;12.03.2013;2013;03;05;Tiistai;1;7;8;2;1;3
89;12.03.2013;2013;03;06;Tiistai;12;36;48;4;7;11
89;12.03.2013;2013;03;07;Tiistai;24;114;138;9;37;46
89;12.03.2013;2013;03;08;Tiistai;26;108;134;12;44;56
89;12.03.2013;2013;03;09;Tiistai;25;63;88;13;39;52
89;12.03.2013;2013;03;10;Tiistai;28;51;79;19;35;54
89;12.03.2013;2013;03;11;Tiistai;27;29;56;27;21;48
89;12.03.2013;2013;03;12;Tiistai;30;31;61;34;47;81
89;12.03.2013;2013;03;13;Tiistai;35;36;71;27;48;75
89;12.03.2013;2013;03;14;Tiistai;74;48;122;38;28;66
89;12.03.2013;2013;03;15;Tiistai;93;42;135;58;32;90
89;12.03.2013;2013;03;16;Tiistai;122;52;174;65;27;92
89;12.03.2013;2013;03;17;Tiistai;71;50;121;33;33;66
89;12.03.2013;2013;03;18;Tiistai;39;29;68;32;32;64
89;12.03.2013;2013;03;19;Tiistai;49;25;74;24;14;38
89;12.03.2013;2013;03;20;Tiistai;39;23;62;15;6;21
89;12.03.2013;2013;03;21;Tiistai;27;12;39;11;9;20
89;12.03.2013;2013;03;22;Tiistai;14;8;22;6;2;8
89;12.03.2013;2013;03;23;Tiistai;9;0;9;1;1;2
89;13.03.2013;2013;03;00;Keskiviikko;6;1;7;1;0;1
89;13.03.2013;2013;03;01;Keskiviikko;2;0;2;0;2;2
89;13.03.2013;2013;03;02;Keskiviikko;0;1;1;0;0;0
89;13.03.2013;2013;03;03;Keskiviikko;2;1;3;1;0;1
89;13.03.2013;2013;03;04;Keskiviikko;0;3;3;2;1;3
89;13.03.2013;2013;03;05;Keskiviikko;1;9;10;1;0;1
89;13.03.2013;2013;03;06;Keskiviikko;8;24;32;5;6;11
89;13.03.2013;2013;03;07;Keskiviikko;21;92;113;9;42;51
89;13.03.2013;2013;03;08;Keskiviikko;27;115;142;15;39;54
89;13.03.2013;2013;03;09;Keskiviikko;17;66;83;12;33;45
89;13.03.2013;2013;03;10;Keskiviikko;21;43;64;29;47;76
89;13.03.2013;2013;03;11;Keskiviikko;22;35;57;22;21;43
89;13.03.2013;2013;03;12;Keskiviikko;39;40;79;27;46;73
89;13.03.2013;2013;03;13;Keskiviikko;42;47;89;42;32;74
89;13.03.2013;2013;03;14;Keskiviikko;62;47;109;49;32;81
89;13.03.2013;2013;03;15;Keskiviikko;86;31;117;54;44;98
89;13.03.2013;2013;03;16;Keskiviikko;115;64;179;60;22;82
89;13.03.2013;2013;03;17;Keskiviikko;56;46;102;65;28;93
89;13.03.2013;2013;03;18;Keskiviikko;44;38;82;36;25;61
89;13.03.2013;2013;03;19;Keskiviikko;35;22;57;20;20;40
89;13.03.2013;2013;03;20;Keskiviikko;38;25;63;15;17;32
89;13.03.2013;2013;03;21;Keskiviikko;28;8;36;9;8;17
89;13.03.2013;2013;03;22;Keskiviikko;9;2;11;3;3;6
89;13.03.2013;2013;03;23;Keskiviikko;6;1;7;4;0;4
89;14.03.2013;2013;03;00;Torstai;4;1;5;5;0;5
89;14.03.2013;2013;03;01;Torstai;3;1;4;1;1;2
89;14.03.2013;2013;03;02;Torstai;2;0;2;1;0;1
89;14.03.2013;2013;03;03;Torstai;0;0;0;0;0;0
89;14.03.2013;2013;03;04;Torstai;2;3;5;3;0;3
89;14.03.2013;2013;03;05;Torstai;2;6;8;0;1;1
89;14.03.2013;2013;03;06;Torstai;11;32;43;4;1;5
89;14.03.2013;2013;03;07;Torstai;27;111;138;12;33;45
89;14.03.2013;2013;03;08;Torstai;25;120;145;12;32;44
89;14.03.2013;2013;03;09;Torstai;15;62;77;13;28;41
89;14.03.2013;2013;03;10;Torstai;26;40;66;16;20;36
89;14.03.2013;2013;03;11;Torstai;16;34;50;21;30;51
89;14.03.2013;2013;03;12;Torstai;25;52;77;36;30;66
89;14.03.2013;2013;03;13;Torstai;33;46;79;36;38;74
89;14.03.2013;2013;03;14;Torstai;74;61;135;44;31;75
89;14.03.2013;2013;03;15;Torstai;91;39;130;48;31;79
89;14.03.2013;2013;03;16;Torstai;113;51;164;60;30;90
89;14.03.2013;2013;03;17;Torstai;57;35;92;42;23;65
89;14.03.2013;2013;03;18;Torstai;46;34;80;33;22;55
89;14.03.2013;2013;03;19;Torstai;33;22;55;30;17;47
89;14.03.2013;2013;03;20;Torstai;26;25;51;17;8;25
89;14.03.2013;2013;03;21;Torstai;38;9;47;7;4;11
89;14.03.2013;2013;03;22;Torstai;14;4;18;8;2;10
89;14.03.2013;2013;03;23;Torstai;8;6;14;5;4;9
89;15.03.2013;2013;03;00;Perjantai;1;1;2;1;0;1
89;15.03.2013;2013;03;01;Perjantai;3;0;3;1;2;3
89;15.03.2013;2013;03;02;Perjantai;1;0;1;0;1;1
89;15.03.2013;2013;03;03;Perjantai;4;0;4;2;0;2
89;15.03.2013;2013;03;04;Perjantai;1;3;4;1;2;3
89;15.03.2013;2013;03;05;Perjantai;1;8;9;1;1;2
89;15.03.2013;2013;03;06;Perjantai;12;28;40;2;6;8
89;15.03.2013;2013;03;07;Perjantai;15;93;108;10;32;42
89;15.03.2013;2013;03;08;Perjantai;25;103;128;19;30;49
89;15.03.2013;2013;03;09;Perjantai;19;64;83;17;31;48
89;15.03.2013;2013;03;10;Perjantai;17;42;59;20;31;51
89;15.03.2013;2013;03;11;Perjantai;25;61;86;19;54;73
89;15.03.2013;2013;03;12;Perjantai;32;55;87;29;38;67
89;15.03.2013;2013;03;13;Perjantai;66;65;131;45;36;81
89;15.03.2013;2013;03;14;Perjantai;77;49;126;37;31;68
89;15.03.2013;2013;03;15;Perjantai;91;39;130;50;28;78
89;15.03.2013;2013;03;16;Perjantai;85;41;126;52;23;75
89;15.03.2013;2013;03;17;Perjantai;49;45;94;51;57;108
89;15.03.2013;2013;03;18;Perjantai;42;23;65;35;21;56
89;15.03.2013;2013;03;19;Perjantai;29;25;54;18;17;35
89;15.03.2013;2013;03;20;Perjantai;22;22;44;9;11;20
89;15.03.2013;2013;03;21;Perjantai;22;16;38;3;4;7
89;15.03.2013;2013;03;22;Perjantai;19;7;26;5;5;10
89;15.03.2013;2013;03;23;Perjantai;12;9;21;6;3;9
89;16.03.2013;2013;03;00;Lauantai;8;1;9;4;5;9
89;16.03.2013;2013;03;01;Lauantai;3;5;8;0;1;1
89;16.03.2013;2013;03;02;Lauantai;10;2;12;5;1;6
89;16.03.2013;2013;03;03;Lauantai;7;2;9;5;1;6
89;16.03.2013;2013;03;04;Lauantai;5;1;6;1;1;2
89;16.03.2013;2013;03;05;Lauantai;2;3;5;0;0;0
89;16.03.2013;2013;03;06;Lauantai;3;9;12;1;3;4
89;16.03.2013;2013;03;07;Lauantai;3;6;9;7;2;9
89;16.03.2013;2013;03;08;Lauantai;4;18;22;10;14;24
89;16.03.2013;2013;03;09;Lauantai;5;35;40;16;24;40
89;16.03.2013;2013;03;10;Lauantai;12;42;54;29;41;70
89;16.03.2013;2013;03;11;Lauantai;26;39;65;25;63;88
89;16.03.2013;2013;03;12;Lauantai;29;46;75;51;62;113
89;16.03.2013;2013;03;13;Lauantai;24;48;72;83;91;174
89;16.03.2013;2013;03;14;Lauantai;34;41;75;60;54;114
89;16.03.2013;2013;03;15;Lauantai;62;34;96;58;54;112
89;16.03.2013;2013;03;16;Lauantai;46;22;68;49;26;75
89;16.03.2013;2013;03;17;Lauantai;28;18;46;28;28;56
89;16.03.2013;2013;03;18;Lauantai;33;19;52;26;21;47
89;16.03.2013;2013;03;19;Lauantai;14;30;44;19;8;27
89;16.03.2013;2013;03;20;Lauantai;12;11;23;8;5;13
89;16.03.2013;2013;03;21;Lauantai;9;9;18;6;6;12
89;16.03.2013;2013;03;22;Lauantai;20;12;32;5;4;9
89;16.03.2013;2013;03;23;Lauantai;7;5;12;6;5;11
89;17.03.2013;2013;03;00;Sunnuntai;10;10;20;5;2;7
89;17.03.2013;2013;03;01;Sunnuntai;10;4;14;5;1;6
89;17.03.2013;2013;03;02;Sunnuntai;11;4;15;6;1;7
89;17.03.2013;2013;03;03;Sunnuntai;6;2;8;5;3;8
89;17.03.2013;2013;03;04;Sunnuntai;12;4;16;5;1;6
89;17.03.2013;2013;03;05;Sunnuntai;4;1;5;1;0;1
89;17.03.2013;2013;03;06;Sunnuntai;1;5;6;1;5;6
89;17.03.2013;2013;03;07;Sunnuntai;3;1;4;2;0;2
89;17.03.2013;2013;03;08;Sunnuntai;2;6;8;8;12;20
89;17.03.2013;2013;03;09;Sunnuntai;5;10;15;23;12;35
89;17.03.2013;2013;03;10;Sunnuntai;4;21;25;29;36;65
89;17.03.2013;2013;03;11;Sunnuntai;21;26;47;58;39;97
89;17.03.2013;2013;03;12;Sunnuntai;27;57;84;54;80;134
89;17.03.2013;2013;03;13;Sunnuntai;42;39;81;81;82;163
89;17.03.2013;2013;03;14;Sunnuntai;43;37;80;59;64;123
89;17.03.2013;2013;03;15;Sunnuntai;44;24;68;62;52;114
89;17.03.2013;2013;03;16;Sunnuntai;43;41;84;38;34;72
89;17.03.2013;2013;03;17;Sunnuntai;25;16;41;32;22;54
89;17.03.2013;2013;03;18;Sunnuntai;33;25;58;29;21;50
89;17.03.2013;2013;03;19;Sunnuntai;24;11;35;20;22;42
89;17.03.2013;2013;03;20;Sunnuntai;22;22;44;14;12;26
89;17.03.2013;2013;03;21;Sunnuntai;9;5;14;19;9;28
89;17.03.2013;2013;03;22;Sunnuntai;18;1;19;4;2;6
89;17.03.2013;2013;03;23;Sunnuntai;6;2;8;4;4;8
89;18.03.2013;2013;03;00;Maanantai;2;9;11;3;1;4
89;18.03.2013;2013;03;01;Maanantai;2;0;2;1;1;2
89;18.03.2013;2013;03;02;Maanantai;2;1;3;0;0;0
89;18.03.2013;2013;03;03;Maanantai;0;2;2;0;0;0
89;18.03.2013;2013;03;04;Maanantai;1;4;5;0;2;2
89;18.03.2013;2013;03;05;Maanantai;2;8;10;1;2;3
89;18.03.2013;2013;03;06;Maanantai;9;32;41;5;8;13
89;18.03.2013;2013;03;07;Maanantai;34;102;136;6;40;46
89;18.03.2013;2013;03;08;Maanantai;28;146;174;16;36;52
89;18.03.2013;2013;03;09;Maanantai;28;75;103;13;38;51
89;18.03.2013;2013;03;10;Maanantai;28;59;87;27;35;62
89;18.03.2013;2013;03;11;Maanantai;26;47;73;31;42;73
89;18.03.2013;2013;03;12;Maanantai;35;47;82;40;40;80
89;18.03.2013;2013;03;13;Maanantai;35;58;93;38;38;76
89;18.03.2013;2013;03;14;Maanantai;67;56;123;69;38;107
89;18.03.2013;2013;03;15;Maanantai;112;48;160;64;37;101
89;18.03.2013;2013;03;16;Maanantai;165;72;237;66;30;96
89;18.03.2013;2013;03;17;Maanantai;91;65;156;55;37;92
89;18.03.2013;2013;03;18;Maanantai;52;45;97;37;30;67
89;18.03.2013;2013;03;19;Maanantai;43;22;65;37;30;67
89;18.03.2013;2013;03;20;Maanantai;42;21;63;13;12;25
89;18.03.2013;2013;03;21;Maanantai;30;8;38;16;14;30
89;18.03.2013;2013;03;22;Maanantai;5;2;7;7;1;8
89;18.03.2013;2013;03;23;Maanantai;1;0;1;1;1;2
89;19.03.2013;2013;03;00;Tiistai;1;0;1;2;0;2
89;19.03.2013;2013;03;01;Tiistai;0;0;0;1;2;3
89;19.03.2013;2013;03;02;Tiistai;2;1;3;1;0;1
89;19.03.2013;2013;03;03;Tiistai;0;2;2;1;1;2
89;19.03.2013;2013;03;04;Tiistai;1;4;5;1;0;1
89;19.03.2013;2013;03;05;Tiistai;1;7;8;0;2;2
89;19.03.2013;2013;03;06;Tiistai;13;35;48;8;5;13
89;19.03.2013;2013;03;07;Tiistai;26;109;135;9;39;48
89;19.03.2013;2013;03;08;Tiistai;34;141;175;8;40;48
89;19.03.2013;2013;03;09;Tiistai;28;73;101;16;43;59
89;19.03.2013;2013;03;10;Tiistai;26;66;92;32;43;75
89;19.03.2013;2013;03;11;Tiistai;42;54;96;36;29;65
89;19.03.2013;2013;03;12;Tiistai;36;43;79;26;40;66
89;19.03.2013;2013;03;13;Tiistai;50;41;91;32;34;66
89;19.03.2013;2013;03;14;Tiistai;66;44;110;44;29;73
89;19.03.2013;2013;03;15;Tiistai;105;55;160;35;20;55
89;19.03.2013;2013;03;16;Tiistai;125;62;187;54;33;87
89;19.03.2013;2013;03;17;Tiistai;69;50;119;30;30;60
89;19.03.2013;2013;03;18;Tiistai;59;43;102;31;35;66
89;19.03.2013;2013;03;19;Tiistai;37;20;57;28;23;51
89;19.03.2013;2013;03;20;Tiistai;36;32;68;13;25;38
89;19.03.2013;2013;03;21;Tiistai;26;8;34;15;9;24
89;19.03.2013;2013;03;22;Tiistai;13;4;17;3;2;5
89;19.03.2013;2013;03;23;Tiistai;8;2;10;1;1;2
89;20.03.2013;2013;03;00;Keskiviikko;2;2;4;0;0;0
89;20.03.2013;2013;03;01;Keskiviikko;0;0;0;0;1;1
89;20.03.2013;2013;03;02;Keskiviikko;0;0;0;0;0;0
89;20.03.2013;2013;03;03;Keskiviikko;1;1;2;0;0;0
89;20.03.2013;2013;03;04;Keskiviikko;0;5;5;0;0;0
89;20.03.2013;2013;03;05;Keskiviikko;3;9;12;2;0;2
89;20.03.2013;2013;03;06;Keskiviikko;10;35;45;7;8;15
89;20.03.2013;2013;03;07;Keskiviikko;27;106;133;12;40;52
89;20.03.2013;2013;03;08;Keskiviikko;41;139;180;15;38;53
89;20.03.2013;2013;03;09;Keskiviikko;25;69;94;23;43;66
89;20.03.2013;2013;03;10;Keskiviikko;25;41;66;21;39;60
89;20.03.2013;2013;03;11;Keskiviikko;19;56;75;34;47;81
89;20.03.2013;2013;03;12;Keskiviikko;36;45;81;49;60;109
89;20.03.2013;2013;03;13;Keskiviikko;63;49;112;36;37;73
89;20.03.2013;2013;03;14;Keskiviikko;88;69;157;64;23;87
89;20.03.2013;2013;03;15;Keskiviikko;107;47;154;43;31;74
89;20.03.2013;2013;03;16;Keskiviikko;148;72;220;60;35;95
89;20.03.2013;2013;03;17;Keskiviikko;83;62;145;63;34;97
89;20.03.2013;2013;03;18;Keskiviikko;62;55;117;41;26;67
89;20.03.2013;2013;03;19;Keskiviikko;42;24;66;33;27;60
89;20.03.2013;2013;03;20;Keskiviikko;42;24;66;28;29;57
89;20.03.2013;2013;03;21;Keskiviikko;26;12;38;10;15;25
89;20.03.2013;2013;03;22;Keskiviikko;8;9;17;10;7;17
89;20.03.2013;2013;03;23;Keskiviikko;11;4;15;4;4;8
89;21.03.2013;2013;03;00;Torstai;6;2;8;0;3;3
89;21.03.2013;2013;03;01;Torstai;5;0;5;2;1;3
89;21.03.2013;2013;03;02;Torstai;8;0;8;1;1;2
89;21.03.2013;2013;03;03;Torstai;2;2;4;2;0;2
89;21.03.2013;2013;03;04;Torstai;0;5;5;1;0;1
89;21.03.2013;2013;03;05;Torstai;0;5;5;1;2;3
89;21.03.2013;2013;03;06;Torstai;10;33;43;3;7;10
89;21.03.2013;2013;03;07;Torstai;28;126;154;8;39;47
89;21.03.2013;2013;03;08;Torstai;36;147;183;17;41;58
89;21.03.2013;2013;03;09;Torstai;28;65;93;16;45;61
89;21.03.2013;2013;03;10;Torstai;29;51;80;27;33;60
89;21.03.2013;2013;03;11;Torstai;38;65;103;32;41;73
89;21.03.2013;2013;03;12;Torstai;37;43;80;27;37;64
89;21.03.2013;2013;03;13;Torstai;43;40;83;42;38;80
89;21.03.2013;2013;03;14;Torstai;59;54;113;35;30;65
89;21.03.2013;2013;03;15;Torstai;102;57;159;50;20;70
89;21.03.2013;2013;03;16;Torstai;139;70;209;51;24;75
89;21.03.2013;2013;03;17;Torstai;84;62;146;37;18;55
89;21.03.2013;2013;03;18;Torstai;48;36;84;28;36;64
89;21.03.2013;2013;03;19;Torstai;52;18;70;25;15;40
89;21.03.2013;2013;03;20;Torstai;44;19;63;28;12;40
89;21.03.2013;2013;03;21;Torstai;29;14;43;5;7;12
89;21.03.2013;2013;03;22;Torstai;13;5;18;5;0;5
89;21.03.2013;2013;03;23;Torstai;7;3;10;6;2;8
89;22.03.2013;2013;03;00;Perjantai;4;2;6;2;0;2
89;22.03.2013;2013;03;01;Perjantai;2;1;3;0;0;0
89;22.03.2013;2013;03;02;Perjantai;4;1;5;0;1;1
89;22.03.2013;2013;03;03;Perjantai;3;1;4;0;0;0
89;22.03.2013;2013;03;04;Perjantai;3;5;8;0;0;0
89;22.03.2013;2013;03;05;Perjantai;1;10;11;1;0;1
89;22.03.2013;2013;03;06;Perjantai;13;23;36;7;6;13
89;22.03.2013;2013;03;07;Perjantai;28;126;154;10;33;43
89;22.03.2013;2013;03;08;Perjantai;23;123;146;9;35;44
89;22.03.2013;2013;03;09;Perjantai;24;77;101;11;45;56
89;22.03.2013;2013;03;10;Perjantai;24;51;75;12;18;30
89;22.03.2013;2013;03;11;Perjantai;35;60;95;32;33;65
89;22.03.2013;2013;03;12;Perjantai;38;55;93;35;34;69
89;22.03.2013;2013;03;13;Perjantai;73;63;136;33;33;66
89;22.03.2013;2013;03;14;Perjantai;78;60;138;47;28;75
89;22.03.2013;2013;03;15;Perjantai;104;67;171;36;18;54
89;22.03.2013;2013;03;16;Perjantai;94;38;132;36;35;71
89;22.03.2013;2013;03;17;Perjantai;57;47;104;36;29;65
89;22.03.2013;2013;03;18;Perjantai;47;28;75;30;20;50
89;22.03.2013;2013;03;19;Perjantai;42;34;76;24;12;36
89;22.03.2013;2013;03;20;Perjantai;31;21;52;17;16;33
89;22.03.2013;2013;03;21;Perjantai;24;18;42;7;6;13
89;22.03.2013;2013;03;22;Perjantai;20;17;37;4;7;11
89;22.03.2013;2013;03;23;Perjantai;19;5;24;5;8;13
89;23.03.2013;2013;03;00;Lauantai;6;10;16;6;3;9
89;23.03.2013;2013;03;01;Lauantai;6;6;12;3;6;9
89;23.03.2013;2013;03;02;Lauantai;8;5;13;4;1;5
89;23.03.2013;2013;03;03;Lauantai;12;3;15;8;0;8
89;23.03.2013;2013;03;04;Lauantai;10;1;11;9;1;10
89;23.03.2013;2013;03;05;Lauantai;7;0;7;1;0;1
89;23.03.2013;2013;03;06;Lauantai;1;8;9;1;2;3
89;23.03.2013;2013;03;07;Lauantai;4;16;20;7;7;14
89;23.03.2013;2013;03;08;Lauantai;8;20;28;8;14;22
89;23.03.2013;2013;03;09;Lauantai;8;45;53;17;35;52
89;23.03.2013;2013;03;10;Lauantai;20;40;60;22;48;70
89;23.03.2013;2013;03;11;Lauantai;31;54;85;49;63;112
89;23.03.2013;2013;03;12;Lauantai;30;39;69;59;71;130
89;23.03.2013;2013;03;13;Lauantai;53;67;120;59;37;96
89;23.03.2013;2013;03;14;Lauantai;38;47;85;49;37;86
89;23.03.2013;2013;03;15;Lauantai;68;38;106;29;35;64
89;23.03.2013;2013;03;16;Lauantai;46;31;77;35;30;65
89;23.03.2013;2013;03;17;Lauantai;49;29;78;44;27;71
89;23.03.2013;2013;03;18;Lauantai;25;24;49;25;25;50
89;23.03.2013;2013;03;19;Lauantai;22;25;47;15;22;37
89;23.03.2013;2013;03;20;Lauantai;16;26;42;7;14;21
89;23.03.2013;2013;03;21;Lauantai;20;15;35;8;6;14
89;23.03.2013;2013;03;22;Lauantai;20;14;34;5;5;10
89;23.03.2013;2013;03;23;Lauantai;12;9;21;4;7;11
89;24.03.2013;2013;03;00;Sunnuntai;19;19;38;5;5;10
89;24.03.2013;2013;03;01;Sunnuntai;10;4;14;5;5;10
89;24.03.2013;2013;03;02;Sunnuntai;9;2;11;13;1;14
89;24.03.2013;2013;03;03;Sunnuntai;8;0;8;5;0;5
89;24.03.2013;2013;03;04;Sunnuntai;12;1;13;3;0;3
89;24.03.2013;2013;03;05;Sunnuntai;5;2;7;3;0;3
89;24.03.2013;2013;03;06;Sunnuntai;7;9;16;2;2;4
89;24.03.2013;2013;03;07;Sunnuntai;3;6;9;1;5;6
89;24.03.2013;2013;03;08;Sunnuntai;5;13;18;13;11;24
89;24.03.2013;2013;03;09;Sunnuntai;7;13;20;36;33;69
89;24.03.2013;2013;03;10;Sunnuntai;6;24;30;47;50;97
89;24.03.2013;2013;03;11;Sunnuntai;19;36;55;58;63;121
89;24.03.2013;2013;03;12;Sunnuntai;22;48;70;62;76;138
89;24.03.2013;2013;03;13;Sunnuntai;51;44;95;83;93;176
89;24.03.2013;2013;03;14;Sunnuntai;36;37;73;83;63;146
89;24.03.2013;2013;03;15;Sunnuntai;41;39;80;59;46;105
89;24.03.2013;2013;03;16;Sunnuntai;41;45;86;47;39;86
89;24.03.2013;2013;03;17;Sunnuntai;46;22;68;31;33;64
89;24.03.2013;2013;03;18;Sunnuntai;29;16;45;29;22;51
89;24.03.2013;2013;03;19;Sunnuntai;27;7;34;20;25;45
89;24.03.2013;2013;03;20;Sunnuntai;27;11;38;26;18;44
89;24.03.2013;2013;03;21;Sunnuntai;12;15;27;7;6;13
89;24.03.2013;2013;03;22;Sunnuntai;5;2;7;2;0;2
89;24.03.2013;2013;03;23;Sunnuntai;5;0;5;1;0;1
89;25.03.2013;2013;03;00;Maanantai;2;1;3;0;0;0
89;25.03.2013;2013;03;01;Maanantai;3;0;3;1;0;1
89;25.03.2013;2013;03;02;Maanantai;0;0;0;1;0;1
89;25.03.2013;2013;03;03;Maanantai;2;0;2;0;0;0
89;25.03.2013;2013;03;04;Maanantai;2;2;4;0;0;0
89;25.03.2013;2013;03;05;Maanantai;3;8;11;1;1;2
89;25.03.2013;2013;03;06;Maanantai;18;37;55;3;7;10
89;25.03.2013;2013;03;07;Maanantai;34;110;144;8;39;47
89;25.03.2013;2013;03;08;Maanantai;35;140;175;20;37;57
89;25.03.2013;2013;03;09;Maanantai;37;84;121;13;43;56
89;25.03.2013;2013;03;10;Maanantai;39;52;91;32;32;64
89;25.03.2013;2013;03;11;Maanantai;45;62;107;36;46;82
89;25.03.2013;2013;03;12;Maanantai;47;60;107;35;47;82
89;25.03.2013;2013;03;13;Maanantai;60;70;130;40;41;81
89;25.03.2013;2013;03;14;Maanantai;75;59;134;71;35;106
89;25.03.2013;2013;03;15;Maanantai;112;53;165;51;33;84
89;25.03.2013;2013;03;16;Maanantai;146;78;224;71;38;109
89;25.03.2013;2013;03;17;Maanantai;62;71;133;51;34;85
89;25.03.2013;2013;03;18;Maanantai;55;51;106;45;33;78
89;25.03.2013;2013;03;19;Maanantai;64;23;87;27;23;50
89;25.03.2013;2013;03;20;Maanantai;44;26;70;20;17;37
89;25.03.2013;2013;03;21;Maanantai;34;17;51;14;10;24
89;25.03.2013;2013;03;22;Maanantai;17;1;18;5;3;8
89;25.03.2013;2013;03;23;Maanantai;5;3;8;1;1;2
89;26.03.2013;2013;03;00;Tiistai;0;0;0;2;1;3
89;26.03.2013;2013;03;01;Tiistai;2;0;2;1;0;1
89;26.03.2013;2013;03;02;Tiistai;1;0;1;0;0;0
89;26.03.2013;2013;03;03;Tiistai;1;1;2;0;1;1
89;26.03.2013;2013;03;04;Tiistai;0;4;4;0;1;1
89;26.03.2013;2013;03;05;Tiistai;1;8;9;3;0;3
89;26.03.2013;2013;03;06;Tiistai;12;42;54;6;8;14
89;26.03.2013;2013;03;07;Tiistai;32;123;155;8;42;50
89;26.03.2013;2013;03;08;Tiistai;36;140;176;14;36;50
89;26.03.2013;2013;03;09;Tiistai;29;77;106;12;46;58
89;26.03.2013;2013;03;10;Tiistai;23;57;80;31;36;67
89;26.03.2013;2013;03;11;Tiistai;41;67;108;40;44;84
89;26.03.2013;2013;03;12;Tiistai;52;47;99;59;49;108
89;26.03.2013;2013;03;13;Tiistai;63;62;125;36;42;78
89;26.03.2013;2013;03;14;Tiistai;58;62;120;45;25;70
89;26.03.2013;2013;03;15;Tiistai;116;61;177;52;37;89
89;26.03.2013;2013;03;16;Tiistai;145;70;215;49;31;80
89;26.03.2013;2013;03;17;Tiistai;74;53;127;34;44;78
89;26.03.2013;2013;03;18;Tiistai;52;51;103;56;27;83
89;26.03.2013;2013;03;19;Tiistai;48;33;81;49;21;70
89;26.03.2013;2013;03;20;Tiistai;45;17;62;14;21;35
89;26.03.2013;2013;03;21;Tiistai;30;12;42;13;6;19
89;26.03.2013;2013;03;22;Tiistai;13;6;19;8;2;10
89;26.03.2013;2013;03;23;Tiistai;8;3;11;3;1;4
89;27.03.2013;2013;03;00;Keskiviikko;0;2;2;1;0;1
89;27.03.2013;2013;03;01;Keskiviikko;1;0;1;1;1;2
89;27.03.2013;2013;03;02;Keskiviikko;0;0;0;2;0;2
89;27.03.2013;2013;03;03;Keskiviikko;0;3;3;0;0;0
89;27.03.2013;2013;03;04;Keskiviikko;0;3;3;0;1;1
89;27.03.2013;2013;03;05;Keskiviikko;4;10;14;1;1;2
89;27.03.2013;2013;03;06;Keskiviikko;13;32;45;4;9;13
89;27.03.2013;2013;03;07;Keskiviikko;33;101;134;8;36;44
89;27.03.2013;2013;03;08;Keskiviikko;33;131;164;15;46;61
89;27.03.2013;2013;03;09;Keskiviikko;23;72;95;13;35;48
89;27.03.2013;2013;03;10;Keskiviikko;27;52;79;16;41;57
89;27.03.2013;2013;03;11;Keskiviikko;32;45;77;19;35;54
89;27.03.2013;2013;03;12;Keskiviikko;50;78;128;33;40;73
89;27.03.2013;2013;03;13;Keskiviikko;55;50;105;36;22;58
89;27.03.2013;2013;03;14;Keskiviikko;85;51;136;49;33;82
89;27.03.2013;2013;03;15;Keskiviikko;91;71;162;46;27;73
89;27.03.2013;2013;03;16;Keskiviikko;131;61;192;62;29;91
89;27.03.2013;2013;03;17;Keskiviikko;70;46;116;54;36;90
89;27.03.2013;2013;03;18;Keskiviikko;45;46;91;35;26;61
89;27.03.2013;2013;03;19;Keskiviikko;41;23;64;25;22;47
89;27.03.2013;2013;03;20;Keskiviikko;42;25;67;24;12;36
89;27.03.2013;2013;03;21;Keskiviikko;37;11;48;16;8;24
89;27.03.2013;2013;03;22;Keskiviikko;8;11;19;5;8;13
89;27.03.2013;2013;03;23;Keskiviikko;7;2;9;1;1;2
89;28.03.2013;2013;03;00;Torstai;8;3;11;7;3;10
89;28.03.2013;2013;03;01;Torstai;4;2;6;1;0;1
89;28.03.2013;2013;03;02;Torstai;2;2;4;4;1;5
89;28.03.2013;2013;03;03;Torstai;4;1;5;4;1;5
89;28.03.2013;2013;03;04;Torstai;5;8;13;1;1;2
89;28.03.2013;2013;03;05;Torstai;4;7;11;0;1;1
89;28.03.2013;2013;03;06;Torstai;12;27;39;5;7;12
89;28.03.2013;2013;03;07;Torstai;25;106;131;7;37;44
89;28.03.2013;2013;03;08;Torstai;31;98;129;20;30;50
89;28.03.2013;2013;03;09;Torstai;24;58;82;15;22;37
89;28.03.2013;2013;03;10;Torstai;24;49;73;18;38;56
89;28.03.2013;2013;03;11;Torstai;26;85;111;21;38;59
89;28.03.2013;2013;03;12;Torstai;37;56;93;40;44;84
89;28.03.2013;2013;03;13;Torstai;84;68;152;38;32;70
89;28.03.2013;2013;03;14;Torstai;71;53;124;46;31;77
89;28.03.2013;2013;03;15;Torstai;73;57;130;34;40;74
89;28.03.2013;2013;03;16;Torstai;85;33;118;48;23;71
89;28.03.2013;2013;03;17;Torstai;42;29;71;35;32;67
89;28.03.2013;2013;03;18;Torstai;45;31;76;28;21;49
89;28.03.2013;2013;03;19;Torstai;26;16;42;15;18;33
89;28.03.2013;2013;03;20;Torstai;32;19;51;12;7;19
89;28.03.2013;2013;03;21;Torstai;12;16;28;7;7;14
89;28.03.2013;2013;03;22;Torstai;13;10;23;3;6;9
89;28.03.2013;2013;03;23;Torstai;8;8;16;5;2;7
89;29.03.2013;2013;03;00;Perjantai;4;10;14;3;5;8
89;29.03.2013;2013;03;01;Perjantai;4;2;6;5;1;6
89;29.03.2013;2013;03;02;Perjantai;4;0;4;4;2;6
89;29.03.2013;2013;03;03;Perjantai;8;2;10;3;0;3
89;29.03.2013;2013;03;04;Perjantai;11;0;11;3;2;5
89;29.03.2013;2013;03;05;Perjantai;3;2;5;4;0;4
89;29.03.2013;2013;03;06;Perjantai;3;8;11;2;5;7
89;29.03.2013;2013;03;07;Perjantai;4;6;10;0;3;3
89;29.03.2013;2013;03;08;Perjantai;1;6;7;10;10;20
89;29.03.2013;2013;03;09;Perjantai;6;7;13;16;15;31
89;29.03.2013;2013;03;10;Perjantai;6;13;19;43;40;83
89;29.03.2013;2013;03;11;Perjantai;13;23;36;53;50;103
89;29.03.2013;2013;03;12;Perjantai;23;33;56;47;71;118
89;29.03.2013;2013;03;13;Perjantai;18;22;40;75;62;137
89;29.03.2013;2013;03;14;Perjantai;29;24;53;64;57;121
89;29.03.2013;2013;03;15;Perjantai;15;24;39;58;44;102
89;29.03.2013;2013;03;16;Perjantai;18;16;34;18;30;48
89;29.03.2013;2013;03;17;Perjantai;9;17;26;30;33;63
89;29.03.2013;2013;03;18;Perjantai;20;12;32;21;19;40
89;29.03.2013;2013;03;19;Perjantai;12;16;28;21;11;32
89;29.03.2013;2013;03;20;Perjantai;18;17;35;8;13;21
89;29.03.2013;2013;03;21;Perjantai;8;15;23;6;6;12
89;29.03.2013;2013;03;22;Perjantai;7;19;26;4;5;9
89;29.03.2013;2013;03;23;Perjantai;3;8;11;0;13;13
89;30.03.2013;2013;03;00;Lauantai;7;10;17;4;2;6
89;30.03.2013;2013;03;01;Lauantai;9;6;15;4;3;7
89;30.03.2013;2013;03;02;Lauantai;10;1;11;4;2;6
89;30.03.2013;2013;03;03;Lauantai;3;1;4;8;0;8
89;30.03.2013;2013;03;04;Lauantai;8;1;9;6;2;8
89;30.03.2013;2013;03;05;Lauantai;2;4;6;1;1;2
89;30.03.2013;2013;03;06;Lauantai;3;2;5;1;4;5
89;30.03.2013;2013;03;07;Lauantai;1;6;7;3;4;7
89;30.03.2013;2013;03;08;Lauantai;3;8;11;6;11;17
89;30.03.2013;2013;03;09;Lauantai;7;19;26;16;31;47
89;30.03.2013;2013;03;10;Lauantai;11;31;42;18;29;47
89;30.03.2013;2013;03;11;Lauantai;21;28;49;28;49;77
89;30.03.2013;2013;03;12;Lauantai;23;48;71;45;66;111
89;30.03.2013;2013;03;13;Lauantai;34;36;70;42;51;93
89;30.03.2013;2013;03;14;Lauantai;43;29;72;46;41;87
89;30.03.2013;2013;03;15;Lauantai;28;25;53;30;17;47
89;30.03.2013;2013;03;16;Lauantai;33;14;47;36;21;57
89;30.03.2013;2013;03;17;Lauantai;34;19;53;23;31;54
89;30.03.2013;2013;03;18;Lauantai;16;35;51;17;26;43
89;30.03.2013;2013;03;19;Lauantai;11;8;19;25;9;34
89;30.03.2013;2013;03;20;Lauantai;9;14;23;14;10;24
89;30.03.2013;2013;03;21;Lauantai;9;8;17;8;12;20
89;30.03.2013;2013;03;22;Lauantai;4;12;16;4;8;12
89;30.03.2013;2013;03;23;Lauantai;6;11;17;2;6;8
89;31.03.2013;2013;03;00;Sunnuntai;11;8;19;4;3;7
89;31.03.2013;2013;03;01;Sunnuntai;10;1;11;4;1;5
89;31.03.2013;2013;03;02;Sunnuntai;10;4;14;7;3;10
89;31.03.2013;2013;03;03;Sunnuntai;11;2;13;16;1;17
89;31.03.2013;2013;03;04;Sunnuntai;0;0;0;0;0;0
89;31.03.2013;2013;03;05;Sunnuntai;2;0;2;0;3;3
89;31.03.2013;2013;03;06;Sunnuntai;1;1;2;1;2;3
89;31.03.2013;2013;03;07;Sunnuntai;4;1;5;5;4;9
89;31.03.2013;2013;03;08;Sunnuntai;0;2;2;7;8;15
89;31.03.2013;2013;03;09;Sunnuntai;3;5;8;9;9;18
89;31.03.2013;2013;03;10;Sunnuntai;3;12;15;17;18;35
89;31.03.2013;2013;03;11;Sunnuntai;9;13;22;43;32;75
89;31.03.2013;2013;03;12;Sunnuntai;17;20;37;50;44;94
89;31.03.2013;2013;03;13;Sunnuntai;16;26;42;57;73;130
89;31.03.2013;2013;03;14;Sunnuntai;18;26;44;61;75;136
89;31.03.2013;2013;03;15;Sunnuntai;31;23;54;66;56;122
89;31.03.2013;2013;03;16;Sunnuntai;22;22;44;29;39;68
89;31.03.2013;2013;03;17;Sunnuntai;20;18;38;39;33;72
89;31.03.2013;2013;03;18;Sunnuntai;16;18;34;24;22;46
89;31.03.2013;2013;03;19;Sunnuntai;23;20;43;24;18;42
89;31.03.2013;2013;03;20;Sunnuntai;12;15;27;16;9;25
89;31.03.2013;2013;03;21;Sunnuntai;14;12;26;13;6;19
89;31.03.2013;2013;03;22;Sunnuntai;5;6;11;3;2;5
89;31.03.2013;2013;03;23;Sunnuntai;9;9;18;2;4;6
89;01.04.2013;2013;04;00;Maanantai;14;4;18;3;4;7
89;01.04.2013;2013;04;01;Maanantai;4;5;9;0;5;5
89;01.04.2013;2013;04;02;Maanantai;4;0;4;1;0;1
89;01.04.2013;2013;04;03;Maanantai;2;0;2;4;0;4
89;01.04.2013;2013;04;04;Maanantai;5;2;7;2;1;3
89;01.04.2013;2013;04;05;Maanantai;0;2;2;2;0;2
89;01.04.2013;2013;04;06;Maanantai;1;6;7;0;4;4
89;01.04.2013;2013;04;07;Maanantai;2;4;6;3;2;5
89;01.04.2013;2013;04;08;Maanantai;2;13;15;12;6;18
89;01.04.2013;2013;04;09;Maanantai;5;7;12;13;21;34
89;01.04.2013;2013;04;10;Maanantai;4;8;12;16;27;43
89;01.04.2013;2013;04;11;Maanantai;13;24;37;39;39;78
89;01.04.2013;2013;04;12;Maanantai;15;25;40;48;49;97
89;01.04.2013;2013;04;13;Maanantai;29;33;62;90;70;160
89;01.04.2013;2013;04;14;Maanantai;22;40;62;71;60;131
89;01.04.2013;2013;04;15;Maanantai;43;21;64;62;50;112
89;01.04.2013;2013;04;16;Maanantai;26;37;63;37;36;73
89;01.04.2013;2013;04;17;Maanantai;29;20;49;49;41;90
89;01.04.2013;2013;04;18;Maanantai;29;31;60;35;34;69
89;01.04.2013;2013;04;19;Maanantai;20;24;44;22;28;50
89;01.04.2013;2013;04;20;Maanantai;15;9;24;23;13;36
89;01.04.2013;2013;04;21;Maanantai;20;8;28;5;7;12
89;01.04.2013;2013;04;22;Maanantai;10;3;13;4;2;6
89;01.04.2013;2013;04;23;Maanantai;2;2;4;1;2;3
89;02.04.2013;2013;04;00;Tiistai;3;2;5;1;0;1
89;02.04.2013;2013;04;01;Tiistai;0;2;2;3;0;3
89;02.04.2013;2013;04;02;Tiistai;1;1;2;0;0;0
89;02.04.2013;2013;04;03;Tiistai;0;4;4;1;0;1
89;02.04.2013;2013;04;04;Tiistai;0;4;4;1;0;1
89;02.04.2013;2013;04;05;Tiistai;0;11;11;2;2;4
89;02.04.2013;2013;04;06;Tiistai;14;28;42;2;7;9
89;02.04.2013;2013;04;07;Tiistai;25;100;125;8;25;33
89;02.04.2013;2013;04;08;Tiistai;37;133;170;10;41;51
89;02.04.2013;2013;04;09;Tiistai;34;84;118;11;26;37
89;02.04.2013;2013;04;10;Tiistai;27;63;90;17;38;55
89;02.04.2013;2013;04;11;Tiistai;34;54;88;25;29;54
89;02.04.2013;2013;04;12;Tiistai;38;56;94;26;43;69
89;02.04.2013;2013;04;13;Tiistai;44;56;100;37;41;78
89;02.04.2013;2013;04;14;Tiistai;83;52;135;48;41;89
89;02.04.2013;2013;04;15;Tiistai;97;55;152;43;32;75
89;02.04.2013;2013;04;16;Tiistai;128;56;184;53;17;70
89;02.04.2013;2013;04;17;Tiistai;65;54;119;54;30;84
89;02.04.2013;2013;04;18;Tiistai;43;37;80;23;28;51
89;02.04.2013;2013;04;19;Tiistai;74;19;93;27;25;52
89;02.04.2013;2013;04;20;Tiistai;45;25;70;30;22;52
89;02.04.2013;2013;04;21;Tiistai;20;10;30;13;7;20
89;02.04.2013;2013;04;22;Tiistai;10;2;12;6;3;9
89;02.04.2013;2013;04;23;Tiistai;7;1;8;3;3;6
89;03.04.2013;2013;04;00;Keskiviikko;2;0;2;1;1;2
89;03.04.2013;2013;04;01;Keskiviikko;1;5;6;3;0;3
89;03.04.2013;2013;04;02;Keskiviikko;0;0;0;0;0;0
89;03.04.2013;2013;04;03;Keskiviikko;2;2;4;1;1;2
89;03.04.2013;2013;04;04;Keskiviikko;1;6;7;0;0;0
89;03.04.2013;2013;04;05;Keskiviikko;4;11;15;0;0;0
89;03.04.2013;2013;04;06;Keskiviikko;13;33;46;1;7;8
89;03.04.2013;2013;04;07;Keskiviikko;26;85;111;5;51;56
89;03.04.2013;2013;04;08;Keskiviikko;51;148;199;13;41;54
89;03.04.2013;2013;04;09;Keskiviikko;17;82;99;11;38;49
89;03.04.2013;2013;04;10;Keskiviikko;30;54;84;28;41;69
89;03.04.2013;2013;04;11;Keskiviikko;35;61;96;31;34;65
89;03.04.2013;2013;04;12;Keskiviikko;45;60;105;37;53;90
89;03.04.2013;2013;04;13;Keskiviikko;47;55;102;43;44;87
89;03.04.2013;2013;04;14;Keskiviikko;91;50;141;43;40;83
89;03.04.2013;2013;04;15;Keskiviikko;114;54;168;54;26;80
89;03.04.2013;2013;04;16;Keskiviikko;146;79;225;72;32;104
89;03.04.2013;2013;04;17;Keskiviikko;82;48;130;62;37;99
89;03.04.2013;2013;04;18;Keskiviikko;51;44;95;37;35;72
89;03.04.2013;2013;04;19;Keskiviikko;46;12;58;39;35;74
89;03.04.2013;2013;04;20;Keskiviikko;45;33;78;26;15;41
89;03.04.2013;2013;04;21;Keskiviikko;23;14;37;7;4;11
89;03.04.2013;2013;04;22;Keskiviikko;14;4;18;5;1;6
89;03.04.2013;2013;04;23;Keskiviikko;9;2;11;1;1;2
89;04.04.2013;2013;04;00;Torstai;5;2;7;1;3;4
89;04.04.2013;2013;04;01;Torstai;2;0;2;1;2;3
89;04.04.2013;2013;04;02;Torstai;0;1;1;0;1;1
89;04.04.2013;2013;04;03;Torstai;0;1;1;3;0;3
89;04.04.2013;2013;04;04;Torstai;2;12;14;0;0;0
89;04.04.2013;2013;04;05;Torstai;2;11;13;0;1;1
89;04.04.2013;2013;04;06;Torstai;12;38;50;7;6;13
89;04.04.2013;2013;04;07;Torstai;39;96;135;9;36;45
89;04.04.2013;2013;04;08;Torstai;47;129;176;17;39;56
89;04.04.2013;2013;04;09;Torstai;18;70;88;8;25;33
89;04.04.2013;2013;04;10;Torstai;20;54;74;23;36;59
89;04.04.2013;2013;04;11;Torstai;30;51;81;28;36;64
89;04.04.2013;2013;04;12;Torstai;35;56;91;22;41;63
89;04.04.2013;2013;04;13;Torstai;50;66;116;35;39;74
89;04.04.2013;2013;04;14;Torstai;60;53;113;35;49;84
89;04.04.2013;2013;04;15;Torstai;104;65;169;56;43;99
89;04.04.2013;2013;04;16;Torstai;133;66;199;51;32;83
89;04.04.2013;2013;04;17;Torstai;89;52;141;43;32;75
89;04.04.2013;2013;04;18;Torstai;60;47;107;41;29;70
89;04.04.2013;2013;04;19;Torstai;56;31;87;33;31;64
89;04.04.2013;2013;04;20;Torstai;39;24;63;32;22;54
89;04.04.2013;2013;04;21;Torstai;37;15;52;12;11;23
89;04.04.2013;2013;04;22;Torstai;16;7;23;10;4;14
89;04.04.2013;2013;04;23;Torstai;9;8;17;2;5;7
89;05.04.2013;2013;04;00;Perjantai;8;3;11;3;0;3
89;05.04.2013;2013;04;01;Perjantai;4;0;4;3;0;3
89;05.04.2013;2013;04;02;Perjantai;2;0;2;0;0;0
89;05.04.2013;2013;04;03;Perjantai;11;1;12;2;0;2
89;05.04.2013;2013;04;04;Perjantai;4;6;10;2;1;3
89;05.04.2013;2013;04;05;Perjantai;0;11;11;0;0;0
89;05.04.2013;2013;04;06;Perjantai;11;38;49;3;8;11
89;05.04.2013;2013;04;07;Perjantai;31;97;128;14;33;47
89;05.04.2013;2013;04;08;Perjantai;34;126;160;11;30;41
89;05.04.2013;2013;04;09;Perjantai;29;68;97;16;30;46
89;05.04.2013;2013;04;10;Perjantai;20;46;66;23;34;57
89;05.04.2013;2013;04;11;Perjantai;33;49;82;30;33;63
89;05.04.2013;2013;04;12;Perjantai;45;57;102;28;46;74
89;05.04.2013;2013;04;13;Perjantai;67;67;134;43;42;85
89;05.04.2013;2013;04;14;Perjantai;87;53;140;31;40;71
89;05.04.2013;2013;04;15;Perjantai;102;65;167;51;30;81
89;05.04.2013;2013;04;16;Perjantai;115;54;169;43;36;79
89;05.04.2013;2013;04;17;Perjantai;58;55;113;36;22;58
89;05.04.2013;2013;04;18;Perjantai;57;30;87;25;32;57
89;05.04.2013;2013;04;19;Perjantai;37;32;69;19;13;32
89;05.04.2013;2013;04;20;Perjantai;50;25;75;17;13;30
89;05.04.2013;2013;04;21;Perjantai;29;21;50;9;10;19
89;05.04.2013;2013;04;22;Perjantai;12;16;28;6;9;15
89;05.04.2013;2013;04;23;Perjantai;15;8;23;9;7;16
89;06.04.2013;2013;04;00;Lauantai;12;7;19;6;7;13
89;06.04.2013;2013;04;01;Lauantai;2;3;5;1;2;3
89;06.04.2013;2013;04;02;Lauantai;6;3;9;7;3;10
89;06.04.2013;2013;04;03;Lauantai;11;1;12;4;0;4
89;06.04.2013;2013;04;04;Lauantai;8;1;9;2;1;3
89;06.04.2013;2013;04;05;Lauantai;2;2;4;2;1;3
89;06.04.2013;2013;04;06;Lauantai;4;10;14;1;0;1
89;06.04.2013;2013;04;07;Lauantai;6;17;23;0;7;7
89;06.04.2013;2013;04;08;Lauantai;5;15;20;5;8;13
89;06.04.2013;2013;04;09;Lauantai;8;28;36;15;38;53
89;06.04.2013;2013;04;10;Lauantai;14;54;68;22;40;62
89;06.04.2013;2013;04;11;Lauantai;15;37;52;32;45;77
89;06.04.2013;2013;04;12;Lauantai;40;55;95;48;47;95
89;06.04.2013;2013;04;13;Lauantai;45;45;90;49;61;110
89;06.04.2013;2013;04;14;Lauantai;43;47;90;39;57;96
89;06.04.2013;2013;04;15;Lauantai;75;43;118;47;39;86
89;06.04.2013;2013;04;16;Lauantai;52;46;98;43;36;79
89;06.04.2013;2013;04;17;Lauantai;45;32;77;36;25;61
89;06.04.2013;2013;04;18;Lauantai;43;30;73;45;25;70
89;06.04.2013;2013;04;19;Lauantai;28;30;58;23;24;47
89;06.04.2013;2013;04;20;Lauantai;21;18;39;17;18;35
89;06.04.2013;2013;04;21;Lauantai;17;10;27;6;11;17
89;06.04.2013;2013;04;22;Lauantai;16;5;21;8;6;14
89;06.04.2013;2013;04;23;Lauantai;11;18;29;1;12;13
89;07.04.2013;2013;04;00;Sunnuntai;11;13;24;3;9;12
89;07.04.2013;2013;04;01;Sunnuntai;9;7;16;6;2;8
89;07.04.2013;2013;04;02;Sunnuntai;10;4;14;10;0;10
89;07.04.2013;2013;04;03;Sunnuntai;16;3;19;5;0;5
89;07.04.2013;2013;04;04;Sunnuntai;12;0;12;8;2;10
89;07.04.2013;2013;04;05;Sunnuntai;7;2;9;3;2;5
89;07.04.2013;2013;04;06;Sunnuntai;3;4;7;1;2;3
89;07.04.2013;2013;04;07;Sunnuntai;4;2;6;5;2;7
89;07.04.2013;2013;04;08;Sunnuntai;4;2;6;1;6;7
89;07.04.2013;2013;04;09;Sunnuntai;5;7;12;17;15;32
89;07.04.2013;2013;04;10;Sunnuntai;6;16;22;21;28;49
89;07.04.2013;2013;04;11;Sunnuntai;16;24;40;34;40;74
89;07.04.2013;2013;04;12;Sunnuntai;24;38;62;36;49;85
89;07.04.2013;2013;04;13;Sunnuntai;35;38;73;44;53;97
89;07.04.2013;2013;04;14;Sunnuntai;34;31;65;38;52;90
89;07.04.2013;2013;04;15;Sunnuntai;42;30;72;45;37;82
89;07.04.2013;2013;04;16;Sunnuntai;25;21;46;41;45;86
89;07.04.2013;2013;04;17;Sunnuntai;35;39;74;35;34;69
89;07.04.2013;2013;04;18;Sunnuntai;19;27;46;29;33;62
89;07.04.2013;2013;04;19;Sunnuntai;30;26;56;45;33;78
89;07.04.2013;2013;04;20;Sunnuntai;17;14;31;29;19;48
89;07.04.2013;2013;04;21;Sunnuntai;24;9;33;12;14;26
89;07.04.2013;2013;04;22;Sunnuntai;4;1;5;11;3;14
89;07.04.2013;2013;04;23;Sunnuntai;6;3;9;6;1;7
89;08.04.2013;2013;04;00;Maanantai;2;3;5;0;3;3
89;08.04.2013;2013;04;01;Maanantai;1;0;1;1;1;2
89;08.04.2013;2013;04;02;Maanantai;0;1;1;0;0;0
89;08.04.2013;2013;04;03;Maanantai;3;2;5;0;0;0
89;08.04.2013;2013;04;04;Maanantai;3;2;5;1;0;1
89;08.04.2013;2013;04;05;Maanantai;4;14;18;0;0;0
89;08.04.2013;2013;04;06;Maanantai;13;37;50;0;7;7
89;08.04.2013;2013;04;07;Maanantai;32;95;127;7;35;42
89;08.04.2013;2013;04;08;Maanantai;32;146;178;15;42;57
89;08.04.2013;2013;04;09;Maanantai;38;79;117;17;52;69
89;08.04.2013;2013;04;10;Maanantai;33;64;97;18;47;65
89;08.04.2013;2013;04;11;Maanantai;40;63;103;34;47;81
89;08.04.2013;2013;04;12;Maanantai;46;61;107;38;32;70
89;08.04.2013;2013;04;13;Maanantai;62;51;113;38;35;73
89;08.04.2013;2013;04;14;Maanantai;79;59;138;35;22;57
89;08.04.2013;2013;04;15;Maanantai;112;56;168;64;54;118
89;08.04.2013;2013;04;16;Maanantai;149;67;216;65;30;95
89;08.04.2013;2013;04;17;Maanantai;102;46;148;52;27;79
89;08.04.2013;2013;04;18;Maanantai;75;52;127;36;30;66
89;08.04.2013;2013;04;19;Maanantai;58;41;99;47;30;77
89;08.04.2013;2013;04;20;Maanantai;53;22;75;22;21;43
89;08.04.2013;2013;04;21;Maanantai;22;20;42;17;4;21
89;08.04.2013;2013;04;22;Maanantai;20;3;23;5;3;8
89;08.04.2013;2013;04;23;Maanantai;2;3;5;1;1;2
89;09.04.2013;2013;04;00;Tiistai;0;2;2;3;1;4
89;09.04.2013;2013;04;01;Tiistai;2;3;5;0;0;0
89;09.04.2013;2013;04;02;Tiistai;1;0;1;1;1;2
89;09.04.2013;2013;04;03;Tiistai;0;0;0;2;0;2
89;09.04.2013;2013;04;04;Tiistai;0;5;5;0;1;1
89;09.04.2013;2013;04;05;Tiistai;2;12;14;2;2;4
89;09.04.2013;2013;04;06;Tiistai;10;48;58;5;4;9
89;09.04.2013;2013;04;07;Tiistai;32;116;148;4;42;46
89;09.04.2013;2013;04;08;Tiistai;43;160;203;9;46;55
89;09.04.2013;2013;04;09;Tiistai;35;84;119;12;54;66
89;09.04.2013;2013;04;10;Tiistai;29;55;84;29;55;84
89;09.04.2013;2013;04;11;Tiistai;43;53;96;39;38;77
89;09.04.2013;2013;04;12;Tiistai;48;55;103;31;45;76
89;09.04.2013;2013;04;13;Tiistai;55;73;128;35;48;83
89;09.04.2013;2013;04;14;Tiistai;86;53;139;53;33;86
89;09.04.2013;2013;04;15;Tiistai;127;72;199;48;36;84
89;09.04.2013;2013;04;16;Tiistai;182;62;244;63;37;100
89;09.04.2013;2013;04;17;Tiistai;103;52;155;40;32;72
89;09.04.2013;2013;04;18;Tiistai;63;48;111;44;36;80
89;09.04.2013;2013;04;19;Tiistai;47;31;78;47;48;95
89;09.04.2013;2013;04;20;Tiistai;74;25;99;39;36;75
89;09.04.2013;2013;04;21;Tiistai;30;21;51;15;13;28
89;09.04.2013;2013;04;22;Tiistai;27;10;37;6;2;8
89;09.04.2013;2013;04;23;Tiistai;3;2;5;2;1;3
89;10.04.2013;2013;04;00;Keskiviikko;3;2;5;1;3;4
89;10.04.2013;2013;04;01;Keskiviikko;2;2;4;1;0;1
89;10.04.2013;2013;04;02;Keskiviikko;2;1;3;0;0;0
89;10.04.2013;2013;04;03;Keskiviikko;1;2;3;0;0;0
89;10.04.2013;2013;04;04;Keskiviikko;1;4;5;0;1;1
89;10.04.2013;2013;04;05;Keskiviikko;0;12;12;0;2;2
89;10.04.2013;2013;04;06;Keskiviikko;9;36;45;4;4;8
89;10.04.2013;2013;04;07;Keskiviikko;32;145;177;10;45;55
89;10.04.2013;2013;04;08;Keskiviikko;56;172;228;12;52;64
89;10.04.2013;2013;04;09;Keskiviikko;38;104;142;12;54;66
89;10.04.2013;2013;04;10;Keskiviikko;36;78;114;24;38;62
89;10.04.2013;2013;04;11;Keskiviikko;41;73;114;28;33;61
89;10.04.2013;2013;04;12;Keskiviikko;63;55;118;43;45;88
89;10.04.2013;2013;04;13;Keskiviikko;74;60;134;36;37;73
89;10.04.2013;2013;04;14;Keskiviikko;90;72;162;56;37;93
89;10.04.2013;2013;04;15;Keskiviikko;102;71;173;47;41;88
89;10.04.2013;2013;04;16;Keskiviikko;166;78;244;51;35;86
89;10.04.2013;2013;04;17;Keskiviikko;94;70;164;50;31;81
89;10.04.2013;2013;04;18;Keskiviikko;62;59;121;48;47;95
89;10.04.2013;2013;04;19;Keskiviikko;58;31;89;47;34;81
89;10.04.2013;2013;04;20;Keskiviikko;57;30;87;29;25;54
89;10.04.2013;2013;04;21;Keskiviikko;43;8;51;18;9;27
89;10.04.2013;2013;04;22;Keskiviikko;21;14;35;5;0;5
89;10.04.2013;2013;04;23;Keskiviikko;11;0;11;2;3;5
89;11.04.2013;2013;04;00;Torstai;6;3;9;4;0;4
89;11.04.2013;2013;04;01;Torstai;7;0;7;1;0;1
89;11.04.2013;2013;04;02;Torstai;4;1;5;0;0;0
89;11.04.2013;2013;04;03;Torstai;3;1;4;0;0;0
89;11.04.2013;2013;04;04;Torstai;1;6;7;3;1;4
89;11.04.2013;2013;04;05;Torstai;2;12;14;1;3;4
89;11.04.2013;2013;04;06;Torstai;14;45;59;2;6;8
89;11.04.2013;2013;04;07;Torstai;35;139;174;5;37;42
89;11.04.2013;2013;04;08;Torstai;51;136;187;20;51;71
89;11.04.2013;2013;04;09;Torstai;38;89;127;18;43;61
89;11.04.2013;2013;04;10;Torstai;29;77;106;18;36;54
89;11.04.2013;2013;04;11;Torstai;31;67;98;35;48;83
89;11.04.2013;2013;04;12;Torstai;62;66;128;28;41;69
89;11.04.2013;2013;04;13;Torstai;60;60;120;31;35;66
89;11.04.2013;2013;04;14;Torstai;108;48;156;48;30;78
89;11.04.2013;2013;04;15;Torstai;109;86;195;50;34;84
89;11.04.2013;2013;04;16;Torstai;146;84;230;58;35;93
89;11.04.2013;2013;04;17;Torstai;109;74;183;52;48;100
89;11.04.2013;2013;04;18;Torstai;87;50;137;40;43;83
89;11.04.2013;2013;04;19;Torstai;63;41;104;31;32;63
89;11.04.2013;2013;04;20;Torstai;58;31;89;24;13;37
89;11.04.2013;2013;04;21;Torstai;51;14;65;12;5;17
89;11.04.2013;2013;04;22;Torstai;19;14;33;8;6;14
89;11.04.2013;2013;04;23;Torstai;2;5;7;3;3;6
89;12.04.2013;2013;04;00;Perjantai;7;1;8;2;0;2
89;12.04.2013;2013;04;01;Perjantai;2;2;4;1;0;1
89;12.04.2013;2013;04;02;Perjantai;0;2;2;2;0;2
89;12.04.2013;2013;04;03;Perjantai;0;0;0;0;1;1
89;12.04.2013;2013;04;04;Perjantai;4;6;10;1;0;1
89;12.04.2013;2013;04;05;Perjantai;0;14;14;2;2;4
89;12.04.2013;2013;04;06;Perjantai;14;34;48;1;4;5
89;12.04.2013;2013;04;07;Perjantai;25;113;138;8;37;45
89;12.04.2013;2013;04;08;Perjantai;46;135;181;14;34;48
89;12.04.2013;2013;04;09;Perjantai;40;91;131;10;42;52
89;12.04.2013;2013;04;10;Perjantai;41;60;101;29;29;58
89;12.04.2013;2013;04;11;Perjantai;45;73;118;28;37;65
89;12.04.2013;2013;04;12;Perjantai;57;59;116;33;39;72
89;12.04.2013;2013;04;13;Perjantai;75;68;143;40;52;92
89;12.04.2013;2013;04;14;Perjantai;72;62;134;33;35;68
89;12.04.2013;2013;04;15;Perjantai;117;72;189;44;37;81
89;12.04.2013;2013;04;16;Perjantai;123;44;167;44;23;67
89;12.04.2013;2013;04;17;Perjantai;81;62;143;36;19;55
89;12.04.2013;2013;04;18;Perjantai;58;33;91;33;17;50
89;12.04.2013;2013;04;19;Perjantai;37;24;61;23;15;38
89;12.04.2013;2013;04;20;Perjantai;43;30;73;12;12;24
89;12.04.2013;2013;04;21;Perjantai;30;21;51;14;5;19
89;12.04.2013;2013;04;22;Perjantai;9;14;23;7;10;17
89;12.04.2013;2013;04;23;Perjantai;19;15;34;5;13;18
89;13.04.2013;2013;04;00;Lauantai;10;12;22;8;9;17
89;13.04.2013;2013;04;01;Lauantai;14;0;14;8;3;11
89;13.04.2013;2013;04;02;Lauantai;13;3;16;10;2;12
89;13.04.2013;2013;04;03;Lauantai;10;2;12;10;0;10
89;13.04.2013;2013;04;04;Lauantai;7;4;11;6;0;6
89;13.04.2013;2013;04;05;Lauantai;3;1;4;2;1;3
89;13.04.2013;2013;04;06;Lauantai;1;7;8;2;3;5
89;13.04.2013;2013;04;07;Lauantai;6;15;21;0;9;9
89;13.04.2013;2013;04;08;Lauantai;9;35;44;7;14;21
89;13.04.2013;2013;04;09;Lauantai;24;39;63;16;34;50
89;13.04.2013;2013;04;10;Lauantai;18;66;84;11;31;42
89;13.04.2013;2013;04;11;Lauantai;40;47;87;27;44;71
89;13.04.2013;2013;04;12;Lauantai;43;73;116;29;60;89
89;13.04.2013;2013;04;13;Lauantai;52;52;104;40;49;89
89;13.04.2013;2013;04;14;Lauantai;64;52;116;51;37;88
89;13.04.2013;2013;04;15;Lauantai;68;46;114;49;27;76
89;13.04.2013;2013;04;16;Lauantai;57;33;90;31;25;56
89;13.04.2013;2013;04;17;Lauantai;61;47;108;36;27;63
89;13.04.2013;2013;04;18;Lauantai;48;26;74;29;19;48
89;13.04.2013;2013;04;19;Lauantai;27;19;46;15;18;33
89;13.04.2013;2013;04;20;Lauantai;16;22;38;16;9;25
89;13.04.2013;2013;04;21;Lauantai;10;16;26;5;10;15
89;13.04.2013;2013;04;22;Lauantai;14;17;31;12;8;20
89;13.04.2013;2013;04;23;Lauantai;13;21;34;6;3;9
89;14.04.2013;2013;04;00;Sunnuntai;18;12;30;3;1;4
89;14.04.2013;2013;04;01;Sunnuntai;16;10;26;6;0;6
89;14.04.2013;2013;04;02;Sunnuntai;10;2;12;12;2;14
89;14.04.2013;2013;04;03;Sunnuntai;9;0;9;7;0;7
89;14.04.2013;2013;04;04;Sunnuntai;21;1;22;6;0;6
89;14.04.2013;2013;04;05;Sunnuntai;0;2;2;1;0;1
89;14.04.2013;2013;04;06;Sunnuntai;2;6;8;1;0;1
89;14.04.2013;2013;04;07;Sunnuntai;5;7;12;2;5;7
89;14.04.2013;2013;04;08;Sunnuntai;7;8;15;14;15;29
89;14.04.2013;2013;04;09;Sunnuntai;10;19;29;25;19;44
89;14.04.2013;2013;04;10;Sunnuntai;20;24;44;26;36;62
89;14.04.2013;2013;04;11;Sunnuntai;29;43;72;33;51;84
89;14.04.2013;2013;04;12;Sunnuntai;45;61;106;43;52;95
89;14.04.2013;2013;04;13;Sunnuntai;46;59;105;33;58;91
89;14.04.2013;2013;04;14;Sunnuntai;58;65;123;60;61;121
89;14.04.2013;2013;04;15;Sunnuntai;78;76;154;59;67;126
89;14.04.2013;2013;04;16;Sunnuntai;71;62;133;69;55;124
89;14.04.2013;2013;04;17;Sunnuntai;69;40;109;59;48;107
89;14.04.2013;2013;04;18;Sunnuntai;53;41;94;56;38;94
89;14.04.2013;2013;04;19;Sunnuntai;41;25;66;47;24;71
89;14.04.2013;2013;04;20;Sunnuntai;37;14;51;31;28;59
89;14.04.2013;2013;04;21;Sunnuntai;18;7;25;14;9;23
89;14.04.2013;2013;04;22;Sunnuntai;7;6;13;8;2;10
89;14.04.2013;2013;04;23;Sunnuntai;7;3;10;2;6;8
89;15.04.2013;2013;04;00;Maanantai;1;3;4;2;1;3
89;15.04.2013;2013;04;01;Maanantai;3;0;3;1;0;1
89;15.04.2013;2013;04;02;Maanantai;0;2;2;0;0;0
89;15.04.2013;2013;04;03;Maanantai;1;2;3;1;0;1
89;15.04.2013;2013;04;04;Maanantai;1;5;6;2;1;3
89;15.04.2013;2013;04;05;Maanantai;3;13;16;1;1;2
89;15.04.2013;2013;04;06;Maanantai;13;21;34;0;2;2
89;15.04.2013;2013;04;07;Maanantai;25;99;124;4;14;18
89;15.04.2013;2013;04;08;Maanantai;33;123;156;12;30;42
89;15.04.2013;2013;04;09;Maanantai;33;64;97;3;34;37
89;15.04.2013;2013;04;10;Maanantai;26;68;94;25;21;46
89;15.04.2013;2013;04;11;Maanantai;31;45;76;15;25;40
89;15.04.2013;2013;04;12;Maanantai;45;61;106;21;22;43
89;15.04.2013;2013;04;13;Maanantai;58;49;107;34;35;69
89;15.04.2013;2013;04;14;Maanantai;87;46;133;31;16;47
89;15.04.2013;2013;04;15;Maanantai;113;59;172;36;22;58
89;15.04.2013;2013;04;16;Maanantai;149;60;209;35;22;57
89;15.04.2013;2013;04;17;Maanantai;79;51;130;17;10;27
89;15.04.2013;2013;04;18;Maanantai;52;34;86;22;13;35
89;15.04.2013;2013;04;19;Maanantai;22;17;39;15;17;32
89;15.04.2013;2013;04;20;Maanantai;36;14;50;18;12;30
89;15.04.2013;2013;04;21;Maanantai;24;7;31;18;11;29
89;15.04.2013;2013;04;22;Maanantai;16;3;19;4;4;8
89;15.04.2013;2013;04;23;Maanantai;3;2;5;3;1;4
89;16.04.2013;2013;04;00;Tiistai;4;0;4;4;0;4
89;16.04.2013;2013;04;01;Tiistai;1;2;3;1;0;1
89;16.04.2013;2013;04;02;Tiistai;2;1;3;1;1;2
89;16.04.2013;2013;04;03;Tiistai;1;2;3;1;0;1
89;16.04.2013;2013;04;04;Tiistai;0;3;3;0;1;1
89;16.04.2013;2013;04;05;Tiistai;2;13;15;2;1;3
89;16.04.2013;2013;04;06;Tiistai;16;41;57;1;7;8
89;16.04.2013;2013;04;07;Tiistai;37;143;180;10;27;37
89;16.04.2013;2013;04;08;Tiistai;47;166;213;18;34;52
89;16.04.2013;2013;04;09;Tiistai;30;80;110;9;27;36
89;16.04.2013;2013;04;10;Tiistai;31;45;76;25;31;56
89;16.04.2013;2013;04;11;Tiistai;40;54;94;23;25;48
89;16.04.2013;2013;04;12;Tiistai;49;58;107;21;17;38
89;16.04.2013;2013;04;13;Tiistai;50;58;108;31;37;68
89;16.04.2013;2013;04;14;Tiistai;67;80;147;30;29;59
89;16.04.2013;2013;04;15;Tiistai;134;39;173;34;32;66
89;16.04.2013;2013;04;16;Tiistai;177;83;260;46;26;72
89;16.04.2013;2013;04;17;Tiistai;77;55;132;52;39;91
89;16.04.2013;2013;04;18;Tiistai;66;60;126;43;42;85
89;16.04.2013;2013;04;19;Tiistai;59;33;92;54;38;92
89;16.04.2013;2013;04;20;Tiistai;66;44;110;37;26;63
89;16.04.2013;2013;04;21;Tiistai;46;22;68;19;21;40
89;16.04.2013;2013;04;22;Tiistai;19;5;24;15;4;19
89;16.04.2013;2013;04;23;Tiistai;3;3;6;4;1;5
89;17.04.2013;2013;04;00;Keskiviikko;11;2;13;2;1;3
89;17.04.2013;2013;04;01;Keskiviikko;2;3;5;0;1;1
89;17.04.2013;2013;04;02;Keskiviikko;2;1;3;1;1;2
89;17.04.2013;2013;04;03;Keskiviikko;0;2;2;0;0;0
89;17.04.2013;2013;04;04;Keskiviikko;0;2;2;1;1;2
89;17.04.2013;2013;04;05;Keskiviikko;1;13;14;1;1;2
89;17.04.2013;2013;04;06;Keskiviikko;10;47;57;2;5;7
89;17.04.2013;2013;04;07;Keskiviikko;39;136;175;11;28;39
89;17.04.2013;2013;04;08;Keskiviikko;44;170;214;17;41;58
89;17.04.2013;2013;04;09;Keskiviikko;47;79;126;28;49;77
89;17.04.2013;2013;04;10;Keskiviikko;31;73;104;28;34;62
89;17.04.2013;2013;04;11;Keskiviikko;46;67;113;31;29;60
89;17.04.2013;2013;04;12;Keskiviikko;48;61;109;29;33;62
89;17.04.2013;2013;04;13;Keskiviikko;73;61;134;28;30;58
89;17.04.2013;2013;04;14;Keskiviikko;106;53;159;28;24;52
89;17.04.2013;2013;04;15;Keskiviikko;129;57;186;37;17;54
89;17.04.2013;2013;04;16;Keskiviikko;186;73;259;42;34;76
89;17.04.2013;2013;04;17;Keskiviikko;103;91;194;31;24;55
89;17.04.2013;2013;04;18;Keskiviikko;71;53;124;43;36;79
89;17.04.2013;2013;04;19;Keskiviikko;52;33;85;37;29;66
89;17.04.2013;2013;04;20;Keskiviikko;44;28;72;37;25;62
89;17.04.2013;2013;04;21;Keskiviikko;45;23;68;15;11;26
89;17.04.2013;2013;04;22;Keskiviikko;19;7;26;6;5;11
89;17.04.2013;2013;04;23;Keskiviikko;8;7;15;3;5;8
89;18.04.2013;2013;04;00;Torstai;7;4;11;2;2;4
89;18.04.2013;2013;04;01;Torstai;4;2;6;6;0;6
89;18.04.2013;2013;04;02;Torstai;3;0;3;4;1;5
89;18.04.2013;2013;04;03;Torstai;1;3;4;1;0;1
89;18.04.2013;2013;04;04;Torstai;4;0;4;1;1;2
89;18.04.2013;2013;04;05;Torstai;1;17;18;2;0;2
89;18.04.2013;2013;04;06;Torstai;15;44;59;5;12;17
89;18.04.2013;2013;04;07;Torstai;34;142;176;8;41;49
89;18.04.2013;2013;04;08;Torstai;55;177;232;20;40;60
89;18.04.2013;2013;04;09;Torstai;47;111;158;18;87;105
89;18.04.2013;2013;04;10;Torstai;37;71;108;26;32;58
89;18.04.2013;2013;04;11;Torstai;64;83;147;31;38;69
89;18.04.2013;2013;04;12;Torstai;61;72;133;31;34;65
89;18.04.2013;2013;04;13;Torstai;67;71;138;37;26;63
89;18.04.2013;2013;04;14;Torstai;105;73;178;33;20;53
89;18.04.2013;2013;04;15;Torstai;127;51;178;22;20;42
89;18.04.2013;2013;04;16;Torstai;148;53;201;20;10;30
89;18.04.2013;2013;04;17;Torstai;78;45;123;20;9;29
89;18.04.2013;2013;04;18;Torstai;60;19;79;13;15;28
89;18.04.2013;2013;04;19;Torstai;26;18;44;13;4;17
89;18.04.2013;2013;04;20;Torstai;38;19;57;16;18;34
89;18.04.2013;2013;04;21;Torstai;27;12;39;9;4;13
89;18.04.2013;2013;04;22;Torstai;8;1;9;6;2;8
89;18.04.2013;2013;04;23;Torstai;5;0;5;1;1;2
89;19.04.2013;2013;04;00;Perjantai;1;2;3;1;0;1
89;19.04.2013;2013;04;01;Perjantai;6;2;8;0;0;0
89;19.04.2013;2013;04;02;Perjantai;1;0;1;0;0;0
89;19.04.2013;2013;04;03;Perjantai;1;2;3;2;0;2
89;19.04.2013;2013;04;04;Perjantai;2;1;3;0;1;1
89;19.04.2013;2013;04;05;Perjantai;1;15;16;1;2;3
89;19.04.2013;2013;04;06;Perjantai;11;45;56;3;10;13
89;19.04.2013;2013;04;07;Perjantai;30;119;149;7;32;39
89;19.04.2013;2013;04;08;Perjantai;45;140;185;19;38;57
89;19.04.2013;2013;04;09;Perjantai;31;90;121;12;26;38
89;19.04.2013;2013;04;10;Perjantai;39;58;97;19;30;49
89;19.04.2013;2013;04;11;Perjantai;40;68;108;38;26;64
89;19.04.2013;2013;04;12;Perjantai;61;52;113;12;39;51
89;19.04.2013;2013;04;13;Perjantai;88;81;169;31;31;62
89;19.04.2013;2013;04;14;Perjantai;108;63;171;32;19;51
89;19.04.2013;2013;04;15;Perjantai;116;59;175;26;20;46
89;19.04.2013;2013;04;16;Perjantai;127;72;199;33;30;63
89;19.04.2013;2013;04;17;Perjantai;77;70;147;24;24;48
89;19.04.2013;2013;04;18;Perjantai;62;53;115;24;27;51
89;19.04.2013;2013;04;19;Perjantai;48;29;77;27;14;41
89;19.04.2013;2013;04;20;Perjantai;50;39;89;14;12;26
89;19.04.2013;2013;04;21;Perjantai;27;32;59;11;10;21
89;19.04.2013;2013;04;22;Perjantai;23;31;54;3;14;17
89;19.04.2013;2013;04;23;Perjantai;25;14;39;6;9;15
89;20.04.2013;2013;04;00;Lauantai;18;10;28;10;5;15
89;20.04.2013;2013;04;01;Lauantai;18;11;29;2;2;4
89;20.04.2013;2013;04;02;Lauantai;16;10;26;2;1;3
89;20.04.2013;2013;04;03;Lauantai;15;4;19;6;0;6
89;20.04.2013;2013;04;04;Lauantai;12;2;14;17;2;19
89;20.04.2013;2013;04;05;Lauantai;6;2;8;1;0;1
89;20.04.2013;2013;04;06;Lauantai;6;8;14;3;0;3
89;20.04.2013;2013;04;07;Lauantai;8;14;22;5;5;10
89;20.04.2013;2013;04;08;Lauantai;11;31;42;10;10;20
89;20.04.2013;2013;04;09;Lauantai;13;43;56;13;21;34
89;20.04.2013;2013;04;10;Lauantai;17;41;58;19;25;44
89;20.04.2013;2013;04;11;Lauantai;28;63;91;17;30;47
89;20.04.2013;2013;04;12;Lauantai;37;72;109;31;42;73
89;20.04.2013;2013;04;13;Lauantai;56;81;137;27;30;57
89;20.04.2013;2013;04;14;Lauantai;81;65;146;46;35;81
89;20.04.2013;2013;04;15;Lauantai;70;55;125;48;36;84
89;20.04.2013;2013;04;16;Lauantai;70;64;134;37;50;87
89;20.04.2013;2013;04;17;Lauantai;88;62;150;48;38;86
89;20.04.2013;2013;04;18;Lauantai;68;42;110;38;35;73
89;20.04.2013;2013;04;19;Lauantai;30;37;67;31;22;53
89;20.04.2013;2013;04;20;Lauantai;38;30;68;19;21;40
89;20.04.2013;2013;04;21;Lauantai;18;28;46;5;13;18
89;20.04.2013;2013;04;22;Lauantai;27;17;44;6;10;16
89;20.04.2013;2013;04;23;Lauantai;13;14;27;6;9;15
89;21.04.2013;2013;04;00;Sunnuntai;13;9;22;5;13;18
89;21.04.2013;2013;04;01;Sunnuntai;13;3;16;4;4;8
89;21.04.2013;2013;04;02;Sunnuntai;18;8;26;11;0;11
89;21.04.2013;2013;04;03;Sunnuntai;8;3;11;13;1;14
89;21.04.2013;2013;04;04;Sunnuntai;18;4;22;12;1;13
89;21.04.2013;2013;04;05;Sunnuntai;5;4;9;4;3;7
89;21.04.2013;2013;04;06;Sunnuntai;0;4;4;4;1;5
89;21.04.2013;2013;04;07;Sunnuntai;1;8;9;6;7;13
89;21.04.2013;2013;04;08;Sunnuntai;14;10;24;14;8;22
89;21.04.2013;2013;04;09;Sunnuntai;16;27;43;28;34;62
89;21.04.2013;2013;04;10;Sunnuntai;28;66;94;43;47;90
89;21.04.2013;2013;04;11;Sunnuntai;47;81;128;69;61;130
89;21.04.2013;2013;04;12;Sunnuntai;64;102;166;62;75;137
89;21.04.2013;2013;04;13;Sunnuntai;75;80;155;58;63;121
89;21.04.2013;2013;04;14;Sunnuntai;122;74;196;66;53;119
89;21.04.2013;2013;04;15;Sunnuntai;65;51;116;63;46;109
89;21.04.2013;2013;04;16;Sunnuntai;90;80;170;49;30;79
89;21.04.2013;2013;04;17;Sunnuntai;79;91;170;57;43;100
89;21.04.2013;2013;04;18;Sunnuntai;93;59;152;48;44;92
89;21.04.2013;2013;04;19;Sunnuntai;79;28;107;42;47;89
89;21.04.2013;2013;04;20;Sunnuntai;50;16;66;35;24;59
89;21.04.2013;2013;04;21;Sunnuntai;30;13;43;18;26;44
89;21.04.2013;2013;04;22;Sunnuntai;15;2;17;5;4;9
89;21.04.2013;2013;04;23;Sunnuntai;13;6;19;2;0;2
89;22.04.2013;2013;04;00;Maanantai;3;1;4;0;3;3
89;22.04.2013;2013;04;01;Maanantai;1;1;2;1;1;2
89;22.04.2013;2013;04;02;Maanantai;0;0;0;0;0;0
89;22.04.2013;2013;04;03;Maanantai;2;1;3;0;1;1
89;22.04.2013;2013;04;04;Maanantai;2;5;7;0;3;3
89;22.04.2013;2013;04;05;Maanantai;3;11;14;0;3;3
89;22.04.2013;2013;04;06;Maanantai;25;52;77;8;8;16
89;22.04.2013;2013;04;07;Maanantai;53;163;216;3;29;32
89;22.04.2013;2013;04;08;Maanantai;54;208;262;16;40;56
89;22.04.2013;2013;04;09;Maanantai;47;119;166;21;43;64
89;22.04.2013;2013;04;10;Maanantai;47;107;154;34;36;70
89;22.04.2013;2013;04;11;Maanantai;75;101;176;26;36;62
89;22.04.2013;2013;04;12;Maanantai;88;103;191;39;43;82
89;22.04.2013;2013;04;13;Maanantai;87;108;195;71;46;117
89;22.04.2013;2013;04;14;Maanantai;167;98;265;71;37;108
89;22.04.2013;2013;04;15;Maanantai;206;122;328;70;36;106
89;22.04.2013;2013;04;16;Maanantai;249;141;390;81;34;115
89;22.04.2013;2013;04;17;Maanantai;158;80;238;43;29;72
89;22.04.2013;2013;04;18;Maanantai;118;75;193;47;44;91
89;22.04.2013;2013;04;19;Maanantai;86;65;151;50;39;89
89;22.04.2013;2013;04;20;Maanantai;78;38;116;26;30;56
89;22.04.2013;2013;04;21;Maanantai;36;21;57;19;12;31
89;22.04.2013;2013;04;22;Maanantai;23;13;36;5;3;8
89;22.04.2013;2013;04;23;Maanantai;11;3;14;3;4;7
89;23.04.2013;2013;04;00;Tiistai;5;7;12;1;0;1
89;23.04.2013;2013;04;01;Tiistai;5;5;10;0;2;2
89;23.04.2013;2013;04;02;Tiistai;2;0;2;0;0;0
89;23.04.2013;2013;04;03;Tiistai;1;2;3;3;0;3
89;23.04.2013;2013;04;04;Tiistai;0;3;3;0;1;1
89;23.04.2013;2013;04;05;Tiistai;7;16;23;2;3;5
89;23.04.2013;2013;04;06;Tiistai;17;47;64;10;9;19
89;23.04.2013;2013;04;07;Tiistai;46;141;187;9;26;35
89;23.04.2013;2013;04;08;Tiistai;50;160;210;13;46;59
89;23.04.2013;2013;04;09;Tiistai;45;88;133;29;43;72
89;23.04.2013;2013;04;10;Tiistai;38;68;106;22;36;58
89;23.04.2013;2013;04;11;Tiistai;43;47;90;13;32;45
89;23.04.2013;2013;04;12;Tiistai;38;68;106;20;27;47
89;23.04.2013;2013;04;13;Tiistai;60;61;121;26;22;48
89;23.04.2013;2013;04;14;Tiistai;71;39;110;30;13;43
89;23.04.2013;2013;04;15;Tiistai;129;60;189;28;15;43
89;23.04.2013;2013;04;16;Tiistai;167;69;236;37;17;54
89;23.04.2013;2013;04;17;Tiistai;88;63;151;25;18;43
89;23.04.2013;2013;04;18;Tiistai;61;48;109;29;20;49
89;23.04.2013;2013;04;19;Tiistai;38;40;78;23;27;50
89;23.04.2013;2013;04;20;Tiistai;60;28;88;31;15;46
89;23.04.2013;2013;04;21;Tiistai;34;18;52;4;11;15
89;23.04.2013;2013;04;22;Tiistai;14;3;17;3;4;7
89;23.04.2013;2013;04;23;Tiistai;9;1;10;4;0;4
89;24.04.2013;2013;04;00;Keskiviikko;2;2;4;0;0;0
89;24.04.2013;2013;04;01;Keskiviikko;4;1;5;0;4;4
89;24.04.2013;2013;04;02;Keskiviikko;1;2;3;0;0;0
89;24.04.2013;2013;04;03;Keskiviikko;1;2;3;0;0;0
89;24.04.2013;2013;04;04;Keskiviikko;1;5;6;2;0;2
89;24.04.2013;2013;04;05;Keskiviikko;3;12;15;1;1;2
89;24.04.2013;2013;04;06;Keskiviikko;18;50;68;6;8;14
89;24.04.2013;2013;04;07;Keskiviikko;44;165;209;6;26;32
89;24.04.2013;2013;04;08;Keskiviikko;57;164;221;13;42;55
89;24.04.2013;2013;04;09;Keskiviikko;43;115;158;12;40;52
89;24.04.2013;2013;04;10;Keskiviikko;37;56;93;25;27;52
89;24.04.2013;2013;04;11;Keskiviikko;51;94;145;37;23;60
89;24.04.2013;2013;04;12;Keskiviikko;76;81;157;20;41;61
89;24.04.2013;2013;04;13;Keskiviikko;95;118;213;37;29;66
89;24.04.2013;2013;04;14;Keskiviikko;139;107;246;45;35;80
89;24.04.2013;2013;04;15;Keskiviikko;168;118;286;45;33;78
89;24.04.2013;2013;04;16;Keskiviikko;221;165;386;52;55;107
89;24.04.2013;2013;04;17;Keskiviikko;139;125;264;60;59;119
89;24.04.2013;2013;04;18;Keskiviikko;110;68;178;56;57;113
89;24.04.2013;2013;04;19;Keskiviikko;88;61;149;60;47;107
89;24.04.2013;2013;04;20;Keskiviikko;101;36;137;33;27;60
89;24.04.2013;2013;04;21;Keskiviikko;40;30;70;14;18;32
89;24.04.2013;2013;04;22;Keskiviikko;23;29;52;8;4;12
89;24.04.2013;2013;04;23;Keskiviikko;12;12;24;5;3;8
89;25.04.2013;2013;04;00;Torstai;6;10;16;6;1;7
89;25.04.2013;2013;04;01;Torstai;10;4;14;3;2;5
89;25.04.2013;2013;04;02;Torstai;10;2;12;2;0;2
89;25.04.2013;2013;04;03;Torstai;3;1;4;1;0;1
89;25.04.2013;2013;04;04;Torstai;0;7;7;1;1;2
89;25.04.2013;2013;04;05;Torstai;1;9;10;0;4;4
89;25.04.2013;2013;04;06;Torstai;22;59;81;1;4;5
89;25.04.2013;2013;04;07;Torstai;47;175;222;7;35;42
89;25.04.2013;2013;04;08;Torstai;61;188;249;16;32;48
89;25.04.2013;2013;04;09;Torstai;57;107;164;21;34;55
89;25.04.2013;2013;04;10;Torstai;66;98;164;21;27;48
89;25.04.2013;2013;04;11;Torstai;63;75;138;33;40;73
89;25.04.2013;2013;04;12;Torstai;54;87;141;22;22;44
89;25.04.2013;2013;04;13;Torstai;103;90;193;26;14;40
89;25.04.2013;2013;04;14;Torstai;107;85;192;36;37;73
89;25.04.2013;2013;04;15;Torstai;179;76;255;32;22;54
89;25.04.2013;2013;04;16;Torstai;212;103;315;43;27;70
89;25.04.2013;2013;04;17;Torstai;124;80;204;39;24;63
89;25.04.2013;2013;04;18;Torstai;84;81;165;58;44;102
89;25.04.2013;2013;04;19;Torstai;86;59;145;49;40;89
89;25.04.2013;2013;04;20;Torstai;79;50;129;28;35;63
89;25.04.2013;2013;04;21;Torstai;68;33;101;21;11;32
89;25.04.2013;2013;04;22;Torstai;23;11;34;5;9;14
89;25.04.2013;2013;04;23;Torstai;11;25;36;1;2;3
89;26.04.2013;2013;04;00;Perjantai;7;8;15;4;0;4
89;26.04.2013;2013;04;01;Perjantai;10;1;11;1;0;1
89;26.04.2013;2013;04;02;Perjantai;9;0;9;5;0;5
89;26.04.2013;2013;04;03;Perjantai;10;3;13;1;1;2
89;26.04.2013;2013;04;04;Perjantai;0;4;4;1;0;1
89;26.04.2013;2013;04;05;Perjantai;2;15;17;1;2;3
89;26.04.2013;2013;04;06;Perjantai;22;47;69;5;7;12
89;26.04.2013;2013;04;07;Perjantai;40;155;195;4;29;33
89;26.04.2013;2013;04;08;Perjantai;57;184;241;16;29;45
89;26.04.2013;2013;04;09;Perjantai;41;126;167;20;29;49
89;26.04.2013;2013;04;10;Perjantai;57;85;142;20;41;61
89;26.04.2013;2013;04;11;Perjantai;75;99;174;17;26;43
89;26.04.2013;2013;04;12;Perjantai;81;95;176;14;40;54
89;26.04.2013;2013;04;13;Perjantai;114;109;223;13;38;51
89;26.04.2013;2013;04;14;Perjantai;150;122;272;26;31;57
89;26.04.2013;2013;04;15;Perjantai;176;130;306;32;53;85
89;26.04.2013;2013;04;16;Perjantai;209;83;292;49;37;86
89;26.04.2013;2013;04;17;Perjantai;110;97;207;36;37;73
89;26.04.2013;2013;04;18;Perjantai;120;61;181;31;43;74
89;26.04.2013;2013;04;19;Perjantai;89;82;171;18;30;48
89;26.04.2013;2013;04;20;Perjantai;63;60;123;21;14;35
89;26.04.2013;2013;04;21;Perjantai;58;27;85;13;15;28
89;26.04.2013;2013;04;22;Perjantai;36;33;69;11;11;22
89;26.04.2013;2013;04;23;Perjantai;25;17;42;4;14;18
89;27.04.2013;2013;04;00;Lauantai;31;13;44;5;11;16
89;27.04.2013;2013;04;01;Lauantai;18;3;21;1;2;3
89;27.04.2013;2013;04;02;Lauantai;21;7;28;8;2;10
89;27.04.2013;2013;04;03;Lauantai;22;3;25;8;0;8
89;27.04.2013;2013;04;04;Lauantai;15;3;18;4;0;4
89;27.04.2013;2013;04;05;Lauantai;6;3;9;2;1;3
89;27.04.2013;2013;04;06;Lauantai;2;15;17;3;3;6
89;27.04.2013;2013;04;07;Lauantai;8;12;20;4;4;8
89;27.04.2013;2013;04;08;Lauantai;9;32;41;9;16;25
89;27.04.2013;2013;04;09;Lauantai;16;55;71;22;37;59
89;27.04.2013;2013;04;10;Lauantai;48;93;141;28;32;60
89;27.04.2013;2013;04;11;Lauantai;57;127;184;19;41;60
89;27.04.2013;2013;04;12;Lauantai;81;132;213;29;45;74
89;27.04.2013;2013;04;13;Lauantai;85;123;208;35;36;71
89;27.04.2013;2013;04;14;Lauantai;97;92;189;33;52;85
89;27.04.2013;2013;04;15;Lauantai;105;79;184;34;31;65
89;27.04.2013;2013;04;16;Lauantai;89;74;163;32;32;64
89;27.04.2013;2013;04;17;Lauantai;99;101;200;27;32;59
89;27.04.2013;2013;04;18;Lauantai;85;72;157;15;29;44
89;27.04.2013;2013;04;19;Lauantai;47;47;94;39;24;63
89;27.04.2013;2013;04;20;Lauantai;47;55;102;14;25;39
89;27.04.2013;2013;04;21;Lauantai;43;36;79;6;13;19
89;27.04.2013;2013;04;22;Lauantai;42;20;62;6;8;14
89;27.04.2013;2013;04;23;Lauantai;23;27;50;4;8;12
89;28.04.2013;2013;04;00;Sunnuntai;13;23;36;5;8;13
89;28.04.2013;2013;04;01;Sunnuntai;40;10;50;6;2;8
89;28.04.2013;2013;04;02;Sunnuntai;21;8;29;6;1;7
89;28.04.2013;2013;04;03;Sunnuntai;23;2;25;5;0;5
89;28.04.2013;2013;04;04;Sunnuntai;15;1;16;8;1;9
89;28.04.2013;2013;04;05;Sunnuntai;3;3;6;2;0;2
89;28.04.2013;2013;04;06;Sunnuntai;2;6;8;2;3;5
89;28.04.2013;2013;04;07;Sunnuntai;6;7;13;1;2;3
89;28.04.2013;2013;04;08;Sunnuntai;5;11;16;7;8;15
89;28.04.2013;2013;04;09;Sunnuntai;16;21;37;22;24;46
89;28.04.2013;2013;04;10;Sunnuntai;18;44;62;36;47;83
89;28.04.2013;2013;04;11;Sunnuntai;49;93;142;33;43;76
89;28.04.2013;2013;04;12;Sunnuntai;65;126;191;28;44;72
89;28.04.2013;2013;04;13;Sunnuntai;98;92;190;41;45;86
89;28.04.2013;2013;04;14;Sunnuntai;96;105;201;49;55;104
89;28.04.2013;2013;04;15;Sunnuntai;108;91;199;54;55;109
89;28.04.2013;2013;04;16;Sunnuntai;93;92;185;43;51;94
89;28.04.2013;2013;04;17;Sunnuntai;103;48;151;35;36;71
89;28.04.2013;2013;04;18;Sunnuntai;90;72;162;34;30;64
89;28.04.2013;2013;04;19;Sunnuntai;65;38;103;24;36;60
89;28.04.2013;2013;04;20;Sunnuntai;70;37;107;30;22;52
89;28.04.2013;2013;04;21;Sunnuntai;32;26;58;8;16;24
89;28.04.2013;2013;04;22;Sunnuntai;14;7;21;6;5;11
89;28.04.2013;2013;04;23;Sunnuntai;14;8;22;5;5;10
89;29.04.2013;2013;04;00;Maanantai;8;5;13;5;4;9
89;29.04.2013;2013;04;01;Maanantai;4;1;5;0;1;1
89;29.04.2013;2013;04;02;Maanantai;8;2;10;0;0;0
89;29.04.2013;2013;04;03;Maanantai;4;4;8;1;1;2
89;29.04.2013;2013;04;04;Maanantai;1;5;6;6;0;6
89;29.04.2013;2013;04;05;Maanantai;4;13;17;0;5;5
89;29.04.2013;2013;04;06;Maanantai;29;46;75;6;2;8
89;29.04.2013;2013;04;07;Maanantai;34;166;200;6;21;27
89;29.04.2013;2013;04;08;Maanantai;58;194;252;12;42;54
89;29.04.2013;2013;04;09;Maanantai;37;121;158;17;28;45
89;29.04.2013;2013;04;10;Maanantai;41;72;113;15;24;39
89;29.04.2013;2013;04;11;Maanantai;49;79;128;14;23;37
89;29.04.2013;2013;04;12;Maanantai;64;76;140;16;24;40
89;29.04.2013;2013;04;13;Maanantai;63;76;139;25;18;43
89;29.04.2013;2013;04;14;Maanantai;112;89;201;24;26;50
89;29.04.2013;2013;04;15;Maanantai;177;95;272;26;20;46
89;29.04.2013;2013;04;16;Maanantai;209;105;314;41;20;61
89;29.04.2013;2013;04;17;Maanantai;128;101;229;34;24;58
89;29.04.2013;2013;04;18;Maanantai;91;78;169;26;36;62
89;29.04.2013;2013;04;19;Maanantai;90;47;137;29;28;57
89;29.04.2013;2013;04;20;Maanantai;68;38;106;34;20;54
89;29.04.2013;2013;04;21;Maanantai;37;28;65;19;16;35
89;29.04.2013;2013;04;22;Maanantai;18;13;31;5;8;13
89;29.04.2013;2013;04;23;Maanantai;1;12;13;9;2;11
89;30.04.2013;2013;04;00;Tiistai;7;12;19;0;0;0
89;30.04.2013;2013;04;01;Tiistai;12;6;18;7;1;8
89;30.04.2013;2013;04;02;Tiistai;10;3;13;0;1;1
89;30.04.2013;2013;04;03;Tiistai;12;3;15;2;0;2
89;30.04.2013;2013;04;04;Tiistai;4;5;9;4;0;4
89;30.04.2013;2013;04;05;Tiistai;7;12;19;1;1;2
89;30.04.2013;2013;04;06;Tiistai;21;46;67;3;1;4
89;30.04.2013;2013;04;07;Tiistai;37;126;163;3;21;24
89;30.04.2013;2013;04;08;Tiistai;39;144;183;9;25;34
89;30.04.2013;2013;04;09;Tiistai;36;86;122;5;31;36
89;30.04.2013;2013;04;10;Tiistai;32;61;93;21;22;43
89;30.04.2013;2013;04;11;Tiistai;40;110;150;12;20;32
89;30.04.2013;2013;04;12;Tiistai;69;102;171;17;17;34
89;30.04.2013;2013;04;13;Tiistai;81;116;197;13;34;47
89;30.04.2013;2013;04;14;Tiistai;124;190;314;21;19;40
89;30.04.2013;2013;04;15;Tiistai;166;130;296;33;31;64
89;30.04.2013;2013;04;16;Tiistai;197;137;334;34;24;58
89;30.04.2013;2013;04;17;Tiistai;117;102;219;23;25;48
89;30.04.2013;2013;04;18;Tiistai;82;116;198;33;47;80
89;30.04.2013;2013;04;19;Tiistai;63;96;159;27;40;67
89;30.04.2013;2013;04;20;Tiistai;51;81;132;23;41;64
89;30.04.2013;2013;04;21;Tiistai;52;73;125;27;30;57
89;30.04.2013;2013;04;22;Tiistai;40;87;127;19;32;51
89;30.04.2013;2013;04;23;Tiistai;39;45;84;11;20;31
89;01.05.2013;2013;05;00;Keskiviikko;47;37;84;22;14;36
89;01.05.2013;2013;05;01;Keskiviikko;72;18;90;25;10;35
89;01.05.2013;2013;05;02;Keskiviikko;69;6;75;26;7;33
89;01.05.2013;2013;05;03;Keskiviikko;59;14;73;25;2;27
89;01.05.2013;2013;05;04;Keskiviikko;44;8;52;18;3;21
89;01.05.2013;2013;05;05;Keskiviikko;50;8;58;6;0;6
89;01.05.2013;2013;05;06;Keskiviikko;3;9;12;2;2;4
89;01.05.2013;2013;05;07;Keskiviikko;16;4;20;1;7;8
89;01.05.2013;2013;05;08;Keskiviikko;9;11;20;7;12;19
89;01.05.2013;2013;05;09;Keskiviikko;19;35;54;14;24;38
89;01.05.2013;2013;05;10;Keskiviikko;37;97;134;31;51;82
89;01.05.2013;2013;05;11;Keskiviikko;59;198;257;50;74;124
89;01.05.2013;2013;05;12;Keskiviikko;99;177;276;37;69;106
89;01.05.2013;2013;05;13;Keskiviikko;209;178;387;59;66;125
89;01.05.2013;2013;05;14;Keskiviikko;183;119;302;50;68;118
89;01.05.2013;2013;05;15;Keskiviikko;127;85;212;55;38;93
89;01.05.2013;2013;05;16;Keskiviikko;121;60;181;47;32;79
89;01.05.2013;2013;05;17;Keskiviikko;76;54;130;39;36;75
89;01.05.2013;2013;05;18;Keskiviikko;79;50;129;32;44;76
89;01.05.2013;2013;05;19;Keskiviikko;45;44;89;31;34;65
89;01.05.2013;2013;05;20;Keskiviikko;42;19;61;33;26;59
89;01.05.2013;2013;05;21;Keskiviikko;28;30;58;15;23;38
89;01.05.2013;2013;05;22;Keskiviikko;18;19;37;5;6;11
89;01.05.2013;2013;05;23;Keskiviikko;13;12;25;4;4;8
89;02.05.2013;2013;05;00;Torstai;6;10;16;2;2;4
89;02.05.2013;2013;05;01;Torstai;2;3;5;1;1;2
89;02.05.2013;2013;05;02;Torstai;1;0;1;1;0;1
89;02.05.2013;2013;05;03;Torstai;5;3;8;3;0;3
89;02.05.2013;2013;05;04;Torstai;0;5;5;0;1;1
89;02.05.2013;2013;05;05;Torstai;3;14;17;2;0;2
89;02.05.2013;2013;05;06;Torstai;21;70;91;2;6;8
89;02.05.2013;2013;05;07;Torstai;51;190;241;7;33;40
89;02.05.2013;2013;05;08;Torstai;76;188;264;20;28;48
89;02.05.2013;2013;05;09;Torstai;44;110;154;11;31;42
89;02.05.2013;2013;05;10;Torstai;42;86;128;20;20;40
89;02.05.2013;2013;05;11;Torstai;53;55;108;15;16;31
89;02.05.2013;2013;05;12;Torstai;35;64;99;14;24;38
89;02.05.2013;2013;05;13;Torstai;77;69;146;25;22;47
89;02.05.2013;2013;05;14;Torstai;98;44;142;28;16;44
89;02.05.2013;2013;05;15;Torstai;133;51;184;14;11;25
89;02.05.2013;2013;05;16;Torstai;186;75;261;22;16;38
89;02.05.2013;2013;05;17;Torstai;111;58;169;23;11;34
89;02.05.2013;2013;05;18;Torstai;51;40;91;20;22;42
89;02.05.2013;2013;05;19;Torstai;49;28;77;25;25;50
89;02.05.2013;2013;05;20;Torstai;40;37;77;18;18;36
89;02.05.2013;2013;05;21;Torstai;32;11;43;14;6;20
89;02.05.2013;2013;05;22;Torstai;14;3;17;2;3;5
89;02.05.2013;2013;05;23;Torstai;8;4;12;4;0;4
89;03.05.2013;2013;05;00;Perjantai;3;3;6;3;1;4
89;03.05.2013;2013;05;01;Perjantai;1;0;1;2;1;3
89;03.05.2013;2013;05;02;Perjantai;5;1;6;1;1;2
89;03.05.2013;2013;05;03;Perjantai;0;4;4;1;0;1
89;03.05.2013;2013;05;04;Perjantai;1;8;9;0;1;1
89;03.05.2013;2013;05;05;Perjantai;3;17;20;2;1;3
89;03.05.2013;2013;05;06;Perjantai;21;67;88;1;1;2
89;03.05.2013;2013;05;07;Perjantai;41;185;226;9;27;36
89;03.05.2013;2013;05;08;Perjantai;57;166;223;10;23;33
89;03.05.2013;2013;05;09;Perjantai;40;113;153;18;29;47
89;03.05.2013;2013;05;10;Perjantai;48;69;117;24;28;52
89;03.05.2013;2013;05;11;Perjantai;56;108;164;17;37;54
89;03.05.2013;2013;05;12;Perjantai;84;88;172;33;37;70
89;03.05.2013;2013;05;13;Perjantai;106;82;188;27;28;55
89;03.05.2013;2013;05;14;Perjantai;124;85;209;52;34;86
89;03.05.2013;2013;05;15;Perjantai;174;110;284;30;27;57
89;03.05.2013;2013;05;16;Perjantai;175;78;253;67;25;92
89;03.05.2013;2013;05;17;Perjantai;117;62;179;36;28;64
89;03.05.2013;2013;05;18;Perjantai;78;43;121;29;15;44
89;03.05.2013;2013;05;19;Perjantai;65;49;114;26;25;51
89;03.05.2013;2013;05;20;Perjantai;54;43;97;11;17;28
89;03.05.2013;2013;05;21;Perjantai;29;29;58;12;12;24
89;03.05.2013;2013;05;22;Perjantai;31;25;56;10;9;19
89;03.05.2013;2013;05;23;Perjantai;21;13;34;6;5;11
89;04.05.2013;2013;05;00;Lauantai;21;7;28;7;7;14
89;04.05.2013;2013;05;01;Lauantai;18;6;24;1;1;2
89;04.05.2013;2013;05;02;Lauantai;16;3;19;2;2;4
89;04.05.2013;2013;05;03;Lauantai;6;3;9;7;1;8
89;04.05.2013;2013;05;04;Lauantai;7;1;8;7;1;8
89;04.05.2013;2013;05;05;Lauantai;2;2;4;2;0;2
89;04.05.2013;2013;05;06;Lauantai;3;13;16;1;3;4
89;04.05.2013;2013;05;07;Lauantai;4;12;16;1;0;1
89;04.05.2013;2013;05;08;Lauantai;10;31;41;7;2;9
89;04.05.2013;2013;05;09;Lauantai;12;40;52;6;9;15
89;04.05.2013;2013;05;10;Lauantai;11;32;43;10;13;23
89;04.05.2013;2013;05;11;Lauantai;51;32;83;6;17;23
89;04.05.2013;2013;05;12;Lauantai;26;51;77;8;15;23
89;04.05.2013;2013;05;13;Lauantai;28;76;104;23;25;48
89;04.05.2013;2013;05;14;Lauantai;70;73;143;21;22;43
89;04.05.2013;2013;05;15;Lauantai;76;55;131;36;28;64
89;04.05.2013;2013;05;16;Lauantai;58;57;115;34;25;59
89;04.05.2013;2013;05;17;Lauantai;87;53;140;34;35;69
89;04.05.2013;2013;05;18;Lauantai;48;53;101;38;28;66
89;04.05.2013;2013;05;19;Lauantai;70;48;118;30;33;63
89;04.05.2013;2013;05;20;Lauantai;37;44;81;15;18;33
89;04.05.2013;2013;05;21;Lauantai;19;20;39;12;11;23
89;04.05.2013;2013;05;22;Lauantai;22;25;47;11;7;18
89;04.05.2013;2013;05;23;Lauantai;19;16;35;3;8;11
89;05.05.2013;2013;05;00;Sunnuntai;26;10;36;2;7;9
89;05.05.2013;2013;05;01;Sunnuntai;16;8;24;2;1;3
89;05.05.2013;2013;05;02;Sunnuntai;9;7;16;7;0;7
89;05.05.2013;2013;05;03;Sunnuntai;10;2;12;4;0;4
89;05.05.2013;2013;05;04;Sunnuntai;13;3;16;4;0;4
89;05.05.2013;2013;05;05;Sunnuntai;4;4;8;0;0;0
89;05.05.2013;2013;05;06;Sunnuntai;2;10;12;1;0;1
89;05.05.2013;2013;05;07;Sunnuntai;7;9;16;2;2;4
89;05.05.2013;2013;05;08;Sunnuntai;5;13;18;4;5;9
89;05.05.2013;2013;05;09;Sunnuntai;9;21;30;20;17;37
89;05.05.2013;2013;05;10;Sunnuntai;31;43;74;19;46;65
89;05.05.2013;2013;05;11;Sunnuntai;29;61;90;29;53;82
89;05.05.2013;2013;05;12;Sunnuntai;64;84;148;37;42;79
89;05.05.2013;2013;05;13;Sunnuntai;94;84;178;41;68;109
89;05.05.2013;2013;05;14;Sunnuntai;84;101;185;63;51;114
89;05.05.2013;2013;05;15;Sunnuntai;104;101;205;62;48;110
89;05.05.2013;2013;05;16;Sunnuntai;92;72;164;32;39;71
89;05.05.2013;2013;05;17;Sunnuntai;77;84;161;26;34;60
89;05.05.2013;2013;05;18;Sunnuntai;64;45;109;34;37;71
89;05.05.2013;2013;05;19;Sunnuntai;64;51;115;20;37;57
89;05.05.2013;2013;05;20;Sunnuntai;65;41;106;30;37;67
89;05.05.2013;2013;05;21;Sunnuntai;33;19;52;9;8;17
89;05.05.2013;2013;05;22;Sunnuntai;19;6;25;7;5;12
89;05.05.2013;2013;05;23;Sunnuntai;7;2;9;6;6;12
89;06.05.2013;2013;05;00;Maanantai;3;6;9;0;2;2
89;06.05.2013;2013;05;01;Maanantai;1;2;3;2;2;4
89;06.05.2013;2013;05;02;Maanantai;4;0;4;1;0;1
89;06.05.2013;2013;05;03;Maanantai;0;7;7;2;0;2
89;06.05.2013;2013;05;04;Maanantai;1;6;7;1;1;2
89;06.05.2013;2013;05;05;Maanantai;8;17;25;1;2;3
89;06.05.2013;2013;05;06;Maanantai;27;68;95;3;3;6
89;06.05.2013;2013;05;07;Maanantai;49;208;257;6;28;34
89;06.05.2013;2013;05;08;Maanantai;76;245;321;12;31;43
89;06.05.2013;2013;05;09;Maanantai;43;143;186;12;41;53
89;06.05.2013;2013;05;10;Maanantai;58;123;181;18;26;44
89;06.05.2013;2013;05;11;Maanantai;79;79;158;22;37;59
89;06.05.2013;2013;05;12;Maanantai;85;120;205;21;35;56
89;06.05.2013;2013;05;13;Maanantai;124;106;230;33;37;70
89;06.05.2013;2013;05;14;Maanantai;175;86;261;27;24;51
89;06.05.2013;2013;05;15;Maanantai;221;115;336;38;27;65
89;06.05.2013;2013;05;16;Maanantai;259;133;392;50;33;83
89;06.05.2013;2013;05;17;Maanantai;165;112;277;59;30;89
89;06.05.2013;2013;05;18;Maanantai;124;81;205;37;38;75
89;06.05.2013;2013;05;19;Maanantai;94;45;139;43;47;90
89;06.05.2013;2013;05;20;Maanantai;73;53;126;32;22;54
89;06.05.2013;2013;05;21;Maanantai;45;39;84;16;21;37
89;06.05.2013;2013;05;22;Maanantai;25;13;38;10;5;15
89;06.05.2013;2013;05;23;Maanantai;14;7;21;3;4;7
89;07.05.2013;2013;05;00;Tiistai;5;8;13;2;2;4
89;07.05.2013;2013;05;01;Tiistai;4;1;5;1;0;1
89;07.05.2013;2013;05;02;Tiistai;0;2;2;1;0;1
89;07.05.2013;2013;05;03;Tiistai;3;1;4;0;1;1
89;07.05.2013;2013;05;04;Tiistai;4;8;12;1;1;2
89;07.05.2013;2013;05;05;Tiistai;5;16;21;4;2;6
89;07.05.2013;2013;05;06;Tiistai;27;79;106;3;4;7
89;07.05.2013;2013;05;07;Tiistai;51;216;267;4;23;27
89;07.05.2013;2013;05;08;Tiistai;77;208;285;13;30;43
89;07.05.2013;2013;05;09;Tiistai;42;114;156;16;22;38
89;07.05.2013;2013;05;10;Tiistai;53;100;153;15;32;47
89;07.05.2013;2013;05;11;Tiistai;73;102;175;20;19;39
89;07.05.2013;2013;05;12;Tiistai;72;89;161;15;13;28
89;07.05.2013;2013;05;13;Tiistai;99;49;148;16;17;33
89;07.05.2013;2013;05;14;Tiistai;103;64;167;21;11;32
89;07.05.2013;2013;05;15;Tiistai;166;95;261;21;14;35
89;07.05.2013;2013;05;16;Tiistai;270;112;382;24;22;46
89;07.05.2013;2013;05;17;Tiistai;141;103;244;33;34;67
89;07.05.2013;2013;05;18;Tiistai;107;79;186;50;40;90
89;07.05.2013;2013;05;19;Tiistai;81;70;151;29;37;66
89;07.05.2013;2013;05;20;Tiistai;110;55;165;22;28;50
89;07.05.2013;2013;05;21;Tiistai;62;23;85;20;12;32
89;07.05.2013;2013;05;22;Tiistai;32;17;49;7;4;11
89;07.05.2013;2013;05;23;Tiistai;16;11;27;1;3;4
89;08.05.2013;2013;05;00;Keskiviikko;9;5;14;3;2;5
89;08.05.2013;2013;05;01;Keskiviikko;1;0;1;1;1;2
89;08.05.2013;2013;05;02;Keskiviikko;1;2;3;2;1;3
89;08.05.2013;2013;05;03;Keskiviikko;1;4;5;0;0;0
89;08.05.2013;2013;05;04;Keskiviikko;1;7;8;0;0;0
89;08.05.2013;2013;05;05;Keskiviikko;6;18;24;1;2;3
89;08.05.2013;2013;05;06;Keskiviikko;32;75;107;3;6;9
89;08.05.2013;2013;05;07;Keskiviikko;53;233;286;5;24;29
89;08.05.2013;2013;05;08;Keskiviikko;60;216;276;8;26;34
89;08.05.2013;2013;05;09;Keskiviikko;49;129;178;8;33;41
89;08.05.2013;2013;05;10;Keskiviikko;58;83;141;27;29;56
89;08.05.2013;2013;05;11;Keskiviikko;71;110;181;13;34;47
89;08.05.2013;2013;05;12;Keskiviikko;98;98;196;27;30;57
89;08.05.2013;2013;05;13;Keskiviikko;118;103;221;37;34;71
89;08.05.2013;2013;05;14;Keskiviikko;191;122;313;33;29;62
89;08.05.2013;2013;05;15;Keskiviikko;225;99;324;49;16;65
89;08.05.2013;2013;05;16;Keskiviikko;269;139;408;38;31;69
89;08.05.2013;2013;05;17;Keskiviikko;173;137;310;58;30;88
89;08.05.2013;2013;05;18;Keskiviikko;122;105;227;35;33;68
89;08.05.2013;2013;05;19;Keskiviikko;103;79;182;27;31;58
89;08.05.2013;2013;05;20;Keskiviikko;66;50;116;14;21;35
89;08.05.2013;2013;05;21;Keskiviikko;52;32;84;16;13;29
89;08.05.2013;2013;05;22;Keskiviikko;36;32;68;5;15;20
89;08.05.2013;2013;05;23;Keskiviikko;24;25;49;9;13;22
89;09.05.2013;2013;05;00;Torstai;15;17;32;1;11;12
89;09.05.2013;2013;05;01;Torstai;20;10;30;5;1;6
89;09.05.2013;2013;05;02;Torstai;17;3;20;7;4;11
89;09.05.2013;2013;05;03;Torstai;20;2;22;4;0;4
89;09.05.2013;2013;05;04;Torstai;19;3;22;3;0;3
89;09.05.2013;2013;05;05;Torstai;3;5;8;1;0;1
89;09.05.2013;2013;05;06;Torstai;4;11;15;0;0;0
89;09.05.2013;2013;05;07;Torstai;7;6;13;2;6;8
89;09.05.2013;2013;05;08;Torstai;8;13;21;6;1;7
89;09.05.2013;2013;05;09;Torstai;8;13;21;14;22;36
89;09.05.2013;2013;05;10;Torstai;25;26;51;9;28;37
89;09.05.2013;2013;05;11;Torstai;16;24;40;34;35;69
89;09.05.2013;2013;05;12;Torstai;25;39;64;27;29;56
89;09.05.2013;2013;05;13;Torstai;26;34;60;29;35;64
89;09.05.2013;2013;05;14;Torstai;31;28;59;12;21;33
89;09.05.2013;2013;05;15;Torstai;39;24;63;21;27;48
89;09.05.2013;2013;05;16;Torstai;15;24;39;14;16;30
89;09.05.2013;2013;05;17;Torstai;32;38;70;13;18;31
89;09.05.2013;2013;05;18;Torstai;35;25;60;18;19;37
89;09.05.2013;2013;05;19;Torstai;17;14;31;20;13;33
89;09.05.2013;2013;05;20;Torstai;29;18;47;8;16;24
89;09.05.2013;2013;05;21;Torstai;20;11;31;8;9;17
89;09.05.2013;2013;05;22;Torstai;12;13;25;2;5;7
89;09.05.2013;2013;05;23;Torstai;10;4;14;0;1;1
89;10.05.2013;2013;05;00;Perjantai;2;1;3;2;0;2
89;10.05.2013;2013;05;01;Perjantai;1;1;2;1;1;2
89;10.05.2013;2013;05;02;Perjantai;2;0;2;2;0;2
89;10.05.2013;2013;05;03;Perjantai;3;3;6;0;0;0
89;10.05.2013;2013;05;04;Perjantai;2;3;5;1;2;3
89;10.05.2013;2013;05;05;Perjantai;4;12;16;0;1;1
89;10.05.2013;2013;05;06;Perjantai;16;63;79;4;4;8
89;10.05.2013;2013;05;07;Perjantai;38;94;132;2;11;13
89;10.05.2013;2013;05;08;Perjantai;27;104;131;7;15;22
89;10.05.2013;2013;05;09;Perjantai;28;88;116;7;21;28
89;10.05.2013;2013;05;10;Perjantai;32;40;72;8;7;15
89;10.05.2013;2013;05;11;Perjantai;29;56;85;21;32;53
89;10.05.2013;2013;05;12;Perjantai;44;54;98;12;20;32
89;10.05.2013;2013;05;13;Perjantai;66;55;121;20;7;27
89;10.05.2013;2013;05;14;Perjantai;95;49;144;12;19;31
89;10.05.2013;2013;05;15;Perjantai;77;69;146;8;10;18
89;10.05.2013;2013;05;16;Perjantai;109;43;152;10;10;20
89;10.05.2013;2013;05;17;Perjantai;65;37;102;7;11;18
89;10.05.2013;2013;05;18;Perjantai;49;58;107;15;13;28
89;10.05.2013;2013;05;19;Perjantai;40;16;56;16;10;26
89;10.05.2013;2013;05;20;Perjantai;35;28;63;5;7;12
89;10.05.2013;2013;05;21;Perjantai;20;20;40;9;4;13
89;10.05.2013;2013;05;22;Perjantai;19;9;28;5;1;6
89;10.05.2013;2013;05;23;Perjantai;10;14;24;2;5;7
89;11.05.2013;2013;05;00;Lauantai;10;5;15;0;1;1
89;11.05.2013;2013;05;01;Lauantai;11;5;16;2;2;4
89;11.05.2013;2013;05;02;Lauantai;10;4;14;2;4;6
89;11.05.2013;2013;05;03;Lauantai;9;3;12;4;0;4
89;11.05.2013;2013;05;04;Lauantai;8;2;10;5;0;5
89;11.05.2013;2013;05;05;Lauantai;3;5;8;1;0;1
89;11.05.2013;2013;05;06;Lauantai;3;12;15;3;3;6
89;11.05.2013;2013;05;07;Lauantai;5;11;16;3;6;9
89;11.05.2013;2013;05;08;Lauantai;10;30;40;6;11;17
89;11.05.2013;2013;05;09;Lauantai;17;42;59;13;22;35
89;11.05.2013;2013;05;10;Lauantai;28;60;88;17;27;44
89;11.05.2013;2013;05;11;Lauantai;48;76;124;18;31;49
89;11.05.2013;2013;05;12;Lauantai;54;63;117;19;27;46
89;11.05.2013;2013;05;13;Lauantai;81;75;156;28;38;66
89;11.05.2013;2013;05;14;Lauantai;75;44;119;28;34;62
89;11.05.2013;2013;05;15;Lauantai;72;29;101;17;18;35
89;11.05.2013;2013;05;16;Lauantai;58;28;86;17;14;31
89;11.05.2013;2013;05;17;Lauantai;62;35;97;30;18;48
89;11.05.2013;2013;05;18;Lauantai;33;27;60;18;23;41
89;11.05.2013;2013;05;19;Lauantai;18;29;47;28;14;42
89;11.05.2013;2013;05;20;Lauantai;20;28;48;9;13;22
89;11.05.2013;2013;05;21;Lauantai;30;26;56;14;18;32
89;11.05.2013;2013;05;22;Lauantai;12;19;31;7;6;13
89;11.05.2013;2013;05;23;Lauantai;19;20;39;3;6;9
89;12.05.2013;2013;05;00;Sunnuntai;9;11;20;1;5;6
89;12.05.2013;2013;05;01;Sunnuntai;14;6;20;3;0;3
89;12.05.2013;2013;05;02;Sunnuntai;14;5;19;5;7;12
89;12.05.2013;2013;05;03;Sunnuntai;11;0;11;1;1;2
89;12.05.2013;2013;05;04;Sunnuntai;10;1;11;9;0;9
89;12.05.2013;2013;05;05;Sunnuntai;3;6;9;1;0;1
89;12.05.2013;2013;05;06;Sunnuntai;5;8;13;1;0;1
89;12.05.2013;2013;05;07;Sunnuntai;3;3;6;4;9;13
89;12.05.2013;2013;05;08;Sunnuntai;8;20;28;9;11;20
89;12.05.2013;2013;05;09;Sunnuntai;14;26;40;5;20;25
89;12.05.2013;2013;05;10;Sunnuntai;31;27;58;28;29;57
89;12.05.2013;2013;05;11;Sunnuntai;36;56;92;21;44;65
89;12.05.2013;2013;05;12;Sunnuntai;48;64;112;24;37;61
89;12.05.2013;2013;05;13;Sunnuntai;74;65;139;37;33;70
89;12.05.2013;2013;05;14;Sunnuntai;66;69;135;30;35;65
89;12.05.2013;2013;05;15;Sunnuntai;65;50;115;24;29;53
89;12.05.2013;2013;05;16;Sunnuntai;72;76;148;30;24;54
89;12.05.2013;2013;05;17;Sunnuntai;86;77;163;33;56;89
89;12.05.2013;2013;05;18;Sunnuntai;65;76;141;49;50;99
89;12.05.2013;2013;05;19;Sunnuntai;92;54;146;24;43;67
89;12.05.2013;2013;05;20;Sunnuntai;61;53;114;42;36;78
89;12.05.2013;2013;05;21;Sunnuntai;31;19;50;18;15;33
89;12.05.2013;2013;05;22;Sunnuntai;11;14;25;4;12;16
89;12.05.2013;2013;05;23;Sunnuntai;8;4;12;3;1;4
89;13.05.2013;2013;05;00;Maanantai;5;11;16;1;1;2
89;13.05.2013;2013;05;01;Maanantai;3;1;4;1;2;3
89;13.05.2013;2013;05;02;Maanantai;5;0;5;2;0;2
89;13.05.2013;2013;05;03;Maanantai;0;1;1;1;1;2
89;13.05.2013;2013;05;04;Maanantai;0;8;8;0;1;1
89;13.05.2013;2013;05;05;Maanantai;7;16;23;3;1;4
89;13.05.2013;2013;05;06;Maanantai;31;77;108;1;9;10
89;13.05.2013;2013;05;07;Maanantai;47;203;250;6;22;28
89;13.05.2013;2013;05;08;Maanantai;76;228;304;10;29;39
89;13.05.2013;2013;05;09;Maanantai;45;133;178;9;39;48
89;13.05.2013;2013;05;10;Maanantai;59;112;171;11;28;39
89;13.05.2013;2013;05;11;Maanantai;77;103;180;20;36;56
89;13.05.2013;2013;05;12;Maanantai;84;115;199;22;32;54
89;13.05.2013;2013;05;13;Maanantai;93;71;164;16;27;43
89;13.05.2013;2013;05;14;Maanantai;136;86;222;18;12;30
89;13.05.2013;2013;05;15;Maanantai;189;107;296;18;40;58
89;13.05.2013;2013;05;16;Maanantai;282;102;384;37;22;59
89;13.05.2013;2013;05;17;Maanantai;121;57;178;16;16;32
89;13.05.2013;2013;05;18;Maanantai;91;56;147;20;18;38
89;13.05.2013;2013;05;19;Maanantai;64;31;95;24;22;46
89;13.05.2013;2013;05;20;Maanantai;63;51;114;56;41;97
89;13.05.2013;2013;05;21;Maanantai;35;24;59;16;20;36
89;13.05.2013;2013;05;22;Maanantai;16;11;27;12;7;19
89;13.05.2013;2013;05;23;Maanantai;10;4;14;5;3;8
89;14.05.2013;2013;05;00;Tiistai;10;1;11;1;4;5
89;14.05.2013;2013;05;01;Tiistai;1;0;1;0;0;0
89;14.05.2013;2013;05;02;Tiistai;0;0;0;0;1;1
89;14.05.2013;2013;05;03;Tiistai;1;3;4;1;0;1
89;14.05.2013;2013;05;04;Tiistai;3;10;13;0;1;1
89;14.05.2013;2013;05;05;Tiistai;4;11;15;1;5;6
89;14.05.2013;2013;05;06;Tiistai;30;82;112;1;7;8
89;14.05.2013;2013;05;07;Tiistai;41;169;210;2;23;25
89;14.05.2013;2013;05;08;Tiistai;64;224;288;5;25;30
89;14.05.2013;2013;05;09;Tiistai;43;106;149;5;31;36
89;14.05.2013;2013;05;10;Tiistai;43;81;124;19;41;60
89;14.05.2013;2013;05;11;Tiistai;60;107;167;17;44;61
89;14.05.2013;2013;05;12;Tiistai;74;97;171;22;26;48
89;14.05.2013;2013;05;13;Tiistai;105;89;194;28;28;56
89;14.05.2013;2013;05;14;Tiistai;149;109;258;24;30;54
89;14.05.2013;2013;05;15;Tiistai;186;87;273;29;23;52
89;14.05.2013;2013;05;16;Tiistai;268;128;396;33;28;61
89;14.05.2013;2013;05;17;Tiistai;161;127;288;44;34;78
89;14.05.2013;2013;05;18;Tiistai;100;73;173;39;41;80
89;14.05.2013;2013;05;19;Tiistai;102;60;162;33;33;66
89;14.05.2013;2013;05;20;Tiistai;91;42;133;32;11;43
89;14.05.2013;2013;05;21;Tiistai;43;13;56;4;12;16
89;14.05.2013;2013;05;22;Tiistai;25;6;31;6;3;9
89;14.05.2013;2013;05;23;Tiistai;18;19;37;2;2;4
89;15.05.2013;2013;05;00;Keskiviikko;3;3;6;3;1;4
89;15.05.2013;2013;05;01;Keskiviikko;0;1;1;0;2;2
89;15.05.2013;2013;05;02;Keskiviikko;2;1;3;0;0;0
89;15.05.2013;2013;05;03;Keskiviikko;7;1;8;1;0;1
89;15.05.2013;2013;05;04;Keskiviikko;3;3;6;0;1;1
89;15.05.2013;2013;05;05;Keskiviikko;8;17;25;4;2;6
89;15.05.2013;2013;05;06;Keskiviikko;18;71;89;5;8;13
89;15.05.2013;2013;05;07;Keskiviikko;78;218;296;8;24;32
89;15.05.2013;2013;05;08;Keskiviikko;85;243;328;9;32;41
89;15.05.2013;2013;05;09;Keskiviikko;44;134;178;7;39;46
89;15.05.2013;2013;05;10;Keskiviikko;60;109;169;24;36;60
89;15.05.2013;2013;05;11;Keskiviikko;80;120;200;29;42;71
89;15.05.2013;2013;05;12;Keskiviikko;113;125;238;28;39;67
89;15.05.2013;2013;05;13;Keskiviikko;124;111;235;49;50;99
89;15.05.2013;2013;05;14;Keskiviikko;170;130;300;73;21;94
89;15.05.2013;2013;05;15;Keskiviikko;226;161;387;96;34;130
89;15.05.2013;2013;05;16;Keskiviikko;300;166;466;84;29;113
89;15.05.2013;2013;05;17;Keskiviikko;203;140;343;89;38;127
89;15.05.2013;2013;05;18;Keskiviikko;131;119;250;44;59;103
89;15.05.2013;2013;05;19;Keskiviikko;124;68;192;60;41;101
89;15.05.2013;2013;05;20;Keskiviikko;104;56;160;34;28;62
89;15.05.2013;2013;05;21;Keskiviikko;72;37;109;14;17;31
89;15.05.2013;2013;05;22;Keskiviikko;33;24;57;12;10;22
89;15.05.2013;2013;05;23;Keskiviikko;12;17;29;3;9;12
89;16.05.2013;2013;05;00;Torstai;8;4;12;1;2;3
89;16.05.2013;2013;05;01;Torstai;6;2;8;6;1;7
89;16.05.2013;2013;05;02;Torstai;7;0;7;1;2;3
89;16.05.2013;2013;05;03;Torstai;2;3;5;2;0;2
89;16.05.2013;2013;05;04;Torstai;7;1;8;0;2;2
89;16.05.2013;2013;05;05;Torstai;2;27;29;2;3;5
89;16.05.2013;2013;05;06;Torstai;33;79;112;6;6;12
89;16.05.2013;2013;05;07;Torstai;72;235;307;7;19;26
89;16.05.2013;2013;05;08;Torstai;77;253;330;10;51;61
89;16.05.2013;2013;05;09;Torstai;50;164;214;22;33;55
89;16.05.2013;2013;05;10;Torstai;63;150;213;20;30;50
89;16.05.2013;2013;05;11;Torstai;121;120;241;27;34;61
89;16.05.2013;2013;05;12;Torstai;99;150;249;28;25;53
89;16.05.2013;2013;05;13;Torstai;152;151;303;49;60;109
89;16.05.2013;2013;05;14;Torstai;185;141;326;32;30;62
89;16.05.2013;2013;05;15;Torstai;228;168;396;45;45;90
89;16.05.2013;2013;05;16;Torstai;303;150;453;59;30;89
89;16.05.2013;2013;05;17;Torstai;235;150;385;64;29;93
89;16.05.2013;2013;05;18;Torstai;155;129;284;55;46;101
89;16.05.2013;2013;05;19;Torstai;118;80;198;35;30;65
89;16.05.2013;2013;05;20;Torstai;101;53;154;27;19;46
89;16.05.2013;2013;05;21;Torstai;93;63;156;20;29;49
89;16.05.2013;2013;05;22;Torstai;51;18;69;13;17;30
89;16.05.2013;2013;05;23;Torstai;21;7;28;7;11;18
89;17.05.2013;2013;05;00;Perjantai;13;11;24;3;3;6
89;17.05.2013;2013;05;01;Perjantai;4;4;8;1;3;4
89;17.05.2013;2013;05;02;Perjantai;3;1;4;2;0;2
89;17.05.2013;2013;05;03;Perjantai;6;2;8;0;1;1
89;17.05.2013;2013;05;04;Perjantai;10;4;14;0;0;0
89;17.05.2013;2013;05;05;Perjantai;4;25;29;1;4;5
89;17.05.2013;2013;05;06;Perjantai;25;79;104;3;4;7
89;17.05.2013;2013;05;07;Perjantai;65;208;273;6;17;23
89;17.05.2013;2013;05;08;Perjantai;71;217;288;12;34;46
89;17.05.2013;2013;05;09;Perjantai;56;126;182;20;67;87
89;17.05.2013;2013;05;10;Perjantai;64;165;229;21;33;54
89;17.05.2013;2013;05;11;Perjantai;94;158;252;28;45;73
89;17.05.2013;2013;05;12;Perjantai;130;133;263;32;94;126
89;17.05.2013;2013;05;13;Perjantai;191;177;368;34;38;72
89;17.05.2013;2013;05;14;Perjantai;220;185;405;33;46;79
89;17.05.2013;2013;05;15;Perjantai;289;222;511;36;45;81
89;17.05.2013;2013;05;16;Perjantai;261;237;498;51;63;114
89;17.05.2013;2013;05;17;Perjantai;203;185;388;41;48;89
89;17.05.2013;2013;05;18;Perjantai;195;174;369;66;71;137
89;17.05.2013;2013;05;19;Perjantai;151;184;335;56;63;119
89;17.05.2013;2013;05;20;Perjantai;145;144;289;47;58;105
89;17.05.2013;2013;05;21;Perjantai;130;138;268;42;52;94
89;17.05.2013;2013;05;22;Perjantai;123;111;234;31;47;78
89;17.05.2013;2013;05;23;Perjantai;85;60;145;16;33;49
89;18.05.2013;2013;05;00;Lauantai;70;48;118;22;13;35
89;18.05.2013;2013;05;01;Lauantai;47;20;67;8;11;19
89;18.05.2013;2013;05;02;Lauantai;50;7;57;11;3;14
89;18.05.2013;2013;05;03;Lauantai;24;5;29;7;5;12
89;18.05.2013;2013;05;04;Lauantai;29;5;34;4;1;5
89;18.05.2013;2013;05;05;Lauantai;12;10;22;2;0;2
89;18.05.2013;2013;05;06;Lauantai;6;14;20;1;3;4
89;18.05.2013;2013;05;07;Lauantai;7;19;26;8;7;15
89;18.05.2013;2013;05;08;Lauantai;14;51;65;12;12;24
89;18.05.2013;2013;05;09;Lauantai;33;102;135;20;43;63
89;18.05.2013;2013;05;10;Lauantai;85;146;231;26;46;72
89;18.05.2013;2013;05;11;Lauantai;121;177;298;22;42;64
89;18.05.2013;2013;05;12;Lauantai;186;209;395;47;62;109
89;18.05.2013;2013;05;13;Lauantai;213;230;443;23;62;85
89;18.05.2013;2013;05;14;Lauantai;232;214;446;67;61;128
89;18.05.2013;2013;05;15;Lauantai;274;209;483;66;43;109
89;18.05.2013;2013;05;16;Lauantai;136;120;256;86;31;117
89;18.05.2013;2013;05;17;Lauantai;111;68;179;71;19;90
89;18.05.2013;2013;05;18;Lauantai;129;141;270;35;33;68
89;18.05.2013;2013;05;19;Lauantai;126;191;317;41;49;90
89;18.05.2013;2013;05;20;Lauantai;113;139;252;36;40;76
89;18.05.2013;2013;05;21;Lauantai;94;121;215;35;60;95
89;18.05.2013;2013;05;22;Lauantai;69;73;142;8;34;42
89;18.05.2013;2013;05;23;Lauantai;69;46;115;18;20;38
89;19.05.2013;2013;05;00;Sunnuntai;43;44;87;6;21;27
89;19.05.2013;2013;05;01;Sunnuntai;51;23;74;3;8;11
89;19.05.2013;2013;05;02;Sunnuntai;50;12;62;14;9;23
89;19.05.2013;2013;05;03;Sunnuntai;47;3;50;8;1;9
89;19.05.2013;2013;05;04;Sunnuntai;32;4;36;10;1;11
89;19.05.2013;2013;05;05;Sunnuntai;9;4;13;0;0;0
89;19.05.2013;2013;05;06;Sunnuntai;5;14;19;3;2;5
89;19.05.2013;2013;05;07;Sunnuntai;5;18;23;3;0;3
89;19.05.2013;2013;05;08;Sunnuntai;15;22;37;5;13;18
89;19.05.2013;2013;05;09;Sunnuntai;30;37;67;11;25;36
89;19.05.2013;2013;05;10;Sunnuntai;45;99;144;31;52;83
89;19.05.2013;2013;05;11;Sunnuntai;104;158;262;30;55;85
89;19.05.2013;2013;05;12;Sunnuntai;180;197;377;38;60;98
89;19.05.2013;2013;05;13;Sunnuntai;257;280;537;60;90;150
89;19.05.2013;2013;05;14;Sunnuntai;252;265;517;61;68;129
89;19.05.2013;2013;05;15;Sunnuntai;235;259;494;50;61;111
89;19.05.2013;2013;05;16;Sunnuntai;202;245;447;47;76;123
89;19.05.2013;2013;05;17;Sunnuntai;183;190;373;34;59;93
89;19.05.2013;2013;05;18;Sunnuntai;174;127;301;44;37;81
89;19.05.2013;2013;05;19;Sunnuntai;107;103;210;44;37;81
89;19.05.2013;2013;05;20;Sunnuntai;128;98;226;46;43;89
89;19.05.2013;2013;05;21;Sunnuntai;105;52;157;17;26;43
89;19.05.2013;2013;05;22;Sunnuntai;35;28;63;10;8;18
89;19.05.2013;2013;05;23;Sunnuntai;14;17;31;7;4;11
89;20.05.2013;2013;05;00;Maanantai;6;6;12;4;3;7
89;20.05.2013;2013;05;01;Maanantai;7;9;16;0;0;0
89;20.05.2013;2013;05;02;Maanantai;4;1;5;5;0;5
89;20.05.2013;2013;05;03;Maanantai;0;6;6;1;1;2
89;20.05.2013;2013;05;04;Maanantai;4;6;10;2;1;3
89;20.05.2013;2013;05;05;Maanantai;6;24;30;0;2;2
89;20.05.2013;2013;05;06;Maanantai;28;73;101;8;5;13
89;20.05.2013;2013;05;07;Maanantai;65;238;303;4;22;26
89;20.05.2013;2013;05;08;Maanantai;67;304;371;10;24;34
89;20.05.2013;2013;05;09;Maanantai;63;162;225;19;39;58
89;20.05.2013;2013;05;10;Maanantai;60;152;212;9;27;36
89;20.05.2013;2013;05;11;Maanantai;103;132;235;21;26;47
89;20.05.2013;2013;05;12;Maanantai;91;136;227;23;23;46
89;20.05.2013;2013;05;13;Maanantai;165;140;305;28;30;58
89;20.05.2013;2013;05;14;Maanantai;200;160;360;49;40;89
89;20.05.2013;2013;05;15;Maanantai;293;123;416;41;52;93
89;20.05.2013;2013;05;16;Maanantai;317;179;496;34;34;68
89;20.05.2013;2013;05;17;Maanantai;256;143;399;35;30;65
89;20.05.2013;2013;05;18;Maanantai;221;125;346;42;27;69
89;20.05.2013;2013;05;19;Maanantai;142;89;231;40;49;89
89;20.05.2013;2013;05;20;Maanantai;129;70;199;30;47;77
89;20.05.2013;2013;05;21;Maanantai;66;62;128;18;24;42
89;20.05.2013;2013;05;22;Maanantai;37;16;53;7;10;17
89;20.05.2013;2013;05;23;Maanantai;11;8;19;2;8;10
89;21.05.2013;2013;05;00;Tiistai;3;11;14;1;0;1
89;21.05.2013;2013;05;01;Tiistai;5;1;6;1;1;2
89;21.05.2013;2013;05;02;Tiistai;4;0;4;0;0;0
89;21.05.2013;2013;05;03;Tiistai;1;4;5;2;0;2
89;21.05.2013;2013;05;04;Tiistai;2;6;8;0;0;0
89;21.05.2013;2013;05;05;Tiistai;5;19;24;0;1;1
89;21.05.2013;2013;05;06;Tiistai;29;87;116;5;4;9
89;21.05.2013;2013;05;07;Tiistai;57;273;330;5;21;26
89;21.05.2013;2013;05;08;Tiistai;68;317;385;4;27;31
89;21.05.2013;2013;05;09;Tiistai;66;193;259;12;43;55
89;21.05.2013;2013;05;10;Tiistai;54;116;170;21;22;43
89;21.05.2013;2013;05;11;Tiistai;92;135;227;16;29;45
89;21.05.2013;2013;05;12;Tiistai;119;141;260;44;62;106
89;21.05.2013;2013;05;13;Tiistai;160;142;302;28;31;59
89;21.05.2013;2013;05;14;Tiistai;181;139;320;32;38;70
89;21.05.2013;2013;05;15;Tiistai;266;158;424;61;27;88
89;21.05.2013;2013;05;16;Tiistai;388;179;567;40;19;59
89;21.05.2013;2013;05;17;Tiistai;205;183;388;56;73;129
89;21.05.2013;2013;05;18;Tiistai;185;143;328;36;48;84
89;21.05.2013;2013;05;19;Tiistai;181;105;286;52;59;111
89;21.05.2013;2013;05;20;Tiistai;134;82;216;58;41;99
89;21.05.2013;2013;05;21;Tiistai;87;58;145;21;34;55
89;21.05.2013;2013;05;22;Tiistai;41;42;83;25;19;44
89;21.05.2013;2013;05;23;Tiistai;14;13;27;5;5;10
89;22.05.2013;2013;05;00;Keskiviikko;11;3;14;1;0;1
89;22.05.2013;2013;05;01;Keskiviikko;8;6;14;1;2;3
89;22.05.2013;2013;05;02;Keskiviikko;2;4;6;2;0;2
89;22.05.2013;2013;05;03;Keskiviikko;1;1;2;0;0;0
89;22.05.2013;2013;05;04;Keskiviikko;7;6;13;5;7;12
89;22.05.2013;2013;05;05;Keskiviikko;6;16;22;4;2;6
89;22.05.2013;2013;05;06;Keskiviikko;29;88;117;3;8;11
89;22.05.2013;2013;05;07;Keskiviikko;65;256;321;5;22;27
89;22.05.2013;2013;05;08;Keskiviikko;75;287;362;4;46;50
89;22.05.2013;2013;05;09;Keskiviikko;60;168;228;8;27;35
89;22.05.2013;2013;05;10;Keskiviikko;73;153;226;17;31;48
89;22.05.2013;2013;05;11;Keskiviikko;83;133;216;30;23;53
89;22.05.2013;2013;05;12;Keskiviikko;146;192;338;42;78;120
89;22.05.2013;2013;05;13;Keskiviikko;148;131;279;18;40;58
89;22.05.2013;2013;05;14;Keskiviikko;204;141;345;26;37;63
89;22.05.2013;2013;05;15;Keskiviikko;270;177;447;42;33;75
89;22.05.2013;2013;05;16;Keskiviikko;346;182;528;47;42;89
89;22.05.2013;2013;05;17;Keskiviikko;250;171;421;37;49;86
89;22.05.2013;2013;05;18;Keskiviikko;201;141;342;35;53;88
89;22.05.2013;2013;05;19;Keskiviikko;175;112;287;39;45;84
89;22.05.2013;2013;05;20;Keskiviikko;138;73;211;43;30;73
89;22.05.2013;2013;05;21;Keskiviikko;84;58;142;21;22;43
89;22.05.2013;2013;05;22;Keskiviikko;54;29;83;42;27;69
89;22.05.2013;2013;05;23;Keskiviikko;20;17;37;4;5;9
89;23.05.2013;2013;05;00;Torstai;12;8;20;2;2;4
89;23.05.2013;2013;05;01;Torstai;5;7;12;2;2;4
89;23.05.2013;2013;05;02;Torstai;7;0;7;0;0;0
89;23.05.2013;2013;05;03;Torstai;3;3;6;1;1;2
89;23.05.2013;2013;05;04;Torstai;10;7;17;0;2;2
89;23.05.2013;2013;05;05;Torstai;11;20;31;1;2;3
89;23.05.2013;2013;05;06;Torstai;32;93;125;2;5;7
89;23.05.2013;2013;05;07;Torstai;66;255;321;8;24;32
89;23.05.2013;2013;05;08;Torstai;64;296;360;21;46;67
89;23.05.2013;2013;05;09;Torstai;63;162;225;23;76;99
89;23.05.2013;2013;05;10;Torstai;64;121;185;29;38;67
89;23.05.2013;2013;05;11;Torstai;93;150;243;27;36;63
89;23.05.2013;2013;05;12;Torstai;115;125;240;16;26;42
89;23.05.2013;2013;05;13;Torstai;124;125;249;25;33;58
89;23.05.2013;2013;05;14;Torstai;175;151;326;34;31;65
89;23.05.2013;2013;05;15;Torstai;283;169;452;30;32;62
89;23.05.2013;2013;05;16;Torstai;318;157;475;35;29;64
89;23.05.2013;2013;05;17;Torstai;206;160;366;22;27;49
89;23.05.2013;2013;05;18;Torstai;194;150;344;40;49;89
89;23.05.2013;2013;05;19;Torstai;173;118;291;37;52;89
89;23.05.2013;2013;05;20;Torstai;132;70;202;37;41;78
89;23.05.2013;2013;05;21;Torstai;100;60;160;33;42;75
89;23.05.2013;2013;05;22;Torstai;44;36;80;11;13;24
89;23.05.2013;2013;05;23;Torstai;30;17;47;6;5;11
89;24.05.2013;2013;05;00;Perjantai;16;13;29;5;2;7
89;24.05.2013;2013;05;01;Perjantai;6;1;7;4;3;7
89;24.05.2013;2013;05;02;Perjantai;8;0;8;5;3;8
89;24.05.2013;2013;05;03;Perjantai;3;1;4;2;0;2
89;24.05.2013;2013;05;04;Perjantai;7;6;13;0;0;0
89;24.05.2013;2013;05;05;Perjantai;8;20;28;2;3;5
89;24.05.2013;2013;05;06;Perjantai;25;88;113;0;9;9
89;24.05.2013;2013;05;07;Perjantai;49;210;259;6;17;23
89;24.05.2013;2013;05;08;Perjantai;74;268;342;24;40;64
89;24.05.2013;2013;05;09;Perjantai;75;189;264;29;42;71
89;24.05.2013;2013;05;10;Perjantai;57;124;181;19;39;58
89;24.05.2013;2013;05;11;Perjantai;107;162;269;21;58;79
89;24.05.2013;2013;05;12;Perjantai;159;164;323;21;29;50
89;24.05.2013;2013;05;13;Perjantai;240;132;372;37;16;53
89;24.05.2013;2013;05;14;Perjantai;217;125;342;23;24;47
89;24.05.2013;2013;05;15;Perjantai;267;155;422;64;40;104
89;24.05.2013;2013;05;16;Perjantai;258;168;426;32;40;72
89;24.05.2013;2013;05;17;Perjantai;193;157;350;34;39;73
89;24.05.2013;2013;05;18;Perjantai;206;152;358;55;32;87
89;24.05.2013;2013;05;19;Perjantai;181;134;315;32;42;74
89;24.05.2013;2013;05;20;Perjantai;177;129;306;46;56;102
89;24.05.2013;2013;05;21;Perjantai;118;141;259;86;117;203
89;24.05.2013;2013;05;22;Perjantai;68;131;199;46;85;131
89;24.05.2013;2013;05;23;Perjantai;80;96;176;51;74;125
89;25.05.2013;2013;05;00;Lauantai;59;76;135;25;57;82
89;25.05.2013;2013;05;01;Lauantai;53;31;84;18;39;57
89;25.05.2013;2013;05;02;Lauantai;42;38;80;18;22;40
89;25.05.2013;2013;05;03;Lauantai;39;12;51;10;14;24
89;25.05.2013;2013;05;04;Lauantai;41;6;47;5;3;8
89;25.05.2013;2013;05;05;Lauantai;10;14;24;3;2;5
89;25.05.2013;2013;05;06;Lauantai;1;17;18;6;3;9
89;25.05.2013;2013;05;07;Lauantai;5;16;21;5;8;13
89;25.05.2013;2013;05;08;Lauantai;14;59;73;11;9;20
89;25.05.2013;2013;05;09;Lauantai;23;121;144;8;31;39
89;25.05.2013;2013;05;10;Lauantai;59;180;239;8;55;63
89;25.05.2013;2013;05;11;Lauantai;112;179;291;19;54;73
89;25.05.2013;2013;05;12;Lauantai;145;265;410;58;627;685
89;25.05.2013;2013;05;13;Lauantai;121;318;439;106;1062;1168
89;25.05.2013;2013;05;14;Lauantai;176;220;396;79;519;598
89;25.05.2013;2013;05;15;Lauantai;228;215;443;58;309;367
89;25.05.2013;2013;05;16;Lauantai;228;146;374;41;89;130
89;25.05.2013;2013;05;17;Lauantai;175;166;341;41;39;80
89;25.05.2013;2013;05;18;Lauantai;130;146;276;33;59;92
89;25.05.2013;2013;05;19;Lauantai;139;127;266;24;37;61
89;25.05.2013;2013;05;20;Lauantai;86;129;215;30;42;72
89;25.05.2013;2013;05;21;Lauantai;89;119;208;32;45;77
89;25.05.2013;2013;05;22;Lauantai;78;77;155;16;24;40
89;25.05.2013;2013;05;23;Lauantai;55;82;137;28;38;66
89;26.05.2013;2013;05;00;Sunnuntai;45;27;72;9;13;22
89;26.05.2013;2013;05;01;Sunnuntai;52;23;75;8;5;13
89;26.05.2013;2013;05;02;Sunnuntai;41;5;46;7;3;10
89;26.05.2013;2013;05;03;Sunnuntai;51;2;53;12;0;12
89;26.05.2013;2013;05;04;Sunnuntai;34;3;37;3;2;5
89;26.05.2013;2013;05;05;Sunnuntai;6;4;10;5;0;5
89;26.05.2013;2013;05;06;Sunnuntai;3;14;17;1;6;7
89;26.05.2013;2013;05;07;Sunnuntai;6;15;21;2;3;5
89;26.05.2013;2013;05;08;Sunnuntai;15;20;35;12;9;21
89;26.05.2013;2013;05;09;Sunnuntai;24;43;67;17;24;41
89;26.05.2013;2013;05;10;Sunnuntai;60;79;139;33;47;80
89;26.05.2013;2013;05;11;Sunnuntai;76;130;206;25;44;69
89;26.05.2013;2013;05;12;Sunnuntai;93;166;259;39;45;84
89;26.05.2013;2013;05;13;Sunnuntai;139;234;373;37;87;124
89;26.05.2013;2013;05;14;Sunnuntai;198;180;378;47;66;113
89;26.05.2013;2013;05;15;Sunnuntai;205;143;348;55;37;92
89;26.05.2013;2013;05;16;Sunnuntai;158;150;308;34;42;76
89;26.05.2013;2013;05;17;Sunnuntai;174;175;349;32;37;69
89;26.05.2013;2013;05;18;Sunnuntai;139;158;297;42;41;83
89;26.05.2013;2013;05;19;Sunnuntai;138;147;285;48;54;102
89;26.05.2013;2013;05;20;Sunnuntai;113;125;238;39;38;77
89;26.05.2013;2013;05;21;Sunnuntai;60;52;112;27;18;45
89;26.05.2013;2013;05;22;Sunnuntai;46;37;83;12;12;24
89;26.05.2013;2013;05;23;Sunnuntai;30;7;37;10;7;17
89;27.05.2013;2013;05;00;Maanantai;16;8;24;1;4;5
89;27.05.2013;2013;05;01;Maanantai;2;6;8;0;1;1
89;27.05.2013;2013;05;02;Maanantai;3;1;4;0;2;2
89;27.05.2013;2013;05;03;Maanantai;8;6;14;1;0;1
89;27.05.2013;2013;05;04;Maanantai;3;4;7;1;0;1
89;27.05.2013;2013;05;05;Maanantai;7;23;30;0;1;1
89;27.05.2013;2013;05;06;Maanantai;28;87;115;3;4;7
89;27.05.2013;2013;05;07;Maanantai;65;246;311;10;21;31
89;27.05.2013;2013;05;08;Maanantai;70;282;352;6;29;35
89;27.05.2013;2013;05;09;Maanantai;57;169;226;8;23;31
89;27.05.2013;2013;05;10;Maanantai;72;151;223;13;33;46
89;27.05.2013;2013;05;11;Maanantai;102;141;243;40;49;89
89;27.05.2013;2013;05;12;Maanantai;111;142;253;21;39;60
89;27.05.2013;2013;05;13;Maanantai;172;167;339;35;38;73
89;27.05.2013;2013;05;14;Maanantai;201;145;346;45;35;80
89;27.05.2013;2013;05;15;Maanantai;276;161;437;30;36;66
89;27.05.2013;2013;05;16;Maanantai;368;175;543;32;27;59
89;27.05.2013;2013;05;17;Maanantai;219;162;381;31;38;69
89;27.05.2013;2013;05;18;Maanantai;186;159;345;51;42;93
89;27.05.2013;2013;05;19;Maanantai;180;129;309;40;42;82
89;27.05.2013;2013;05;20;Maanantai;138;91;229;36;55;91
89;27.05.2013;2013;05;21;Maanantai;102;62;164;26;22;48
89;27.05.2013;2013;05;22;Maanantai;50;29;79;12;11;23
89;27.05.2013;2013;05;23;Maanantai;26;15;41;2;8;10
89;28.05.2013;2013;05;00;Tiistai;13;12;25;5;4;9
89;28.05.2013;2013;05;01;Tiistai;7;9;16;3;5;8
89;28.05.2013;2013;05;02;Tiistai;1;5;6;0;0;0
89;28.05.2013;2013;05;03;Tiistai;2;1;3;4;0;4
89;28.05.2013;2013;05;04;Tiistai;3;5;8;1;0;1
89;28.05.2013;2013;05;05;Tiistai;6;27;33;1;4;5
89;28.05.2013;2013;05;06;Tiistai;40;102;142;2;6;8
89;28.05.2013;2013;05;07;Tiistai;72;307;379;8;24;32
89;28.05.2013;2013;05;08;Tiistai;72;322;394;14;44;58
89;28.05.2013;2013;05;09;Tiistai;72;235;307;22;45;67
89;28.05.2013;2013;05;10;Tiistai;114;169;283;25;63;88
89;28.05.2013;2013;05;11;Tiistai;129;201;330;35;58;93
89;28.05.2013;2013;05;12;Tiistai;179;190;369;60;51;111
89;28.05.2013;2013;05;13;Tiistai;204;194;398;62;69;131
89;28.05.2013;2013;05;14;Tiistai;257;152;409;46;60;106
89;28.05.2013;2013;05;15;Tiistai;354;199;553;43;57;100
89;28.05.2013;2013;05;16;Tiistai;405;214;619;32;41;73
89;28.05.2013;2013;05;17;Tiistai;254;212;466;50;51;101
89;28.05.2013;2013;05;18;Tiistai;226;235;461;34;53;87
89;28.05.2013;2013;05;19;Tiistai;221;178;399;43;60;103
89;28.05.2013;2013;05;20;Tiistai;214;141;355;43;35;78
89;28.05.2013;2013;05;21;Tiistai;106;76;182;31;40;71
89;28.05.2013;2013;05;22;Tiistai;49;51;100;16;19;35
89;28.05.2013;2013;05;23;Tiistai;22;21;43;7;13;20
89;29.05.2013;2013;05;00;Keskiviikko;20;16;36;4;7;11
89;29.05.2013;2013;05;01;Keskiviikko;15;6;21;2;3;5
89;29.05.2013;2013;05;02;Keskiviikko;10;3;13;2;0;2
89;29.05.2013;2013;05;03;Keskiviikko;4;1;5;1;1;2
89;29.05.2013;2013;05;04;Keskiviikko;3;2;5;2;2;4
89;29.05.2013;2013;05;05;Keskiviikko;7;26;33;0;2;2
89;29.05.2013;2013;05;06;Keskiviikko;35;93;128;8;12;20
89;29.05.2013;2013;05;07;Keskiviikko;74;301;375;6;35;41
89;29.05.2013;2013;05;08;Keskiviikko;68;309;377;7;34;41
89;29.05.2013;2013;05;09;Keskiviikko;69;210;279;13;34;47
89;29.05.2013;2013;05;10;Keskiviikko;110;160;270;37;85;122
89;29.05.2013;2013;05;11;Keskiviikko;153;252;405;35;55;90
89;29.05.2013;2013;05;12;Keskiviikko;192;193;385;29;38;67
89;29.05.2013;2013;05;13;Keskiviikko;245;143;388;51;38;89
89;29.05.2013;2013;05;14;Keskiviikko;271;170;441;53;29;82
89;29.05.2013;2013;05;15;Keskiviikko;341;223;564;41;42;83
89;29.05.2013;2013;05;16;Keskiviikko;450;240;690;41;56;97
89;29.05.2013;2013;05;17;Keskiviikko;258;268;526;47;56;103
89;29.05.2013;2013;05;18;Keskiviikko;222;198;420;65;55;120
89;29.05.2013;2013;05;19;Keskiviikko;221;197;418;39;38;77
89;29.05.2013;2013;05;20;Keskiviikko;192;135;327;31;50;81
89;29.05.2013;2013;05;21;Keskiviikko;124;128;252;24;39;63
89;29.05.2013;2013;05;22;Keskiviikko;74;83;157;10;13;23
89;29.05.2013;2013;05;23;Keskiviikko;50;39;89;9;12;21
89;30.05.2013;2013;05;00;Torstai;27;9;36;7;3;10
89;30.05.2013;2013;05;01;Torstai;14;6;20;3;3;6
89;30.05.2013;2013;05;02;Torstai;9;8;17;4;0;4
89;30.05.2013;2013;05;03;Torstai;7;4;11;2;0;2
89;30.05.2013;2013;05;04;Torstai;13;4;17;1;0;1
89;30.05.2013;2013;05;05;Torstai;8;21;29;5;9;14
89;30.05.2013;2013;05;06;Torstai;33;98;131;11;8;19
89;30.05.2013;2013;05;07;Torstai;65;269;334;8;23;31
89;30.05.2013;2013;05;08;Torstai;94;288;382;11;35;46
89;30.05.2013;2013;05;09;Torstai;64;209;273;17;123;140
89;30.05.2013;2013;05;10;Torstai;110;156;266;20;31;51
89;30.05.2013;2013;05;11;Torstai;125;143;268;19;28;47
89;30.05.2013;2013;05;12;Torstai;213;158;371;77;42;119
89;30.05.2013;2013;05;13;Torstai;210;215;425;51;39;90
89;30.05.2013;2013;05;14;Torstai;242;199;441;43;38;81
89;30.05.2013;2013;05;15;Torstai;348;219;567;39;32;71
89;30.05.2013;2013;05;16;Torstai;407;242;649;41;24;65
89;30.05.2013;2013;05;17;Torstai;268;225;493;44;37;81
89;30.05.2013;2013;05;18;Torstai;227;225;452;56;45;101
89;30.05.2013;2013;05;19;Torstai;257;186;443;41;83;124
89;30.05.2013;2013;05;20;Torstai;209;195;404;39;50;89
89;30.05.2013;2013;05;21;Torstai;125;113;238;18;43;61
89;30.05.2013;2013;05;22;Torstai;84;79;163;29;28;57
89;30.05.2013;2013;05;23;Torstai;53;39;92;9;19;28
89;31.05.2013;2013;05;00;Perjantai;36;25;61;5;6;11
89;31.05.2013;2013;05;01;Perjantai;15;11;26;1;1;2
89;31.05.2013;2013;05;02;Perjantai;16;4;20;2;1;3
89;31.05.2013;2013;05;03;Perjantai;14;2;16;7;0;7
89;31.05.2013;2013;05;04;Perjantai;10;5;15;1;0;1
89;31.05.2013;2013;05;05;Perjantai;14;26;40;4;1;5
89;31.05.2013;2013;05;06;Perjantai;30;91;121;7;5;12
89;31.05.2013;2013;05;07;Perjantai;51;263;314;9;17;26
89;31.05.2013;2013;05;08;Perjantai;81;251;332;11;62;73
89;31.05.2013;2013;05;09;Perjantai;71;174;245;28;40;68
89;31.05.2013;2013;05;10;Perjantai;109;161;270;14;23;37
89;31.05.2013;2013;05;11;Perjantai;165;169;334;22;35;57
89;31.05.2013;2013;05;12;Perjantai;195;168;363;23;23;46
89;31.05.2013;2013;05;13;Perjantai;219;179;398;32;26;58
89;31.05.2013;2013;05;14;Perjantai;261;221;482;29;32;61
89;31.05.2013;2013;05;15;Perjantai;292;216;508;20;31;51
89;31.05.2013;2013;05;16;Perjantai;240;152;392;20;32;52
89;31.05.2013;2013;05;17;Perjantai;135;123;258;18;27;45
89;31.05.2013;2013;05;18;Perjantai;150;121;271;24;27;51
89;31.05.2013;2013;05;19;Perjantai;145;113;258;27;23;50
89;31.05.2013;2013;05;20;Perjantai;151;128;279;25;43;68
89;31.05.2013;2013;05;21;Perjantai;131;141;272;23;43;66
89;31.05.2013;2013;05;22;Perjantai;96;91;187;33;43;76
89;31.05.2013;2013;05;23;Perjantai;66;80;146;25;37;62
89;01.06.2013;2013;06;00;Lauantai;74;72;146;43;40;83
89;01.06.2013;2013;06;01;Lauantai;58;40;98;13;23;36
89;01.06.2013;2013;06;02;Lauantai;52;12;64;13;6;19
89;01.06.2013;2013;06;03;Lauantai;43;6;49;11;4;15
89;01.06.2013;2013;06;04;Lauantai;35;6;41;3;1;4
89;01.06.2013;2013;06;05;Lauantai;6;10;16;3;0;3
89;01.06.2013;2013;06;06;Lauantai;7;20;27;1;3;4
89;01.06.2013;2013;06;07;Lauantai;14;31;45;5;11;16
89;01.06.2013;2013;06;08;Lauantai;30;82;112;9;12;21
89;01.06.2013;2013;06;09;Lauantai;48;96;144;11;30;41
89;01.06.2013;2013;06;10;Lauantai;101;188;289;17;27;44
89;01.06.2013;2013;06;11;Lauantai;80;134;214;25;37;62
89;01.06.2013;2013;06;12;Lauantai;146;167;313;16;34;50
89;01.06.2013;2013;06;13;Lauantai;155;149;304;16;29;45
89;01.06.2013;2013;06;14;Lauantai;168;138;306;28;27;55
89;01.06.2013;2013;06;15;Lauantai;136;107;243;11;27;38
89;01.06.2013;2013;06;16;Lauantai;113;102;215;20;19;39
89;01.06.2013;2013;06;17;Lauantai;133;113;246;22;23;45
89;01.06.2013;2013;06;18;Lauantai;133;120;253;24;27;51
89;01.06.2013;2013;06;19;Lauantai;124;175;299;33;61;94
89;01.06.2013;2013;06;20;Lauantai;119;169;288;27;44;71
89;01.06.2013;2013;06;21;Lauantai;101;145;246;18;44;62
89;01.06.2013;2013;06;22;Lauantai;85;126;211;9;27;36
89;01.06.2013;2013;06;23;Lauantai;51;86;137;13;35;48
89;02.06.2013;2013;06;00;Sunnuntai;44;46;90;11;5;16
89;02.06.2013;2013;06;01;Sunnuntai;30;29;59;7;3;10
89;02.06.2013;2013;06;02;Sunnuntai;75;15;90;17;9;26
89;02.06.2013;2013;06;03;Sunnuntai;64;8;72;24;2;26
89;02.06.2013;2013;06;04;Sunnuntai;44;8;52;15;16;31
89;02.06.2013;2013;06;05;Sunnuntai;14;8;22;2;0;2
89;02.06.2013;2013;06;06;Sunnuntai;2;13;15;5;5;10
89;02.06.2013;2013;06;07;Sunnuntai;11;15;26;4;8;12
89;02.06.2013;2013;06;08;Sunnuntai;18;38;56;9;20;29
89;02.06.2013;2013;06;09;Sunnuntai;40;57;97;18;15;33
89;02.06.2013;2013;06;10;Sunnuntai;65;121;186;22;30;52
89;02.06.2013;2013;06;11;Sunnuntai;79;133;212;31;51;82
89;02.06.2013;2013;06;12;Sunnuntai;133;179;312;30;42;72
89;02.06.2013;2013;06;13;Sunnuntai;164;197;361;24;26;50
89;02.06.2013;2013;06;14;Sunnuntai;200;173;373;33;52;85
89;02.06.2013;2013;06;15;Sunnuntai;176;168;344;26;54;80
89;02.06.2013;2013;06;16;Sunnuntai;204;208;412;33;29;62
89;02.06.2013;2013;06;17;Sunnuntai;186;155;341;32;34;66
89;02.06.2013;2013;06;18;Sunnuntai;144;140;284;26;21;47
89;02.06.2013;2013;06;19;Sunnuntai;132;147;279;36;51;87
89;02.06.2013;2013;06;20;Sunnuntai;122;122;244;23;37;60
89;02.06.2013;2013;06;21;Sunnuntai;85;85;170;16;22;38
89;02.06.2013;2013;06;22;Sunnuntai;66;36;102;14;15;29
89;02.06.2013;2013;06;23;Sunnuntai;26;31;57;5;13;18
89;03.06.2013;2013;06;00;Maanantai;9;13;22;4;4;8
89;03.06.2013;2013;06;01;Maanantai;11;5;16;0;3;3
89;03.06.2013;2013;06;02;Maanantai;0;2;2;3;1;4
89;03.06.2013;2013;06;03;Maanantai;4;1;5;4;1;5
89;03.06.2013;2013;06;04;Maanantai;4;9;13;2;1;3
89;03.06.2013;2013;06;05;Maanantai;11;32;43;5;2;7
89;03.06.2013;2013;06;06;Maanantai;31;96;127;10;6;16
89;03.06.2013;2013;06;07;Maanantai;70;231;301;2;23;25
89;03.06.2013;2013;06;08;Maanantai;61;262;323;6;28;34
89;03.06.2013;2013;06;09;Maanantai;69;176;245;12;29;41
89;03.06.2013;2013;06;10;Maanantai;81;112;193;21;24;45
89;03.06.2013;2013;06;11;Maanantai;130;134;264;14;23;37
89;03.06.2013;2013;06;12;Maanantai;126;156;282;25;43;68
89;03.06.2013;2013;06;13;Maanantai;196;149;345;12;32;44
89;03.06.2013;2013;06;14;Maanantai;180;167;347;29;24;53
89;03.06.2013;2013;06;15;Maanantai;321;188;509;30;35;65
89;03.06.2013;2013;06;16;Maanantai;399;212;611;43;34;77
89;03.06.2013;2013;06;17;Maanantai;237;118;355;27;29;56
89;03.06.2013;2013;06;18;Maanantai;115;59;174;12;17;29
89;03.06.2013;2013;06;19;Maanantai;123;71;194;18;21;39
89;03.06.2013;2013;06;20;Maanantai;116;90;206;32;26;58
89;03.06.2013;2013;06;21;Maanantai;92;61;153;18;12;30
89;03.06.2013;2013;06;22;Maanantai;14;9;23;4;2;6
89;03.06.2013;2013;06;23;Maanantai;16;5;21;3;2;5
89;04.06.2013;2013;06;00;Tiistai;12;2;14;5;3;8
89;04.06.2013;2013;06;01;Tiistai;7;3;10;1;5;6
89;04.06.2013;2013;06;02;Tiistai;6;9;15;0;0;0
89;04.06.2013;2013;06;03;Tiistai;6;2;8;0;0;0
89;04.06.2013;2013;06;04;Tiistai;5;4;9;0;1;1
89;04.06.2013;2013;06;05;Tiistai;8;25;33;2;3;5
89;04.06.2013;2013;06;06;Tiistai;33;91;124;8;6;14
89;04.06.2013;2013;06;07;Tiistai;46;218;264;9;22;31
89;04.06.2013;2013;06;08;Tiistai;54;225;279;10;23;33
89;04.06.2013;2013;06;09;Tiistai;55;116;171;7;14;21
89;04.06.2013;2013;06;10;Tiistai;46;119;165;22;41;63
89;04.06.2013;2013;06;11;Tiistai;54;142;196;12;47;59
89;04.06.2013;2013;06;12;Tiistai;85;121;206;21;30;51
89;04.06.2013;2013;06;13;Tiistai;141;113;254;11;19;30
89;04.06.2013;2013;06;14;Tiistai;170;131;301;17;16;33
89;04.06.2013;2013;06;15;Tiistai;265;127;392;32;21;53
89;04.06.2013;2013;06;16;Tiistai;318;159;477;33;29;62
89;04.06.2013;2013;06;17;Tiistai;227;159;386;38;42;80
89;04.06.2013;2013;06;18;Tiistai;194;139;333;35;48;83
89;04.06.2013;2013;06;19;Tiistai;158;125;283;33;33;66
89;04.06.2013;2013;06;20;Tiistai;206;117;323;26;39;65
89;04.06.2013;2013;06;21;Tiistai;117;77;194;23;20;43
89;04.06.2013;2013;06;22;Tiistai;62;55;117;19;13;32
89;04.06.2013;2013;06;23;Tiistai;36;23;59;10;11;21
89;05.06.2013;2013;06;00;Keskiviikko;17;21;38;4;7;11
89;05.06.2013;2013;06;01;Keskiviikko;8;9;17;1;0;1
89;05.06.2013;2013;06;02;Keskiviikko;8;1;9;1;4;5
89;05.06.2013;2013;06;03;Keskiviikko;8;3;11;1;2;3
89;05.06.2013;2013;06;04;Keskiviikko;2;2;4;2;1;3
89;05.06.2013;2013;06;05;Keskiviikko;8;20;28;2;2;4
89;05.06.2013;2013;06;06;Keskiviikko;30;99;129;7;6;13
89;05.06.2013;2013;06;07;Keskiviikko;69;268;337;5;21;26
89;05.06.2013;2013;06;08;Keskiviikko;59;237;296;10;33;43
89;05.06.2013;2013;06;09;Keskiviikko;58;170;228;22;25;47
89;05.06.2013;2013;06;10;Keskiviikko;79;125;204;19;23;42
89;05.06.2013;2013;06;11;Keskiviikko;101;187;288;13;24;37
89;05.06.2013;2013;06;12;Keskiviikko;152;165;317;17;36;53
89;05.06.2013;2013;06;13;Keskiviikko;166;149;315;24;27;51
89;05.06.2013;2013;06;14;Keskiviikko;191;189;380;17;25;42
89;05.06.2013;2013;06;15;Keskiviikko;305;229;534;44;44;88
89;05.06.2013;2013;06;16;Keskiviikko;375;223;598;30;36;66
89;05.06.2013;2013;06;17;Keskiviikko;247;197;444;31;40;71
89;05.06.2013;2013;06;18;Keskiviikko;202;151;353;33;53;86
89;05.06.2013;2013;06;19;Keskiviikko;231;149;380;39;54;93
89;05.06.2013;2013;06;20;Keskiviikko;168;137;305;33;48;81
89;05.06.2013;2013;06;21;Keskiviikko;140;96;236;27;39;66
89;05.06.2013;2013;06;22;Keskiviikko;70;41;111;16;11;27
89;05.06.2013;2013;06;23;Keskiviikko;40;28;68;5;9;14
89;06.06.2013;2013;06;00;Torstai;24;6;30;1;0;1
89;06.06.2013;2013;06;01;Torstai;16;14;30;2;2;4
89;06.06.2013;2013;06;02;Torstai;12;4;16;2;3;5
89;06.06.2013;2013;06;03;Torstai;14;2;16;3;1;4
89;06.06.2013;2013;06;04;Torstai;18;6;24;4;0;4
89;06.06.2013;2013;06;05;Torstai;10;18;28;2;2;4
89;06.06.2013;2013;06;06;Torstai;31;98;129;3;6;9
89;06.06.2013;2013;06;07;Torstai;43;240;283;4;18;22
89;06.06.2013;2013;06;08;Torstai;51;200;251;12;29;41
89;06.06.2013;2013;06;09;Torstai;50;160;210;11;20;31
89;06.06.2013;2013;06;10;Torstai;64;135;199;24;28;52
89;06.06.2013;2013;06;11;Torstai;68;126;194;17;25;42
89;06.06.2013;2013;06;12;Torstai;102;161;263;19;35;54
89;06.06.2013;2013;06;13;Torstai;146;153;299;26;37;63
89;06.06.2013;2013;06;14;Torstai;207;147;354;42;33;75
89;06.06.2013;2013;06;15;Torstai;289;177;466;36;24;60
89;06.06.2013;2013;06;16;Torstai;345;175;520;34;24;58
89;06.06.2013;2013;06;17;Torstai;218;204;422;20;34;54
89;06.06.2013;2013;06;18;Torstai;230;169;399;30;41;71
89;06.06.2013;2013;06;19;Torstai;162;140;302;39;45;84
89;06.06.2013;2013;06;20;Torstai;176;129;305;31;41;72
89;06.06.2013;2013;06;21;Torstai;108;78;186;20;21;41
89;06.06.2013;2013;06;22;Torstai;87;37;124;15;23;38
89;06.06.2013;2013;06;23;Torstai;25;33;58;7;11;18
89;07.06.2013;2013;06;00;Perjantai;14;8;22;3;4;7
89;07.06.2013;2013;06;01;Perjantai;21;3;24;5;1;6
89;07.06.2013;2013;06;02;Perjantai;13;1;14;4;4;8
89;07.06.2013;2013;06;03;Perjantai;12;1;13;0;0;0
89;07.06.2013;2013;06;04;Perjantai;4;2;6;3;1;4
89;07.06.2013;2013;06;05;Perjantai;3;20;23;0;1;1
89;07.06.2013;2013;06;06;Perjantai;31;93;124;4;8;12
89;07.06.2013;2013;06;07;Perjantai;44;213;257;10;12;22
89;07.06.2013;2013;06;08;Perjantai;45;201;246;10;25;35
89;07.06.2013;2013;06;09;Perjantai;55;134;189;15;19;34
89;07.06.2013;2013;06;10;Perjantai;61;110;171;10;34;44
89;07.06.2013;2013;06;11;Perjantai;84;169;253;31;43;74
89;07.06.2013;2013;06;12;Perjantai;100;152;252;20;28;48
89;07.06.2013;2013;06;13;Perjantai;159;154;313;34;24;58
89;07.06.2013;2013;06;14;Perjantai;235;144;379;39;30;69
89;07.06.2013;2013;06;15;Perjantai;266;183;449;34;37;71
89;07.06.2013;2013;06;16;Perjantai;240;182;422;27;19;46
89;07.06.2013;2013;06;17;Perjantai;164;157;321;26;25;51
89;07.06.2013;2013;06;18;Perjantai;154;134;288;38;42;80
89;07.06.2013;2013;06;19;Perjantai;117;142;259;12;37;49
89;07.06.2013;2013;06;20;Perjantai;146;114;260;23;19;42
89;07.06.2013;2013;06;21;Perjantai;81;121;202;26;21;47
89;07.06.2013;2013;06;22;Perjantai;58;90;148;22;27;49
89;07.06.2013;2013;06;23;Perjantai;58;80;138;19;26;45
89;08.06.2013;2013;06;00;Lauantai;57;32;89;6;17;23
89;08.06.2013;2013;06;01;Lauantai;76;27;103;8;16;24
89;08.06.2013;2013;06;02;Lauantai;38;10;48;6;4;10
89;08.06.2013;2013;06;03;Lauantai;38;11;49;7;0;7
89;08.06.2013;2013;06;04;Lauantai;30;7;37;7;0;7
89;08.06.2013;2013;06;05;Lauantai;8;7;15;3;2;5
89;08.06.2013;2013;06;06;Lauantai;5;21;26;2;0;2
89;08.06.2013;2013;06;07;Lauantai;9;18;27;3;2;5
89;08.06.2013;2013;06;08;Lauantai;16;26;42;10;11;21
89;08.06.2013;2013;06;09;Lauantai;14;55;69;8;18;26
89;08.06.2013;2013;06;10;Lauantai;29;98;127;5;25;30
89;08.06.2013;2013;06;11;Lauantai;57;102;159;12;17;29
89;08.06.2013;2013;06;12;Lauantai;78;109;187;24;37;61
89;08.06.2013;2013;06;13;Lauantai;79;96;175;26;30;56
89;08.06.2013;2013;06;14;Lauantai;116;83;199;25;16;41
89;08.06.2013;2013;06;15;Lauantai;102;51;153;20;8;28
89;08.06.2013;2013;06;16;Lauantai;87;70;157;25;21;46
89;08.06.2013;2013;06;17;Lauantai;101;65;166;26;15;41
89;08.06.2013;2013;06;18;Lauantai;103;83;186;45;27;72
89;08.06.2013;2013;06;19;Lauantai;72;134;206;26;31;57
89;08.06.2013;2013;06;20;Lauantai;76;101;177;22;33;55
89;08.06.2013;2013;06;21;Lauantai;62;92;154;14;22;36
89;08.06.2013;2013;06;22;Lauantai;58;81;139;4;50;54
89;08.06.2013;2013;06;23;Lauantai;35;73;108;17;10;27
89;09.06.2013;2013;06;00;Sunnuntai;33;39;72;8;12;20
89;09.06.2013;2013;06;01;Sunnuntai;34;28;62;8;2;10
89;09.06.2013;2013;06;02;Sunnuntai;39;11;50;7;1;8
89;09.06.2013;2013;06;03;Sunnuntai;50;11;61;12;2;14
89;09.06.2013;2013;06;04;Sunnuntai;47;5;52;15;1;16
89;09.06.2013;2013;06;05;Sunnuntai;7;1;8;2;1;3
89;09.06.2013;2013;06;06;Sunnuntai;6;19;25;2;1;3
89;09.06.2013;2013;06;07;Sunnuntai;11;6;17;5;4;9
89;09.06.2013;2013;06;08;Sunnuntai;10;21;31;18;5;23
89;09.06.2013;2013;06;09;Sunnuntai;23;40;63;31;28;59
89;09.06.2013;2013;06;10;Sunnuntai;36;58;94;13;23;36
89;09.06.2013;2013;06;11;Sunnuntai;48;89;137;20;28;48
89;09.06.2013;2013;06;12;Sunnuntai;68;99;167;35;38;73
89;09.06.2013;2013;06;13;Sunnuntai;74;85;159;23;56;79
89;09.06.2013;2013;06;14;Sunnuntai;72;55;127;22;16;38
89;09.06.2013;2013;06;15;Sunnuntai;123;94;217;29;35;64
89;09.06.2013;2013;06;16;Sunnuntai;82;59;141;22;13;35
89;09.06.2013;2013;06;17;Sunnuntai;66;65;131;14;20;34
89;09.06.2013;2013;06;18;Sunnuntai;93;91;184;23;32;55
89;09.06.2013;2013;06;19;Sunnuntai;88;86;174;20;57;77
89;09.06.2013;2013;06;20;Sunnuntai;84;66;150;21;34;55
89;09.06.2013;2013;06;21;Sunnuntai;43;31;74;19;15;34
89;09.06.2013;2013;06;22;Sunnuntai;43;36;79;12;8;20
89;09.06.2013;2013;06;23;Sunnuntai;20;19;39;8;4;12
89;10.06.2013;2013;06;00;Maanantai;12;15;27;2;2;4
89;10.06.2013;2013;06;01;Maanantai;10;6;16;2;1;3
89;10.06.2013;2013;06;02;Maanantai;6;8;14;2;1;3
89;10.06.2013;2013;06;03;Maanantai;4;4;8;1;0;1
89;10.06.2013;2013;06;04;Maanantai;12;4;16;1;3;4
89;10.06.2013;2013;06;05;Maanantai;10;31;41;4;0;4
89;10.06.2013;2013;06;06;Maanantai;26;80;106;2;3;5
89;10.06.2013;2013;06;07;Maanantai;47;244;291;8;20;28
89;10.06.2013;2013;06;08;Maanantai;71;207;278;22;18;40
89;10.06.2013;2013;06;09;Maanantai;47;145;192;19;26;45
89;10.06.2013;2013;06;10;Maanantai;59;113;172;15;22;37
89;10.06.2013;2013;06;11;Maanantai;99;134;233;22;33;55
89;10.06.2013;2013;06;12;Maanantai;109;150;259;25;43;68
89;10.06.2013;2013;06;13;Maanantai;141;145;286;32;36;68
89;10.06.2013;2013;06;14;Maanantai;150;131;281;33;43;76
89;10.06.2013;2013;06;15;Maanantai;264;146;410;45;36;81
89;10.06.2013;2013;06;16;Maanantai;323;190;513;49;32;81
89;10.06.2013;2013;06;17;Maanantai;214;139;353;33;42;75
89;10.06.2013;2013;06;18;Maanantai;219;124;343;39;50;89
89;10.06.2013;2013;06;19;Maanantai;156;101;257;46;48;94
89;10.06.2013;2013;06;20;Maanantai;122;74;196;42;32;74
89;10.06.2013;2013;06;21;Maanantai;95;52;147;18;15;33
89;10.06.2013;2013;06;22;Maanantai;36;25;61;7;11;18
89;10.06.2013;2013;06;23;Maanantai;22;15;37;9;1;10
89;11.06.2013;2013;06;00;Tiistai;19;15;34;1;2;3
89;11.06.2013;2013;06;01;Tiistai;10;6;16;9;3;12
89;11.06.2013;2013;06;02;Tiistai;4;5;9;1;1;2
89;11.06.2013;2013;06;03;Tiistai;5;5;10;0;1;1
89;11.06.2013;2013;06;04;Tiistai;8;3;11;1;1;2
89;11.06.2013;2013;06;05;Tiistai;10;23;33;1;0;1
89;11.06.2013;2013;06;06;Tiistai;25;81;106;1;5;6
89;11.06.2013;2013;06;07;Tiistai;45;151;196;5;9;14
89;11.06.2013;2013;06;08;Tiistai;37;136;173;15;20;35
89;11.06.2013;2013;06;09;Tiistai;36;102;138;18;12;30
89;11.06.2013;2013;06;10;Tiistai;31;78;109;14;24;38
89;11.06.2013;2013;06;11;Tiistai;48;73;121;14;19;33
89;11.06.2013;2013;06;12;Tiistai;74;98;172;11;42;53
89;11.06.2013;2013;06;13;Tiistai;76;75;151;26;18;44
89;11.06.2013;2013;06;14;Tiistai;111;84;195;24;14;38
89;11.06.2013;2013;06;15;Tiistai;175;108;283;16;23;39
89;11.06.2013;2013;06;16;Tiistai;219;105;324;34;18;52
89;11.06.2013;2013;06;17;Tiistai;148;86;234;16;42;58
89;11.06.2013;2013;06;18;Tiistai;104;76;180;27;36;63
89;11.06.2013;2013;06;19;Tiistai;90;65;155;22;27;49
89;11.06.2013;2013;06;20;Tiistai;85;41;126;27;20;47
89;11.06.2013;2013;06;21;Tiistai;82;42;124;12;17;29
89;11.06.2013;2013;06;22;Tiistai;31;31;62;7;6;13
89;11.06.2013;2013;06;23;Tiistai;26;25;51;4;0;4
89;12.06.2013;2013;06;00;Keskiviikko;16;8;24;2;6;8
89;12.06.2013;2013;06;01;Keskiviikko;7;5;12;2;0;2
89;12.06.2013;2013;06;02;Keskiviikko;6;6;12;5;0;5
89;12.06.2013;2013;06;03;Keskiviikko;5;2;7;2;0;2
89;12.06.2013;2013;06;04;Keskiviikko;11;5;16;2;1;3
89;12.06.2013;2013;06;05;Keskiviikko;12;23;35;2;1;3
89;12.06.2013;2013;06;06;Keskiviikko;24;96;120;4;7;11
89;12.06.2013;2013;06;07;Keskiviikko;61;228;289;11;28;39
89;12.06.2013;2013;06;08;Keskiviikko;53;201;254;13;28;41
89;12.06.2013;2013;06;09;Keskiviikko;53;147;200;12;39;51
89;12.06.2013;2013;06;10;Keskiviikko;54;105;159;20;33;53
89;12.06.2013;2013;06;11;Keskiviikko;66;109;175;19;32;51
89;12.06.2013;2013;06;12;Keskiviikko;101;107;208;22;33;55
89;12.06.2013;2013;06;13;Keskiviikko;138;119;257;17;27;44
89;12.06.2013;2013;06;14;Keskiviikko;171;113;284;27;28;55
89;12.06.2013;2013;06;15;Keskiviikko;233;132;365;38;22;60
89;12.06.2013;2013;06;16;Keskiviikko;295;130;425;27;19;46
89;12.06.2013;2013;06;17;Keskiviikko;208;145;353;29;25;54
89;12.06.2013;2013;06;18;Keskiviikko;147;108;255;43;23;66
89;12.06.2013;2013;06;19;Keskiviikko;156;73;229;33;36;69
89;12.06.2013;2013;06;20;Keskiviikko;103;65;168;26;26;52
89;12.06.2013;2013;06;21;Keskiviikko;68;49;117;12;18;30
89;12.06.2013;2013;06;22;Keskiviikko;43;32;75;11;11;22
89;12.06.2013;2013;06;23;Keskiviikko;23;10;33;4;4;8
89;13.06.2013;2013;06;00;Torstai;15;12;27;2;5;7
89;13.06.2013;2013;06;01;Torstai;13;6;19;5;0;5
89;13.06.2013;2013;06;02;Torstai;13;3;16;1;0;1
89;13.06.2013;2013;06;03;Torstai;5;4;9;4;2;6
89;13.06.2013;2013;06;04;Torstai;16;3;19;4;0;4
89;13.06.2013;2013;06;05;Torstai;6;19;25;2;0;2
89;13.06.2013;2013;06;06;Torstai;26;95;121;2;5;7
89;13.06.2013;2013;06;07;Torstai;54;211;265;11;17;28
89;13.06.2013;2013;06;08;Torstai;43;186;229;9;31;40
89;13.06.2013;2013;06;09;Torstai;47;145;192;24;34;58
89;13.06.2013;2013;06;10;Torstai;60;106;166;22;39;61
89;13.06.2013;2013;06;11;Torstai;83;116;199;28;45;73
89;13.06.2013;2013;06;12;Torstai;97;118;215;19;32;51
89;13.06.2013;2013;06;13;Torstai;109;97;206;19;37;56
89;13.06.2013;2013;06;14;Torstai;128;126;254;41;43;84
89;13.06.2013;2013;06;15;Torstai;270;150;420;29;41;70
89;13.06.2013;2013;06;16;Torstai;316;139;455;40;32;72
89;13.06.2013;2013;06;17;Torstai;167;152;319;46;42;88
89;13.06.2013;2013;06;18;Torstai;169;110;279;39;34;73
89;13.06.2013;2013;06;19;Torstai;140;117;257;55;51;106
89;13.06.2013;2013;06;20;Torstai;132;77;209;34;34;68
89;13.06.2013;2013;06;21;Torstai;98;53;151;23;18;41
89;13.06.2013;2013;06;22;Torstai;57;31;88;10;5;15
89;13.06.2013;2013;06;23;Torstai;25;25;50;5;5;10
89;14.06.2013;2013;06;00;Perjantai;20;18;38;4;4;8
89;14.06.2013;2013;06;01;Perjantai;13;6;19;11;1;12
89;14.06.2013;2013;06;02;Perjantai;15;1;16;3;1;4
89;14.06.2013;2013;06;03;Perjantai;9;6;15;3;1;4
89;14.06.2013;2013;06;04;Perjantai;8;6;14;0;0;0
89;14.06.2013;2013;06;05;Perjantai;10;15;25;1;0;1
89;14.06.2013;2013;06;06;Perjantai;20;66;86;1;1;2
89;14.06.2013;2013;06;07;Perjantai;30;131;161;7;11;18
89;14.06.2013;2013;06;08;Perjantai;32;117;149;3;16;19
89;14.06.2013;2013;06;09;Perjantai;20;95;115;4;14;18
89;14.06.2013;2013;06;10;Perjantai;26;70;96;14;19;33
89;14.06.2013;2013;06;11;Perjantai;36;55;91;15;21;36
89;14.06.2013;2013;06;12;Perjantai;47;55;102;11;19;30
89;14.06.2013;2013;06;13;Perjantai;74;91;165;8;21;29
89;14.06.2013;2013;06;14;Perjantai;98;80;178;16;19;35
89;14.06.2013;2013;06;15;Perjantai;135;51;186;15;11;26
89;14.06.2013;2013;06;16;Perjantai;144;63;207;14;14;28
89;14.06.2013;2013;06;17;Perjantai;73;47;120;15;16;31
89;14.06.2013;2013;06;18;Perjantai;81;48;129;12;20;32
89;14.06.2013;2013;06;19;Perjantai;56;34;90;12;8;20
89;14.06.2013;2013;06;20;Perjantai;40;37;77;7;19;26
89;14.06.2013;2013;06;21;Perjantai;32;30;62;12;7;19
89;14.06.2013;2013;06;22;Perjantai;24;26;50;9;4;13
89;14.06.2013;2013;06;23;Perjantai;23;18;41;4;8;12
89;15.06.2013;2013;06;00;Lauantai;23;18;41;5;8;13
89;15.06.2013;2013;06;01;Lauantai;18;14;32;8;2;10
89;15.06.2013;2013;06;02;Lauantai;21;7;28;14;1;15
89;15.06.2013;2013;06;03;Lauantai;27;4;31;10;0;10
89;15.06.2013;2013;06;04;Lauantai;26;9;35;8;0;8
89;15.06.2013;2013;06;05;Lauantai;5;7;12;3;0;3
89;15.06.2013;2013;06;06;Lauantai;6;22;28;0;1;1
89;15.06.2013;2013;06;07;Lauantai;10;14;24;2;3;5
89;15.06.2013;2013;06;08;Lauantai;5;33;38;3;7;10
89;15.06.2013;2013;06;09;Lauantai;20;47;67;10;10;20
89;15.06.2013;2013;06;10;Lauantai;16;37;53;8;17;25
89;15.06.2013;2013;06;11;Lauantai;28;61;89;11;25;36
89;15.06.2013;2013;06;12;Lauantai;35;78;113;13;21;34
89;15.06.2013;2013;06;13;Lauantai;47;47;94;13;23;36
89;15.06.2013;2013;06;14;Lauantai;72;46;118;9;16;25
89;15.06.2013;2013;06;15;Lauantai;64;47;111;21;22;43
89;15.06.2013;2013;06;16;Lauantai;61;42;103;18;25;43
89;15.06.2013;2013;06;17;Lauantai;53;65;118;24;24;48
89;15.06.2013;2013;06;18;Lauantai;58;61;119;26;35;61
89;15.06.2013;2013;06;19;Lauantai;57;68;125;16;30;46
89;15.06.2013;2013;06;20;Lauantai;70;61;131;12;18;30
89;15.06.2013;2013;06;21;Lauantai;49;44;93;16;18;34
89;15.06.2013;2013;06;22;Lauantai;33;60;93;11;13;24
89;15.06.2013;2013;06;23;Lauantai;26;47;73;7;11;18
89;16.06.2013;2013;06;00;Sunnuntai;25;37;62;7;8;15
89;16.06.2013;2013;06;01;Sunnuntai;36;21;57;2;4;6
89;16.06.2013;2013;06;02;Sunnuntai;34;4;38;7;0;7
89;16.06.2013;2013;06;03;Sunnuntai;38;3;41;11;0;11
89;16.06.2013;2013;06;04;Sunnuntai;42;8;50;8;0;8
89;16.06.2013;2013;06;05;Sunnuntai;9;4;13;2;1;3
89;16.06.2013;2013;06;06;Sunnuntai;10;17;27;2;1;3
89;16.06.2013;2013;06;07;Sunnuntai;7;7;14;4;6;10
89;16.06.2013;2013;06;08;Sunnuntai;5;12;17;8;11;19
89;16.06.2013;2013;06;09;Sunnuntai;28;42;70;11;12;23
89;16.06.2013;2013;06;10;Sunnuntai;30;53;83;14;23;37
89;16.06.2013;2013;06;11;Sunnuntai;51;88;139;23;34;57
89;16.06.2013;2013;06;12;Sunnuntai;108;162;270;30;42;72
89;16.06.2013;2013;06;13;Sunnuntai;139;142;281;33;38;71
89;16.06.2013;2013;06;14;Sunnuntai;158;169;327;27;41;68
89;16.06.2013;2013;06;15;Sunnuntai;165;120;285;46;27;73
89;16.06.2013;2013;06;16;Sunnuntai;170;129;299;29;32;61
89;16.06.2013;2013;06;17;Sunnuntai;139;121;260;31;30;61
89;16.06.2013;2013;06;18;Sunnuntai;103;104;207;33;34;67
89;16.06.2013;2013;06;19;Sunnuntai;77;56;133;28;30;58
89;16.06.2013;2013;06;20;Sunnuntai;43;43;86;15;15;30
89;16.06.2013;2013;06;21;Sunnuntai;31;29;60;20;11;31
89;16.06.2013;2013;06;22;Sunnuntai;25;15;40;5;5;10
89;16.06.2013;2013;06;23;Sunnuntai;14;7;21;3;1;4
89;17.06.2013;2013;06;00;Maanantai;14;7;21;3;3;6
89;17.06.2013;2013;06;01;Maanantai;10;5;15;2;0;2
89;17.06.2013;2013;06;02;Maanantai;2;3;5;1;0;1
89;17.06.2013;2013;06;03;Maanantai;2;3;5;1;0;1
89;17.06.2013;2013;06;04;Maanantai;5;7;12;2;2;4
89;17.06.2013;2013;06;05;Maanantai;16;17;33;2;0;2
89;17.06.2013;2013;06;06;Maanantai;14;78;92;5;7;12
89;17.06.2013;2013;06;07;Maanantai;41;153;194;4;13;17
89;17.06.2013;2013;06;08;Maanantai;29;140;169;9;23;32
89;17.06.2013;2013;06;09;Maanantai;28;86;114;15;20;35
89;17.06.2013;2013;06;10;Maanantai;32;81;113;29;32;61
89;17.06.2013;2013;06;11;Maanantai;41;32;73;6;14;20
89;17.06.2013;2013;06;12;Maanantai;47;57;104;14;15;29
89;17.06.2013;2013;06;13;Maanantai;37;25;62;9;10;19
89;17.06.2013;2013;06;14;Maanantai;69;74;143;11;15;26
89;17.06.2013;2013;06;15;Maanantai;153;118;271;18;24;42
89;17.06.2013;2013;06;16;Maanantai;204;118;322;32;27;59
89;17.06.2013;2013;06;17;Maanantai;149;99;248;37;30;67
89;17.06.2013;2013;06;18;Maanantai;133;101;234;39;27;66
89;17.06.2013;2013;06;19;Maanantai;107;59;166;31;37;68
89;17.06.2013;2013;06;20;Maanantai;88;54;142;21;25;46
89;17.06.2013;2013;06;21;Maanantai;54;27;81;24;20;44
89;17.06.2013;2013;06;22;Maanantai;34;22;56;9;6;15
89;17.06.2013;2013;06;23;Maanantai;23;8;31;6;6;12
89;18.06.2013;2013;06;00;Tiistai;11;9;20;2;5;7
89;18.06.2013;2013;06;01;Tiistai;6;2;8;6;0;6
89;18.06.2013;2013;06;02;Tiistai;1;0;1;0;1;1
89;18.06.2013;2013;06;03;Tiistai;2;1;3;0;0;0
89;18.06.2013;2013;06;04;Tiistai;10;5;15;0;0;0
89;18.06.2013;2013;06;05;Tiistai;7;16;23;2;2;4
89;18.06.2013;2013;06;06;Tiistai;21;82;103;2;7;9
89;18.06.2013;2013;06;07;Tiistai;52;193;245;6;12;18
89;18.06.2013;2013;06;08;Tiistai;45;184;229;15;25;40
89;18.06.2013;2013;06;09;Tiistai;41;134;175;13;20;33
89;18.06.2013;2013;06;10;Tiistai;46;90;136;16;26;42
89;18.06.2013;2013;06;11;Tiistai;57;75;132;24;20;44
89;18.06.2013;2013;06;12;Tiistai;68;102;170;21;28;49
89;18.06.2013;2013;06;13;Tiistai;95;84;179;17;26;43
89;18.06.2013;2013;06;14;Tiistai;132;105;237;24;10;34
89;18.06.2013;2013;06;15;Tiistai;182;102;284;22;16;38
89;18.06.2013;2013;06;16;Tiistai;260;87;347;25;29;54
89;18.06.2013;2013;06;17;Tiistai;176;118;294;23;16;39
89;18.06.2013;2013;06;18;Tiistai;114;91;205;24;22;46
89;18.06.2013;2013;06;19;Tiistai;108;58;166;28;23;51
89;18.06.2013;2013;06;20;Tiistai;124;43;167;29;26;55
89;18.06.2013;2013;06;21;Tiistai;69;33;102;19;14;33
89;18.06.2013;2013;06;22;Tiistai;35;23;58;8;7;15
89;18.06.2013;2013;06;23;Tiistai;19;8;27;1;6;7
89;19.06.2013;2013;06;00;Keskiviikko;9;16;25;3;5;8
89;19.06.2013;2013;06;01;Keskiviikko;6;4;10;2;0;2
89;19.06.2013;2013;06;02;Keskiviikko;3;4;7;2;1;3
89;19.06.2013;2013;06;03;Keskiviikko;6;3;9;0;1;1
89;19.06.2013;2013;06;04;Keskiviikko;2;1;3;0;1;1
89;19.06.2013;2013;06;05;Keskiviikko;11;20;31;2;1;3
89;19.06.2013;2013;06;06;Keskiviikko;21;88;109;5;8;13
89;19.06.2013;2013;06;07;Keskiviikko;37;167;204;2;15;17
89;19.06.2013;2013;06;08;Keskiviikko;32;178;210;10;25;35
89;19.06.2013;2013;06;09;Keskiviikko;24;96;120;8;15;23
89;19.06.2013;2013;06;10;Keskiviikko;41;87;128;17;29;46
89;19.06.2013;2013;06;11;Keskiviikko;57;79;136;18;26;44
89;19.06.2013;2013;06;12;Keskiviikko;68;100;168;28;43;71
89;19.06.2013;2013;06;13;Keskiviikko;96;129;225;24;37;61
89;19.06.2013;2013;06;14;Keskiviikko;139;110;249;29;31;60
89;19.06.2013;2013;06;15;Keskiviikko;208;129;337;27;31;58
89;19.06.2013;2013;06;16;Keskiviikko;275;153;428;39;25;64
89;19.06.2013;2013;06;17;Keskiviikko;167;103;270;44;19;63
89;19.06.2013;2013;06;18;Keskiviikko;136;111;247;17;36;53
89;19.06.2013;2013;06;19;Keskiviikko;140;98;238;28;26;54
89;19.06.2013;2013;06;20;Keskiviikko;108;112;220;20;28;48
89;19.06.2013;2013;06;21;Keskiviikko;94;51;145;23;18;41
89;19.06.2013;2013;06;22;Keskiviikko;48;39;87;6;10;16
89;19.06.2013;2013;06;23;Keskiviikko;44;20;64;7;5;12
89;20.06.2013;2013;06;00;Torstai;28;11;39;6;1;7
89;20.06.2013;2013;06;01;Torstai;6;6;12;3;1;4
89;20.06.2013;2013;06;02;Torstai;11;3;14;2;1;3
89;20.06.2013;2013;06;03;Torstai;4;2;6;2;0;2
89;20.06.2013;2013;06;04;Torstai;12;4;16;1;1;2
89;20.06.2013;2013;06;05;Torstai;9;18;27;2;1;3
89;20.06.2013;2013;06;06;Torstai;22;78;100;4;7;11
89;20.06.2013;2013;06;07;Torstai;31;168;199;5;15;20
89;20.06.2013;2013;06;08;Torstai;41;157;198;8;19;27
89;20.06.2013;2013;06;09;Torstai;36;107;143;7;13;20
89;20.06.2013;2013;06;10;Torstai;46;84;130;11;21;32
89;20.06.2013;2013;06;11;Torstai;72;95;167;18;14;32
89;20.06.2013;2013;06;12;Torstai;95;89;184;17;30;47
89;20.06.2013;2013;06;13;Torstai;104;109;213;15;22;37
89;20.06.2013;2013;06;14;Torstai;183;96;279;21;16;37
89;20.06.2013;2013;06;15;Torstai;191;84;275;15;9;24
89;20.06.2013;2013;06;16;Torstai;127;44;171;10;8;18
89;20.06.2013;2013;06;17;Torstai;58;37;95;10;2;12
89;20.06.2013;2013;06;18;Torstai;35;33;68;9;8;17
89;20.06.2013;2013;06;19;Torstai;53;17;70;9;13;22
89;20.06.2013;2013;06;20;Torstai;34;29;63;7;6;13
89;20.06.2013;2013;06;21;Torstai;39;19;58;5;7;12
89;20.06.2013;2013;06;22;Torstai;7;13;20;5;2;7
89;20.06.2013;2013;06;23;Torstai;8;14;22;2;4;6
89;21.06.2013;2013;06;00;Perjantai;16;11;27;2;3;5
89;21.06.2013;2013;06;01;Perjantai;9;4;13;1;1;2
89;21.06.2013;2013;06;02;Perjantai;10;0;10;5;0;5
89;21.06.2013;2013;06;03;Perjantai;7;3;10;1;0;1
89;21.06.2013;2013;06;04;Perjantai;8;3;11;2;1;3
89;21.06.2013;2013;06;05;Perjantai;7;6;13;3;1;4
89;21.06.2013;2013;06;06;Perjantai;8;16;24;2;6;8
89;21.06.2013;2013;06;07;Perjantai;5;18;23;5;2;7
89;21.06.2013;2013;06;08;Perjantai;12;14;26;5;10;15
89;21.06.2013;2013;06;09;Perjantai;17;43;60;7;12;19
89;21.06.2013;2013;06;10;Perjantai;40;46;86;13;17;30
89;21.06.2013;2013;06;11;Perjantai;61;52;113;18;15;33
89;21.06.2013;2013;06;12;Perjantai;61;52;113;19;16;35
89;21.06.2013;2013;06;13;Perjantai;66;60;126;20;23;43
89;21.06.2013;2013;06;14;Perjantai;55;77;132;18;28;46
89;21.06.2013;2013;06;15;Perjantai;69;86;155;18;25;43
89;21.06.2013;2013;06;16;Perjantai;66;64;130;18;13;31
89;21.06.2013;2013;06;17;Perjantai;70;68;138;16;30;46
89;21.06.2013;2013;06;18;Perjantai;56;118;174;22;50;72
89;21.06.2013;2013;06;19;Perjantai;49;95;144;13;24;37
89;21.06.2013;2013;06;20;Perjantai;49;85;134;12;23;35
89;21.06.2013;2013;06;21;Perjantai;94;69;163;35;18;53
89;21.06.2013;2013;06;22;Perjantai;62;83;145;7;18;25
89;21.06.2013;2013;06;23;Perjantai;41;43;84;7;22;29
89;22.06.2013;2013;06;00;Lauantai;38;37;75;10;15;25
89;22.06.2013;2013;06;01;Lauantai;41;15;56;4;4;8
89;22.06.2013;2013;06;02;Lauantai;39;7;46;5;2;7
89;22.06.2013;2013;06;03;Lauantai;24;11;35;11;3;14
89;22.06.2013;2013;06;04;Lauantai;21;6;27;15;0;15
89;22.06.2013;2013;06;05;Lauantai;12;1;13;5;1;6
89;22.06.2013;2013;06;06;Lauantai;5;19;24;3;1;4
89;22.06.2013;2013;06;07;Lauantai;6;12;18;2;2;4
89;22.06.2013;2013;06;08;Lauantai;11;9;20;7;3;10
89;22.06.2013;2013;06;09;Lauantai;18;26;44;4;17;21
89;22.06.2013;2013;06;10;Lauantai;36;44;80;11;16;27
89;22.06.2013;2013;06;11;Lauantai;51;78;129;14;13;27
89;22.06.2013;2013;06;12;Lauantai;61;87;148;18;39;57
89;22.06.2013;2013;06;13;Lauantai;68;54;122;20;32;52
89;22.06.2013;2013;06;14;Lauantai;75;50;125;10;19;29
89;22.06.2013;2013;06;15;Lauantai;41;48;89;10;11;21
89;22.06.2013;2013;06;16;Lauantai;25;17;42;6;9;15
89;22.06.2013;2013;06;17;Lauantai;17;20;37;5;7;12
89;22.06.2013;2013;06;18;Lauantai;16;39;55;13;15;28
89;22.06.2013;2013;06;19;Lauantai;31;49;80;15;23;38
89;22.06.2013;2013;06;20;Lauantai;50;75;125;11;37;48
89;22.06.2013;2013;06;21;Lauantai;57;57;114;12;17;29
89;22.06.2013;2013;06;22;Lauantai;31;36;67;7;7;14
89;22.06.2013;2013;06;23;Lauantai;22;30;52;8;12;20
89;23.06.2013;2013;06;00;Sunnuntai;11;19;30;2;5;7
89;23.06.2013;2013;06;01;Sunnuntai;37;10;47;5;3;8
89;23.06.2013;2013;06;02;Sunnuntai;18;11;29;3;3;6
89;23.06.2013;2013;06;03;Sunnuntai;9;11;20;4;2;6
89;23.06.2013;2013;06;04;Sunnuntai;18;2;20;5;1;6
89;23.06.2013;2013;06;05;Sunnuntai;8;7;15;1;1;2
89;23.06.2013;2013;06;06;Sunnuntai;3;14;17;4;4;8
89;23.06.2013;2013;06;07;Sunnuntai;7;9;16;3;5;8
89;23.06.2013;2013;06;08;Sunnuntai;11;16;27;7;7;14
89;23.06.2013;2013;06;09;Sunnuntai;17;35;52;6;11;17
89;23.06.2013;2013;06;10;Sunnuntai;26;49;75;14;19;33
89;23.06.2013;2013;06;11;Sunnuntai;43;44;87;19;19;38
89;23.06.2013;2013;06;12;Sunnuntai;28;53;81;13;21;34
89;23.06.2013;2013;06;13;Sunnuntai;60;92;152;13;52;65
89;23.06.2013;2013;06;14;Sunnuntai;48;59;107;36;19;55
89;23.06.2013;2013;06;15;Sunnuntai;64;66;130;14;15;29
89;23.06.2013;2013;06;16;Sunnuntai;105;67;172;46;34;80
89;23.06.2013;2013;06;17;Sunnuntai;102;86;188;23;20;43
89;23.06.2013;2013;06;18;Sunnuntai;95;86;181;17;25;42
89;23.06.2013;2013;06;19;Sunnuntai;92;83;175;39;48;87
89;23.06.2013;2013;06;20;Sunnuntai;80;56;136;28;27;55
89;23.06.2013;2013;06;21;Sunnuntai;42;37;79;9;15;24
89;23.06.2013;2013;06;22;Sunnuntai;35;28;63;16;15;31
89;23.06.2013;2013;06;23;Sunnuntai;29;15;44;4;5;9
89;24.06.2013;2013;06;00;Maanantai;13;6;19;13;7;20
89;24.06.2013;2013;06;01;Maanantai;5;8;13;0;1;1
89;24.06.2013;2013;06;02;Maanantai;6;5;11;2;4;6
89;24.06.2013;2013;06;03;Maanantai;4;4;8;0;0;0
89;24.06.2013;2013;06;04;Maanantai;4;5;9;4;0;4
89;24.06.2013;2013;06;05;Maanantai;14;23;37;1;1;2
89;24.06.2013;2013;06;06;Maanantai;17;81;98;3;3;6
89;24.06.2013;2013;06;07;Maanantai;39;192;231;6;16;22
89;24.06.2013;2013;06;08;Maanantai;51;178;229;12;19;31
89;24.06.2013;2013;06;09;Maanantai;47;165;212;13;21;34
89;24.06.2013;2013;06;10;Maanantai;48;141;189;12;33;45
89;24.06.2013;2013;06;11;Maanantai;115;165;280;22;32;54
89;24.06.2013;2013;06;12;Maanantai;158;159;317;28;31;59
89;24.06.2013;2013;06;13;Maanantai;157;154;311;30;37;67
89;24.06.2013;2013;06;14;Maanantai;167;151;318;28;26;54
89;24.06.2013;2013;06;15;Maanantai;260;146;406;23;23;46
89;24.06.2013;2013;06;16;Maanantai;330;171;501;36;26;62
89;24.06.2013;2013;06;17;Maanantai;221;203;424;38;41;79
89;24.06.2013;2013;06;18;Maanantai;237;226;463;41;48;89
89;24.06.2013;2013;06;19;Maanantai;255;131;386;53;31;84
89;24.06.2013;2013;06;20;Maanantai;171;100;271;27;29;56
89;24.06.2013;2013;06;21;Maanantai;96;89;185;21;23;44
89;24.06.2013;2013;06;22;Maanantai;55;58;113;13;15;28
89;24.06.2013;2013;06;23;Maanantai;37;26;63;4;6;10
89;25.06.2013;2013;06;00;Tiistai;15;16;31;2;1;3
89;25.06.2013;2013;06;01;Tiistai;22;3;25;0;2;2
89;25.06.2013;2013;06;02;Tiistai;7;5;12;3;1;4
89;25.06.2013;2013;06;03;Tiistai;2;2;4;1;0;1
89;25.06.2013;2013;06;04;Tiistai;7;6;13;3;1;4
89;25.06.2013;2013;06;05;Tiistai;9;28;37;2;4;6
89;25.06.2013;2013;06;06;Tiistai;25;95;120;6;4;10
89;25.06.2013;2013;06;07;Tiistai;52;202;254;8;14;22
89;25.06.2013;2013;06;08;Tiistai;55;187;242;11;33;44
89;25.06.2013;2013;06;09;Tiistai;44;129;173;14;24;38
89;25.06.2013;2013;06;10;Tiistai;71;121;192;14;46;60
89;25.06.2013;2013;06;11;Tiistai;95;138;233;16;32;48
89;25.06.2013;2013;06;12;Tiistai;122;154;276;18;23;41
89;25.06.2013;2013;06;13;Tiistai;135;116;251;21;26;47
89;25.06.2013;2013;06;14;Tiistai;143;108;251;21;18;39
89;25.06.2013;2013;06;15;Tiistai;226;122;348;27;26;53
89;25.06.2013;2013;06;16;Tiistai;324;132;456;27;16;43
89;25.06.2013;2013;06;17;Tiistai;208;113;321;28;18;46
89;25.06.2013;2013;06;18;Tiistai;147;112;259;33;33;66
89;25.06.2013;2013;06;19;Tiistai;144;82;226;39;31;70
89;25.06.2013;2013;06;20;Tiistai;147;79;226;34;25;59
89;25.06.2013;2013;06;21;Tiistai;110;60;170;19;18;37
89;25.06.2013;2013;06;22;Tiistai;43;37;80;14;14;28
89;25.06.2013;2013;06;23;Tiistai;22;21;43;7;8;15
89;26.06.2013;2013;06;00;Keskiviikko;15;12;27;2;5;7
89;26.06.2013;2013;06;01;Keskiviikko;17;6;23;1;5;6
89;26.06.2013;2013;06;02;Keskiviikko;14;8;22;3;0;3
89;26.06.2013;2013;06;03;Keskiviikko;9;5;14;1;0;1
89;26.06.2013;2013;06;04;Keskiviikko;8;3;11;1;0;1
89;26.06.2013;2013;06;05;Keskiviikko;12;25;37;0;3;3
89;26.06.2013;2013;06;06;Keskiviikko;22;87;109;3;4;7
89;26.06.2013;2013;06;07;Keskiviikko;39;207;246;10;14;24
89;26.06.2013;2013;06;08;Keskiviikko;52;219;271;7;28;35
89;26.06.2013;2013;06;09;Keskiviikko;52;165;217;20;32;52
89;26.06.2013;2013;06;10;Keskiviikko;81;138;219;29;43;72
89;26.06.2013;2013;06;11;Keskiviikko;120;195;315;19;41;60
89;26.06.2013;2013;06;12;Keskiviikko;176;191;367;27;33;60
89;26.06.2013;2013;06;13;Keskiviikko;208;186;394;28;45;73
89;26.06.2013;2013;06;14;Keskiviikko;242;210;452;50;42;92
89;26.06.2013;2013;06;15;Keskiviikko;295;226;521;37;37;74
89;26.06.2013;2013;06;16;Keskiviikko;375;188;563;41;35;76
89;26.06.2013;2013;06;17;Keskiviikko;281;206;487;39;44;83
89;26.06.2013;2013;06;18;Keskiviikko;259;249;508;48;73;121
89;26.06.2013;2013;06;19;Keskiviikko;248;174;422;33;40;73
89;26.06.2013;2013;06;20;Keskiviikko;173;146;319;41;44;85
89;26.06.2013;2013;06;21;Keskiviikko;159;102;261;15;27;42
89;26.06.2013;2013;06;22;Keskiviikko;78;61;139;18;11;29
89;26.06.2013;2013;06;23;Keskiviikko;45;52;97;6;6;12
89;27.06.2013;2013;06;00;Torstai;29;25;54;7;8;15
89;27.06.2013;2013;06;01;Torstai;25;16;41;9;3;12
89;27.06.2013;2013;06;02;Torstai;22;10;32;8;2;10
89;27.06.2013;2013;06;03;Torstai;15;8;23;0;3;3
89;27.06.2013;2013;06;04;Torstai;16;8;24;1;0;1
89;27.06.2013;2013;06;05;Torstai;9;22;31;4;3;7
89;27.06.2013;2013;06;06;Torstai;19;94;113;6;6;12
89;27.06.2013;2013;06;07;Torstai;50;199;249;10;18;28
89;27.06.2013;2013;06;08;Torstai;54;179;233;9;19;28
89;27.06.2013;2013;06;09;Torstai;53;139;192;10;27;37
89;27.06.2013;2013;06;10;Torstai;86;165;251;10;23;33
89;27.06.2013;2013;06;11;Torstai;134;155;289;26;32;58
89;27.06.2013;2013;06;12;Torstai;128;139;267;18;24;42
89;27.06.2013;2013;06;13;Torstai;154;178;332;28;23;51
89;27.06.2013;2013;06;14;Torstai;177;106;283;36;34;70
89;27.06.2013;2013;06;15;Torstai;251;191;442;32;27;59
89;27.06.2013;2013;06;16;Torstai;287;176;463;36;27;63
89;27.06.2013;2013;06;17;Torstai;197;132;329;17;20;37
89;27.06.2013;2013;06;18;Torstai;146;118;264;26;43;69
89;27.06.2013;2013;06;19;Torstai;99;72;171;26;25;51
89;27.06.2013;2013;06;20;Torstai;97;55;152;21;22;43
89;27.06.2013;2013;06;21;Torstai;71;36;107;19;7;26
89;27.06.2013;2013;06;22;Torstai;25;20;45;5;10;15
89;27.06.2013;2013;06;23;Torstai;14;10;24;4;4;8
89;28.06.2013;2013;06;00;Perjantai;14;13;27;0;0;0
89;28.06.2013;2013;06;01;Perjantai;11;10;21;0;3;3
89;28.06.2013;2013;06;02;Perjantai;10;3;13;2;2;4
89;28.06.2013;2013;06;03;Perjantai;8;6;14;3;1;4
89;28.06.2013;2013;06;04;Perjantai;9;2;11;5;3;8
89;28.06.2013;2013;06;05;Perjantai;8;26;34;1;1;2
89;28.06.2013;2013;06;06;Perjantai;19;69;88;6;3;9
89;28.06.2013;2013;06;07;Perjantai;29;165;194;5;19;24
89;28.06.2013;2013;06;08;Perjantai;31;126;157;6;9;15
89;28.06.2013;2013;06;09;Perjantai;23;53;76;5;9;14
89;28.06.2013;2013;06;10;Perjantai;23;31;54;2;7;9
89;28.06.2013;2013;06;11;Perjantai;31;61;92;12;9;21
89;28.06.2013;2013;06;12;Perjantai;47;85;132;17;31;48
89;28.06.2013;2013;06;13;Perjantai;82;95;177;13;36;49
89;28.06.2013;2013;06;14;Perjantai;125;95;220;26;27;53
89;28.06.2013;2013;06;15;Perjantai;169;83;252;26;15;41
89;28.06.2013;2013;06;16;Perjantai;145;93;238;27;19;46
89;28.06.2013;2013;06;17;Perjantai;119;97;216;15;25;40
89;28.06.2013;2013;06;18;Perjantai;77;79;156;17;25;42
89;28.06.2013;2013;06;19;Perjantai;93;69;162;19;22;41
89;28.06.2013;2013;06;20;Perjantai;97;79;176;17;33;50
89;28.06.2013;2013;06;21;Perjantai;81;72;153;13;17;30
89;28.06.2013;2013;06;22;Perjantai;57;66;123;12;18;30
89;28.06.2013;2013;06;23;Perjantai;47;43;90;7;13;20
89;29.06.2013;2013;06;00;Lauantai;36;45;81;13;13;26
89;29.06.2013;2013;06;01;Lauantai;54;32;86;5;5;10
89;29.06.2013;2013;06;02;Lauantai;42;17;59;9;3;12
89;29.06.2013;2013;06;03;Lauantai;42;6;48;13;3;16
89;29.06.2013;2013;06;04;Lauantai;28;4;32;6;0;6
89;29.06.2013;2013;06;05;Lauantai;16;3;19;1;3;4
89;29.06.2013;2013;06;06;Lauantai;13;19;32;6;8;14
89;29.06.2013;2013;06;07;Lauantai;6;18;24;5;3;8
89;29.06.2013;2013;06;08;Lauantai;20;46;66;6;16;22
89;29.06.2013;2013;06;09;Lauantai;27;89;116;11;20;31
89;29.06.2013;2013;06;10;Lauantai;56;137;193;10;31;41
89;29.06.2013;2013;06;11;Lauantai;88;170;258;24;42;66
89;29.06.2013;2013;06;12;Lauantai;166;183;349;25;45;70
89;29.06.2013;2013;06;13;Lauantai;184;196;380;34;53;87
89;29.06.2013;2013;06;14;Lauantai;231;193;424;34;25;59
89;29.06.2013;2013;06;15;Lauantai;204;135;339;34;44;78
89;29.06.2013;2013;06;16;Lauantai;178;166;344;37;32;69
89;29.06.2013;2013;06;17;Lauantai;190;206;396;33;62;95
89;29.06.2013;2013;06;18;Lauantai;121;172;293;26;40;66
89;29.06.2013;2013;06;19;Lauantai;105;171;276;31;47;78
89;29.06.2013;2013;06;20;Lauantai;130;157;287;31;38;69
89;29.06.2013;2013;06;21;Lauantai;87;145;232;26;30;56
89;29.06.2013;2013;06;22;Lauantai;81;84;165;13;16;29
89;29.06.2013;2013;06;23;Lauantai;52;33;85;9;4;13
89;30.06.2013;2013;06;00;Sunnuntai;35;28;63;2;3;5
89;30.06.2013;2013;06;01;Sunnuntai;65;28;93;7;7;14
89;30.06.2013;2013;06;02;Sunnuntai;57;10;67;8;4;12
89;30.06.2013;2013;06;03;Sunnuntai;58;4;62;11;1;12
89;30.06.2013;2013;06;04;Sunnuntai;34;4;38;10;6;16
89;30.06.2013;2013;06;05;Sunnuntai;20;3;23;3;3;6
89;30.06.2013;2013;06;06;Sunnuntai;3;11;14;0;1;1
89;30.06.2013;2013;06;07;Sunnuntai;6;7;13;2;0;2
89;30.06.2013;2013;06;08;Sunnuntai;5;4;9;0;0;0
89;30.06.2013;2013;06;09;Sunnuntai;4;4;8;0;5;5
89;30.06.2013;2013;06;10;Sunnuntai;7;17;24;3;5;8
89;30.06.2013;2013;06;11;Sunnuntai;7;49;56;11;21;32
89;30.06.2013;2013;06;12;Sunnuntai;47;99;146;16;37;53
89;30.06.2013;2013;06;13;Sunnuntai;60;117;177;18;52;70
89;30.06.2013;2013;06;14;Sunnuntai;58;75;133;21;26;47
89;30.06.2013;2013;06;15;Sunnuntai;110;69;179;22;40;62
89;30.06.2013;2013;06;16;Sunnuntai;109;67;176;41;25;66
89;30.06.2013;2013;06;17;Sunnuntai;115;77;192;27;29;56
89;30.06.2013;2013;06;18;Sunnuntai;97;95;192;29;40;69
89;30.06.2013;2013;06;19;Sunnuntai;63;59;122;18;25;43
89;30.06.2013;2013;06;20;Sunnuntai;64;47;111;34;19;53
89;30.06.2013;2013;06;21;Sunnuntai;52;47;99;21;7;28
89;30.06.2013;2013;06;22;Sunnuntai;31;21;52;7;10;17
89;30.06.2013;2013;06;23;Sunnuntai;20;22;42;3;6;9
89;01.07.2013;2013;07;00;Maanantai;11;9;20;5;6;11
89;01.07.2013;2013;07;01;Maanantai;8;6;14;4;3;7
89;01.07.2013;2013;07;02;Maanantai;6;4;10;1;1;2
89;01.07.2013;2013;07;03;Maanantai;2;3;5;4;3;7
89;01.07.2013;2013;07;04;Maanantai;6;3;9;2;0;2
89;01.07.2013;2013;07;05;Maanantai;8;21;29;0;0;0
89;01.07.2013;2013;07;06;Maanantai;10;54;64;5;5;10
89;01.07.2013;2013;07;07;Maanantai;13;78;91;2;11;13
89;01.07.2013;2013;07;08;Maanantai;22;77;99;4;12;16
89;01.07.2013;2013;07;09;Maanantai;25;61;86;3;16;19
89;01.07.2013;2013;07;10;Maanantai;31;52;83;7;11;18
89;01.07.2013;2013;07;11;Maanantai;38;28;66;6;6;12
89;01.07.2013;2013;07;12;Maanantai;38;76;114;11;11;22
89;01.07.2013;2013;07;13;Maanantai;40;77;117;13;20;33
89;01.07.2013;2013;07;14;Maanantai;93;80;173;12;25;37
89;01.07.2013;2013;07;15;Maanantai;107;55;162;16;13;29
89;01.07.2013;2013;07;16;Maanantai;122;54;176;28;22;50
89;01.07.2013;2013;07;17;Maanantai;100;53;153;18;9;27
89;01.07.2013;2013;07;18;Maanantai;49;34;83;28;22;50
89;01.07.2013;2013;07;19;Maanantai;65;29;94;21;28;49
89;01.07.2013;2013;07;20;Maanantai;52;18;70;19;15;34
89;01.07.2013;2013;07;21;Maanantai;31;10;41;6;6;12
89;01.07.2013;2013;07;22;Maanantai;24;10;34;8;5;13
89;01.07.2013;2013;07;23;Maanantai;9;6;15;5;2;7
89;02.07.2013;2013;07;00;Tiistai;3;9;12;2;0;2
89;02.07.2013;2013;07;01;Tiistai;8;8;16;4;3;7
89;02.07.2013;2013;07;02;Tiistai;4;2;6;3;1;4
89;02.07.2013;2013;07;03;Tiistai;6;1;7;2;0;2
89;02.07.2013;2013;07;04;Tiistai;5;3;8;0;0;0
89;02.07.2013;2013;07;05;Tiistai;3;16;19;1;1;2
89;02.07.2013;2013;07;06;Tiistai;17;72;89;2;9;11
89;02.07.2013;2013;07;07;Tiistai;18;120;138;5;20;25
89;02.07.2013;2013;07;08;Tiistai;28;135;163;9;19;28
89;02.07.2013;2013;07;09;Tiistai;31;100;131;15;24;39
89;02.07.2013;2013;07;10;Tiistai;61;111;172;26;51;77
89;02.07.2013;2013;07;11;Tiistai;73;85;158;25;32;57
89;02.07.2013;2013;07;12;Tiistai;82;72;154;9;11;20
89;02.07.2013;2013;07;13;Tiistai;76;89;165;26;29;55
89;02.07.2013;2013;07;14;Tiistai;105;69;174;26;24;50
89;02.07.2013;2013;07;15;Tiistai;117;69;186;17;9;26
89;02.07.2013;2013;07;16;Tiistai;162;67;229;25;12;37
89;02.07.2013;2013;07;17;Tiistai;75;58;133;12;18;30
89;02.07.2013;2013;07;18;Tiistai;72;32;104;14;10;24
89;02.07.2013;2013;07;19;Tiistai;65;27;92;13;17;30
89;02.07.2013;2013;07;20;Tiistai;55;37;92;18;17;35
89;02.07.2013;2013;07;21;Tiistai;48;22;70;19;21;40
89;02.07.2013;2013;07;22;Tiistai;27;23;50;11;13;24
89;02.07.2013;2013;07;23;Tiistai;18;12;30;4;2;6
89;03.07.2013;2013;07;00;Keskiviikko;6;5;11;1;9;10
89;03.07.2013;2013;07;01;Keskiviikko;7;6;13;6;0;6
89;03.07.2013;2013;07;02;Keskiviikko;3;5;8;0;0;0
89;03.07.2013;2013;07;03;Keskiviikko;5;2;7;1;0;1
89;03.07.2013;2013;07;04;Keskiviikko;2;4;6;1;0;1
89;03.07.2013;2013;07;05;Keskiviikko;10;23;33;2;2;4
89;03.07.2013;2013;07;06;Keskiviikko;23;68;91;4;7;11
89;03.07.2013;2013;07;07;Keskiviikko;23;129;152;9;17;26
89;03.07.2013;2013;07;08;Keskiviikko;30;134;164;14;25;39
89;03.07.2013;2013;07;09;Keskiviikko;61;96;157;10;22;32
89;03.07.2013;2013;07;10;Keskiviikko;66;142;208;20;26;46
89;03.07.2013;2013;07;11;Keskiviikko;68;95;163;17;46;63
89;03.07.2013;2013;07;12;Keskiviikko;68;83;151;20;33;53
89;03.07.2013;2013;07;13;Keskiviikko;106;116;222;22;34;56
89;03.07.2013;2013;07;14;Keskiviikko;100;64;164;13;14;27
89;03.07.2013;2013;07;15;Keskiviikko;165;72;237;32;17;49
89;03.07.2013;2013;07;16;Keskiviikko;181;126;307;29;26;55
89;03.07.2013;2013;07;17;Keskiviikko;115;52;167;18;16;34
89;03.07.2013;2013;07;18;Keskiviikko;98;95;193;26;38;64
89;03.07.2013;2013;07;19;Keskiviikko;99;89;188;34;48;82
89;03.07.2013;2013;07;20;Keskiviikko;96;79;175;37;22;59
89;03.07.2013;2013;07;21;Keskiviikko;111;57;168;35;21;56
89;03.07.2013;2013;07;22;Keskiviikko;37;32;69;9;13;22
89;03.07.2013;2013;07;23;Keskiviikko;13;10;23;5;0;5
89;04.07.2013;2013;07;00;Torstai;15;14;29;3;3;6
89;04.07.2013;2013;07;01;Torstai;9;3;12;5;6;11
89;04.07.2013;2013;07;02;Torstai;10;1;11;3;0;3
89;04.07.2013;2013;07;03;Torstai;13;4;17;2;0;2
89;04.07.2013;2013;07;04;Torstai;7;5;12;5;1;6
89;04.07.2013;2013;07;05;Torstai;6;21;27;3;0;3
89;04.07.2013;2013;07;06;Torstai;18;75;93;3;9;12
89;04.07.2013;2013;07;07;Torstai;17;126;143;6;15;21
89;04.07.2013;2013;07;08;Torstai;32;146;178;3;26;29
89;04.07.2013;2013;07;09;Torstai;28;111;139;13;24;37
89;04.07.2013;2013;07;10;Torstai;62;151;213;15;39;54
89;04.07.2013;2013;07;11;Torstai;88;168;256;26;44;70
89;04.07.2013;2013;07;12;Torstai;98;147;245;29;35;64
89;04.07.2013;2013;07;13;Torstai;146;154;300;36;46;82
89;04.07.2013;2013;07;14;Torstai;141;137;278;32;47;79
89;04.07.2013;2013;07;15;Torstai;179;128;307;25;30;55
89;04.07.2013;2013;07;16;Torstai;254;102;356;39;27;66
89;04.07.2013;2013;07;17;Torstai;149;81;230;28;20;48
89;04.07.2013;2013;07;18;Torstai;126;82;208;22;50;72
89;04.07.2013;2013;07;19;Torstai;70;40;110;16;16;32
89;04.07.2013;2013;07;20;Torstai;89;52;141;21;21;42
89;04.07.2013;2013;07;21;Torstai;84;32;116;33;17;50
89;04.07.2013;2013;07;22;Torstai;28;28;56;5;4;9
89;04.07.2013;2013;07;23;Torstai;23;17;40;2;4;6
89;05.07.2013;2013;07;00;Perjantai;22;12;34;5;2;7
89;05.07.2013;2013;07;01;Perjantai;13;11;24;3;5;8
89;05.07.2013;2013;07;02;Perjantai;7;2;9;3;0;3
89;05.07.2013;2013;07;03;Perjantai;7;3;10;2;0;2
89;05.07.2013;2013;07;04;Perjantai;10;11;21;3;0;3
89;05.07.2013;2013;07;05;Perjantai;10;17;27;2;4;6
89;05.07.2013;2013;07;06;Perjantai;14;72;86;2;5;7
89;05.07.2013;2013;07;07;Perjantai;29;123;152;6;7;13
89;05.07.2013;2013;07;08;Perjantai;29;113;142;7;19;26
89;05.07.2013;2013;07;09;Perjantai;34;88;122;14;18;32
89;05.07.2013;2013;07;10;Perjantai;51;120;171;16;33;49
89;05.07.2013;2013;07;11;Perjantai;78;126;204;30;66;96
89;05.07.2013;2013;07;12;Perjantai;125;184;309;35;30;65
89;05.07.2013;2013;07;13;Perjantai;151;155;306;21;33;54
89;05.07.2013;2013;07;14;Perjantai;155;103;258;20;31;51
89;05.07.2013;2013;07;15;Perjantai;165;117;282;29;22;51
89;05.07.2013;2013;07;16;Perjantai;175;109;284;29;28;57
89;05.07.2013;2013;07;17;Perjantai;136;104;240;33;35;68
89;05.07.2013;2013;07;18;Perjantai;119;112;231;31;43;74
89;05.07.2013;2013;07;19;Perjantai;92;115;207;33;55;88
89;05.07.2013;2013;07;20;Perjantai;94;69;163;22;28;50
89;05.07.2013;2013;07;21;Perjantai;82;100;182;15;29;44
89;05.07.2013;2013;07;22;Perjantai;65;83;148;8;11;19
89;05.07.2013;2013;07;23;Perjantai;56;48;104;9;15;24
89;06.07.2013;2013;07;00;Lauantai;28;34;62;3;4;7
89;06.07.2013;2013;07;01;Lauantai;57;21;78;10;6;16
89;06.07.2013;2013;07;02;Lauantai;59;14;73;14;1;15
89;06.07.2013;2013;07;03;Lauantai;35;4;39;5;1;6
89;06.07.2013;2013;07;04;Lauantai;26;9;35;8;0;8
89;06.07.2013;2013;07;05;Lauantai;13;8;21;6;4;10
89;06.07.2013;2013;07;06;Lauantai;7;13;20;3;3;6
89;06.07.2013;2013;07;07;Lauantai;5;15;20;2;6;8
89;06.07.2013;2013;07;08;Lauantai;9;30;39;7;12;19
89;06.07.2013;2013;07;09;Lauantai;24;43;67;10;16;26
89;06.07.2013;2013;07;10;Lauantai;31;63;94;10;29;39
89;06.07.2013;2013;07;11;Lauantai;47;71;118;24;29;53
89;06.07.2013;2013;07;12;Lauantai;53;127;180;18;26;44
89;06.07.2013;2013;07;13;Lauantai;81;106;187;10;28;38
89;06.07.2013;2013;07;14;Lauantai;122;97;219;28;30;58
89;06.07.2013;2013;07;15;Lauantai;106;103;209;22;37;59
89;06.07.2013;2013;07;16;Lauantai;123;117;240;28;31;59
89;06.07.2013;2013;07;17;Lauantai;110;165;275;33;61;94
89;06.07.2013;2013;07;18;Lauantai;101;149;250;29;61;90
89;06.07.2013;2013;07;19;Lauantai;89;114;203;32;36;68
89;06.07.2013;2013;07;20;Lauantai;124;109;233;30;30;60
89;06.07.2013;2013;07;21;Lauantai;81;100;181;18;34;52
89;06.07.2013;2013;07;22;Lauantai;65;94;159;15;16;31
89;06.07.2013;2013;07;23;Lauantai;42;54;96;7;16;23
89;07.07.2013;2013;07;00;Sunnuntai;41;35;76;7;10;17
89;07.07.2013;2013;07;01;Sunnuntai;36;22;58;3;4;7
89;07.07.2013;2013;07;02;Sunnuntai;46;4;50;13;2;15
89;07.07.2013;2013;07;03;Sunnuntai;58;6;64;8;1;9
89;07.07.2013;2013;07;04;Sunnuntai;44;4;48;13;1;14
89;07.07.2013;2013;07;05;Sunnuntai;20;3;23;2;0;2
89;07.07.2013;2013;07;06;Sunnuntai;10;16;26;1;4;5
89;07.07.2013;2013;07;07;Sunnuntai;8;21;29;1;7;8
89;07.07.2013;2013;07;08;Sunnuntai;13;17;30;6;12;18
89;07.07.2013;2013;07;09;Sunnuntai;20;48;68;16;17;33
89;07.07.2013;2013;07;10;Sunnuntai;51;71;122;13;30;43
89;07.07.2013;2013;07;11;Sunnuntai;97;116;213;30;38;68
89;07.07.2013;2013;07;12;Sunnuntai;147;208;355;38;59;97
89;07.07.2013;2013;07;13;Sunnuntai;146;242;388;49;91;140
89;07.07.2013;2013;07;14;Sunnuntai;194;176;370;67;55;122
89;07.07.2013;2013;07;15;Sunnuntai;197;168;365;64;70;134
89;07.07.2013;2013;07;16;Sunnuntai;200;151;351;68;57;125
89;07.07.2013;2013;07;17;Sunnuntai;163;198;361;56;71;127
89;07.07.2013;2013;07;18;Sunnuntai;151;119;270;34;38;72
89;07.07.2013;2013;07;19;Sunnuntai;106;114;220;28;36;64
89;07.07.2013;2013;07;20;Sunnuntai;151;78;229;35;19;54
89;07.07.2013;2013;07;21;Sunnuntai;48;46;94;14;19;33
89;07.07.2013;2013;07;22;Sunnuntai;41;28;69;14;6;20
89;07.07.2013;2013;07;23;Sunnuntai;14;14;28;8;9;17
89;08.07.2013;2013;07;00;Maanantai;13;6;19;1;1;2
89;08.07.2013;2013;07;01;Maanantai;11;1;12;2;0;2
89;08.07.2013;2013;07;02;Maanantai;12;3;15;0;0;0
89;08.07.2013;2013;07;03;Maanantai;11;9;20;3;0;3
89;08.07.2013;2013;07;04;Maanantai;3;2;5;2;1;3
89;08.07.2013;2013;07;05;Maanantai;9;20;29;0;1;1
89;08.07.2013;2013;07;06;Maanantai;11;87;98;0;8;8
89;08.07.2013;2013;07;07;Maanantai;32;134;166;6;16;22
89;08.07.2013;2013;07;08;Maanantai;28;138;166;8;14;22
89;08.07.2013;2013;07;09;Maanantai;37;92;129;14;12;26
89;08.07.2013;2013;07;10;Maanantai;61;112;173;14;32;46
89;08.07.2013;2013;07;11;Maanantai;70;112;182;24;33;57
89;08.07.2013;2013;07;12;Maanantai;91;145;236;27;26;53
89;08.07.2013;2013;07;13;Maanantai;125;141;266;35;50;85
89;08.07.2013;2013;07;14;Maanantai;154;129;283;49;34;83
89;08.07.2013;2013;07;15;Maanantai;208;126;334;39;20;59
89;08.07.2013;2013;07;16;Maanantai;216;136;352;39;26;65
89;08.07.2013;2013;07;17;Maanantai;190;129;319;29;37;66
89;08.07.2013;2013;07;18;Maanantai;154;148;302;38;55;93
89;08.07.2013;2013;07;19;Maanantai;175;83;258;50;38;88
89;08.07.2013;2013;07;20;Maanantai;111;59;170;31;22;53
89;08.07.2013;2013;07;21;Maanantai;64;51;115;9;20;29
89;08.07.2013;2013;07;22;Maanantai;36;31;67;6;12;18
89;08.07.2013;2013;07;23;Maanantai;35;23;58;5;4;9
89;09.07.2013;2013;07;00;Tiistai;8;13;21;2;0;2
89;09.07.2013;2013;07;01;Tiistai;7;4;11;2;1;3
89;09.07.2013;2013;07;02;Tiistai;4;2;6;0;1;1
89;09.07.2013;2013;07;03;Tiistai;7;3;10;2;0;2
89;09.07.2013;2013;07;04;Tiistai;2;13;15;1;1;2
89;09.07.2013;2013;07;05;Tiistai;6;21;27;2;1;3
89;09.07.2013;2013;07;06;Tiistai;17;90;107;2;5;7
89;09.07.2013;2013;07;07;Tiistai;31;127;158;15;11;26
89;09.07.2013;2013;07;08;Tiistai;29;117;146;8;23;31
89;09.07.2013;2013;07;09;Tiistai;38;113;151;21;31;52
89;09.07.2013;2013;07;10;Tiistai;58;93;151;23;30;53
89;09.07.2013;2013;07;11;Tiistai;51;86;137;15;29;44
89;09.07.2013;2013;07;12;Tiistai;69;90;159;13;30;43
89;09.07.2013;2013;07;13;Tiistai;91;76;167;12;21;33
89;09.07.2013;2013;07;14;Tiistai;99;49;148;7;18;25
89;09.07.2013;2013;07;15;Tiistai;156;65;221;20;16;36
89;09.07.2013;2013;07;16;Tiistai;162;61;223;21;19;40
89;09.07.2013;2013;07;17;Tiistai;113;60;173;18;15;33
89;09.07.2013;2013;07;18;Tiistai;79;62;141;16;21;37
89;09.07.2013;2013;07;19;Tiistai;72;41;113;18;16;34
89;09.07.2013;2013;07;20;Tiistai;72;43;115;20;23;43
89;09.07.2013;2013;07;21;Tiistai;38;28;66;20;17;37
89;09.07.2013;2013;07;22;Tiistai;26;21;47;6;6;12
89;09.07.2013;2013;07;23;Tiistai;20;9;29;2;3;5
89;10.07.2013;2013;07;00;Keskiviikko;9;14;23;2;1;3
89;10.07.2013;2013;07;01;Keskiviikko;10;5;15;1;0;1
89;10.07.2013;2013;07;02;Keskiviikko;3;0;3;1;0;1
89;10.07.2013;2013;07;03;Keskiviikko;5;5;10;4;0;4
89;10.07.2013;2013;07;04;Keskiviikko;5;2;7;0;0;0
89;10.07.2013;2013;07;05;Keskiviikko;7;24;31;1;2;3
89;10.07.2013;2013;07;06;Keskiviikko;16;77;93;3;4;7
89;10.07.2013;2013;07;07;Keskiviikko;26;113;139;6;12;18
89;10.07.2013;2013;07;08;Keskiviikko;28;107;135;11;18;29
89;10.07.2013;2013;07;09;Keskiviikko;36;93;129;9;18;27
89;10.07.2013;2013;07;10;Keskiviikko;49;107;156;27;43;70
89;10.07.2013;2013;07;11;Keskiviikko;65;75;140;15;23;38
89;10.07.2013;2013;07;12;Keskiviikko;70;117;187;14;33;47
89;10.07.2013;2013;07;13;Keskiviikko;89;114;203;11;17;28
89;10.07.2013;2013;07;14;Keskiviikko;144;117;261;17;38;55
89;10.07.2013;2013;07;15;Keskiviikko;182;133;315;33;25;58
89;10.07.2013;2013;07;16;Keskiviikko;189;138;327;12;21;33
89;10.07.2013;2013;07;17;Keskiviikko;173;93;266;32;33;65
89;10.07.2013;2013;07;18;Keskiviikko;140;148;288;33;54;87
89;10.07.2013;2013;07;19;Keskiviikko;119;116;235;26;40;66
89;10.07.2013;2013;07;20;Keskiviikko;97;99;196;25;28;53
89;10.07.2013;2013;07;21;Keskiviikko;115;64;179;35;21;56
89;10.07.2013;2013;07;22;Keskiviikko;51;43;94;21;21;42
89;10.07.2013;2013;07;23;Keskiviikko;30;19;49;13;13;26
89;11.07.2013;2013;07;00;Torstai;64;18;82;7;6;13
89;11.07.2013;2013;07;01;Torstai;24;8;32;2;7;9
89;11.07.2013;2013;07;02;Torstai;17;6;23;7;1;8
89;11.07.2013;2013;07;03;Torstai;13;2;15;4;1;5
89;11.07.2013;2013;07;04;Torstai;19;6;25;2;2;4
89;11.07.2013;2013;07;05;Torstai;11;21;32;4;5;9
89;11.07.2013;2013;07;06;Torstai;19;88;107;3;5;8
89;11.07.2013;2013;07;07;Torstai;25;120;145;5;11;16
89;11.07.2013;2013;07;08;Torstai;36;126;162;7;25;32
89;11.07.2013;2013;07;09;Torstai;34;88;122;11;17;28
89;11.07.2013;2013;07;10;Torstai;53;100;153;10;28;38
89;11.07.2013;2013;07;11;Torstai;66;120;186;24;39;63
89;11.07.2013;2013;07;12;Torstai;97;142;239;19;43;62
89;11.07.2013;2013;07;13;Torstai;113;152;265;29;36;65
89;11.07.2013;2013;07;14;Torstai;164;103;267;25;43;68
89;11.07.2013;2013;07;15;Torstai;226;134;360;28;28;56
89;11.07.2013;2013;07;16;Torstai;226;138;364;42;44;86
89;11.07.2013;2013;07;17;Torstai;144;151;295;35;30;65
89;11.07.2013;2013;07;18;Torstai;129;152;281;44;67;111
89;11.07.2013;2013;07;19;Torstai;120;98;218;25;50;75
89;11.07.2013;2013;07;20;Torstai;96;71;167;25;32;57
89;11.07.2013;2013;07;21;Torstai;130;73;203;34;28;62
89;11.07.2013;2013;07;22;Torstai;45;36;81;9;15;24
89;11.07.2013;2013;07;23;Torstai;28;23;51;10;5;15
89;12.07.2013;2013;07;00;Perjantai;31;11;42;8;2;10
89;12.07.2013;2013;07;01;Perjantai;17;11;28;2;2;4
89;12.07.2013;2013;07;02;Perjantai;11;1;12;5;2;7
89;12.07.2013;2013;07;03;Perjantai;13;3;16;0;0;0
89;12.07.2013;2013;07;04;Perjantai;15;4;19;1;0;1
89;12.07.2013;2013;07;05;Perjantai;14;26;40;3;3;6
89;12.07.2013;2013;07;06;Perjantai;18;78;96;5;6;11
89;12.07.2013;2013;07;07;Perjantai;26;102;128;6;13;19
89;12.07.2013;2013;07;08;Perjantai;32;119;151;9;20;29
89;12.07.2013;2013;07;09;Perjantai;37;85;122;13;23;36
89;12.07.2013;2013;07;10;Perjantai;51;107;158;26;25;51
89;12.07.2013;2013;07;11;Perjantai;71;138;209;14;31;45
89;12.07.2013;2013;07;12;Perjantai;110;112;222;30;28;58
89;12.07.2013;2013;07;13;Perjantai;131;125;256;22;34;56
89;12.07.2013;2013;07;14;Perjantai;150;122;272;32;20;52
89;12.07.2013;2013;07;15;Perjantai;173;123;296;28;31;59
89;12.07.2013;2013;07;16;Perjantai;158;118;276;29;19;48
89;12.07.2013;2013;07;17;Perjantai;103;115;218;18;36;54
89;12.07.2013;2013;07;18;Perjantai;117;91;208;21;29;50
89;12.07.2013;2013;07;19;Perjantai;67;110;177;21;30;51
89;12.07.2013;2013;07;20;Perjantai;90;106;196;7;32;39
89;12.07.2013;2013;07;21;Perjantai;72;79;151;15;20;35
89;12.07.2013;2013;07;22;Perjantai;43;100;143;15;16;31
89;12.07.2013;2013;07;23;Perjantai;46;48;94;23;30;53
89;13.07.2013;2013;07;00;Lauantai;47;38;85;9;7;16
89;13.07.2013;2013;07;01;Lauantai;58;19;77;8;5;13
89;13.07.2013;2013;07;02;Lauantai;41;9;50;16;5;21
89;13.07.2013;2013;07;03;Lauantai;32;1;33;5;0;5
89;13.07.2013;2013;07;04;Lauantai;41;10;51;10;1;11
89;13.07.2013;2013;07;05;Lauantai;19;6;25;0;2;2
89;13.07.2013;2013;07;06;Lauantai;11;14;25;7;3;10
89;13.07.2013;2013;07;07;Lauantai;11;15;26;4;7;11
89;13.07.2013;2013;07;08;Lauantai;10;28;38;5;4;9
89;13.07.2013;2013;07;09;Lauantai;14;38;52;4;12;16
89;13.07.2013;2013;07;10;Lauantai;26;60;86;8;20;28
89;13.07.2013;2013;07;11;Lauantai;40;63;103;11;23;34
89;13.07.2013;2013;07;12;Lauantai;56;84;140;15;25;40
89;13.07.2013;2013;07;13;Lauantai;59;72;131;12;13;25
89;13.07.2013;2013;07;14;Lauantai;51;86;137;12;16;28
89;13.07.2013;2013;07;15;Lauantai;105;68;173;26;26;52
89;13.07.2013;2013;07;16;Lauantai;90;46;136;24;35;59
89;13.07.2013;2013;07;17;Lauantai;85;118;203;24;39;63
89;13.07.2013;2013;07;18;Lauantai;61;118;179;20;55;75
89;13.07.2013;2013;07;19;Lauantai;70;114;184;25;30;55
89;13.07.2013;2013;07;20;Lauantai;65;76;141;21;25;46
89;13.07.2013;2013;07;21;Lauantai;39;76;115;11;21;32
89;13.07.2013;2013;07;22;Lauantai;32;70;102;3;16;19
89;13.07.2013;2013;07;23;Lauantai;31;39;70;4;15;19
89;14.07.2013;2013;07;00;Sunnuntai;44;33;77;13;7;20
89;14.07.2013;2013;07;01;Sunnuntai;48;21;69;6;5;11
89;14.07.2013;2013;07;02;Sunnuntai;46;7;53;11;0;11
89;14.07.2013;2013;07;03;Sunnuntai;60;8;68;13;1;14
89;14.07.2013;2013;07;04;Sunnuntai;46;3;49;9;0;9
89;14.07.2013;2013;07;05;Sunnuntai;11;4;15;3;1;4
89;14.07.2013;2013;07;06;Sunnuntai;11;6;17;2;1;3
89;14.07.2013;2013;07;07;Sunnuntai;3;7;10;3;3;6
89;14.07.2013;2013;07;08;Sunnuntai;8;10;18;7;8;15
89;14.07.2013;2013;07;09;Sunnuntai;18;25;43;20;25;45
89;14.07.2013;2013;07;10;Sunnuntai;20;46;66;12;22;34
89;14.07.2013;2013;07;11;Sunnuntai;44;87;131;26;44;70
89;14.07.2013;2013;07;12;Sunnuntai;63;99;162;29;49;78
89;14.07.2013;2013;07;13;Sunnuntai;94;207;301;40;53;93
89;14.07.2013;2013;07;14;Sunnuntai;106;114;220;27;51;78
89;14.07.2013;2013;07;15;Sunnuntai;106;85;191;39;35;74
89;14.07.2013;2013;07;16;Sunnuntai;146;112;258;42;46;88
89;14.07.2013;2013;07;17;Sunnuntai;88;126;214;34;47;81
89;14.07.2013;2013;07;18;Sunnuntai;107;61;168;26;42;68
89;14.07.2013;2013;07;19;Sunnuntai;85;46;131;25;29;54
89;14.07.2013;2013;07;20;Sunnuntai;113;47;160;36;25;61
89;14.07.2013;2013;07;21;Sunnuntai;48;34;82;15;14;29
89;14.07.2013;2013;07;22;Sunnuntai;27;22;49;5;7;12
89;14.07.2013;2013;07;23;Sunnuntai;11;6;17;3;6;9
89;15.07.2013;2013;07;00;Maanantai;13;10;23;0;3;3
89;15.07.2013;2013;07;01;Maanantai;5;4;9;1;0;1
89;15.07.2013;2013;07;02;Maanantai;8;3;11;0;1;1
89;15.07.2013;2013;07;03;Maanantai;9;4;13;0;0;0
89;15.07.2013;2013;07;04;Maanantai;4;4;8;3;1;4
89;15.07.2013;2013;07;05;Maanantai;5;26;31;0;3;3
89;15.07.2013;2013;07;06;Maanantai;21;76;97;2;1;3
89;15.07.2013;2013;07;07;Maanantai;21;114;135;6;7;13
89;15.07.2013;2013;07;08;Maanantai;30;103;133;3;18;21
89;15.07.2013;2013;07;09;Maanantai;38;100;138;12;20;32
89;15.07.2013;2013;07;10;Maanantai;60;118;178;9;27;36
89;15.07.2013;2013;07;11;Maanantai;83;118;201;27;44;71
89;15.07.2013;2013;07;12;Maanantai;94;121;215;22;29;51
89;15.07.2013;2013;07;13;Maanantai;101;100;201;19;29;48
89;15.07.2013;2013;07;14;Maanantai;119;73;192;24;19;43
89;15.07.2013;2013;07;15;Maanantai;140;88;228;21;11;32
89;15.07.2013;2013;07;16;Maanantai;147;77;224;15;15;30
89;15.07.2013;2013;07;17;Maanantai;91;50;141;22;22;44
89;15.07.2013;2013;07;18;Maanantai;72;52;124;16;15;31
89;15.07.2013;2013;07;19;Maanantai;73;23;96;17;14;31
89;15.07.2013;2013;07;20;Maanantai;50;22;72;20;25;45
89;15.07.2013;2013;07;21;Maanantai;34;17;51;11;6;17
89;15.07.2013;2013;07;22;Maanantai;21;17;38;3;5;8
89;15.07.2013;2013;07;23;Maanantai;12;7;19;3;2;5
89;16.07.2013;2013;07;00;Tiistai;9;8;17;0;2;2
89;16.07.2013;2013;07;01;Tiistai;6;3;9;0;0;0
89;16.07.2013;2013;07;02;Tiistai;6;0;6;0;0;0
89;16.07.2013;2013;07;03;Tiistai;3;2;5;1;0;1
89;16.07.2013;2013;07;04;Tiistai;5;9;14;0;1;1
89;16.07.2013;2013;07;05;Tiistai;9;19;28;2;0;2
89;16.07.2013;2013;07;06;Tiistai;22;59;81;3;2;5
89;16.07.2013;2013;07;07;Tiistai;19;93;112;3;20;23
89;16.07.2013;2013;07;08;Tiistai;21;89;110;6;23;29
89;16.07.2013;2013;07;09;Tiistai;20;68;88;9;13;22
89;16.07.2013;2013;07;10;Tiistai;31;79;110;15;26;41
89;16.07.2013;2013;07;11;Tiistai;75;93;168;20;31;51
89;16.07.2013;2013;07;12;Tiistai;54;96;150;19;40;59
89;16.07.2013;2013;07;13;Tiistai;85;87;172;24;32;56
89;16.07.2013;2013;07;14;Tiistai;95;80;175;29;38;67
89;16.07.2013;2013;07;15;Tiistai;162;115;277;28;35;63
89;16.07.2013;2013;07;16;Tiistai;167;116;283;35;25;60
89;16.07.2013;2013;07;17;Tiistai;105;99;204;20;39;59
89;16.07.2013;2013;07;18;Tiistai;118;111;229;36;50;86
89;16.07.2013;2013;07;19;Tiistai;102;80;182;41;42;83
89;16.07.2013;2013;07;20;Tiistai;118;54;172;23;24;47
89;16.07.2013;2013;07;21;Tiistai;56;28;84;19;27;46
89;16.07.2013;2013;07;22;Tiistai;35;33;68;10;11;21
89;16.07.2013;2013;07;23;Tiistai;27;13;40;12;8;20
89;17.07.2013;2013;07;00;Keskiviikko;6;8;14;1;3;4
89;17.07.2013;2013;07;01;Keskiviikko;6;3;9;4;0;4
89;17.07.2013;2013;07;02;Keskiviikko;1;2;3;1;0;1
89;17.07.2013;2013;07;03;Keskiviikko;1;2;3;1;0;1
89;17.07.2013;2013;07;04;Keskiviikko;5;6;11;0;0;0
89;17.07.2013;2013;07;05;Keskiviikko;7;9;16;2;2;4
89;17.07.2013;2013;07;06;Keskiviikko;17;56;73;1;1;2
89;17.07.2013;2013;07;07;Keskiviikko;21;93;114;3;6;9
89;17.07.2013;2013;07;08;Keskiviikko;12;71;83;4;7;11
89;17.07.2013;2013;07;09;Keskiviikko;22;56;78;9;14;23
89;17.07.2013;2013;07;10;Keskiviikko;22;66;88;13;20;33
89;17.07.2013;2013;07;11;Keskiviikko;43;83;126;12;17;29
89;17.07.2013;2013;07;12;Keskiviikko;39;67;106;18;43;61
89;17.07.2013;2013;07;13;Keskiviikko;76;92;168;28;24;52
89;17.07.2013;2013;07;14;Keskiviikko;88;78;166;28;23;51
89;17.07.2013;2013;07;15;Keskiviikko;128;99;227;23;21;44
89;17.07.2013;2013;07;16;Keskiviikko;141;100;241;22;22;44
89;17.07.2013;2013;07;17;Keskiviikko;121;78;199;25;31;56
89;17.07.2013;2013;07;18;Keskiviikko;92;101;193;29;38;67
89;17.07.2013;2013;07;19;Keskiviikko;94;44;138;27;23;50
89;17.07.2013;2013;07;20;Keskiviikko;79;63;142;28;22;50
89;17.07.2013;2013;07;21;Keskiviikko;79;47;126;25;12;37
89;17.07.2013;2013;07;22;Keskiviikko;36;38;74;8;20;28
89;17.07.2013;2013;07;23;Keskiviikko;22;18;40;5;4;9
89;18.07.2013;2013;07;00;Torstai;18;16;34;3;2;5
89;18.07.2013;2013;07;01;Torstai;10;3;13;4;1;5
89;18.07.2013;2013;07;02;Torstai;5;10;15;0;0;0
89;18.07.2013;2013;07;03;Torstai;8;2;10;3;0;3
89;18.07.2013;2013;07;04;Torstai;15;5;20;5;1;6
89;18.07.2013;2013;07;05;Torstai;9;19;28;3;1;4
89;18.07.2013;2013;07;06;Torstai;24;76;100;4;4;8
89;18.07.2013;2013;07;07;Torstai;25;107;132;9;14;23
89;18.07.2013;2013;07;08;Torstai;31;92;123;6;11;17
89;18.07.2013;2013;07;09;Torstai;29;79;108;11;16;27
89;18.07.2013;2013;07;10;Torstai;45;88;133;17;34;51
89;18.07.2013;2013;07;11;Torstai;43;110;153;19;26;45
89;18.07.2013;2013;07;12;Torstai;78;137;215;33;46;79
89;18.07.2013;2013;07;13;Torstai;114;107;221;19;25;44
89;18.07.2013;2013;07;14;Torstai;100;94;194;25;23;48
89;18.07.2013;2013;07;15;Torstai;157;92;249;27;19;46
89;18.07.2013;2013;07;16;Torstai;164;89;253;19;24;43
89;18.07.2013;2013;07;17;Torstai;120;85;205;24;23;47
89;18.07.2013;2013;07;18;Torstai;98;76;174;18;31;49
89;18.07.2013;2013;07;19;Torstai;75;61;136;25;31;56
89;18.07.2013;2013;07;20;Torstai;69;27;96;25;31;56
89;18.07.2013;2013;07;21;Torstai;61;31;92;27;12;39
89;18.07.2013;2013;07;22;Torstai;27;20;47;6;9;15
89;18.07.2013;2013;07;23;Torstai;10;10;20;4;4;8
89;19.07.2013;2013;07;00;Perjantai;12;4;16;0;2;2
89;19.07.2013;2013;07;01;Perjantai;3;2;5;0;1;1
89;19.07.2013;2013;07;02;Perjantai;9;4;13;3;0;3
89;19.07.2013;2013;07;03;Perjantai;2;2;4;0;0;0
89;19.07.2013;2013;07;04;Perjantai;9;2;11;2;0;2
89;19.07.2013;2013;07;05;Perjantai;5;12;17;0;0;0
89;19.07.2013;2013;07;06;Perjantai;11;61;72;1;0;1
89;19.07.2013;2013;07;07;Perjantai;18;88;106;2;7;9
89;19.07.2013;2013;07;08;Perjantai;23;80;103;3;16;19
89;19.07.2013;2013;07;09;Perjantai;33;84;117;13;19;32
89;19.07.2013;2013;07;10;Perjantai;52;91;143;10;26;36
89;19.07.2013;2013;07;11;Perjantai;54;88;142;15;23;38
89;19.07.2013;2013;07;12;Perjantai;74;99;173;18;28;46
89;19.07.2013;2013;07;13;Perjantai;104;127;231;23;43;66
89;19.07.2013;2013;07;14;Perjantai;107;104;211;26;24;50
89;19.07.2013;2013;07;15;Perjantai;137;105;242;28;31;59
89;19.07.2013;2013;07;16;Perjantai;134;92;226;29;23;52
89;19.07.2013;2013;07;17;Perjantai;97;58;155;23;21;44
89;19.07.2013;2013;07;18;Perjantai;90;64;154;22;20;42
89;19.07.2013;2013;07;19;Perjantai;76;43;119;16;24;40
89;19.07.2013;2013;07;20;Perjantai;55;49;104;24;21;45
89;19.07.2013;2013;07;21;Perjantai;53;35;88;10;12;22
89;19.07.2013;2013;07;22;Perjantai;37;36;73;7;13;20
89;19.07.2013;2013;07;23;Perjantai;23;31;54;4;11;15
89;20.07.2013;2013;07;00;Lauantai;22;23;45;1;5;6
89;20.07.2013;2013;07;01;Lauantai;17;20;37;3;1;4
89;20.07.2013;2013;07;02;Lauantai;30;15;45;8;1;9
89;20.07.2013;2013;07;03;Lauantai;25;3;28;10;0;10
89;20.07.2013;2013;07;04;Lauantai;26;4;30;4;2;6
89;20.07.2013;2013;07;05;Lauantai;6;7;13;3;1;4
89;20.07.2013;2013;07;06;Lauantai;7;14;21;3;5;8
89;20.07.2013;2013;07;07;Lauantai;7;20;27;4;9;13
89;20.07.2013;2013;07;08;Lauantai;6;33;39;7;15;22
89;20.07.2013;2013;07;09;Lauantai;19;54;73;12;20;32
89;20.07.2013;2013;07;10;Lauantai;43;79;122;13;26;39
89;20.07.2013;2013;07;11;Lauantai;50;116;166;14;27;41
89;20.07.2013;2013;07;12;Lauantai;83;116;199;48;45;93
89;20.07.2013;2013;07;13;Lauantai;102;121;223;25;36;61
89;20.07.2013;2013;07;14;Lauantai;131;127;258;46;58;104
89;20.07.2013;2013;07;15;Lauantai;146;83;229;37;27;64
89;20.07.2013;2013;07;16;Lauantai;117;98;215;32;36;68
89;20.07.2013;2013;07;17;Lauantai;89;109;198;26;48;74
89;20.07.2013;2013;07;18;Lauantai;75;65;140;24;29;53
89;20.07.2013;2013;07;19;Lauantai;48;58;106;22;23;45
89;20.07.2013;2013;07;20;Lauantai;91;68;159;33;19;52
89;20.07.2013;2013;07;21;Lauantai;39;82;121;5;3;8
89;20.07.2013;2013;07;22;Lauantai;46;30;76;7;9;16
89;20.07.2013;2013;07;23;Lauantai;29;50;79;7;4;11
89;21.07.2013;2013;07;00;Sunnuntai;38;22;60;5;14;19
89;21.07.2013;2013;07;01;Sunnuntai;20;21;41;3;3;6
89;21.07.2013;2013;07;02;Sunnuntai;38;8;46;6;4;10
89;21.07.2013;2013;07;03;Sunnuntai;36;2;38;11;1;12
89;21.07.2013;2013;07;04;Sunnuntai;38;3;41;4;0;4
89;21.07.2013;2013;07;05;Sunnuntai;15;3;18;4;5;9
89;21.07.2013;2013;07;06;Sunnuntai;8;7;15;2;2;4
89;21.07.2013;2013;07;07;Sunnuntai;9;15;24;1;4;5
89;21.07.2013;2013;07;08;Sunnuntai;11;7;18;8;11;19
89;21.07.2013;2013;07;09;Sunnuntai;18;21;39;7;20;27
89;21.07.2013;2013;07;10;Sunnuntai;28;44;72;18;28;46
89;21.07.2013;2013;07;11;Sunnuntai;27;57;84;16;39;55
89;21.07.2013;2013;07;12;Sunnuntai;41;81;122;34;40;74
89;21.07.2013;2013;07;13;Sunnuntai;66;109;175;25;55;80
89;21.07.2013;2013;07;14;Sunnuntai;70;76;146;28;37;65
89;21.07.2013;2013;07;15;Sunnuntai;94;71;165;26;34;60
89;21.07.2013;2013;07;16;Sunnuntai;126;68;194;63;40;103
89;21.07.2013;2013;07;17;Sunnuntai;89;135;224;26;42;68
89;21.07.2013;2013;07;18;Sunnuntai;99;72;171;29;30;59
89;21.07.2013;2013;07;19;Sunnuntai;71;55;126;21;28;49
89;21.07.2013;2013;07;20;Sunnuntai;92;57;149;37;22;59
89;21.07.2013;2013;07;21;Sunnuntai;38;55;93;17;26;43
89;21.07.2013;2013;07;22;Sunnuntai;28;24;52;14;13;27
89;21.07.2013;2013;07;23;Sunnuntai;22;8;30;4;8;12
89;22.07.2013;2013;07;00;Maanantai;8;13;21;2;3;5
89;22.07.2013;2013;07;01;Maanantai;6;1;7;2;1;3
89;22.07.2013;2013;07;02;Maanantai;4;4;8;0;0;0
89;22.07.2013;2013;07;03;Maanantai;10;1;11;2;3;5
89;22.07.2013;2013;07;04;Maanantai;11;6;17;1;1;2
89;22.07.2013;2013;07;05;Maanantai;2;14;16;2;0;2
89;22.07.2013;2013;07;06;Maanantai;26;72;98;3;2;5
89;22.07.2013;2013;07;07;Maanantai;28;118;146;2;17;19
89;22.07.2013;2013;07;08;Maanantai;22;112;134;13;17;30
89;22.07.2013;2013;07;09;Maanantai;34;89;123;9;27;36
89;22.07.2013;2013;07;10;Maanantai;53;68;121;18;13;31
89;22.07.2013;2013;07;11;Maanantai;41;73;114;17;28;45
89;22.07.2013;2013;07;12;Maanantai;63;106;169;33;27;60
89;22.07.2013;2013;07;13;Maanantai;78;93;171;19;24;43
89;22.07.2013;2013;07;14;Maanantai;111;87;198;18;20;38
89;22.07.2013;2013;07;15;Maanantai;131;90;221;14;16;30
89;22.07.2013;2013;07;16;Maanantai;189;83;272;21;30;51
89;22.07.2013;2013;07;17;Maanantai;107;76;183;22;18;40
89;22.07.2013;2013;07;18;Maanantai;100;109;209;26;42;68
89;22.07.2013;2013;07;19;Maanantai;122;51;173;47;22;69
89;22.07.2013;2013;07;20;Maanantai;87;57;144;22;29;51
89;22.07.2013;2013;07;21;Maanantai;56;37;93;15;9;24
89;22.07.2013;2013;07;22;Maanantai;38;37;75;7;14;21
89;22.07.2013;2013;07;23;Maanantai;19;16;35;2;4;6
89;23.07.2013;2013;07;00;Tiistai;15;6;21;1;2;3
89;23.07.2013;2013;07;01;Tiistai;9;5;14;2;2;4
89;23.07.2013;2013;07;02;Tiistai;10;8;18;15;1;16
89;23.07.2013;2013;07;03;Tiistai;5;6;11;1;0;1
89;23.07.2013;2013;07;04;Tiistai;12;6;18;2;0;2
89;23.07.2013;2013;07;05;Tiistai;5;17;22;0;1;1
89;23.07.2013;2013;07;06;Tiistai;28;83;111;1;7;8
89;23.07.2013;2013;07;07;Tiistai;20;97;117;7;11;18
89;23.07.2013;2013;07;08;Tiistai;34;106;140;8;23;31
89;23.07.2013;2013;07;09;Tiistai;22;96;118;16;34;50
89;23.07.2013;2013;07;10;Tiistai;60;109;169;18;38;56
89;23.07.2013;2013;07;11;Tiistai;81;145;226;9;34;43
89;23.07.2013;2013;07;12;Tiistai;117;141;258;18;42;60
89;23.07.2013;2013;07;13;Tiistai;119;168;287;24;37;61
89;23.07.2013;2013;07;14;Tiistai;197;178;375;31;35;66
89;23.07.2013;2013;07;15;Tiistai;205;191;396;28;22;50
89;23.07.2013;2013;07;16;Tiistai;255;180;435;46;32;78
89;23.07.2013;2013;07;17;Tiistai;201;151;352;34;19;53
89;23.07.2013;2013;07;18;Tiistai;175;159;334;36;45;81
89;23.07.2013;2013;07;19;Tiistai;180;122;302;48;39;87
89;23.07.2013;2013;07;20;Tiistai;128;100;228;23;35;58
89;23.07.2013;2013;07;21;Tiistai;89;72;161;17;33;50
89;23.07.2013;2013;07;22;Tiistai;64;46;110;17;14;31
89;23.07.2013;2013;07;23;Tiistai;32;26;58;6;5;11
89;24.07.2013;2013;07;00;Keskiviikko;25;20;45;1;1;2
89;24.07.2013;2013;07;01;Keskiviikko;15;15;30;6;4;10
89;24.07.2013;2013;07;02;Keskiviikko;10;2;12;1;0;1
89;24.07.2013;2013;07;03;Keskiviikko;9;2;11;0;0;0
89;24.07.2013;2013;07;04;Keskiviikko;8;2;10;1;1;2
89;24.07.2013;2013;07;05;Keskiviikko;8;11;19;4;0;4
89;24.07.2013;2013;07;06;Keskiviikko;20;88;108;3;10;13
89;24.07.2013;2013;07;07;Keskiviikko;26;114;140;5;15;20
89;24.07.2013;2013;07;08;Keskiviikko;35;141;176;10;15;25
89;24.07.2013;2013;07;09;Keskiviikko;39;113;152;9;18;27
89;24.07.2013;2013;07;10;Keskiviikko;75;135;210;16;33;49
89;24.07.2013;2013;07;11;Keskiviikko;83;149;232;32;50;82
89;24.07.2013;2013;07;12;Keskiviikko;164;193;357;47;29;76
89;24.07.2013;2013;07;13;Keskiviikko;154;173;327;38;50;88
89;24.07.2013;2013;07;14;Keskiviikko;180;173;353;29;44;73
89;24.07.2013;2013;07;15;Keskiviikko;216;175;391;24;19;43
89;24.07.2013;2013;07;16;Keskiviikko;271;195;466;31;46;77
89;24.07.2013;2013;07;17;Keskiviikko;178;221;399;34;35;69
89;24.07.2013;2013;07;18;Keskiviikko;190;231;421;38;74;112
89;24.07.2013;2013;07;19;Keskiviikko;134;125;259;25;33;58
89;24.07.2013;2013;07;20;Keskiviikko;209;102;311;25;34;59
89;24.07.2013;2013;07;21;Keskiviikko;155;91;246;25;24;49
89;24.07.2013;2013;07;22;Keskiviikko;90;62;152;11;14;25
89;24.07.2013;2013;07;23;Keskiviikko;53;56;109;12;16;28
89;25.07.2013;2013;07;00;Torstai;46;17;63;5;9;14
89;25.07.2013;2013;07;01;Torstai;39;12;51;6;0;6
89;25.07.2013;2013;07;02;Torstai;18;4;22;1;2;3
89;25.07.2013;2013;07;03;Torstai;8;5;13;4;1;5
89;25.07.2013;2013;07;04;Torstai;15;0;15;4;1;5
89;25.07.2013;2013;07;05;Torstai;10;15;25;1;0;1
89;25.07.2013;2013;07;06;Torstai;23;80;103;1;5;6
89;25.07.2013;2013;07;07;Torstai;31;109;140;10;12;22
89;25.07.2013;2013;07;08;Torstai;37;132;169;8;18;26
89;25.07.2013;2013;07;09;Torstai;36;92;128;14;17;31
89;25.07.2013;2013;07;10;Torstai;67;133;200;21;41;62
89;25.07.2013;2013;07;11;Torstai;108;143;251;46;35;81
89;25.07.2013;2013;07;12;Torstai;153;193;346;18;63;81
89;25.07.2013;2013;07;13;Torstai;169;165;334;31;57;88
89;25.07.2013;2013;07;14;Torstai;204;179;383;34;52;86
89;25.07.2013;2013;07;15;Torstai;299;174;473;50;36;86
89;25.07.2013;2013;07;16;Torstai;223;206;429;43;40;83
89;25.07.2013;2013;07;17;Torstai;207;209;416;40;48;88
89;25.07.2013;2013;07;18;Torstai;201;254;455;47;72;119
89;25.07.2013;2013;07;19;Torstai;169;144;313;44;46;90
89;25.07.2013;2013;07;20;Torstai;152;146;298;27;47;74
89;25.07.2013;2013;07;21;Torstai;133;83;216;44;36;80
89;25.07.2013;2013;07;22;Torstai;88;53;141;12;11;23
89;25.07.2013;2013;07;23;Torstai;53;32;85;6;4;10
89;26.07.2013;2013;07;00;Perjantai;20;14;34;1;3;4
89;26.07.2013;2013;07;01;Perjantai;25;15;40;2;4;6
89;26.07.2013;2013;07;02;Perjantai;28;2;30;8;1;9
89;26.07.2013;2013;07;03;Perjantai;11;5;16;2;0;2
89;26.07.2013;2013;07;04;Perjantai;19;7;26;3;0;3
89;26.07.2013;2013;07;05;Perjantai;7;17;24;0;1;1
89;26.07.2013;2013;07;06;Perjantai;25;74;99;11;16;27
89;26.07.2013;2013;07;07;Perjantai;19;100;119;10;15;25
89;26.07.2013;2013;07;08;Perjantai;31;129;160;5;23;28
89;26.07.2013;2013;07;09;Perjantai;49;122;171;18;36;54
89;26.07.2013;2013;07;10;Perjantai;60;132;192;21;36;57
89;26.07.2013;2013;07;11;Perjantai;120;160;280;25;54;79
89;26.07.2013;2013;07;12;Perjantai;163;217;380;31;41;72
89;26.07.2013;2013;07;13;Perjantai;186;211;397;28;39;67
89;26.07.2013;2013;07;14;Perjantai;219;245;464;32;47;79
89;26.07.2013;2013;07;15;Perjantai;270;284;554;33;52;85
89;26.07.2013;2013;07;16;Perjantai;240;221;461;18;52;70
89;26.07.2013;2013;07;17;Perjantai;193;198;391;22;33;55
89;26.07.2013;2013;07;18;Perjantai;170;168;338;21;29;50
89;26.07.2013;2013;07;19;Perjantai;141;179;320;21;57;78
89;26.07.2013;2013;07;20;Perjantai;148;164;312;16;41;57
89;26.07.2013;2013;07;21;Perjantai;88;120;208;8;28;36
89;26.07.2013;2013;07;22;Perjantai;78;94;172;18;29;47
89;26.07.2013;2013;07;23;Perjantai;101;55;156;11;26;37
89;27.07.2013;2013;07;00;Lauantai;128;27;155;25;4;29
89;27.07.2013;2013;07;01;Lauantai;128;18;146;15;7;22
89;27.07.2013;2013;07;02;Lauantai;68;7;75;26;4;30
89;27.07.2013;2013;07;03;Lauantai;73;3;76;15;3;18
89;27.07.2013;2013;07;04;Lauantai;65;4;69;16;4;20
89;27.07.2013;2013;07;05;Lauantai;26;9;35;6;4;10
89;27.07.2013;2013;07;06;Lauantai;11;20;31;14;10;24
89;27.07.2013;2013;07;07;Lauantai;7;18;25;6;4;10
89;27.07.2013;2013;07;08;Lauantai;12;28;40;6;24;30
89;27.07.2013;2013;07;09;Lauantai;19;89;108;5;35;40
89;27.07.2013;2013;07;10;Lauantai;65;140;205;19;34;53
89;27.07.2013;2013;07;11;Lauantai;106;146;252;17;35;52
89;27.07.2013;2013;07;12;Lauantai;140;189;329;19;48;67
89;27.07.2013;2013;07;13;Lauantai;145;264;409;31;46;77
89;27.07.2013;2013;07;14;Lauantai;208;201;409;39;54;93
89;27.07.2013;2013;07;15;Lauantai;178;192;370;36;35;71
89;27.07.2013;2013;07;16;Lauantai;218;171;389;33;39;72
89;27.07.2013;2013;07;17;Lauantai;130;101;231;21;19;40
89;27.07.2013;2013;07;18;Lauantai;95;136;231;18;21;39
89;27.07.2013;2013;07;19;Lauantai;84;92;176;20;27;47
89;27.07.2013;2013;07;20;Lauantai;59;132;191;15;24;39
89;27.07.2013;2013;07;21;Lauantai;82;102;184;19;46;65
89;27.07.2013;2013;07;22;Lauantai;65;121;186;12;24;36
89;27.07.2013;2013;07;23;Lauantai;70;41;111;10;9;19
89;28.07.2013;2013;07;00;Sunnuntai;106;40;146;11;14;25
89;28.07.2013;2013;07;01;Sunnuntai;133;18;151;21;10;31
89;28.07.2013;2013;07;02;Sunnuntai;79;2;81;22;2;24
89;28.07.2013;2013;07;03;Sunnuntai;55;0;55;33;1;34
89;28.07.2013;2013;07;04;Sunnuntai;49;5;54;16;4;20
89;28.07.2013;2013;07;05;Sunnuntai;9;5;14;2;0;2
89;28.07.2013;2013;07;06;Sunnuntai;12;8;20;2;2;4
89;28.07.2013;2013;07;07;Sunnuntai;8;11;19;10;15;25
89;28.07.2013;2013;07;08;Sunnuntai;8;6;14;7;17;24
89;28.07.2013;2013;07;09;Sunnuntai;11;30;41;8;26;34
89;28.07.2013;2013;07;10;Sunnuntai;28;34;62;21;30;51
89;28.07.2013;2013;07;11;Sunnuntai;58;74;132;22;36;58
89;28.07.2013;2013;07;12;Sunnuntai;93;161;254;34;49;83
89;28.07.2013;2013;07;13;Sunnuntai;125;205;330;55;92;147
89;28.07.2013;2013;07;14;Sunnuntai;171;160;331;36;50;86
89;28.07.2013;2013;07;15;Sunnuntai;168;125;293;51;45;96
89;28.07.2013;2013;07;16;Sunnuntai;169;147;316;47;37;84
89;28.07.2013;2013;07;17;Sunnuntai;172;213;385;48;77;125
89;28.07.2013;2013;07;18;Sunnuntai;165;131;296;26;43;69
89;28.07.2013;2013;07;19;Sunnuntai;102;87;189;32;30;62
89;28.07.2013;2013;07;20;Sunnuntai;141;80;221;36;31;67
89;28.07.2013;2013;07;21;Sunnuntai;68;51;119;27;28;55
89;28.07.2013;2013;07;22;Sunnuntai;46;31;77;15;20;35
89;28.07.2013;2013;07;23;Sunnuntai;25;20;45;4;7;11
89;29.07.2013;2013;07;00;Maanantai;15;9;24;5;1;6
89;29.07.2013;2013;07;01;Maanantai;10;9;19;0;1;1
89;29.07.2013;2013;07;02;Maanantai;4;2;6;2;0;2
89;29.07.2013;2013;07;03;Maanantai;5;3;8;1;1;2
89;29.07.2013;2013;07;04;Maanantai;5;3;8;3;0;3
89;29.07.2013;2013;07;05;Maanantai;6;18;24;1;2;3
89;29.07.2013;2013;07;06;Maanantai;27;75;102;2;9;11
89;29.07.2013;2013;07;07;Maanantai;35;140;175;7;22;29
89;29.07.2013;2013;07;08;Maanantai;51;152;203;11;27;38
89;29.07.2013;2013;07;09;Maanantai;44;138;182;14;25;39
89;29.07.2013;2013;07;10;Maanantai;62;143;205;14;23;37
89;29.07.2013;2013;07;11;Maanantai;102;165;267;23;34;57
89;29.07.2013;2013;07;12;Maanantai;141;133;274;24;24;48
89;29.07.2013;2013;07;13;Maanantai;172;164;336;24;35;59
89;29.07.2013;2013;07;14;Maanantai;205;154;359;28;45;73
89;29.07.2013;2013;07;15;Maanantai;277;190;467;34;36;70
89;29.07.2013;2013;07;16;Maanantai;312;165;477;31;33;64
89;29.07.2013;2013;07;17;Maanantai;168;128;296;19;20;39
89;29.07.2013;2013;07;18;Maanantai;147;106;253;24;16;40
89;29.07.2013;2013;07;19;Maanantai;109;59;168;31;42;73
89;29.07.2013;2013;07;20;Maanantai;99;55;154;27;23;50
89;29.07.2013;2013;07;21;Maanantai;56;60;116;16;22;38
89;29.07.2013;2013;07;22;Maanantai;37;29;66;13;10;23
89;29.07.2013;2013;07;23;Maanantai;19;10;29;5;1;6
89;30.07.2013;2013;07;00;Tiistai;11;6;17;0;3;3
89;30.07.2013;2013;07;01;Tiistai;6;13;19;0;1;1
89;30.07.2013;2013;07;02;Tiistai;7;2;9;3;3;6
89;30.07.2013;2013;07;03;Tiistai;8;3;11;2;2;4
89;30.07.2013;2013;07;04;Tiistai;8;11;19;3;2;5
89;30.07.2013;2013;07;05;Tiistai;5;13;18;0;1;1
89;30.07.2013;2013;07;06;Tiistai;15;52;67;6;5;11
89;30.07.2013;2013;07;07;Tiistai;35;116;151;4;9;13
89;30.07.2013;2013;07;08;Tiistai;29;122;151;5;15;20
89;30.07.2013;2013;07;09;Tiistai;34;89;123;8;13;21
89;30.07.2013;2013;07;10;Tiistai;25;44;69;5;10;15
89;30.07.2013;2013;07;11;Tiistai;36;28;64;7;14;21
89;30.07.2013;2013;07;12;Tiistai;55;30;85;9;6;15
89;30.07.2013;2013;07;13;Tiistai;49;52;101;9;11;20
89;30.07.2013;2013;07;14;Tiistai;64;53;117;14;15;29
89;30.07.2013;2013;07;15;Tiistai;116;69;185;19;21;40
89;30.07.2013;2013;07;16;Tiistai;147;72;219;12;13;25
89;30.07.2013;2013;07;17;Tiistai;103;55;158;13;5;18
89;30.07.2013;2013;07;18;Tiistai;69;64;133;20;28;48
89;30.07.2013;2013;07;19;Tiistai;75;31;106;33;32;65
89;30.07.2013;2013;07;20;Tiistai;57;22;79;25;33;58
89;30.07.2013;2013;07;21;Tiistai;41;23;64;11;17;28
89;30.07.2013;2013;07;22;Tiistai;46;16;62;18;11;29
89;30.07.2013;2013;07;23;Tiistai;9;11;20;2;7;9
89;31.07.2013;2013;07;00;Keskiviikko;7;15;22;4;7;11
89;31.07.2013;2013;07;01;Keskiviikko;11;7;18;2;0;2
89;31.07.2013;2013;07;02;Keskiviikko;7;13;20;0;1;1
89;31.07.2013;2013;07;03;Keskiviikko;5;3;8;2;0;2
89;31.07.2013;2013;07;04;Keskiviikko;11;6;17;1;4;5
89;31.07.2013;2013;07;05;Keskiviikko;3;17;20;5;1;6
89;31.07.2013;2013;07;06;Keskiviikko;15;67;82;6;4;10
89;31.07.2013;2013;07;07;Keskiviikko;31;128;159;9;11;20
89;31.07.2013;2013;07;08;Keskiviikko;45;137;182;7;18;25
89;31.07.2013;2013;07;09;Keskiviikko;39;118;157;11;27;38
89;31.07.2013;2013;07;10;Keskiviikko;51;116;167;15;35;50
89;31.07.2013;2013;07;11;Keskiviikko;67;67;134;9;24;33
89;31.07.2013;2013;07;12;Keskiviikko;81;84;165;16;23;39
89;31.07.2013;2013;07;13;Keskiviikko;85;73;158;18;24;42
89;31.07.2013;2013;07;14;Keskiviikko;123;75;198;10;16;26
89;31.07.2013;2013;07;15;Keskiviikko;178;123;301;17;27;44
89;31.07.2013;2013;07;16;Keskiviikko;198;69;267;29;11;40
89;31.07.2013;2013;07;17;Keskiviikko;93;54;147;12;7;19
89;31.07.2013;2013;07;18;Keskiviikko;95;55;150;18;11;29
89;31.07.2013;2013;07;19;Keskiviikko;52;57;109;23;22;45
89;31.07.2013;2013;07;20;Keskiviikko;96;48;144;16;13;29
89;31.07.2013;2013;07;21;Keskiviikko;50;48;98;18;11;29
89;31.07.2013;2013;07;22;Keskiviikko;37;27;64;8;7;15
89;31.07.2013;2013;07;23;Keskiviikko;21;17;38;11;3;14
89;01.08.2013;2013;08;00;Torstai;20;10;30;2;2;4
89;01.08.2013;2013;08;01;Torstai;8;12;20;5;3;8
89;01.08.2013;2013;08;02;Torstai;5;6;11;4;1;5
89;01.08.2013;2013;08;03;Torstai;13;12;25;2;2;4
89;01.08.2013;2013;08;04;Torstai;5;4;9;4;1;5
89;01.08.2013;2013;08;05;Torstai;5;10;15;0;0;0
89;01.08.2013;2013;08;06;Torstai;11;46;57;2;4;6
89;01.08.2013;2013;08;07;Torstai;31;108;139;2;5;7
89;01.08.2013;2013;08;08;Torstai;38;109;147;5;13;18
89;01.08.2013;2013;08;09;Torstai;19;72;91;5;18;23
89;01.08.2013;2013;08;10;Torstai;24;59;83;6;12;18
89;01.08.2013;2013;08;11;Torstai;46;69;115;12;18;30
89;01.08.2013;2013;08;12;Torstai;80;101;181;19;28;47
89;01.08.2013;2013;08;13;Torstai;76;80;156;14;15;29
89;01.08.2013;2013;08;14;Torstai;126;89;215;19;11;30
89;01.08.2013;2013;08;15;Torstai;149;110;259;22;30;52
89;01.08.2013;2013;08;16;Torstai;172;110;282;35;33;68
89;01.08.2013;2013;08;17;Torstai;124;85;209;27;23;50
89;01.08.2013;2013;08;18;Torstai;103;103;206;22;22;44
89;01.08.2013;2013;08;19;Torstai;83;56;139;22;16;38
89;01.08.2013;2013;08;20;Torstai;79;26;105;19;21;40
89;01.08.2013;2013;08;21;Torstai;70;26;96;8;4;12
89;01.08.2013;2013;08;22;Torstai;35;16;51;9;6;15
89;01.08.2013;2013;08;23;Torstai;12;14;26;3;2;5
89;02.08.2013;2013;08;00;Perjantai;10;4;14;1;4;5
89;02.08.2013;2013;08;01;Perjantai;12;6;18;2;0;2
89;02.08.2013;2013;08;02;Perjantai;14;5;19;0;0;0
89;02.08.2013;2013;08;03;Perjantai;8;8;16;2;1;3
89;02.08.2013;2013;08;04;Perjantai;10;3;13;0;0;0
89;02.08.2013;2013;08;05;Perjantai;6;15;21;2;1;3
89;02.08.2013;2013;08;06;Perjantai;20;67;87;1;6;7
89;02.08.2013;2013;08;07;Perjantai;36;127;163;9;14;23
89;02.08.2013;2013;08;08;Perjantai;50;175;225;6;14;20
89;02.08.2013;2013;08;09;Perjantai;44;122;166;4;25;29
89;02.08.2013;2013;08;10;Perjantai;63;140;203;11;30;41
89;02.08.2013;2013;08;11;Perjantai;106;138;244;20;29;49
89;02.08.2013;2013;08;12;Perjantai;109;151;260;23;42;65
89;02.08.2013;2013;08;13;Perjantai;174;149;323;32;42;74
89;02.08.2013;2013;08;14;Perjantai;183;137;320;28;32;60
89;02.08.2013;2013;08;15;Perjantai;211;154;365;23;27;50
89;02.08.2013;2013;08;16;Perjantai;222;132;354;43;30;73
89;02.08.2013;2013;08;17;Perjantai;169;131;300;20;24;44
89;02.08.2013;2013;08;18;Perjantai;135;153;288;35;45;80
89;02.08.2013;2013;08;19;Perjantai;130;129;259;35;50;85
89;02.08.2013;2013;08;20;Perjantai;136;132;268;35;52;87
89;02.08.2013;2013;08;21;Perjantai;128;107;235;31;40;71
89;02.08.2013;2013;08;22;Perjantai;73;115;188;14;41;55
89;02.08.2013;2013;08;23;Perjantai;67;64;131;7;17;24
89;03.08.2013;2013;08;00;Lauantai;60;30;90;7;6;13
89;03.08.2013;2013;08;01;Lauantai;49;24;73;5;4;9
89;03.08.2013;2013;08;02;Lauantai;39;6;45;15;1;16
89;03.08.2013;2013;08;03;Lauantai;41;5;46;10;1;11
89;03.08.2013;2013;08;04;Lauantai;42;3;45;7;0;7
89;03.08.2013;2013;08;05;Lauantai;13;10;23;3;1;4
89;03.08.2013;2013;08;06;Lauantai;7;20;27;2;2;4
89;03.08.2013;2013;08;07;Lauantai;6;27;33;4;5;9
89;03.08.2013;2013;08;08;Lauantai;11;31;42;8;13;21
89;03.08.2013;2013;08;09;Lauantai;27;95;122;11;24;35
89;03.08.2013;2013;08;10;Lauantai;67;151;218;29;29;58
89;03.08.2013;2013;08;11;Lauantai;122;178;300;25;46;71
89;03.08.2013;2013;08;12;Lauantai;151;175;326;23;48;71
89;03.08.2013;2013;08;13;Lauantai;143;183;326;25;50;75
89;03.08.2013;2013;08;14;Lauantai;194;166;360;33;31;64
89;03.08.2013;2013;08;15;Lauantai;163;138;301;25;24;49
89;03.08.2013;2013;08;16;Lauantai;181;121;302;21;28;49
89;03.08.2013;2013;08;17;Lauantai;148;204;352;38;49;87
89;03.08.2013;2013;08;18;Lauantai;139;191;330;31;51;82
89;03.08.2013;2013;08;19;Lauantai;145;167;312;25;41;66
89;03.08.2013;2013;08;20;Lauantai;90;120;210;33;31;64
89;03.08.2013;2013;08;21;Lauantai;71;113;184;14;27;41
89;03.08.2013;2013;08;22;Lauantai;71;107;178;7;13;20
89;03.08.2013;2013;08;23;Lauantai;76;58;134;11;15;26
89;04.08.2013;2013;08;00;Sunnuntai;76;44;120;9;15;24
89;04.08.2013;2013;08;01;Sunnuntai;65;8;73;12;14;26
89;04.08.2013;2013;08;02;Sunnuntai;75;21;96;6;1;7
89;04.08.2013;2013;08;03;Sunnuntai;49;3;52;11;1;12
89;04.08.2013;2013;08;04;Sunnuntai;38;4;42;14;1;15
89;04.08.2013;2013;08;05;Sunnuntai;16;4;20;2;1;3
89;04.08.2013;2013;08;06;Sunnuntai;4;12;16;1;0;1
89;04.08.2013;2013;08;07;Sunnuntai;10;9;19;4;5;9
89;04.08.2013;2013;08;08;Sunnuntai;12;19;31;10;12;22
89;04.08.2013;2013;08;09;Sunnuntai;34;39;73;15;22;37
89;04.08.2013;2013;08;10;Sunnuntai;43;91;134;25;24;49
89;04.08.2013;2013;08;11;Sunnuntai;113;98;211;20;41;61
89;04.08.2013;2013;08;12;Sunnuntai;140;180;320;29;48;77
89;04.08.2013;2013;08;13;Sunnuntai;178;215;393;22;44;66
89;04.08.2013;2013;08;14;Sunnuntai;171;248;419;28;60;88
89;04.08.2013;2013;08;15;Sunnuntai;179;216;395;37;67;104
89;04.08.2013;2013;08;16;Sunnuntai;188;179;367;36;57;93
89;04.08.2013;2013;08;17;Sunnuntai;213;188;401;35;49;84
89;04.08.2013;2013;08;18;Sunnuntai;151;140;291;16;28;44
89;04.08.2013;2013;08;19;Sunnuntai;142;127;269;23;37;60
89;04.08.2013;2013;08;20;Sunnuntai;123;83;206;34;31;65
89;04.08.2013;2013;08;21;Sunnuntai;80;66;146;30;29;59
89;04.08.2013;2013;08;22;Sunnuntai;34;49;83;11;10;21
89;04.08.2013;2013;08;23;Sunnuntai;30;31;61;3;8;11
89;05.08.2013;2013;08;00;Maanantai;9;14;23;1;2;3
89;05.08.2013;2013;08;01;Maanantai;9;4;13;0;3;3
89;05.08.2013;2013;08;02;Maanantai;16;7;23;2;0;2
89;05.08.2013;2013;08;03;Maanantai;2;5;7;1;1;2
89;05.08.2013;2013;08;04;Maanantai;5;3;8;0;1;1
89;05.08.2013;2013;08;05;Maanantai;8;16;24;2;0;2
89;05.08.2013;2013;08;06;Maanantai;27;65;92;3;3;6
89;05.08.2013;2013;08;07;Maanantai;34;174;208;3;18;21
89;05.08.2013;2013;08;08;Maanantai;38;202;240;10;23;33
89;05.08.2013;2013;08;09;Maanantai;52;123;175;5;23;28
89;05.08.2013;2013;08;10;Maanantai;61;117;178;16;22;38
89;05.08.2013;2013;08;11;Maanantai;107;158;265;16;44;60
89;05.08.2013;2013;08;12;Maanantai;114;169;283;25;31;56
89;05.08.2013;2013;08;13;Maanantai;175;160;335;14;36;50
89;05.08.2013;2013;08;14;Maanantai;161;117;278;32;30;62
89;05.08.2013;2013;08;15;Maanantai;263;160;423;37;41;78
89;05.08.2013;2013;08;16;Maanantai;316;170;486;45;28;73
89;05.08.2013;2013;08;17;Maanantai;226;164;390;31;35;66
89;05.08.2013;2013;08;18;Maanantai;202;166;368;42;32;74
89;05.08.2013;2013;08;19;Maanantai;166;119;285;35;43;78
89;05.08.2013;2013;08;20;Maanantai;171;93;264;41;39;80
89;05.08.2013;2013;08;21;Maanantai;115;61;176;11;20;31
89;05.08.2013;2013;08;22;Maanantai;52;34;86;10;11;21
89;05.08.2013;2013;08;23;Maanantai;14;21;35;7;8;15
89;06.08.2013;2013;08;00;Tiistai;12;8;20;0;1;1
89;06.08.2013;2013;08;01;Tiistai;7;8;15;3;2;5
89;06.08.2013;2013;08;02;Tiistai;5;3;8;0;0;0
89;06.08.2013;2013;08;03;Tiistai;12;1;13;6;1;7
89;06.08.2013;2013;08;04;Tiistai;5;7;12;1;0;1
89;06.08.2013;2013;08;05;Tiistai;7;6;13;1;2;3
89;06.08.2013;2013;08;06;Tiistai;26;80;106;1;4;5
89;06.08.2013;2013;08;07;Tiistai;49;221;270;7;22;29
89;06.08.2013;2013;08;08;Tiistai;67;207;274;8;28;36
89;06.08.2013;2013;08;09;Tiistai;53;138;191;14;33;47
89;06.08.2013;2013;08;10;Tiistai;53;150;203;40;58;98
89;06.08.2013;2013;08;11;Tiistai;99;145;244;20;32;52
89;06.08.2013;2013;08;12;Tiistai;149;210;359;24;36;60
89;06.08.2013;2013;08;13;Tiistai;184;147;331;38;47;85
89;06.08.2013;2013;08;14;Tiistai;244;158;402;34;26;60
89;06.08.2013;2013;08;15;Tiistai;272;192;464;46;51;97
89;06.08.2013;2013;08;16;Tiistai;342;199;541;46;40;86
89;06.08.2013;2013;08;17;Tiistai;240;208;448;44;41;85
89;06.08.2013;2013;08;18;Tiistai;181;170;351;29;28;57
89;06.08.2013;2013;08;19;Tiistai;164;127;291;48;60;108
89;06.08.2013;2013;08;20;Tiistai;152;105;257;43;32;75
89;06.08.2013;2013;08;21;Tiistai;93;52;145;27;28;55
89;06.08.2013;2013;08;22;Tiistai;61;26;87;13;15;28
89;06.08.2013;2013;08;23;Tiistai;30;27;57;5;11;16
89;07.08.2013;2013;08;00;Keskiviikko;18;13;31;6;9;15
89;07.08.2013;2013;08;01;Keskiviikko;7;3;10;1;2;3
89;07.08.2013;2013;08;02;Keskiviikko;9;4;13;3;0;3
89;07.08.2013;2013;08;03;Keskiviikko;9;2;11;0;0;0
89;07.08.2013;2013;08;04;Keskiviikko;9;7;16;0;1;1
89;07.08.2013;2013;08;05;Keskiviikko;10;17;27;2;2;4
89;07.08.2013;2013;08;06;Keskiviikko;23;71;94;5;4;9
89;07.08.2013;2013;08;07;Keskiviikko;44;194;238;7;16;23
89;07.08.2013;2013;08;08;Keskiviikko;48;245;293;9;25;34
89;07.08.2013;2013;08;09;Keskiviikko;41;170;211;7;29;36
89;07.08.2013;2013;08;10;Keskiviikko;51;135;186;13;28;41
89;07.08.2013;2013;08;11;Keskiviikko;118;133;251;29;48;77
89;07.08.2013;2013;08;12;Keskiviikko;107;185;292;17;51;68
89;07.08.2013;2013;08;13;Keskiviikko;183;143;326;25;28;53
89;07.08.2013;2013;08;14;Keskiviikko;209;127;336;41;33;74
89;07.08.2013;2013;08;15;Keskiviikko;257;112;369;27;9;36
89;07.08.2013;2013;08;16;Keskiviikko;235;105;340;28;16;44
89;07.08.2013;2013;08;17;Keskiviikko;155;53;208;20;12;32
89;07.08.2013;2013;08;18;Keskiviikko;93;39;132;13;12;25
89;07.08.2013;2013;08;19;Keskiviikko;77;38;115;28;18;46
89;07.08.2013;2013;08;20;Keskiviikko;55;39;94;17;19;36
89;07.08.2013;2013;08;21;Keskiviikko;37;26;63;10;3;13
89;07.08.2013;2013;08;22;Keskiviikko;36;14;50;4;4;8
89;07.08.2013;2013;08;23;Keskiviikko;22;11;33;2;0;2
89;08.08.2013;2013;08;00;Torstai;10;2;12;1;4;5
89;08.08.2013;2013;08;01;Torstai;6;2;8;0;2;2
89;08.08.2013;2013;08;02;Torstai;8;5;13;2;0;2
89;08.08.2013;2013;08;03;Torstai;5;2;7;0;1;1
89;08.08.2013;2013;08;04;Torstai;7;6;13;1;0;1
89;08.08.2013;2013;08;05;Torstai;4;16;20;0;1;1
89;08.08.2013;2013;08;06;Torstai;17;57;74;0;4;4
89;08.08.2013;2013;08;07;Torstai;34;163;197;7;22;29
89;08.08.2013;2013;08;08;Torstai;52;171;223;4;36;40
89;08.08.2013;2013;08;09;Torstai;32;117;149;16;14;30
89;08.08.2013;2013;08;10;Torstai;47;112;159;15;24;39
89;08.08.2013;2013;08;11;Torstai;64;75;139;16;34;50
89;08.08.2013;2013;08;12;Torstai;80;112;192;24;24;48
89;08.08.2013;2013;08;13;Torstai;103;85;188;21;17;38
89;08.08.2013;2013;08;14;Torstai;135;109;244;19;19;38
89;08.08.2013;2013;08;15;Torstai;208;122;330;27;41;68
89;08.08.2013;2013;08;16;Torstai;244;136;380;25;28;53
89;08.08.2013;2013;08;17;Torstai;160;111;271;28;25;53
89;08.08.2013;2013;08;18;Torstai;150;108;258;30;27;57
89;08.08.2013;2013;08;19;Torstai;126;94;220;32;34;66
89;08.08.2013;2013;08;20;Torstai;113;64;177;31;30;61
89;08.08.2013;2013;08;21;Torstai;59;52;111;18;34;52
89;08.08.2013;2013;08;22;Torstai;50;24;74;10;10;20
89;08.08.2013;2013;08;23;Torstai;20;23;43;2;5;7
89;09.08.2013;2013;08;00;Perjantai;15;8;23;4;1;5
89;09.08.2013;2013;08;01;Perjantai;11;3;14;1;0;1
89;09.08.2013;2013;08;02;Perjantai;11;3;14;4;0;4
89;09.08.2013;2013;08;03;Perjantai;1;2;3;2;2;4
89;09.08.2013;2013;08;04;Perjantai;5;4;9;3;0;3
89;09.08.2013;2013;08;05;Perjantai;10;12;22;0;0;0
89;09.08.2013;2013;08;06;Perjantai;19;57;76;1;6;7
89;09.08.2013;2013;08;07;Perjantai;28;131;159;1;18;19
89;09.08.2013;2013;08;08;Perjantai;45;159;204;6;30;36
89;09.08.2013;2013;08;09;Perjantai;27;133;160;17;31;48
89;09.08.2013;2013;08;10;Perjantai;39;82;121;24;25;49
89;09.08.2013;2013;08;11;Perjantai;54;81;135;14;23;37
89;09.08.2013;2013;08;12;Perjantai;71;84;155;17;23;40
89;09.08.2013;2013;08;13;Perjantai;91;79;170;17;21;38
89;09.08.2013;2013;08;14;Perjantai;129;86;215;25;27;52
89;09.08.2013;2013;08;15;Perjantai;169;120;289;18;31;49
89;09.08.2013;2013;08;16;Perjantai;170;114;284;26;28;54
89;09.08.2013;2013;08;17;Perjantai;137;81;218;18;24;42
89;09.08.2013;2013;08;18;Perjantai;84;70;154;19;22;41
89;09.08.2013;2013;08;19;Perjantai;59;63;122;18;20;38
89;09.08.2013;2013;08;20;Perjantai;79;62;141;20;23;43
89;09.08.2013;2013;08;21;Perjantai;37;55;92;12;8;20
89;09.08.2013;2013;08;22;Perjantai;28;49;77;7;10;17
89;09.08.2013;2013;08;23;Perjantai;32;42;74;20;17;37
89;10.08.2013;2013;08;00;Lauantai;30;23;53;7;8;15
89;10.08.2013;2013;08;01;Lauantai;26;17;43;3;4;7
89;10.08.2013;2013;08;02;Lauantai;33;11;44;11;0;11
89;10.08.2013;2013;08;03;Lauantai;25;5;30;4;0;4
89;10.08.2013;2013;08;04;Lauantai;30;4;34;4;2;6
89;10.08.2013;2013;08;05;Lauantai;7;10;17;3;0;3
89;10.08.2013;2013;08;06;Lauantai;3;15;18;0;6;6
89;10.08.2013;2013;08;07;Lauantai;8;20;28;5;10;15
89;10.08.2013;2013;08;08;Lauantai;23;47;70;11;14;25
89;10.08.2013;2013;08;09;Lauantai;21;63;84;10;25;35
89;10.08.2013;2013;08;10;Lauantai;43;86;129;12;31;43
89;10.08.2013;2013;08;11;Lauantai;80;127;207;22;29;51
89;10.08.2013;2013;08;12;Lauantai;96;185;281;23;42;65
89;10.08.2013;2013;08;13;Lauantai;116;166;282;28;36;64
89;10.08.2013;2013;08;14;Lauantai;143;116;259;19;23;42
89;10.08.2013;2013;08;15;Lauantai;160;96;256;20;23;43
89;10.08.2013;2013;08;16;Lauantai;129;112;241;30;27;57
89;10.08.2013;2013;08;17;Lauantai;167;102;269;17;46;63
89;10.08.2013;2013;08;18;Lauantai;127;89;216;30;35;65
89;10.08.2013;2013;08;19;Lauantai;58;102;160;17;48;65
89;10.08.2013;2013;08;20;Lauantai;72;77;149;18;27;45
89;10.08.2013;2013;08;21;Lauantai;40;67;107;9;19;28
89;10.08.2013;2013;08;22;Lauantai;49;73;122;7;10;17
89;10.08.2013;2013;08;23;Lauantai;49;40;89;5;5;10
89;11.08.2013;2013;08;00;Sunnuntai;33;32;65;8;11;19
89;11.08.2013;2013;08;01;Sunnuntai;37;19;56;4;7;11
89;11.08.2013;2013;08;02;Sunnuntai;34;8;42;9;0;9
89;11.08.2013;2013;08;03;Sunnuntai;25;7;32;6;2;8
89;11.08.2013;2013;08;04;Sunnuntai;35;2;37;12;0;12
89;11.08.2013;2013;08;05;Sunnuntai;16;12;28;2;0;2
89;11.08.2013;2013;08;06;Sunnuntai;5;7;12;0;5;5
89;11.08.2013;2013;08;07;Sunnuntai;10;9;19;2;4;6
89;11.08.2013;2013;08;08;Sunnuntai;11;10;21;6;5;11
89;11.08.2013;2013;08;09;Sunnuntai;19;49;68;9;18;27
89;11.08.2013;2013;08;10;Sunnuntai;35;80;115;29;38;67
89;11.08.2013;2013;08;11;Sunnuntai;56;117;173;25;61;86
89;11.08.2013;2013;08;12;Sunnuntai;94;176;270;36;56;92
89;11.08.2013;2013;08;13;Sunnuntai;118;143;261;39;67;106
89;11.08.2013;2013;08;14;Sunnuntai;125;105;230;46;50;96
89;11.08.2013;2013;08;15;Sunnuntai;142;99;241;35;43;78
89;11.08.2013;2013;08;16;Sunnuntai;102;96;198;32;40;72
89;11.08.2013;2013;08;17;Sunnuntai;99;102;201;31;23;54
89;11.08.2013;2013;08;18;Sunnuntai;73;78;151;24;27;51
89;11.08.2013;2013;08;19;Sunnuntai;85;46;131;20;20;40
89;11.08.2013;2013;08;20;Sunnuntai;60;40;100;12;14;26
89;11.08.2013;2013;08;21;Sunnuntai;29;15;44;11;11;22
89;11.08.2013;2013;08;22;Sunnuntai;31;18;49;14;6;20
89;11.08.2013;2013;08;23;Sunnuntai;17;8;25;4;7;11
89;12.08.2013;2013;08;00;Maanantai;8;5;13;1;1;2
89;12.08.2013;2013;08;01;Maanantai;2;2;4;3;0;3
89;12.08.2013;2013;08;02;Maanantai;4;0;4;1;0;1
89;12.08.2013;2013;08;03;Maanantai;5;2;7;0;0;0
89;12.08.2013;2013;08;04;Maanantai;8;4;12;0;0;0
89;12.08.2013;2013;08;05;Maanantai;5;14;19;0;1;1
89;12.08.2013;2013;08;06;Maanantai;28;74;102;2;7;9
89;12.08.2013;2013;08;07;Maanantai;44;219;263;12;25;37
89;12.08.2013;2013;08;08;Maanantai;71;268;339;10;30;40
89;12.08.2013;2013;08;09;Maanantai;66;202;268;8;35;43
89;12.08.2013;2013;08;10;Maanantai;51;168;219;23;41;64
89;12.08.2013;2013;08;11;Maanantai;76;103;179;25;17;42
89;12.08.2013;2013;08;12;Maanantai;142;126;268;23;25;48
89;12.08.2013;2013;08;13;Maanantai;143;121;264;20;27;47
89;12.08.2013;2013;08;14;Maanantai;159;121;280;26;37;63
89;12.08.2013;2013;08;15;Maanantai;264;133;397;27;28;55
89;12.08.2013;2013;08;16;Maanantai;328;129;457;37;15;52
89;12.08.2013;2013;08;17;Maanantai;186;98;284;31;32;63
89;12.08.2013;2013;08;18;Maanantai;164;101;265;31;33;64
89;12.08.2013;2013;08;19;Maanantai;132;86;218;43;28;71
89;12.08.2013;2013;08;20;Maanantai;116;67;183;18;34;52
89;12.08.2013;2013;08;21;Maanantai;50;47;97;19;23;42
89;12.08.2013;2013;08;22;Maanantai;41;28;69;10;9;19
89;12.08.2013;2013;08;23;Maanantai;16;11;27;4;2;6
89;13.08.2013;2013;08;00;Tiistai;15;5;20;0;2;2
89;13.08.2013;2013;08;01;Tiistai;6;4;10;1;0;1
89;13.08.2013;2013;08;02;Tiistai;5;2;7;1;0;1
89;13.08.2013;2013;08;03;Tiistai;1;1;2;0;1;1
89;13.08.2013;2013;08;04;Tiistai;7;3;10;0;0;0
89;13.08.2013;2013;08;05;Tiistai;5;5;10;0;1;1
89;13.08.2013;2013;08;06;Tiistai;21;88;109;6;8;14
89;13.08.2013;2013;08;07;Tiistai;60;244;304;6;20;26
89;13.08.2013;2013;08;08;Tiistai;83;304;387;16;39;55
89;13.08.2013;2013;08;09;Tiistai;48;160;208;9;21;30
89;13.08.2013;2013;08;10;Tiistai;54;85;139;22;15;37
89;13.08.2013;2013;08;11;Tiistai;61;102;163;19;34;53
89;13.08.2013;2013;08;12;Tiistai;92;80;172;20;26;46
89;13.08.2013;2013;08;13;Tiistai;109;102;211;16;20;36
89;13.08.2013;2013;08;14;Tiistai;156;103;259;22;23;45
89;13.08.2013;2013;08;15;Tiistai;207;131;338;22;17;39
89;13.08.2013;2013;08;16;Tiistai;327;119;446;34;16;50
89;13.08.2013;2013;08;17;Tiistai;126;54;180;13;9;22
89;13.08.2013;2013;08;18;Tiistai;97;65;162;14;18;32
89;13.08.2013;2013;08;19;Tiistai;95;55;150;21;28;49
89;13.08.2013;2013;08;20;Tiistai;81;45;126;25;29;54
89;13.08.2013;2013;08;21;Tiistai;57;31;88;20;25;45
89;13.08.2013;2013;08;22;Tiistai;19;13;32;11;6;17
89;13.08.2013;2013;08;23;Tiistai;4;4;8;5;2;7
89;14.08.2013;2013;08;00;Keskiviikko;8;4;12;1;1;2
89;14.08.2013;2013;08;01;Keskiviikko;4;4;8;1;1;2
89;14.08.2013;2013;08;02;Keskiviikko;1;2;3;0;0;0
89;14.08.2013;2013;08;03;Keskiviikko;1;2;3;0;1;1
89;14.08.2013;2013;08;04;Keskiviikko;7;5;12;3;0;3
89;14.08.2013;2013;08;05;Keskiviikko;6;7;13;2;1;3
89;14.08.2013;2013;08;06;Keskiviikko;26;78;104;5;9;14
89;14.08.2013;2013;08;07;Keskiviikko;55;243;298;6;28;34
89;14.08.2013;2013;08;08;Keskiviikko;75;320;395;8;34;42
89;14.08.2013;2013;08;09;Keskiviikko;48;174;222;43;55;98
89;14.08.2013;2013;08;10;Keskiviikko;58;99;157;27;47;74
89;14.08.2013;2013;08;11;Keskiviikko;84;149;233;39;52;91
89;14.08.2013;2013;08;12;Keskiviikko;147;146;293;18;35;53
89;14.08.2013;2013;08;13;Keskiviikko;157;147;304;31;23;54
89;14.08.2013;2013;08;14;Keskiviikko;201;121;322;35;32;67
89;14.08.2013;2013;08;15;Keskiviikko;239;148;387;30;35;65
89;14.08.2013;2013;08;16;Keskiviikko;348;156;504;46;21;67
89;14.08.2013;2013;08;17;Keskiviikko;169;123;292;30;48;78
89;14.08.2013;2013;08;18;Keskiviikko;154;126;280;37;25;62
89;14.08.2013;2013;08;19;Keskiviikko;113;71;184;28;33;61
89;14.08.2013;2013;08;20;Keskiviikko;112;45;157;27;23;50
89;14.08.2013;2013;08;21;Keskiviikko;58;30;88;9;13;22
89;14.08.2013;2013;08;22;Keskiviikko;24;16;40;6;5;11
89;14.08.2013;2013;08;23;Keskiviikko;16;11;27;1;2;3
89;15.08.2013;2013;08;00;Torstai;14;4;18;2;0;2
89;15.08.2013;2013;08;01;Torstai;2;2;4;0;1;1
89;15.08.2013;2013;08;02;Torstai;6;1;7;1;0;1
89;15.08.2013;2013;08;03;Torstai;1;4;5;1;0;1
89;15.08.2013;2013;08;04;Torstai;5;2;7;1;0;1
89;15.08.2013;2013;08;05;Torstai;8;10;18;0;0;0
89;15.08.2013;2013;08;06;Torstai;21;53;74;0;3;3
89;15.08.2013;2013;08;07;Torstai;38;171;209;6;30;36
89;15.08.2013;2013;08;08;Torstai;54;225;279;11;32;43
89;15.08.2013;2013;08;09;Torstai;30;131;161;7;17;24
89;15.08.2013;2013;08;10;Torstai;45;82;127;15;27;42
89;15.08.2013;2013;08;11;Torstai;60;152;212;18;55;73
89;15.08.2013;2013;08;12;Torstai;90;135;225;23;39;62
89;15.08.2013;2013;08;13;Torstai;101;113;214;24;35;59
89;15.08.2013;2013;08;14;Torstai;175;113;288;17;46;63
89;15.08.2013;2013;08;15;Torstai;204;109;313;25;32;57
89;15.08.2013;2013;08;16;Torstai;264;119;383;26;27;53
89;15.08.2013;2013;08;17;Torstai;173;168;341;28;27;55
89;15.08.2013;2013;08;18;Torstai;111;144;255;26;37;63
89;15.08.2013;2013;08;19;Torstai;111;100;211;23;23;46
89;15.08.2013;2013;08;20;Torstai;107;77;184;23;20;43
89;15.08.2013;2013;08;21;Torstai;108;40;148;19;20;39
89;15.08.2013;2013;08;22;Torstai;71;25;96;17;3;20
89;15.08.2013;2013;08;23;Torstai;35;11;46;10;3;13
89;16.08.2013;2013;08;00;Perjantai;10;9;19;2;2;4
89;16.08.2013;2013;08;01;Perjantai;17;3;20;1;2;3
89;16.08.2013;2013;08;02;Perjantai;12;2;14;1;0;1
89;16.08.2013;2013;08;03;Perjantai;6;1;7;2;0;2
89;16.08.2013;2013;08;04;Perjantai;2;0;2;1;0;1
89;16.08.2013;2013;08;05;Perjantai;7;6;13;0;2;2
89;16.08.2013;2013;08;06;Perjantai;23;75;98;2;8;10
89;16.08.2013;2013;08;07;Perjantai;40;138;178;4;23;27
89;16.08.2013;2013;08;08;Perjantai;45;173;218;8;29;37
89;16.08.2013;2013;08;09;Perjantai;34;110;144;8;60;68
89;16.08.2013;2013;08;10;Perjantai;44;90;134;25;32;57
89;16.08.2013;2013;08;11;Perjantai;65;124;189;42;43;85
89;16.08.2013;2013;08;12;Perjantai;85;106;191;27;32;59
89;16.08.2013;2013;08;13;Perjantai;126;139;265;27;46;73
89;16.08.2013;2013;08;14;Perjantai;176;115;291;32;31;63
89;16.08.2013;2013;08;15;Perjantai;191;120;311;34;30;64
89;16.08.2013;2013;08;16;Perjantai;188;100;288;30;29;59
89;16.08.2013;2013;08;17;Perjantai;116;106;222;23;30;53
89;16.08.2013;2013;08;18;Perjantai;104;107;211;26;42;68
89;16.08.2013;2013;08;19;Perjantai;117;102;219;34;34;68
89;16.08.2013;2013;08;20;Perjantai;87;64;151;19;23;42
89;16.08.2013;2013;08;21;Perjantai;54;71;125;13;19;32
89;16.08.2013;2013;08;22;Perjantai;42;51;93;14;14;28
89;16.08.2013;2013;08;23;Perjantai;27;34;61;3;10;13
89;17.08.2013;2013;08;00;Lauantai;43;14;57;5;7;12
89;17.08.2013;2013;08;01;Lauantai;36;10;46;8;3;11
89;17.08.2013;2013;08;02;Lauantai;27;12;39;5;1;6
89;17.08.2013;2013;08;03;Lauantai;28;6;34;4;0;4
89;17.08.2013;2013;08;04;Lauantai;26;1;27;9;0;9
89;17.08.2013;2013;08;05;Lauantai;9;9;18;1;2;3
89;17.08.2013;2013;08;06;Lauantai;4;18;22;1;1;2
89;17.08.2013;2013;08;07;Lauantai;13;13;26;8;8;16
89;17.08.2013;2013;08;08;Lauantai;14;33;47;12;10;22
89;17.08.2013;2013;08;09;Lauantai;27;83;110;10;30;40
89;17.08.2013;2013;08;10;Lauantai;49;140;189;16;44;60
89;17.08.2013;2013;08;11;Lauantai;73;162;235;26;41;67
89;17.08.2013;2013;08;12;Lauantai;125;134;259;39;46;85
89;17.08.2013;2013;08;13;Lauantai;143;126;269;21;45;66
89;17.08.2013;2013;08;14;Lauantai;127;101;228;28;71;99
89;17.08.2013;2013;08;15;Lauantai;146;60;206;31;19;50
89;17.08.2013;2013;08;16;Lauantai;81;27;108;12;7;19
89;17.08.2013;2013;08;17;Lauantai;65;18;83;21;7;28
89;17.08.2013;2013;08;18;Lauantai;38;24;62;3;2;5
89;17.08.2013;2013;08;19;Lauantai;26;15;41;3;2;5
89;17.08.2013;2013;08;20;Lauantai;29;27;56;5;15;20
89;17.08.2013;2013;08;21;Lauantai;19;21;40;3;6;9
89;17.08.2013;2013;08;22;Lauantai;16;29;45;6;7;13
89;17.08.2013;2013;08;23;Lauantai;9;28;37;6;9;15
89;18.08.2013;2013;08;00;Sunnuntai;12;7;19;3;3;6
89;18.08.2013;2013;08;01;Sunnuntai;19;7;26;3;7;10
89;18.08.2013;2013;08;02;Sunnuntai;12;7;19;7;3;10
89;18.08.2013;2013;08;03;Sunnuntai;26;3;29;4;0;4
89;18.08.2013;2013;08;04;Sunnuntai;22;4;26;11;1;12
89;18.08.2013;2013;08;05;Sunnuntai;5;2;7;5;1;6
89;18.08.2013;2013;08;06;Sunnuntai;7;16;23;4;5;9
89;18.08.2013;2013;08;07;Sunnuntai;5;12;17;6;11;17
89;18.08.2013;2013;08;08;Sunnuntai;5;17;22;5;13;18
89;18.08.2013;2013;08;09;Sunnuntai;10;36;46;12;16;28
89;18.08.2013;2013;08;10;Sunnuntai;31;61;92;22;35;57
89;18.08.2013;2013;08;11;Sunnuntai;40;101;141;31;40;71
89;18.08.2013;2013;08;12;Sunnuntai;110;152;262;43;50;93
89;18.08.2013;2013;08;13;Sunnuntai;118;158;276;23;44;67
89;18.08.2013;2013;08;14;Sunnuntai;167;159;326;56;52;108
89;18.08.2013;2013;08;15;Sunnuntai;142;108;250;32;44;76
89;18.08.2013;2013;08;16;Sunnuntai;124;112;236;41;45;86
89;18.08.2013;2013;08;17;Sunnuntai;144;112;256;67;63;130
89;18.08.2013;2013;08;18;Sunnuntai;114;93;207;40;35;75
89;18.08.2013;2013;08;19;Sunnuntai;97;91;188;47;37;84
89;18.08.2013;2013;08;20;Sunnuntai;100;61;161;35;40;75
89;18.08.2013;2013;08;21;Sunnuntai;69;31;100;12;20;32
89;18.08.2013;2013;08;22;Sunnuntai;29;13;42;11;8;19
89;18.08.2013;2013;08;23;Sunnuntai;12;12;24;5;9;14
89;19.08.2013;2013;08;00;Maanantai;6;7;13;2;2;4
89;19.08.2013;2013;08;01;Maanantai;5;3;8;1;0;1
89;19.08.2013;2013;08;02;Maanantai;3;2;5;1;1;2
89;19.08.2013;2013;08;03;Maanantai;2;2;4;2;0;2
89;19.08.2013;2013;08;04;Maanantai;6;3;9;2;4;6
89;19.08.2013;2013;08;05;Maanantai;4;12;16;1;0;1
89;19.08.2013;2013;08;06;Maanantai;25;65;90;5;9;14
89;19.08.2013;2013;08;07;Maanantai;37;209;246;6;26;32
89;19.08.2013;2013;08;08;Maanantai;87;261;348;6;29;35
89;19.08.2013;2013;08;09;Maanantai;40;156;196;6;21;27
89;19.08.2013;2013;08;10;Maanantai;32;82;114;18;23;41
89;19.08.2013;2013;08;11;Maanantai;55;56;111;11;17;28
89;19.08.2013;2013;08;12;Maanantai;70;56;126;8;17;25
89;19.08.2013;2013;08;13;Maanantai;77;38;115;18;12;30
89;19.08.2013;2013;08;14;Maanantai;124;64;188;20;15;35
89;19.08.2013;2013;08;15;Maanantai;177;122;299;27;14;41
89;19.08.2013;2013;08;16;Maanantai;293;104;397;34;21;55
89;19.08.2013;2013;08;17;Maanantai;130;52;182;20;11;31
89;19.08.2013;2013;08;18;Maanantai;108;72;180;29;32;61
89;19.08.2013;2013;08;19;Maanantai;99;87;186;45;52;97
89;19.08.2013;2013;08;20;Maanantai;107;70;177;40;35;75
89;19.08.2013;2013;08;21;Maanantai;48;31;79;19;7;26
89;19.08.2013;2013;08;22;Maanantai;16;22;38;6;6;12
89;19.08.2013;2013;08;23;Maanantai;13;8;21;3;7;10
89;20.08.2013;2013;08;00;Tiistai;8;5;13;5;5;10
89;20.08.2013;2013;08;01;Tiistai;2;4;6;0;0;0
89;20.08.2013;2013;08;02;Tiistai;2;1;3;0;0;0
89;20.08.2013;2013;08;03;Tiistai;3;5;8;1;0;1
89;20.08.2013;2013;08;04;Tiistai;2;2;4;0;1;1
89;20.08.2013;2013;08;05;Tiistai;4;20;24;2;1;3
89;20.08.2013;2013;08;06;Tiistai;23;75;98;1;6;7
89;20.08.2013;2013;08;07;Tiistai;49;230;279;8;33;41
89;20.08.2013;2013;08;08;Tiistai;87;329;416;13;38;51
89;20.08.2013;2013;08;09;Tiistai;66;186;252;20;37;57
89;20.08.2013;2013;08;10;Tiistai;62;130;192;19;33;52
89;20.08.2013;2013;08;11;Tiistai;94;110;204;11;55;66
89;20.08.2013;2013;08;12;Tiistai;105;141;246;24;33;57
89;20.08.2013;2013;08;13;Tiistai;129;154;283;17;31;48
89;20.08.2013;2013;08;14;Tiistai;253;131;384;39;30;69
89;20.08.2013;2013;08;15;Tiistai;265;163;428;35;46;81
89;20.08.2013;2013;08;16;Tiistai;374;194;568;35;33;68
89;20.08.2013;2013;08;17;Tiistai;245;147;392;36;45;81
89;20.08.2013;2013;08;18;Tiistai;162;163;325;39;49;88
89;20.08.2013;2013;08;19;Tiistai;166;89;255;62;58;120
89;20.08.2013;2013;08;20;Tiistai;180;91;271;48;40;88
89;20.08.2013;2013;08;21;Tiistai;68;39;107;20;22;42
89;20.08.2013;2013;08;22;Tiistai;38;28;66;8;4;12
89;20.08.2013;2013;08;23;Tiistai;26;15;41;3;1;4
89;21.08.2013;2013;08;00;Keskiviikko;9;7;16;2;1;3
89;21.08.2013;2013;08;01;Keskiviikko;6;7;13;2;1;3
89;21.08.2013;2013;08;02;Keskiviikko;2;3;5;1;1;2
89;21.08.2013;2013;08;03;Keskiviikko;7;3;10;1;0;1
89;21.08.2013;2013;08;04;Keskiviikko;4;1;5;0;0;0
89;21.08.2013;2013;08;05;Keskiviikko;3;17;20;1;0;1
89;21.08.2013;2013;08;06;Keskiviikko;22;79;101;1;8;9
89;21.08.2013;2013;08;07;Keskiviikko;51;257;308;5;26;31
89;21.08.2013;2013;08;08;Keskiviikko;95;311;406;10;24;34
89;21.08.2013;2013;08;09;Keskiviikko;50;160;210;11;42;53
89;21.08.2013;2013;08;10;Keskiviikko;56;93;149;14;15;29
89;21.08.2013;2013;08;11;Keskiviikko;74;125;199;16;27;43
89;21.08.2013;2013;08;12;Keskiviikko;97;128;225;23;19;42
89;21.08.2013;2013;08;13;Keskiviikko;143;124;267;21;31;52
89;21.08.2013;2013;08;14;Keskiviikko;197;125;322;21;25;46
89;21.08.2013;2013;08;15;Keskiviikko;254;172;426;36;16;52
89;21.08.2013;2013;08;16;Keskiviikko;380;169;549;35;20;55
89;21.08.2013;2013;08;17;Keskiviikko;229;141;370;45;26;71
89;21.08.2013;2013;08;18;Keskiviikko;183;99;282;38;41;79
89;21.08.2013;2013;08;19;Keskiviikko;125;78;203;37;33;70
89;21.08.2013;2013;08;20;Keskiviikko;112;49;161;22;22;44
89;21.08.2013;2013;08;21;Keskiviikko;79;35;114;19;22;41
89;21.08.2013;2013;08;22;Keskiviikko;34;22;56;4;12;16
89;21.08.2013;2013;08;23;Keskiviikko;20;14;34;5;2;7
89;22.08.2013;2013;08;00;Torstai;10;8;18;1;3;4
89;22.08.2013;2013;08;01;Torstai;7;0;7;2;1;3
89;22.08.2013;2013;08;02;Torstai;10;0;10;2;0;2
89;22.08.2013;2013;08;03;Torstai;8;2;10;2;1;3
89;22.08.2013;2013;08;04;Torstai;8;3;11;4;1;5
89;22.08.2013;2013;08;05;Torstai;5;18;23;1;0;1
89;22.08.2013;2013;08;06;Torstai;26;91;117;1;6;7
89;22.08.2013;2013;08;07;Torstai;41;254;295;7;25;32
89;22.08.2013;2013;08;08;Torstai;83;292;375;8;46;54
89;22.08.2013;2013;08;09;Torstai;49;176;225;19;40;59
89;22.08.2013;2013;08;10;Torstai;51;119;170;39;33;72
89;22.08.2013;2013;08;11;Torstai;101;119;220;10;38;48
89;22.08.2013;2013;08;12;Torstai;85;129;214;22;50;72
89;22.08.2013;2013;08;13;Torstai;129;152;281;22;23;45
89;22.08.2013;2013;08;14;Torstai;201;135;336;39;29;68
89;22.08.2013;2013;08;15;Torstai;247;135;382;40;32;72
89;22.08.2013;2013;08;16;Torstai;344;184;528;43;27;70
89;22.08.2013;2013;08;17;Torstai;187;183;370;32;38;70
89;22.08.2013;2013;08;18;Torstai;153;175;328;37;37;74
89;22.08.2013;2013;08;19;Torstai;143;144;287;51;43;94
89;22.08.2013;2013;08;20;Torstai;156;102;258;36;46;82
89;22.08.2013;2013;08;21;Torstai;146;65;211;28;17;45
89;22.08.2013;2013;08;22;Torstai;98;33;131;9;9;18
89;22.08.2013;2013;08;23;Torstai;42;23;65;2;3;5
89;23.08.2013;2013;08;00;Perjantai;20;8;28;3;0;3
89;23.08.2013;2013;08;01;Perjantai;17;7;24;2;0;2
89;23.08.2013;2013;08;02;Perjantai;13;1;14;3;1;4
89;23.08.2013;2013;08;03;Perjantai;11;3;14;6;0;6
89;23.08.2013;2013;08;04;Perjantai;8;4;12;1;0;1
89;23.08.2013;2013;08;05;Perjantai;5;11;16;0;1;1
89;23.08.2013;2013;08;06;Perjantai;26;80;106;2;4;6
89;23.08.2013;2013;08;07;Perjantai;44;224;268;4;30;34
89;23.08.2013;2013;08;08;Perjantai;83;296;379;6;65;71
89;23.08.2013;2013;08;09;Perjantai;60;167;227;53;62;115
89;23.08.2013;2013;08;10;Perjantai;57;126;183;30;48;78
89;23.08.2013;2013;08;11;Perjantai;88;114;202;22;26;48
89;23.08.2013;2013;08;12;Perjantai;91;110;201;20;28;48
89;23.08.2013;2013;08;13;Perjantai;167;152;319;37;24;61
89;23.08.2013;2013;08;14;Perjantai;251;125;376;30;19;49
89;23.08.2013;2013;08;15;Perjantai;248;146;394;37;39;76
89;23.08.2013;2013;08;16;Perjantai;205;124;329;23;25;48
89;23.08.2013;2013;08;17;Perjantai;147;101;248;21;28;49
89;23.08.2013;2013;08;18;Perjantai;99;138;237;25;35;60
89;23.08.2013;2013;08;19;Perjantai;69;135;204;22;27;49
89;23.08.2013;2013;08;20;Perjantai;73;117;190;12;18;30
89;23.08.2013;2013;08;21;Perjantai;71;67;138;9;19;28
89;23.08.2013;2013;08;22;Perjantai;101;55;156;7;12;19
89;23.08.2013;2013;08;23;Perjantai;63;32;95;5;8;13
89;24.08.2013;2013;08;00;Lauantai;44;19;63;7;3;10
89;24.08.2013;2013;08;01;Lauantai;28;15;43;3;3;6
89;24.08.2013;2013;08;02;Lauantai;38;5;43;4;4;8
89;24.08.2013;2013;08;03;Lauantai;41;4;45;7;1;8
89;24.08.2013;2013;08;04;Lauantai;22;1;23;15;0;15
89;24.08.2013;2013;08;05;Lauantai;12;14;26;0;0;0
89;24.08.2013;2013;08;06;Lauantai;4;18;22;1;4;5
89;24.08.2013;2013;08;07;Lauantai;9;14;23;2;6;8
89;24.08.2013;2013;08;08;Lauantai;9;40;49;5;10;15
89;24.08.2013;2013;08;09;Lauantai;23;71;94;12;22;34
89;24.08.2013;2013;08;10;Lauantai;53;97;150;8;34;42
89;24.08.2013;2013;08;11;Lauantai;76;118;194;32;35;67
89;24.08.2013;2013;08;12;Lauantai;80;147;227;26;142;168
89;24.08.2013;2013;08;13;Lauantai;97;123;220;35;54;89
89;24.08.2013;2013;08;14;Lauantai;142;129;271;47;41;88
89;24.08.2013;2013;08;15;Lauantai;120;118;238;36;30;66
89;24.08.2013;2013;08;16;Lauantai;128;78;206;39;36;75
89;24.08.2013;2013;08;17;Lauantai;118;91;209;28;34;62
89;24.08.2013;2013;08;18;Lauantai;101;78;179;40;34;74
89;24.08.2013;2013;08;19;Lauantai;78;86;164;30;35;65
89;24.08.2013;2013;08;20;Lauantai;60;71;131;9;22;31
89;24.08.2013;2013;08;21;Lauantai;54;66;120;4;6;10
89;24.08.2013;2013;08;22;Lauantai;33;64;97;6;8;14
89;24.08.2013;2013;08;23;Lauantai;23;37;60;2;7;9
89;25.08.2013;2013;08;00;Sunnuntai;28;20;48;5;9;14
89;25.08.2013;2013;08;01;Sunnuntai;32;30;62;8;5;13
89;25.08.2013;2013;08;02;Sunnuntai;43;11;54;7;2;9
89;25.08.2013;2013;08;03;Sunnuntai;40;5;45;9;1;10
89;25.08.2013;2013;08;04;Sunnuntai;28;0;28;3;2;5
89;25.08.2013;2013;08;05;Sunnuntai;6;4;10;0;0;0
89;25.08.2013;2013;08;06;Sunnuntai;1;15;16;5;5;10
89;25.08.2013;2013;08;07;Sunnuntai;12;11;23;1;4;5
89;25.08.2013;2013;08;08;Sunnuntai;10;16;26;5;5;10
89;25.08.2013;2013;08;09;Sunnuntai;21;54;75;13;19;32
89;25.08.2013;2013;08;10;Sunnuntai;18;64;82;20;37;57
89;25.08.2013;2013;08;11;Sunnuntai;52;100;152;24;45;69
89;25.08.2013;2013;08;12;Sunnuntai;85;130;215;33;62;95
89;25.08.2013;2013;08;13;Sunnuntai;120;148;268;41;60;101
89;25.08.2013;2013;08;14;Sunnuntai;144;179;323;61;59;120
89;25.08.2013;2013;08;15;Sunnuntai;169;143;312;32;56;88
89;25.08.2013;2013;08;16;Sunnuntai;143;112;255;35;33;68
89;25.08.2013;2013;08;17;Sunnuntai;151;124;275;41;57;98
89;25.08.2013;2013;08;18;Sunnuntai;168;117;285;38;42;80
89;25.08.2013;2013;08;19;Sunnuntai;81;75;156;31;47;78
89;25.08.2013;2013;08;20;Sunnuntai;72;58;130;21;28;49
89;25.08.2013;2013;08;21;Sunnuntai;59;34;93;12;13;25
89;25.08.2013;2013;08;22;Sunnuntai;21;12;33;5;4;9
89;25.08.2013;2013;08;23;Sunnuntai;20;9;29;4;3;7
89;26.08.2013;2013;08;00;Maanantai;6;6;12;6;2;8
89;26.08.2013;2013;08;01;Maanantai;8;7;15;0;0;0
89;26.08.2013;2013;08;02;Maanantai;1;0;1;2;2;4
89;26.08.2013;2013;08;03;Maanantai;3;3;6;0;0;0
89;26.08.2013;2013;08;04;Maanantai;0;3;3;1;1;2
89;26.08.2013;2013;08;05;Maanantai;4;15;19;1;2;3
89;26.08.2013;2013;08;06;Maanantai;20;76;96;2;3;5
89;26.08.2013;2013;08;07;Maanantai;40;230;270;10;29;39
89;26.08.2013;2013;08;08;Maanantai;77;290;367;7;35;42
89;26.08.2013;2013;08;09;Maanantai;71;201;272;8;37;45
89;26.08.2013;2013;08;10;Maanantai;66;115;181;24;24;48
89;26.08.2013;2013;08;11;Maanantai;113;133;246;22;52;74
89;26.08.2013;2013;08;12;Maanantai;118;145;263;31;36;67
89;26.08.2013;2013;08;13;Maanantai;132;129;261;36;49;85
89;26.08.2013;2013;08;14;Maanantai;241;144;385;48;36;84
89;26.08.2013;2013;08;15;Maanantai;299;165;464;36;19;55
89;26.08.2013;2013;08;16;Maanantai;351;176;527;34;31;65
89;26.08.2013;2013;08;17;Maanantai;193;146;339;29;30;59
89;26.08.2013;2013;08;18;Maanantai;217;126;343;45;35;80
89;26.08.2013;2013;08;19;Maanantai;165;93;258;37;46;83
89;26.08.2013;2013;08;20;Maanantai;120;70;190;32;45;77
89;26.08.2013;2013;08;21;Maanantai;57;37;94;29;19;48
89;26.08.2013;2013;08;22;Maanantai;42;14;56;11;6;17
89;26.08.2013;2013;08;23;Maanantai;14;8;22;3;12;15
89;27.08.2013;2013;08;00;Tiistai;4;3;7;8;5;13
89;27.08.2013;2013;08;01;Tiistai;5;0;5;1;0;1
89;27.08.2013;2013;08;02;Tiistai;3;3;6;1;0;1
89;27.08.2013;2013;08;03;Tiistai;5;1;6;1;0;1
89;27.08.2013;2013;08;04;Tiistai;1;4;5;1;1;2
89;27.08.2013;2013;08;05;Tiistai;5;22;27;2;0;2
89;27.08.2013;2013;08;06;Tiistai;28;85;113;7;10;17
89;27.08.2013;2013;08;07;Tiistai;67;256;323;8;26;34
89;27.08.2013;2013;08;08;Tiistai;90;314;404;11;35;46
89;27.08.2013;2013;08;09;Tiistai;62;187;249;12;48;60
89;27.08.2013;2013;08;10;Tiistai;64;130;194;27;54;81
89;27.08.2013;2013;08;11;Tiistai;112;158;270;45;37;82
89;27.08.2013;2013;08;12;Tiistai;104;159;263;21;36;57
89;27.08.2013;2013;08;13;Tiistai;153;156;309;27;30;57
89;27.08.2013;2013;08;14;Tiistai;212;185;397;35;24;59
89;27.08.2013;2013;08;15;Tiistai;289;159;448;26;19;45
89;27.08.2013;2013;08;16;Tiistai;390;172;562;31;19;50
89;27.08.2013;2013;08;17;Tiistai;245;202;447;35;41;76
89;27.08.2013;2013;08;18;Tiistai;217;127;344;39;45;84
89;27.08.2013;2013;08;19;Tiistai;184;137;321;42;60;102
89;27.08.2013;2013;08;20;Tiistai;134;78;212;39;35;74
89;27.08.2013;2013;08;21;Tiistai;69;44;113;14;17;31
89;27.08.2013;2013;08;22;Tiistai;30;17;47;8;7;15
89;27.08.2013;2013;08;23;Tiistai;11;9;20;5;0;5
89;28.08.2013;2013;08;00;Keskiviikko;9;5;14;3;4;7
89;28.08.2013;2013;08;01;Keskiviikko;3;5;8;4;0;4
89;28.08.2013;2013;08;02;Keskiviikko;2;2;4;1;0;1
89;28.08.2013;2013;08;03;Keskiviikko;2;3;5;1;1;2
89;28.08.2013;2013;08;04;Keskiviikko;3;1;4;3;0;3
89;28.08.2013;2013;08;05;Keskiviikko;4;16;20;1;2;3
89;28.08.2013;2013;08;06;Keskiviikko;29;78;107;6;11;17
89;28.08.2013;2013;08;07;Keskiviikko;52;266;318;3;28;31
89;28.08.2013;2013;08;08;Keskiviikko;105;354;459;9;26;35
89;28.08.2013;2013;08;09;Keskiviikko;55;169;224;16;39;55
89;28.08.2013;2013;08;10;Keskiviikko;55;125;180;16;70;86
89;28.08.2013;2013;08;11;Keskiviikko;93;113;206;50;32;82
89;28.08.2013;2013;08;12;Keskiviikko;113;141;254;27;36;63
89;28.08.2013;2013;08;13;Keskiviikko;155;128;283;27;30;57
89;28.08.2013;2013;08;14;Keskiviikko;204;136;340;33;23;56
89;28.08.2013;2013;08;15;Keskiviikko;248;161;409;33;18;51
89;28.08.2013;2013;08;16;Keskiviikko;381;143;524;20;33;53
89;28.08.2013;2013;08;17;Keskiviikko;193;137;330;32;26;58
89;28.08.2013;2013;08;18;Keskiviikko;182;118;300;27;37;64
89;28.08.2013;2013;08;19;Keskiviikko;126;82;208;24;31;55
89;28.08.2013;2013;08;20;Keskiviikko;119;73;192;24;20;44
89;28.08.2013;2013;08;21;Keskiviikko;78;36;114;12;21;33
89;28.08.2013;2013;08;22;Keskiviikko;32;20;52;8;7;15
89;28.08.2013;2013;08;23;Keskiviikko;16;14;30;4;8;12
89;29.08.2013;2013;08;00;Torstai;16;14;30;2;1;3
89;29.08.2013;2013;08;01;Torstai;9;3;12;2;5;7
89;29.08.2013;2013;08;02;Torstai;7;2;9;7;0;7
89;29.08.2013;2013;08;03;Torstai;11;5;16;2;0;2
89;29.08.2013;2013;08;04;Torstai;18;2;20;1;1;2
89;29.08.2013;2013;08;05;Torstai;5;17;22;1;1;2
89;29.08.2013;2013;08;06;Torstai;31;70;101;2;9;11
89;29.08.2013;2013;08;07;Torstai;39;256;295;7;25;32
89;29.08.2013;2013;08;08;Torstai;88;305;393;6;29;35
89;29.08.2013;2013;08;09;Torstai;64;187;251;38;62;100
89;29.08.2013;2013;08;10;Torstai;80;157;237;32;32;64
89;29.08.2013;2013;08;11;Torstai;93;143;236;26;31;57
89;29.08.2013;2013;08;12;Torstai;100;151;251;23;16;39
89;29.08.2013;2013;08;13;Torstai;130;158;288;17;29;46
89;29.08.2013;2013;08;14;Torstai;195;122;317;35;23;58
89;29.08.2013;2013;08;15;Torstai;269;133;402;45;29;74
89;29.08.2013;2013;08;16;Torstai;348;146;494;27;19;46
89;29.08.2013;2013;08;17;Torstai;216;130;346;34;24;58
89;29.08.2013;2013;08;18;Torstai;164;158;322;29;44;73
89;29.08.2013;2013;08;19;Torstai;140;97;237;33;26;59
89;29.08.2013;2013;08;20;Torstai;132;58;190;23;15;38
89;29.08.2013;2013;08;21;Torstai;73;43;116;14;13;27
89;29.08.2013;2013;08;22;Torstai;38;26;64;10;10;20
89;29.08.2013;2013;08;23;Torstai;11;14;25;6;8;14
89;30.08.2013;2013;08;00;Perjantai;8;2;10;3;0;3
89;30.08.2013;2013;08;01;Perjantai;7;2;9;3;0;3
89;30.08.2013;2013;08;02;Perjantai;10;1;11;0;2;2
89;30.08.2013;2013;08;03;Perjantai;13;3;16;4;0;4
89;30.08.2013;2013;08;04;Perjantai;6;2;8;5;0;5
89;30.08.2013;2013;08;05;Perjantai;4;16;20;0;0;0
89;30.08.2013;2013;08;06;Perjantai;23;61;84;4;8;12
89;30.08.2013;2013;08;07;Perjantai;49;202;251;2;25;27
89;30.08.2013;2013;08;08;Perjantai;75;270;345;10;30;40
89;30.08.2013;2013;08;09;Perjantai;69;163;232;5;49;54
89;30.08.2013;2013;08;10;Perjantai;71;148;219;37;56;93
89;30.08.2013;2013;08;11;Perjantai;86;153;239;54;65;119
89;30.08.2013;2013;08;12;Perjantai;113;158;271;36;21;57
89;30.08.2013;2013;08;13;Perjantai;168;131;299;27;15;42
89;30.08.2013;2013;08;14;Perjantai;270;144;414;27;27;54
89;30.08.2013;2013;08;15;Perjantai;253;139;392;21;22;43
89;30.08.2013;2013;08;16;Perjantai;245;134;379;34;31;65
89;30.08.2013;2013;08;17;Perjantai;160;142;302;24;34;58
89;30.08.2013;2013;08;18;Perjantai;107;122;229;20;25;45
89;30.08.2013;2013;08;19;Perjantai;92;79;171;26;24;50
89;30.08.2013;2013;08;20;Perjantai;136;73;209;10;12;22
89;30.08.2013;2013;08;21;Perjantai;75;61;136;12;6;18
89;30.08.2013;2013;08;22;Perjantai;34;51;85;3;8;11
89;30.08.2013;2013;08;23;Perjantai;33;37;70;5;7;12
89;31.08.2013;2013;08;00;Lauantai;23;10;33;9;13;22
89;31.08.2013;2013;08;01;Lauantai;25;21;46;2;4;6
89;31.08.2013;2013;08;02;Lauantai;25;4;29;7;1;8
89;31.08.2013;2013;08;03;Lauantai;35;3;38;3;1;4
89;31.08.2013;2013;08;04;Lauantai;22;2;24;7;1;8
89;31.08.2013;2013;08;05;Lauantai;16;5;21;5;0;5
89;31.08.2013;2013;08;06;Lauantai;3;21;24;0;1;1
89;31.08.2013;2013;08;07;Lauantai;11;23;34;4;9;13
89;31.08.2013;2013;08;08;Lauantai;13;45;58;5;11;16
89;31.08.2013;2013;08;09;Lauantai;25;75;100;15;27;42
89;31.08.2013;2013;08;10;Lauantai;40;123;163;12;39;51
89;31.08.2013;2013;08;11;Lauantai;67;151;218;9;37;46
89;31.08.2013;2013;08;12;Lauantai;82;174;256;28;165;193
89;31.08.2013;2013;08;13;Lauantai;132;181;313;43;73;116
89;31.08.2013;2013;08;14;Lauantai;163;161;324;35;45;80
89;31.08.2013;2013;08;15;Lauantai;207;106;313;45;27;72
89;31.08.2013;2013;08;16;Lauantai;184;105;289;24;30;54
89;31.08.2013;2013;08;17;Lauantai;123;81;204;37;33;70
89;31.08.2013;2013;08;18;Lauantai;137;108;245;19;28;47
89;31.08.2013;2013;08;19;Lauantai;100;94;194;25;32;57
89;31.08.2013;2013;08;20;Lauantai;80;69;149;56;29;85
89;31.08.2013;2013;08;21;Lauantai;62;63;125;11;11;22
89;31.08.2013;2013;08;22;Lauantai;55;53;108;7;14;21
89;31.08.2013;2013;08;23;Lauantai;31;32;63;9;6;15
89;01.09.2013;2013;09;00;Sunnuntai;28;35;63;2;12;14
89;01.09.2013;2013;09;01;Sunnuntai;15;13;28;10;6;16
89;01.09.2013;2013;09;02;Sunnuntai;22;13;35;9;0;9
89;01.09.2013;2013;09;03;Sunnuntai;36;4;40;10;2;12
89;01.09.2013;2013;09;04;Sunnuntai;26;4;30;6;2;8
89;01.09.2013;2013;09;05;Sunnuntai;11;3;14;0;0;0
89;01.09.2013;2013;09;06;Sunnuntai;6;11;17;1;4;5
89;01.09.2013;2013;09;07;Sunnuntai;6;11;17;2;6;8
89;01.09.2013;2013;09;08;Sunnuntai;13;16;29;8;9;17
89;01.09.2013;2013;09;09;Sunnuntai;18;92;110;12;32;44
89;01.09.2013;2013;09;10;Sunnuntai;115;129;244;27;50;77
89;01.09.2013;2013;09;11;Sunnuntai;65;113;178;32;38;70
89;01.09.2013;2013;09;12;Sunnuntai;106;149;255;47;59;106
89;01.09.2013;2013;09;13;Sunnuntai;138;128;266;40;59;99
89;01.09.2013;2013;09;14;Sunnuntai;152;137;289;33;55;88
89;01.09.2013;2013;09;15;Sunnuntai;112;144;256;34;33;67
89;01.09.2013;2013;09;16;Sunnuntai;117;117;234;37;34;71
89;01.09.2013;2013;09;17;Sunnuntai;125;87;212;28;35;63
89;01.09.2013;2013;09;18;Sunnuntai;125;105;230;36;44;80
89;01.09.2013;2013;09;19;Sunnuntai;90;57;147;31;40;71
89;01.09.2013;2013;09;20;Sunnuntai;68;42;110;40;16;56
89;01.09.2013;2013;09;21;Sunnuntai;38;22;60;12;9;21
89;01.09.2013;2013;09;22;Sunnuntai;18;16;34;1;3;4
89;01.09.2013;2013;09;23;Sunnuntai;6;8;14;6;5;11
89;02.09.2013;2013;09;00;Maanantai;3;4;7;3;1;4
89;02.09.2013;2013;09;01;Maanantai;2;0;2;2;1;3
89;02.09.2013;2013;09;02;Maanantai;1;1;2;1;0;1
89;02.09.2013;2013;09;03;Maanantai;1;4;5;0;0;0
89;02.09.2013;2013;09;04;Maanantai;3;4;7;2;1;3
89;02.09.2013;2013;09;05;Maanantai;4;13;17;1;0;1
89;02.09.2013;2013;09;06;Maanantai;16;38;54;2;5;7
89;02.09.2013;2013;09;07;Maanantai;40;167;207;1;27;28
89;02.09.2013;2013;09;08;Maanantai;86;219;305;5;31;36
89;02.09.2013;2013;09;09;Maanantai;39;152;191;8;34;42
89;02.09.2013;2013;09;10;Maanantai;64;92;156;10;19;29
89;02.09.2013;2013;09;11;Maanantai;75;98;173;10;26;36
89;02.09.2013;2013;09;12;Maanantai;91;99;190;20;17;37
89;02.09.2013;2013;09;13;Maanantai;91;106;197;23;32;55
89;02.09.2013;2013;09;14;Maanantai;162;84;246;27;33;60
89;02.09.2013;2013;09;15;Maanantai;179;110;289;39;32;71
89;02.09.2013;2013;09;16;Maanantai;272;138;410;31;12;43
89;02.09.2013;2013;09;17;Maanantai;168;93;261;30;22;52
89;02.09.2013;2013;09;18;Maanantai;135;93;228;38;36;74
89;02.09.2013;2013;09;19;Maanantai;141;88;229;33;39;72
89;02.09.2013;2013;09;20;Maanantai;79;55;134;44;30;74
89;02.09.2013;2013;09;21;Maanantai;60;36;96;21;20;41
89;02.09.2013;2013;09;22;Maanantai;34;20;54;5;9;14
89;02.09.2013;2013;09;23;Maanantai;19;4;23;1;0;1
89;03.09.2013;2013;09;00;Tiistai;3;11;14;3;1;4
89;03.09.2013;2013;09;01;Tiistai;6;6;12;4;2;6
89;03.09.2013;2013;09;02;Tiistai;0;2;2;1;0;1
89;03.09.2013;2013;09;03;Tiistai;6;2;8;2;1;3
89;03.09.2013;2013;09;04;Tiistai;4;4;8;1;0;1
89;03.09.2013;2013;09;05;Tiistai;5;11;16;2;1;3
89;03.09.2013;2013;09;06;Tiistai;26;72;98;3;6;9
89;03.09.2013;2013;09;07;Tiistai;67;244;311;4;28;32
89;03.09.2013;2013;09;08;Tiistai;115;352;467;14;41;55
89;03.09.2013;2013;09;09;Tiistai;76;184;260;5;45;50
89;03.09.2013;2013;09;10;Tiistai;57;106;163;18;20;38
89;03.09.2013;2013;09;11;Tiistai;103;130;233;26;31;57
89;03.09.2013;2013;09;12;Tiistai;90;120;210;20;28;48
89;03.09.2013;2013;09;13;Tiistai;137;108;245;20;39;59
89;03.09.2013;2013;09;14;Tiistai;220;135;355;31;23;54
89;03.09.2013;2013;09;15;Tiistai;249;157;406;30;33;63
89;03.09.2013;2013;09;16;Tiistai;382;193;575;44;28;72
89;03.09.2013;2013;09;17;Tiistai;201;121;322;36;26;62
89;03.09.2013;2013;09;18;Tiistai;171;101;272;35;39;74
89;03.09.2013;2013;09;19;Tiistai;150;92;242;42;51;93
89;03.09.2013;2013;09;20;Tiistai;131;57;188;30;24;54
89;03.09.2013;2013;09;21;Tiistai;70;32;102;13;9;22
89;03.09.2013;2013;09;22;Tiistai;24;13;37;4;4;8
89;03.09.2013;2013;09;23;Tiistai;10;9;19;0;7;7
89;04.09.2013;2013;09;00;Keskiviikko;5;4;9;2;1;3
89;04.09.2013;2013;09;01;Keskiviikko;2;0;2;1;2;3
89;04.09.2013;2013;09;02;Keskiviikko;3;2;5;1;2;3
89;04.09.2013;2013;09;03;Keskiviikko;2;2;4;1;0;1
89;04.09.2013;2013;09;04;Keskiviikko;3;5;8;0;0;0
89;04.09.2013;2013;09;05;Keskiviikko;2;18;20;1;1;2
89;04.09.2013;2013;09;06;Keskiviikko;24;70;94;5;12;17
89;04.09.2013;2013;09;07;Keskiviikko;59;245;304;2;27;29
89;04.09.2013;2013;09;08;Keskiviikko;97;335;432;11;40;51
89;04.09.2013;2013;09;09;Keskiviikko;81;159;240;5;28;33
89;04.09.2013;2013;09;10;Keskiviikko;66;126;192;26;23;49
89;04.09.2013;2013;09;11;Keskiviikko;91;101;192;21;30;51
89;04.09.2013;2013;09;12;Keskiviikko;77;156;233;20;23;43
89;04.09.2013;2013;09;13;Keskiviikko;129;122;251;15;31;46
89;04.09.2013;2013;09;14;Keskiviikko;211;136;347;22;21;43
89;04.09.2013;2013;09;15;Keskiviikko;247;136;383;37;32;69
89;04.09.2013;2013;09;16;Keskiviikko;338;161;499;40;23;63
89;04.09.2013;2013;09;17;Keskiviikko;195;149;344;28;40;68
89;04.09.2013;2013;09;18;Keskiviikko;142;123;265;35;41;76
89;04.09.2013;2013;09;19;Keskiviikko;130;74;204;34;44;78
89;04.09.2013;2013;09;20;Keskiviikko;119;81;200;22;24;46
89;04.09.2013;2013;09;21;Keskiviikko;68;45;113;15;9;24
89;04.09.2013;2013;09;22;Keskiviikko;25;16;41;3;8;11
89;04.09.2013;2013;09;23;Keskiviikko;23;22;45;1;5;6
89;05.09.2013;2013;09;00;Torstai;8;6;14;0;1;1
89;05.09.2013;2013;09;01;Torstai;8;3;11;2;2;4
89;05.09.2013;2013;09;02;Torstai;11;6;17;1;2;3
89;05.09.2013;2013;09;03;Torstai;5;4;9;1;0;1
89;05.09.2013;2013;09;04;Torstai;8;6;14;2;0;2
89;05.09.2013;2013;09;05;Torstai;7;14;21;2;0;2
89;05.09.2013;2013;09;06;Torstai;27;59;86;4;6;10
89;05.09.2013;2013;09;07;Torstai;47;248;295;2;29;31
89;05.09.2013;2013;09;08;Torstai;117;338;455;10;29;39
89;05.09.2013;2013;09;09;Torstai;69;160;229;8;24;32
89;05.09.2013;2013;09;10;Torstai;55;115;170;20;30;50
89;05.09.2013;2013;09;11;Torstai;93;127;220;24;35;59
89;05.09.2013;2013;09;12;Torstai;103;122;225;24;34;58
89;05.09.2013;2013;09;13;Torstai;133;166;299;22;35;57
89;05.09.2013;2013;09;14;Torstai;189;148;337;21;32;53
89;05.09.2013;2013;09;15;Torstai;285;125;410;26;25;51
89;05.09.2013;2013;09;16;Torstai;338;185;523;36;32;68
89;05.09.2013;2013;09;17;Torstai;213;137;350;29;30;59
89;05.09.2013;2013;09;18;Torstai;169;135;304;36;53;89
89;05.09.2013;2013;09;19;Torstai;179;96;275;32;54;86
89;05.09.2013;2013;09;20;Torstai;152;59;211;43;34;77
89;05.09.2013;2013;09;21;Torstai;63;35;98;18;15;33
89;05.09.2013;2013;09;22;Torstai;25;17;42;9;2;11
89;05.09.2013;2013;09;23;Torstai;11;7;18;7;2;9
89;06.09.2013;2013;09;00;Perjantai;4;12;16;0;2;2
89;06.09.2013;2013;09;01;Perjantai;4;2;6;1;1;2
89;06.09.2013;2013;09;02;Perjantai;5;1;6;2;0;2
89;06.09.2013;2013;09;03;Perjantai;10;5;15;1;0;1
89;06.09.2013;2013;09;04;Perjantai;6;4;10;4;1;5
89;06.09.2013;2013;09;05;Perjantai;3;13;16;1;0;1
89;06.09.2013;2013;09;06;Perjantai;27;59;86;4;5;9
89;06.09.2013;2013;09;07;Perjantai;39;213;252;5;35;40
89;06.09.2013;2013;09;08;Perjantai;90;309;399;13;41;54
89;06.09.2013;2013;09;09;Perjantai;64;160;224;25;23;48
89;06.09.2013;2013;09;10;Perjantai;65;140;205;32;74;106
89;06.09.2013;2013;09;11;Perjantai;84;134;218;38;25;63
89;06.09.2013;2013;09;12;Perjantai;131;133;264;23;48;71
89;06.09.2013;2013;09;13;Perjantai;160;154;314;23;21;44
89;06.09.2013;2013;09;14;Perjantai;256;141;397;40;29;69
89;06.09.2013;2013;09;15;Perjantai;248;146;394;41;30;71
89;06.09.2013;2013;09;16;Perjantai;243;154;397;23;26;49
89;06.09.2013;2013;09;17;Perjantai;170;119;289;24;39;63
89;06.09.2013;2013;09;18;Perjantai;127;101;228;30;29;59
89;06.09.2013;2013;09;19;Perjantai;125;105;230;30;31;61
89;06.09.2013;2013;09;20;Perjantai;94;88;182;23;32;55
89;06.09.2013;2013;09;21;Perjantai;54;48;102;13;11;24
89;06.09.2013;2013;09;22;Perjantai;44;45;89;5;3;8
89;06.09.2013;2013;09;23;Perjantai;25;25;50;3;7;10
89;07.09.2013;2013;09;00;Lauantai;43;21;64;2;16;18
89;07.09.2013;2013;09;01;Lauantai;35;16;51;4;11;15
89;07.09.2013;2013;09;02;Lauantai;34;14;48;13;6;19
89;07.09.2013;2013;09;03;Lauantai;21;8;29;16;0;16
89;07.09.2013;2013;09;04;Lauantai;24;3;27;3;0;3
89;07.09.2013;2013;09;05;Lauantai;5;5;10;2;2;4
89;07.09.2013;2013;09;06;Lauantai;7;8;15;2;3;5
89;07.09.2013;2013;09;07;Lauantai;6;19;25;7;8;15
89;07.09.2013;2013;09;08;Lauantai;13;52;65;9;17;26
89;07.09.2013;2013;09;09;Lauantai;12;74;86;12;49;61
89;07.09.2013;2013;09;10;Lauantai;40;112;152;23;31;54
89;07.09.2013;2013;09;11;Lauantai;83;116;199;33;39;72
89;07.09.2013;2013;09;12;Lauantai;104;168;272;25;53;78
89;07.09.2013;2013;09;13;Lauantai;128;120;248;28;32;60
89;07.09.2013;2013;09;14;Lauantai;127;149;276;27;58;85
89;07.09.2013;2013;09;15;Lauantai;141;114;255;52;42;94
89;07.09.2013;2013;09;16;Lauantai;129;87;216;39;43;82
89;07.09.2013;2013;09;17;Lauantai;129;107;236;28;31;59
89;07.09.2013;2013;09;18;Lauantai;102;117;219;24;22;46
89;07.09.2013;2013;09;19;Lauantai;78;51;129;26;35;61
89;07.09.2013;2013;09;20;Lauantai;67;67;134;26;16;42
89;07.09.2013;2013;09;21;Lauantai;39;49;88;12;9;21
89;07.09.2013;2013;09;22;Lauantai;25;50;75;7;25;32
89;07.09.2013;2013;09;23;Lauantai;30;33;63;5;8;13
89;08.09.2013;2013;09;00;Sunnuntai;23;34;57;0;13;13
89;08.09.2013;2013;09;01;Sunnuntai;19;7;26;9;1;10
89;08.09.2013;2013;09;02;Sunnuntai;29;6;35;3;1;4
89;08.09.2013;2013;09;03;Sunnuntai;28;4;32;9;1;10
89;08.09.2013;2013;09;04;Sunnuntai;38;9;47;4;0;4
89;08.09.2013;2013;09;05;Sunnuntai;9;5;14;0;1;1
89;08.09.2013;2013;09;06;Sunnuntai;5;16;21;2;4;6
89;08.09.2013;2013;09;07;Sunnuntai;4;7;11;4;6;10
89;08.09.2013;2013;09;08;Sunnuntai;6;12;18;4;12;16
89;08.09.2013;2013;09;09;Sunnuntai;20;28;48;17;24;41
89;08.09.2013;2013;09;10;Sunnuntai;27;65;92;33;34;67
89;08.09.2013;2013;09;11;Sunnuntai;57;106;163;49;66;115
89;08.09.2013;2013;09;12;Sunnuntai;92;137;229;43;82;125
89;08.09.2013;2013;09;13;Sunnuntai;114;130;244;39;52;91
89;08.09.2013;2013;09;14;Sunnuntai;113;157;270;44;50;94
89;08.09.2013;2013;09;15;Sunnuntai;119;112;231;33;40;73
89;08.09.2013;2013;09;16;Sunnuntai;116;109;225;29;40;69
89;08.09.2013;2013;09;17;Sunnuntai;100;89;189;25;32;57
89;08.09.2013;2013;09;18;Sunnuntai;117;86;203;42;26;68
89;08.09.2013;2013;09;19;Sunnuntai;83;71;154;31;27;58
89;08.09.2013;2013;09;20;Sunnuntai;57;36;93;24;25;49
89;08.09.2013;2013;09;21;Sunnuntai;45;32;77;16;10;26
89;08.09.2013;2013;09;22;Sunnuntai;26;10;36;4;5;9
89;08.09.2013;2013;09;23;Sunnuntai;12;6;18;1;2;3
89;09.09.2013;2013;09;00;Maanantai;10;7;17;2;1;3
89;09.09.2013;2013;09;01;Maanantai;5;2;7;0;2;2
89;09.09.2013;2013;09;02;Maanantai;4;0;4;1;1;2
89;09.09.2013;2013;09;03;Maanantai;3;4;7;3;0;3
89;09.09.2013;2013;09;04;Maanantai;5;2;7;0;0;0
89;09.09.2013;2013;09;05;Maanantai;5;19;24;0;0;0
89;09.09.2013;2013;09;06;Maanantai;30;62;92;3;4;7
89;09.09.2013;2013;09;07;Maanantai;49;257;306;4;31;35
89;09.09.2013;2013;09;08;Maanantai;76;306;382;10;29;39
89;09.09.2013;2013;09;09;Maanantai;77;254;331;10;68;78
89;09.09.2013;2013;09;10;Maanantai;82;216;298;44;35;79
89;09.09.2013;2013;09;11;Maanantai;116;186;302;19;28;47
89;09.09.2013;2013;09;12;Maanantai;154;189;343;20;28;48
89;09.09.2013;2013;09;13;Maanantai;184;150;334;26;27;53
89;09.09.2013;2013;09;14;Maanantai;238;149;387;25;31;56
89;09.09.2013;2013;09;15;Maanantai;247;138;385;44;25;69
89;09.09.2013;2013;09;16;Maanantai;407;149;556;27;25;52
89;09.09.2013;2013;09;17;Maanantai;239;124;363;30;36;66
89;09.09.2013;2013;09;18;Maanantai;194;138;332;31;30;61
89;09.09.2013;2013;09;19;Maanantai;145;109;254;35;34;69
89;09.09.2013;2013;09;20;Maanantai;125;70;195;30;30;60
89;09.09.2013;2013;09;21;Maanantai;75;31;106;22;19;41
89;09.09.2013;2013;09;22;Maanantai;27;44;71;6;4;10
89;09.09.2013;2013;09;23;Maanantai;11;11;22;1;3;4
89;10.09.2013;2013;09;00;Tiistai;8;8;16;2;1;3
89;10.09.2013;2013;09;01;Tiistai;9;1;10;1;0;1
89;10.09.2013;2013;09;02;Tiistai;13;2;15;0;0;0
89;10.09.2013;2013;09;03;Tiistai;6;2;8;1;0;1
89;10.09.2013;2013;09;04;Tiistai;2;4;6;1;0;1
89;10.09.2013;2013;09;05;Tiistai;3;22;25;1;0;1
89;10.09.2013;2013;09;06;Tiistai;24;65;89;5;9;14
89;10.09.2013;2013;09;07;Tiistai;76;262;338;7;24;31
89;10.09.2013;2013;09;08;Tiistai;97;326;423;15;40;55
89;10.09.2013;2013;09;09;Tiistai;72;203;275;13;38;51
89;10.09.2013;2013;09;10;Tiistai;89;184;273;17;20;37
89;10.09.2013;2013;09;11;Tiistai;112;170;282;14;52;66
89;10.09.2013;2013;09;12;Tiistai;161;160;321;24;25;49
89;10.09.2013;2013;09;13;Tiistai;204;149;353;35;15;50
89;10.09.2013;2013;09;14;Tiistai;218;117;335;29;38;67
89;10.09.2013;2013;09;15;Tiistai;286;180;466;25;18;43
89;10.09.2013;2013;09;16;Tiistai;384;190;574;49;18;67
89;10.09.2013;2013;09;17;Tiistai;245;155;400;41;37;78
89;10.09.2013;2013;09;18;Tiistai;187;130;317;41;57;98
89;10.09.2013;2013;09;19;Tiistai;152;102;254;34;40;74
89;10.09.2013;2013;09;20;Tiistai;126;62;188;36;25;61
89;10.09.2013;2013;09;21;Tiistai;65;40;105;18;13;31
89;10.09.2013;2013;09;22;Tiistai;22;11;33;7;5;12
89;10.09.2013;2013;09;23;Tiistai;17;9;26;2;0;2
89;11.09.2013;2013;09;00;Keskiviikko;2;3;5;1;1;2
89;11.09.2013;2013;09;01;Keskiviikko;1;1;2;0;0;0
89;11.09.2013;2013;09;02;Keskiviikko;2;1;3;1;0;1
89;11.09.2013;2013;09;03;Keskiviikko;2;4;6;1;0;1
89;11.09.2013;2013;09;04;Keskiviikko;4;5;9;0;0;0
89;11.09.2013;2013;09;05;Keskiviikko;3;20;23;2;0;2
89;11.09.2013;2013;09;06;Keskiviikko;18;68;86;2;9;11
89;11.09.2013;2013;09;07;Keskiviikko;66;249;315;2;24;26
89;11.09.2013;2013;09;08;Keskiviikko;92;360;452;6;30;36
89;11.09.2013;2013;09;09;Keskiviikko;70;177;247;11;32;43
89;11.09.2013;2013;09;10;Keskiviikko;75;138;213;10;30;40
89;11.09.2013;2013;09;11;Keskiviikko;102;140;242;21;46;67
89;11.09.2013;2013;09;12;Keskiviikko;147;136;283;34;29;63
89;11.09.2013;2013;09;13;Keskiviikko;175;143;318;13;34;47
89;11.09.2013;2013;09;14;Keskiviikko;221;119;340;14;15;29
89;11.09.2013;2013;09;15;Keskiviikko;222;153;375;21;17;38
89;11.09.2013;2013;09;16;Keskiviikko;377;168;545;29;23;52
89;11.09.2013;2013;09;17;Keskiviikko;218;120;338;38;25;63
89;11.09.2013;2013;09;18;Keskiviikko;159;150;309;29;23;52
89;11.09.2013;2013;09;19;Keskiviikko;119;91;210;30;45;75
89;11.09.2013;2013;09;20;Keskiviikko;103;96;199;33;35;68
89;11.09.2013;2013;09;21;Keskiviikko;82;37;119;19;10;29
89;11.09.2013;2013;09;22;Keskiviikko;72;21;93;12;7;19
89;11.09.2013;2013;09;23;Keskiviikko;7;16;23;3;1;4
89;12.09.2013;2013;09;00;Torstai;21;15;36;1;2;3
89;12.09.2013;2013;09;01;Torstai;26;5;31;0;0;0
89;12.09.2013;2013;09;02;Torstai;9;3;12;0;0;0
89;12.09.2013;2013;09;03;Torstai;12;4;16;1;0;1
89;12.09.2013;2013;09;04;Torstai;11;4;15;0;0;0
89;12.09.2013;2013;09;05;Torstai;5;14;19;0;2;2
89;12.09.2013;2013;09;06;Torstai;25;72;97;4;4;8
89;12.09.2013;2013;09;07;Torstai;58;217;275;7;26;33
89;12.09.2013;2013;09;08;Torstai;84;319;403;10;39;49
89;12.09.2013;2013;09;09;Torstai;81;154;235;13;25;38
89;12.09.2013;2013;09;10;Torstai;62;120;182;9;39;48
89;12.09.2013;2013;09;11;Torstai;97;136;233;22;27;49
89;12.09.2013;2013;09;12;Torstai;120;122;242;16;25;41
89;12.09.2013;2013;09;13;Torstai;130;157;287;23;31;54
89;12.09.2013;2013;09;14;Torstai;183;134;317;26;31;57
89;12.09.2013;2013;09;15;Torstai;217;156;373;41;23;64
89;12.09.2013;2013;09;16;Torstai;354;158;512;45;22;67
89;12.09.2013;2013;09;17;Torstai;205;125;330;41;24;65
89;12.09.2013;2013;09;18;Torstai;148;119;267;35;33;68
89;12.09.2013;2013;09;19;Torstai;140;81;221;43;30;73
89;12.09.2013;2013;09;20;Torstai;91;71;162;41;27;68
89;12.09.2013;2013;09;21;Torstai;60;41;101;11;10;21
89;12.09.2013;2013;09;22;Torstai;25;24;49;7;7;14
89;12.09.2013;2013;09;23;Torstai;11;7;18;3;4;7
89;13.09.2013;2013;09;00;Perjantai;9;6;15;2;0;2
89;13.09.2013;2013;09;01;Perjantai;10;0;10;0;2;2
89;13.09.2013;2013;09;02;Perjantai;5;3;8;2;0;2
89;13.09.2013;2013;09;03;Perjantai;6;5;11;2;0;2
89;13.09.2013;2013;09;04;Perjantai;10;4;14;1;0;1
89;13.09.2013;2013;09;05;Perjantai;5;16;21;1;1;2
89;13.09.2013;2013;09;06;Perjantai;22;65;87;3;3;6
89;13.09.2013;2013;09;07;Perjantai;66;227;293;12;26;38
89;13.09.2013;2013;09;08;Perjantai;81;279;360;6;31;37
89;13.09.2013;2013;09;09;Perjantai;68;168;236;16;37;53
89;13.09.2013;2013;09;10;Perjantai;57;104;161;10;30;40
89;13.09.2013;2013;09;11;Perjantai;96;147;243;19;23;42
89;13.09.2013;2013;09;12;Perjantai;109;161;270;28;37;65
89;13.09.2013;2013;09;13;Perjantai;168;165;333;20;30;50
89;13.09.2013;2013;09;14;Perjantai;233;128;361;30;23;53
89;13.09.2013;2013;09;15;Perjantai;264;148;412;28;24;52
89;13.09.2013;2013;09;16;Perjantai;244;154;398;28;25;53
89;13.09.2013;2013;09;17;Perjantai;150;125;275;30;37;67
89;13.09.2013;2013;09;18;Perjantai;134;109;243;30;44;74
89;13.09.2013;2013;09;19;Perjantai;108;71;179;33;27;60
89;13.09.2013;2013;09;20;Perjantai;101;59;160;19;21;40
89;13.09.2013;2013;09;21;Perjantai;60;59;119;16;17;33
89;13.09.2013;2013;09;22;Perjantai;53;40;93;3;11;14
89;13.09.2013;2013;09;23;Perjantai;32;22;54;5;6;11
89;14.09.2013;2013;09;00;Lauantai;30;18;48;7;8;15
89;14.09.2013;2013;09;01;Lauantai;22;19;41;7;6;13
89;14.09.2013;2013;09;02;Lauantai;28;12;40;6;4;10
89;14.09.2013;2013;09;03;Lauantai;17;1;18;10;1;11
89;14.09.2013;2013;09;04;Lauantai;24;4;28;10;0;10
89;14.09.2013;2013;09;05;Lauantai;9;5;14;5;2;7
89;14.09.2013;2013;09;06;Lauantai;8;9;17;2;1;3
89;14.09.2013;2013;09;07;Lauantai;8;16;24;0;12;12
89;14.09.2013;2013;09;08;Lauantai;16;48;64;10;10;20
89;14.09.2013;2013;09;09;Lauantai;26;86;112;17;15;32
89;14.09.2013;2013;09;10;Lauantai;38;85;123;6;22;28
89;14.09.2013;2013;09;11;Lauantai;72;110;182;20;40;60
89;14.09.2013;2013;09;12;Lauantai;87;113;200;19;30;49
89;14.09.2013;2013;09;13;Lauantai;104;156;260;18;27;45
89;14.09.2013;2013;09;14;Lauantai;122;136;258;29;28;57
89;14.09.2013;2013;09;15;Lauantai;118;101;219;26;22;48
89;14.09.2013;2013;09;16;Lauantai;120;78;198;31;31;62
89;14.09.2013;2013;09;17;Lauantai;113;81;194;34;26;60
89;14.09.2013;2013;09;18;Lauantai;106;97;203;23;32;55
89;14.09.2013;2013;09;19;Lauantai;88;63;151;26;28;54
89;14.09.2013;2013;09;20;Lauantai;60;61;121;3;20;23
89;14.09.2013;2013;09;21;Lauantai;65;48;113;13;15;28
89;14.09.2013;2013;09;22;Lauantai;30;45;75;5;9;14
89;14.09.2013;2013;09;23;Lauantai;27;20;47;5;10;15
89;15.09.2013;2013;09;00;Sunnuntai;18;30;48;8;10;18
89;15.09.2013;2013;09;01;Sunnuntai;33;13;46;4;5;9
89;15.09.2013;2013;09;02;Sunnuntai;30;9;39;13;6;19
89;15.09.2013;2013;09;03;Sunnuntai;22;5;27;10;0;10
89;15.09.2013;2013;09;04;Sunnuntai;25;2;27;12;0;12
89;15.09.2013;2013;09;05;Sunnuntai;13;1;14;0;3;3
89;15.09.2013;2013;09;06;Sunnuntai;9;7;16;7;1;8
89;15.09.2013;2013;09;07;Sunnuntai;5;6;11;1;4;5
89;15.09.2013;2013;09;08;Sunnuntai;6;15;21;3;7;10
89;15.09.2013;2013;09;09;Sunnuntai;16;35;51;9;18;27
89;15.09.2013;2013;09;10;Sunnuntai;28;65;93;34;31;65
89;15.09.2013;2013;09;11;Sunnuntai;57;97;154;55;46;101
89;15.09.2013;2013;09;12;Sunnuntai;75;159;234;37;69;106
89;15.09.2013;2013;09;13;Sunnuntai;124;159;283;38;64;102
89;15.09.2013;2013;09;14;Sunnuntai;136;139;275;40;47;87
89;15.09.2013;2013;09;15;Sunnuntai;146;136;282;37;56;93
89;15.09.2013;2013;09;16;Sunnuntai;125;103;228;41;29;70
89;15.09.2013;2013;09;17;Sunnuntai;120;83;203;40;25;65
89;15.09.2013;2013;09;18;Sunnuntai;85;85;170;29;26;55
89;15.09.2013;2013;09;19;Sunnuntai;96;44;140;42;44;86
89;15.09.2013;2013;09;20;Sunnuntai;48;47;95;13;27;40
89;15.09.2013;2013;09;21;Sunnuntai;29;25;54;13;8;21
89;15.09.2013;2013;09;22;Sunnuntai;16;11;27;4;4;8
89;15.09.2013;2013;09;23;Sunnuntai;16;10;26;3;0;3
89;16.09.2013;2013;09;00;Maanantai;4;10;14;0;2;2
89;16.09.2013;2013;09;01;Maanantai;2;5;7;0;2;2
89;16.09.2013;2013;09;02;Maanantai;0;2;2;0;1;1
89;16.09.2013;2013;09;03;Maanantai;0;4;4;1;0;1
89;16.09.2013;2013;09;04;Maanantai;5;4;9;1;1;2
89;16.09.2013;2013;09;05;Maanantai;2;12;14;0;0;0
89;16.09.2013;2013;09;06;Maanantai;20;45;65;2;8;10
89;16.09.2013;2013;09;07;Maanantai;72;228;300;4;25;29
89;16.09.2013;2013;09;08;Maanantai;92;354;446;10;37;47
89;16.09.2013;2013;09;09;Maanantai;72;200;272;7;61;68
89;16.09.2013;2013;09;10;Maanantai;59;120;179;29;19;48
89;16.09.2013;2013;09;11;Maanantai;100;123;223;16;25;41
89;16.09.2013;2013;09;12;Maanantai;83;116;199;14;19;33
89;16.09.2013;2013;09;13;Maanantai;135;136;271;16;27;43
89;16.09.2013;2013;09;14;Maanantai;178;108;286;18;14;32
89;16.09.2013;2013;09;15;Maanantai;245;139;384;29;15;44
89;16.09.2013;2013;09;16;Maanantai;362;172;534;30;22;52
89;16.09.2013;2013;09;17;Maanantai;188;151;339;23;13;36
89;16.09.2013;2013;09;18;Maanantai;136;96;232;27;34;61
89;16.09.2013;2013;09;19;Maanantai;131;101;232;34;42;76
89;16.09.2013;2013;09;20;Maanantai;90;57;147;29;32;61
89;16.09.2013;2013;09;21;Maanantai;75;25;100;12;13;25
89;16.09.2013;2013;09;22;Maanantai;27;17;44;9;6;15
89;16.09.2013;2013;09;23;Maanantai;6;10;16;3;2;5
89;17.09.2013;2013;09;00;Tiistai;5;10;15;0;0;0
89;17.09.2013;2013;09;01;Tiistai;5;5;10;1;0;1
89;17.09.2013;2013;09;02;Tiistai;1;2;3;0;0;0
89;17.09.2013;2013;09;03;Tiistai;1;3;4;0;0;0
89;17.09.2013;2013;09;04;Tiistai;2;7;9;0;1;1
89;17.09.2013;2013;09;05;Tiistai;1;13;14;1;0;1
89;17.09.2013;2013;09;06;Tiistai;21;64;85;2;9;11
89;17.09.2013;2013;09;07;Tiistai;73;244;317;4;17;21
89;17.09.2013;2013;09;08;Tiistai;109;340;449;9;33;42
89;17.09.2013;2013;09;09;Tiistai;71;180;251;16;23;39
89;17.09.2013;2013;09;10;Tiistai;62;184;246;26;46;72
89;17.09.2013;2013;09;11;Tiistai;64;111;175;24;23;47
89;17.09.2013;2013;09;12;Tiistai;93;121;214;20;27;47
89;17.09.2013;2013;09;13;Tiistai;98;97;195;10;20;30
89;17.09.2013;2013;09;14;Tiistai;246;120;366;22;23;45
89;17.09.2013;2013;09;15;Tiistai;251;128;379;26;29;55
89;17.09.2013;2013;09;16;Tiistai;356;188;544;32;22;54
89;17.09.2013;2013;09;17;Tiistai;199;145;344;35;24;59
89;17.09.2013;2013;09;18;Tiistai;147;116;263;31;27;58
89;17.09.2013;2013;09;19;Tiistai;155;93;248;37;46;83
89;17.09.2013;2013;09;20;Tiistai;110;71;181;34;33;67
89;17.09.2013;2013;09;21;Tiistai;60;19;79;20;9;29
89;17.09.2013;2013;09;22;Tiistai;20;17;37;1;3;4
89;17.09.2013;2013;09;23;Tiistai;14;9;23;2;2;4
89;18.09.2013;2013;09;00;Keskiviikko;10;5;15;0;0;0
89;18.09.2013;2013;09;01;Keskiviikko;17;4;21;1;0;1
89;18.09.2013;2013;09;02;Keskiviikko;8;1;9;1;0;1
89;18.09.2013;2013;09;03;Keskiviikko;7;1;8;1;0;1
89;18.09.2013;2013;09;04;Keskiviikko;2;3;5;0;0;0
89;18.09.2013;2013;09;05;Keskiviikko;3;15;18;2;0;2
89;18.09.2013;2013;09;06;Keskiviikko;29;61;90;2;6;8
89;18.09.2013;2013;09;07;Keskiviikko;60;247;307;7;23;30
89;18.09.2013;2013;09;08;Keskiviikko;100;355;455;10;31;41
89;18.09.2013;2013;09;09;Keskiviikko;69;196;265;13;23;36
89;18.09.2013;2013;09;10;Keskiviikko;56;122;178;11;30;41
89;18.09.2013;2013;09;11;Keskiviikko;108;146;254;21;31;52
89;18.09.2013;2013;09;12;Keskiviikko;112;95;207;14;26;40
89;18.09.2013;2013;09;13;Keskiviikko;110;111;221;14;20;34
89;18.09.2013;2013;09;14;Keskiviikko;190;128;318;25;23;48
89;18.09.2013;2013;09;15;Keskiviikko;266;145;411;26;17;43
89;18.09.2013;2013;09;16;Keskiviikko;319;171;490;24;19;43
89;18.09.2013;2013;09;17;Keskiviikko;217;172;389;24;35;59
89;18.09.2013;2013;09;18;Keskiviikko;173;144;317;33;35;68
89;18.09.2013;2013;09;19;Keskiviikko;132;89;221;29;30;59
89;18.09.2013;2013;09;20;Keskiviikko;92;75;167;22;29;51
89;18.09.2013;2013;09;21;Keskiviikko;66;32;98;11;6;17
89;18.09.2013;2013;09;22;Keskiviikko;34;35;69;10;3;13
89;18.09.2013;2013;09;23;Keskiviikko;30;18;48;4;2;6
89;19.09.2013;2013;09;00;Torstai;19;6;25;5;1;6
89;19.09.2013;2013;09;01;Torstai;15;2;17;2;1;3
89;19.09.2013;2013;09;02;Torstai;4;1;5;0;1;1
89;19.09.2013;2013;09;03;Torstai;23;3;26;1;0;1
89;19.09.2013;2013;09;04;Torstai;7;4;11;0;1;1
89;19.09.2013;2013;09;05;Torstai;5;18;23;1;0;1
89;19.09.2013;2013;09;06;Torstai;23;64;87;5;5;10
89;19.09.2013;2013;09;07;Torstai;65;237;302;5;20;25
89;19.09.2013;2013;09;08;Torstai;106;302;408;8;27;35
89;19.09.2013;2013;09;09;Torstai;66;191;257;19;41;60
89;19.09.2013;2013;09;10;Torstai;83;103;186;16;34;50
89;19.09.2013;2013;09;11;Torstai;74;126;200;17;29;46
89;19.09.2013;2013;09;12;Torstai;97;142;239;38;20;58
89;19.09.2013;2013;09;13;Torstai;97;108;205;14;16;30
89;19.09.2013;2013;09;14;Torstai;169;111;280;16;18;34
89;19.09.2013;2013;09;15;Torstai;209;141;350;26;15;41
89;19.09.2013;2013;09;16;Torstai;329;158;487;16;32;48
89;19.09.2013;2013;09;17;Torstai;190;120;310;23;46;69
89;19.09.2013;2013;09;18;Torstai;135;133;268;31;36;67
89;19.09.2013;2013;09;19;Torstai;131;111;242;54;41;95
89;19.09.2013;2013;09;20;Torstai;104;50;154;17;15;32
89;19.09.2013;2013;09;21;Torstai;70;38;108;20;7;27
89;19.09.2013;2013;09;22;Torstai;25;36;61;8;13;21
89;19.09.2013;2013;09;23;Torstai;21;11;32;0;2;2
89;20.09.2013;2013;09;00;Perjantai;8;2;10;2;1;3
89;20.09.2013;2013;09;01;Perjantai;4;2;6;5;3;8
89;20.09.2013;2013;09;02;Perjantai;2;2;4;2;0;2
89;20.09.2013;2013;09;03;Perjantai;13;4;17;0;0;0
89;20.09.2013;2013;09;04;Perjantai;12;6;18;2;0;2
89;20.09.2013;2013;09;05;Perjantai;6;15;21;0;2;2
89;20.09.2013;2013;09;06;Perjantai;18;61;79;1;3;4
89;20.09.2013;2013;09;07;Perjantai;62;204;266;9;18;27
89;20.09.2013;2013;09;08;Perjantai;88;307;395;16;43;59
89;20.09.2013;2013;09;09;Perjantai;69;175;244;19;28;47
89;20.09.2013;2013;09;10;Perjantai;56;118;174;10;27;37
89;20.09.2013;2013;09;11;Perjantai;98;118;216;20;32;52
89;20.09.2013;2013;09;12;Perjantai;99;118;217;17;19;36
89;20.09.2013;2013;09;13;Perjantai;138;129;267;21;29;50
89;20.09.2013;2013;09;14;Perjantai;195;112;307;26;18;44
89;20.09.2013;2013;09;15;Perjantai;228;143;371;22;37;59
89;20.09.2013;2013;09;16;Perjantai;241;128;369;19;17;36
89;20.09.2013;2013;09;17;Perjantai;132;102;234;12;18;30
89;20.09.2013;2013;09;18;Perjantai;82;97;179;17;22;39
89;20.09.2013;2013;09;19;Perjantai;76;73;149;15;25;40
89;20.09.2013;2013;09;20;Perjantai;57;68;125;14;15;29
89;20.09.2013;2013;09;21;Perjantai;42;48;90;10;22;32
89;20.09.2013;2013;09;22;Perjantai;31;44;75;3;17;20
89;20.09.2013;2013;09;23;Perjantai;24;27;51;4;7;11
89;21.09.2013;2013;09;00;Lauantai;26;17;43;1;5;6
89;21.09.2013;2013;09;01;Lauantai;21;16;37;4;5;9
89;21.09.2013;2013;09;02;Lauantai;25;13;38;2;3;5
89;21.09.2013;2013;09;03;Lauantai;22;5;27;7;0;7
89;21.09.2013;2013;09;04;Lauantai;39;4;43;3;0;3
89;21.09.2013;2013;09;05;Lauantai;13;5;18;3;1;4
89;21.09.2013;2013;09;06;Lauantai;5;15;20;1;1;2
89;21.09.2013;2013;09;07;Lauantai;6;12;18;8;8;16
89;21.09.2013;2013;09;08;Lauantai;13;33;46;8;7;15
89;21.09.2013;2013;09;09;Lauantai;22;94;116;16;27;43
89;21.09.2013;2013;09;10;Lauantai;37;79;116;22;18;40
89;21.09.2013;2013;09;11;Lauantai;51;95;146;18;28;46
89;21.09.2013;2013;09;12;Lauantai;60;96;156;28;36;64
89;21.09.2013;2013;09;13;Lauantai;95;77;172;13;28;41
89;21.09.2013;2013;09;14;Lauantai;85;94;179;14;25;39
89;21.09.2013;2013;09;15;Lauantai;92;71;163;17;19;36
89;21.09.2013;2013;09;16;Lauantai;93;74;167;25;25;50
89;21.09.2013;2013;09;17;Lauantai;88;80;168;21;16;37
89;21.09.2013;2013;09;18;Lauantai;73;68;141;20;26;46
89;21.09.2013;2013;09;19;Lauantai;62;32;94;10;14;24
89;21.09.2013;2013;09;20;Lauantai;37;17;54;7;7;14
89;21.09.2013;2013;09;21;Lauantai;18;27;45;4;6;10
89;21.09.2013;2013;09;22;Lauantai;13;25;38;4;2;6
89;21.09.2013;2013;09;23;Lauantai;19;21;40;1;4;5
89;22.09.2013;2013;09;00;Sunnuntai;19;28;47;2;7;9
89;22.09.2013;2013;09;01;Sunnuntai;17;13;30;3;3;6
89;22.09.2013;2013;09;02;Sunnuntai;17;9;26;2;2;4
89;22.09.2013;2013;09;03;Sunnuntai;31;0;31;9;0;9
89;22.09.2013;2013;09;04;Sunnuntai;22;3;25;5;1;6
89;22.09.2013;2013;09;05;Sunnuntai;10;5;15;1;1;2
89;22.09.2013;2013;09;06;Sunnuntai;4;12;16;0;1;1
89;22.09.2013;2013;09;07;Sunnuntai;5;8;13;2;1;3
89;22.09.2013;2013;09;08;Sunnuntai;4;11;15;4;7;11
89;22.09.2013;2013;09;09;Sunnuntai;12;22;34;11;17;28
89;22.09.2013;2013;09;10;Sunnuntai;25;43;68;12;26;38
89;22.09.2013;2013;09;11;Sunnuntai;42;49;91;27;48;75
89;22.09.2013;2013;09;12;Sunnuntai;62;94;156;28;48;76
89;22.09.2013;2013;09;13;Sunnuntai;91;114;205;39;37;76
89;22.09.2013;2013;09;14;Sunnuntai;112;117;229;41;39;80
89;22.09.2013;2013;09;15;Sunnuntai;102;75;177;31;23;54
89;22.09.2013;2013;09;16;Sunnuntai;85;67;152;32;27;59
89;22.09.2013;2013;09;17;Sunnuntai;68;38;106;14;21;35
89;22.09.2013;2013;09;18;Sunnuntai;53;30;83;17;9;26
89;22.09.2013;2013;09;19;Sunnuntai;39;24;63;9;6;15
89;22.09.2013;2013;09;20;Sunnuntai;21;11;32;12;10;22
89;22.09.2013;2013;09;21;Sunnuntai;23;15;38;7;7;14
89;22.09.2013;2013;09;22;Sunnuntai;12;8;20;2;2;4
89;22.09.2013;2013;09;23;Sunnuntai;8;4;12;1;0;1
89;23.09.2013;2013;09;00;Maanantai;11;1;12;2;1;3
89;23.09.2013;2013;09;01;Maanantai;1;1;2;0;0;0
89;23.09.2013;2013;09;02;Maanantai;1;0;1;0;1;1
89;23.09.2013;2013;09;03;Maanantai;3;5;8;0;1;1
89;23.09.2013;2013;09;04;Maanantai;0;4;4;0;0;0
89;23.09.2013;2013;09;05;Maanantai;0;11;11;1;1;2
89;23.09.2013;2013;09;06;Maanantai;22;53;75;0;4;4
89;23.09.2013;2013;09;07;Maanantai;52;208;260;15;20;35
89;23.09.2013;2013;09;08;Maanantai;88;308;396;9;28;37
89;23.09.2013;2013;09;09;Maanantai;72;166;238;8;32;40
89;23.09.2013;2013;09;10;Maanantai;61;103;164;18;21;39
89;23.09.2013;2013;09;11;Maanantai;97;127;224;22;17;39
89;23.09.2013;2013;09;12;Maanantai;87;125;212;28;31;59
89;23.09.2013;2013;09;13;Maanantai;104;96;200;23;34;57
89;23.09.2013;2013;09;14;Maanantai;177;111;288;20;24;44
89;23.09.2013;2013;09;15;Maanantai;237;106;343;31;14;45
89;23.09.2013;2013;09;16;Maanantai;342;164;506;26;18;44
89;23.09.2013;2013;09;17;Maanantai;202;108;310;22;28;50
89;23.09.2013;2013;09;18;Maanantai;128;90;218;30;30;60
89;23.09.2013;2013;09;19;Maanantai;95;74;169;44;38;82
89;23.09.2013;2013;09;20;Maanantai;92;48;140;25;24;49
89;23.09.2013;2013;09;21;Maanantai;55;27;82;12;11;23
89;23.09.2013;2013;09;22;Maanantai;27;18;45;9;5;14
89;23.09.2013;2013;09;23;Maanantai;5;12;17;1;1;2
89;24.09.2013;2013;09;00;Tiistai;1;6;7;0;0;0
89;24.09.2013;2013;09;01;Tiistai;0;3;3;0;0;0
89;24.09.2013;2013;09;02;Tiistai;3;2;5;0;1;1
89;24.09.2013;2013;09;03;Tiistai;0;1;1;1;0;1
89;24.09.2013;2013;09;04;Tiistai;0;6;6;0;0;0
89;24.09.2013;2013;09;05;Tiistai;4;15;19;1;0;1
89;24.09.2013;2013;09;06;Tiistai;17;59;76;2;2;4
89;24.09.2013;2013;09;07;Tiistai;57;238;295;5;30;35
89;24.09.2013;2013;09;08;Tiistai;102;299;401;13;39;52
89;24.09.2013;2013;09;09;Tiistai;80;172;252;23;25;48
89;24.09.2013;2013;09;10;Tiistai;45;107;152;14;46;60
89;24.09.2013;2013;09;11;Tiistai;72;113;185;25;13;38
89;24.09.2013;2013;09;12;Tiistai;80;125;205;20;45;65
89;24.09.2013;2013;09;13;Tiistai;136;99;235;23;16;39
89;24.09.2013;2013;09;14;Tiistai;170;103;273;32;15;47
89;24.09.2013;2013;09;15;Tiistai;228;102;330;21;24;45
89;24.09.2013;2013;09;16;Tiistai;276;146;422;27;18;45
89;24.09.2013;2013;09;17;Tiistai;169;106;275;32;23;55
89;24.09.2013;2013;09;18;Tiistai;132;97;229;35;34;69
89;24.09.2013;2013;09;19;Tiistai;105;70;175;38;50;88
89;24.09.2013;2013;09;20;Tiistai;79;37;116;36;24;60
89;24.09.2013;2013;09;21;Tiistai;46;32;78;17;10;27
89;24.09.2013;2013;09;22;Tiistai;25;11;36;4;4;8
89;24.09.2013;2013;09;23;Tiistai;15;10;25;0;0;0
89;25.09.2013;2013;09;00;Keskiviikko;5;8;13;0;2;2
89;25.09.2013;2013;09;01;Keskiviikko;3;2;5;0;0;0
89;25.09.2013;2013;09;02;Keskiviikko;1;0;1;1;0;1
89;25.09.2013;2013;09;03;Keskiviikko;3;2;5;1;0;1
89;25.09.2013;2013;09;04;Keskiviikko;2;3;5;0;0;0
89;25.09.2013;2013;09;05;Keskiviikko;0;13;13;2;1;3
89;25.09.2013;2013;09;06;Keskiviikko;21;60;81;4;3;7
89;25.09.2013;2013;09;07;Keskiviikko;62;222;284;7;28;35
89;25.09.2013;2013;09;08;Keskiviikko;99;288;387;10;46;56
89;25.09.2013;2013;09;09;Keskiviikko;77;162;239;14;24;38
89;25.09.2013;2013;09;10;Keskiviikko;71;99;170;12;22;34
89;25.09.2013;2013;09;11;Keskiviikko;84;89;173;13;26;39
89;25.09.2013;2013;09;12;Keskiviikko;80;104;184;23;29;52
89;25.09.2013;2013;09;13;Keskiviikko;108;99;207;23;18;41
89;25.09.2013;2013;09;14;Keskiviikko;163;83;246;23;33;56
89;25.09.2013;2013;09;15;Keskiviikko;187;129;316;23;16;39
89;25.09.2013;2013;09;16;Keskiviikko;288;123;411;33;23;56
89;25.09.2013;2013;09;17;Keskiviikko;176;125;301;17;26;43
89;25.09.2013;2013;09;18;Keskiviikko;109;101;210;25;31;56
89;25.09.2013;2013;09;19;Keskiviikko;94;54;148;26;24;50
89;25.09.2013;2013;09;20;Keskiviikko;76;60;136;16;21;37
89;25.09.2013;2013;09;21;Keskiviikko;82;27;109;9;7;16
89;25.09.2013;2013;09;22;Keskiviikko;26;19;45;6;4;10
89;25.09.2013;2013;09;23;Keskiviikko;10;16;26;3;3;6
89;26.09.2013;2013;09;00;Torstai;7;13;20;1;0;1
89;26.09.2013;2013;09;01;Torstai;8;6;14;6;0;6
89;26.09.2013;2013;09;02;Torstai;7;6;13;3;0;3
89;26.09.2013;2013;09;03;Torstai;7;3;10;4;1;5
89;26.09.2013;2013;09;04;Torstai;21;3;24;3;1;4
89;26.09.2013;2013;09;05;Torstai;1;10;11;0;0;0
89;26.09.2013;2013;09;06;Torstai;17;43;60;0;6;6
89;26.09.2013;2013;09;07;Torstai;43;174;217;3;18;21
89;26.09.2013;2013;09;08;Torstai;82;226;308;6;30;36
89;26.09.2013;2013;09;09;Torstai;53;129;182;14;24;38
89;26.09.2013;2013;09;10;Torstai;61;95;156;15;27;42
89;26.09.2013;2013;09;11;Torstai;57;82;139;19;15;34
89;26.09.2013;2013;09;12;Torstai;78;112;190;18;28;46
89;26.09.2013;2013;09;13;Torstai;81;98;179;19;21;40
89;26.09.2013;2013;09;14;Torstai;131;98;229;22;15;37
89;26.09.2013;2013;09;15;Torstai;195;130;325;25;23;48
89;26.09.2013;2013;09;16;Torstai;243;103;346;26;19;45
89;26.09.2013;2013;09;17;Torstai;152;92;244;22;25;47
89;26.09.2013;2013;09;18;Torstai;99;101;200;28;19;47
89;26.09.2013;2013;09;19;Torstai;98;80;178;18;35;53
89;26.09.2013;2013;09;20;Torstai;62;48;110;26;21;47
89;26.09.2013;2013;09;21;Torstai;49;23;72;10;8;18
89;26.09.2013;2013;09;22;Torstai;18;11;29;7;5;12
89;26.09.2013;2013;09;23;Torstai;17;11;28;3;2;5
89;27.09.2013;2013;09;00;Perjantai;5;6;11;0;3;3
89;27.09.2013;2013;09;01;Perjantai;8;0;8;0;2;2
89;27.09.2013;2013;09;02;Perjantai;8;0;8;1;1;2
89;27.09.2013;2013;09;03;Perjantai;7;4;11;2;0;2
89;27.09.2013;2013;09;04;Perjantai;9;0;9;0;2;2
89;27.09.2013;2013;09;05;Perjantai;3;8;11;1;2;3
89;27.09.2013;2013;09;06;Perjantai;18;45;63;0;4;4
89;27.09.2013;2013;09;07;Perjantai;30;135;165;3;15;18
89;27.09.2013;2013;09;08;Perjantai;63;198;261;6;41;47
89;27.09.2013;2013;09;09;Perjantai;28;97;125;15;20;35
89;27.09.2013;2013;09;10;Perjantai;31;75;106;8;16;24
89;27.09.2013;2013;09;11;Perjantai;55;96;151;23;28;51
89;27.09.2013;2013;09;12;Perjantai;102;87;189;22;27;49
89;27.09.2013;2013;09;13;Perjantai;113;114;227;24;24;48
89;27.09.2013;2013;09;14;Perjantai;169;109;278;30;21;51
89;27.09.2013;2013;09;15;Perjantai;162;106;268;30;25;55
89;27.09.2013;2013;09;16;Perjantai;177;109;286;25;35;60
89;27.09.2013;2013;09;17;Perjantai;96;104;200;16;22;38
89;27.09.2013;2013;09;18;Perjantai;90;59;149;32;23;55
89;27.09.2013;2013;09;19;Perjantai;83;49;132;15;23;38
89;27.09.2013;2013;09;20;Perjantai;64;44;108;10;9;19
89;27.09.2013;2013;09;21;Perjantai;49;46;95;11;7;18
89;27.09.2013;2013;09;22;Perjantai;25;26;51;4;9;13
89;27.09.2013;2013;09;23;Perjantai;17;22;39;6;12;18
89;28.09.2013;2013;09;00;Lauantai;17;36;53;5;5;10
89;28.09.2013;2013;09;01;Lauantai;17;12;29;2;7;9
89;28.09.2013;2013;09;02;Lauantai;14;4;18;0;0;0
89;28.09.2013;2013;09;03;Lauantai;27;1;28;4;3;7
89;28.09.2013;2013;09;04;Lauantai;13;2;15;6;0;6
89;28.09.2013;2013;09;05;Lauantai;10;6;16;1;2;3
89;28.09.2013;2013;09;06;Lauantai;6;13;19;1;1;2
89;28.09.2013;2013;09;07;Lauantai;4;15;19;2;4;6
89;28.09.2013;2013;09;08;Lauantai;9;30;39;7;7;14
89;28.09.2013;2013;09;09;Lauantai;24;60;84;15;26;41
89;28.09.2013;2013;09;10;Lauantai;28;88;116;14;23;37
89;28.09.2013;2013;09;11;Lauantai;62;83;145;13;28;41
89;28.09.2013;2013;09;12;Lauantai;83;107;190;21;42;63
89;28.09.2013;2013;09;13;Lauantai;74;103;177;27;33;60
89;28.09.2013;2013;09;14;Lauantai;90;83;173;26;24;50
89;28.09.2013;2013;09;15;Lauantai;98;76;174;18;27;45
89;28.09.2013;2013;09;16;Lauantai;94;50;144;17;30;47
89;28.09.2013;2013;09;17;Lauantai;74;85;159;25;30;55
89;28.09.2013;2013;09;18;Lauantai;72;49;121;18;33;51
89;28.09.2013;2013;09;19;Lauantai;59;53;112;22;18;40
89;28.09.2013;2013;09;20;Lauantai;51;35;86;17;17;34
89;28.09.2013;2013;09;21;Lauantai;30;28;58;5;7;12
89;28.09.2013;2013;09;22;Lauantai;21;36;57;6;10;16
89;28.09.2013;2013;09;23;Lauantai;13;38;51;6;5;11
89;29.09.2013;2013;09;00;Sunnuntai;26;17;43;1;9;10
89;29.09.2013;2013;09;01;Sunnuntai;21;12;33;4;0;4
89;29.09.2013;2013;09;02;Sunnuntai;22;7;29;9;2;11
89;29.09.2013;2013;09;03;Sunnuntai;18;3;21;6;1;7
89;29.09.2013;2013;09;04;Sunnuntai;15;0;15;4;0;4
89;29.09.2013;2013;09;05;Sunnuntai;2;1;3;0;2;2
89;29.09.2013;2013;09;06;Sunnuntai;3;7;10;1;1;2
89;29.09.2013;2013;09;07;Sunnuntai;6;12;18;1;3;4
89;29.09.2013;2013;09;08;Sunnuntai;2;9;11;7;8;15
89;29.09.2013;2013;09;09;Sunnuntai;14;18;32;17;18;35
89;29.09.2013;2013;09;10;Sunnuntai;25;52;77;24;54;78
89;29.09.2013;2013;09;11;Sunnuntai;41;64;105;35;55;90
89;29.09.2013;2013;09;12;Sunnuntai;74;100;174;61;55;116
89;29.09.2013;2013;09;13;Sunnuntai;95;96;191;32;56;88
89;29.09.2013;2013;09;14;Sunnuntai;79;79;158;28;47;75
89;29.09.2013;2013;09;15;Sunnuntai;94;82;176;37;49;86
89;29.09.2013;2013;09;16;Sunnuntai;121;79;200;32;37;69
89;29.09.2013;2013;09;17;Sunnuntai;71;53;124;37;44;81
89;29.09.2013;2013;09;18;Sunnuntai;83;57;140;32;35;67
89;29.09.2013;2013;09;19;Sunnuntai;52;42;94;26;31;57
89;29.09.2013;2013;09;20;Sunnuntai;44;30;74;17;9;26
89;29.09.2013;2013;09;21;Sunnuntai;28;21;49;11;4;15
89;29.09.2013;2013;09;22;Sunnuntai;9;15;24;4;6;10
89;29.09.2013;2013;09;23;Sunnuntai;11;11;22;1;3;4
89;30.09.2013;2013;09;00;Maanantai;7;2;9;3;0;3
89;30.09.2013;2013;09;01;Maanantai;5;2;7;2;0;2
89;30.09.2013;2013;09;02;Maanantai;2;0;2;0;0;0
89;30.09.2013;2013;09;03;Maanantai;1;1;2;1;0;1
89;30.09.2013;2013;09;04;Maanantai;4;2;6;2;1;3
89;30.09.2013;2013;09;05;Maanantai;2;15;17;0;1;1
89;30.09.2013;2013;09;06;Maanantai;21;44;65;1;6;7
89;30.09.2013;2013;09;07;Maanantai;40;168;208;2;13;15
89;30.09.2013;2013;09;08;Maanantai;85;289;374;8;35;43
89;30.09.2013;2013;09;09;Maanantai;63;177;240;6;25;31
89;30.09.2013;2013;09;10;Maanantai;74;137;211;17;35;52
89;30.09.2013;2013;09;11;Maanantai;81;94;175;15;19;34
89;30.09.2013;2013;09;12;Maanantai;113;118;231;30;24;54
89;30.09.2013;2013;09;13;Maanantai;120;135;255;24;24;48
89;30.09.2013;2013;09;14;Maanantai;177;123;300;18;32;50
89;30.09.2013;2013;09;15;Maanantai;223;132;355;37;25;62
89;30.09.2013;2013;09;16;Maanantai;302;126;428;37;15;52
89;30.09.2013;2013;09;17;Maanantai;173;100;273;27;35;62
89;30.09.2013;2013;09;18;Maanantai;123;90;213;30;30;60
89;30.09.2013;2013;09;19;Maanantai;82;67;149;26;24;50
89;30.09.2013;2013;09;20;Maanantai;71;72;143;19;15;34
89;30.09.2013;2013;09;21;Maanantai;48;31;79;13;5;18
89;30.09.2013;2013;09;22;Maanantai;23;8;31;2;8;10
89;30.09.2013;2013;09;23;Maanantai;16;10;26;1;1;2
89;01.10.2013;2013;10;00;Tiistai;2;8;10;3;0;3
89;01.10.2013;2013;10;01;Tiistai;7;8;15;2;1;3
89;01.10.2013;2013;10;02;Tiistai;15;2;17;1;0;1
89;01.10.2013;2013;10;03;Tiistai;2;3;5;1;0;1
89;01.10.2013;2013;10;04;Tiistai;2;1;3;1;0;1
89;01.10.2013;2013;10;05;Tiistai;2;17;19;1;1;2
89;01.10.2013;2013;10;06;Tiistai;24;47;71;3;4;7
89;01.10.2013;2013;10;07;Tiistai;50;207;257;2;26;28
89;01.10.2013;2013;10;08;Tiistai;89;269;358;9;31;40
89;01.10.2013;2013;10;09;Tiistai;53;154;207;13;34;47
89;01.10.2013;2013;10;10;Tiistai;52;113;165;13;22;35
89;01.10.2013;2013;10;11;Tiistai;63;93;156;32;23;55
89;01.10.2013;2013;10;12;Tiistai;86;123;209;14;28;42
89;01.10.2013;2013;10;13;Tiistai;123;102;225;14;14;28
89;01.10.2013;2013;10;14;Tiistai;155;110;265;20;25;45
89;01.10.2013;2013;10;15;Tiistai;248;123;371;51;25;76
89;01.10.2013;2013;10;16;Tiistai;297;154;451;40;33;73
89;01.10.2013;2013;10;17;Tiistai;169;129;298;32;27;59
89;01.10.2013;2013;10;18;Tiistai;129;101;230;39;38;77
89;01.10.2013;2013;10;19;Tiistai;95;73;168;29;33;62
89;01.10.2013;2013;10;20;Tiistai;94;34;128;18;19;37
89;01.10.2013;2013;10;21;Tiistai;68;33;101;13;10;23
89;01.10.2013;2013;10;22;Tiistai;26;16;42;5;5;10
89;01.10.2013;2013;10;23;Tiistai;10;7;17;2;0;2
89;02.10.2013;2013;10;00;Keskiviikko;4;2;6;1;1;2
89;02.10.2013;2013;10;01;Keskiviikko;0;0;0;1;1;2
89;02.10.2013;2013;10;02;Keskiviikko;1;1;2;1;0;1
89;02.10.2013;2013;10;03;Keskiviikko;3;0;3;1;0;1
89;02.10.2013;2013;10;04;Keskiviikko;0;3;3;0;0;0
89;02.10.2013;2013;10;05;Keskiviikko;2;10;12;0;2;2
89;02.10.2013;2013;10;06;Keskiviikko;21;63;84;1;5;6
89;02.10.2013;2013;10;07;Keskiviikko;41;186;227;1;17;18
89;02.10.2013;2013;10;08;Keskiviikko;73;263;336;11;44;55
89;02.10.2013;2013;10;09;Keskiviikko;50;164;214;10;27;37
89;02.10.2013;2013;10;10;Keskiviikko;50;103;153;17;33;50
89;02.10.2013;2013;10;11;Keskiviikko;64;98;162;17;32;49
89;02.10.2013;2013;10;12;Keskiviikko;90;103;193;21;29;50
89;02.10.2013;2013;10;13;Keskiviikko;120;87;207;14;23;37
89;02.10.2013;2013;10;14;Keskiviikko;161;119;280;20;12;32
89;02.10.2013;2013;10;15;Keskiviikko;168;100;268;33;21;54
89;02.10.2013;2013;10;16;Keskiviikko;282;138;420;34;19;53
89;02.10.2013;2013;10;17;Keskiviikko;181;109;290;29;22;51
89;02.10.2013;2013;10;18;Keskiviikko;140;109;249;38;41;79
89;02.10.2013;2013;10;19;Keskiviikko;114;84;198;31;30;61
89;02.10.2013;2013;10;20;Keskiviikko;81;58;139;30;29;59
89;02.10.2013;2013;10;21;Keskiviikko;48;37;85;13;11;24
89;02.10.2013;2013;10;22;Keskiviikko;23;15;38;5;5;10
89;02.10.2013;2013;10;23;Keskiviikko;19;12;31;0;2;2
89;03.10.2013;2013;10;00;Torstai;7;7;14;4;0;4
89;03.10.2013;2013;10;01;Torstai;9;3;12;2;0;2
89;03.10.2013;2013;10;02;Torstai;4;1;5;0;0;0
89;03.10.2013;2013;10;03;Torstai;7;5;12;0;0;0
89;03.10.2013;2013;10;04;Torstai;8;2;10;0;0;0
89;03.10.2013;2013;10;05;Torstai;5;12;17;1;2;3
89;03.10.2013;2013;10;06;Torstai;16;52;68;1;5;6
89;03.10.2013;2013;10;07;Torstai;42;192;234;4;23;27
89;03.10.2013;2013;10;08;Torstai;97;318;415;9;29;38
89;03.10.2013;2013;10;09;Torstai;52;134;186;10;14;24
89;03.10.2013;2013;10;10;Torstai;52;102;154;6;28;34
89;03.10.2013;2013;10;11;Torstai;88;111;199;27;31;58
89;03.10.2013;2013;10;12;Torstai;91;121;212;28;40;68
89;03.10.2013;2013;10;13;Torstai;89;101;190;37;39;76
89;03.10.2013;2013;10;14;Torstai;181;84;265;32;18;50
89;03.10.2013;2013;10;15;Torstai;203;111;314;33;19;52
89;03.10.2013;2013;10;16;Torstai;317;144;461;33;30;63
89;03.10.2013;2013;10;17;Torstai;171;132;303;35;30;65
89;03.10.2013;2013;10;18;Torstai;125;110;235;31;42;73
89;03.10.2013;2013;10;19;Torstai;113;69;182;35;23;58
89;03.10.2013;2013;10;20;Torstai;81;53;134;22;20;42
89;03.10.2013;2013;10;21;Torstai;96;42;138;14;10;24
89;03.10.2013;2013;10;22;Torstai;17;19;36;4;7;11
89;03.10.2013;2013;10;23;Torstai;19;23;42;4;3;7
89;04.10.2013;2013;10;00;Perjantai;9;15;24;0;1;1
89;04.10.2013;2013;10;01;Perjantai;14;10;24;3;4;7
89;04.10.2013;2013;10;02;Perjantai;16;1;17;3;1;4
89;04.10.2013;2013;10;03;Perjantai;18;3;21;5;0;5
89;04.10.2013;2013;10;04;Perjantai;8;7;15;5;0;5
89;04.10.2013;2013;10;05;Perjantai;7;9;16;1;2;3
89;04.10.2013;2013;10;06;Perjantai;21;46;67;3;6;9
89;04.10.2013;2013;10;07;Perjantai;48;170;218;9;20;29
89;04.10.2013;2013;10;08;Perjantai;73;254;327;10;38;48
89;04.10.2013;2013;10;09;Perjantai;49;205;254;10;19;29
89;04.10.2013;2013;10;10;Perjantai;64;89;153;12;26;38
89;04.10.2013;2013;10;11;Perjantai;77;123;200;16;32;48
89;04.10.2013;2013;10;12;Perjantai;104;106;210;21;19;40
89;04.10.2013;2013;10;13;Perjantai;127;117;244;23;24;47
89;04.10.2013;2013;10;14;Perjantai;186;107;293;31;25;56
89;04.10.2013;2013;10;15;Perjantai;198;91;289;28;21;49
89;04.10.2013;2013;10;16;Perjantai;195;126;321;34;19;53
89;04.10.2013;2013;10;17;Perjantai;143;85;228;12;17;29
89;04.10.2013;2013;10;18;Perjantai;99;81;180;22;41;63
89;04.10.2013;2013;10;19;Perjantai;101;64;165;13;34;47
89;04.10.2013;2013;10;20;Perjantai;69;53;122;21;16;37
89;04.10.2013;2013;10;21;Perjantai;66;35;101;9;19;28
89;04.10.2013;2013;10;22;Perjantai;36;38;74;10;12;22
89;04.10.2013;2013;10;23;Perjantai;19;22;41;3;9;12
89;05.10.2013;2013;10;00;Lauantai;25;20;45;3;5;8
89;05.10.2013;2013;10;01;Lauantai;25;10;35;3;2;5
89;05.10.2013;2013;10;02;Lauantai;23;13;36;5;2;7
89;05.10.2013;2013;10;03;Lauantai;18;4;22;12;1;13
89;05.10.2013;2013;10;04;Lauantai;19;2;21;1;1;2
89;05.10.2013;2013;10;05;Lauantai;8;4;12;0;0;0
89;05.10.2013;2013;10;06;Lauantai;6;7;13;1;0;1
89;05.10.2013;2013;10;07;Lauantai;13;11;24;2;8;10
89;05.10.2013;2013;10;08;Lauantai;11;33;44;9;8;17
89;05.10.2013;2013;10;09;Lauantai;10;70;80;6;26;32
89;05.10.2013;2013;10;10;Lauantai;27;59;86;15;24;39
89;05.10.2013;2013;10;11;Lauantai;56;79;135;19;34;53
89;05.10.2013;2013;10;12;Lauantai;63;108;171;24;39;63
89;05.10.2013;2013;10;13;Lauantai;85;105;190;22;31;53
89;05.10.2013;2013;10;14;Lauantai;70;74;144;26;27;53
89;05.10.2013;2013;10;15;Lauantai;90;41;131;32;32;64
89;05.10.2013;2013;10;16;Lauantai;75;58;133;17;23;40
89;05.10.2013;2013;10;17;Lauantai;85;49;134;27;24;51
89;05.10.2013;2013;10;18;Lauantai;61;43;104;28;24;52
89;05.10.2013;2013;10;19;Lauantai;37;38;75;13;10;23
89;05.10.2013;2013;10;20;Lauantai;30;39;69;11;10;21
89;05.10.2013;2013;10;21;Lauantai;21;40;61;4;5;9
89;05.10.2013;2013;10;22;Lauantai;18;14;32;1;7;8
89;05.10.2013;2013;10;23;Lauantai;10;27;37;6;9;15
89;06.10.2013;2013;10;00;Sunnuntai;18;26;44;4;4;8
89;06.10.2013;2013;10;01;Sunnuntai;20;10;30;2;0;2
89;06.10.2013;2013;10;02;Sunnuntai;25;16;41;3;2;5
89;06.10.2013;2013;10;03;Sunnuntai;22;4;26;6;0;6
89;06.10.2013;2013;10;04;Sunnuntai;22;4;26;9;0;9
89;06.10.2013;2013;10;05;Sunnuntai;7;1;8;2;3;5
89;06.10.2013;2013;10;06;Sunnuntai;10;8;18;0;1;1
89;06.10.2013;2013;10;07;Sunnuntai;3;9;12;1;2;3
89;06.10.2013;2013;10;08;Sunnuntai;8;15;23;5;9;14
89;06.10.2013;2013;10;09;Sunnuntai;19;29;48;17;18;35
89;06.10.2013;2013;10;10;Sunnuntai;29;48;77;33;35;68
89;06.10.2013;2013;10;11;Sunnuntai;41;97;138;42;64;106
89;06.10.2013;2013;10;12;Sunnuntai;68;115;183;35;57;92
89;06.10.2013;2013;10;13;Sunnuntai;111;114;225;33;55;88
89;06.10.2013;2013;10;14;Sunnuntai;103;101;204;43;36;79
89;06.10.2013;2013;10;15;Sunnuntai;92;68;160;37;41;78
89;06.10.2013;2013;10;16;Sunnuntai;87;61;148;36;22;58
89;06.10.2013;2013;10;17;Sunnuntai;69;56;125;24;23;47
89;06.10.2013;2013;10;18;Sunnuntai;68;55;123;21;25;46
89;06.10.2013;2013;10;19;Sunnuntai;46;38;84;17;33;50
89;06.10.2013;2013;10;20;Sunnuntai;40;17;57;19;13;32
89;06.10.2013;2013;10;21;Sunnuntai;32;16;48;6;13;19
89;06.10.2013;2013;10;22;Sunnuntai;13;12;25;4;6;10
89;06.10.2013;2013;10;23;Sunnuntai;7;4;11;7;1;8
89;07.10.2013;2013;10;00;Maanantai;6;3;9;1;1;2
89;07.10.2013;2013;10;01;Maanantai;5;3;8;0;0;0
89;07.10.2013;2013;10;02;Maanantai;8;5;13;0;0;0
89;07.10.2013;2013;10;03;Maanantai;3;3;6;0;0;0
89;07.10.2013;2013;10;04;Maanantai;3;7;10;0;0;0
89;07.10.2013;2013;10;05;Maanantai;4;14;18;1;1;2
89;07.10.2013;2013;10;06;Maanantai;21;48;69;1;5;6
89;07.10.2013;2013;10;07;Maanantai;32;197;229;10;26;36
89;07.10.2013;2013;10;08;Maanantai;80;291;371;2;47;49
89;07.10.2013;2013;10;09;Maanantai;56;172;228;14;43;57
89;07.10.2013;2013;10;10;Maanantai;77;104;181;22;41;63
89;07.10.2013;2013;10;11;Maanantai;81;109;190;28;36;64
89;07.10.2013;2013;10;12;Maanantai;93;108;201;21;36;57
89;07.10.2013;2013;10;13;Maanantai;99;118;217;25;33;58
89;07.10.2013;2013;10;14;Maanantai;192;113;305;33;29;62
89;07.10.2013;2013;10;15;Maanantai;223;135;358;22;15;37
89;07.10.2013;2013;10;16;Maanantai;352;153;505;37;33;70
89;07.10.2013;2013;10;17;Maanantai;201;128;329;23;25;48
89;07.10.2013;2013;10;18;Maanantai;157;99;256;48;40;88
89;07.10.2013;2013;10;19;Maanantai;105;59;164;32;36;68
89;07.10.2013;2013;10;20;Maanantai;70;49;119;20;18;38
89;07.10.2013;2013;10;21;Maanantai;56;21;77;9;13;22
89;07.10.2013;2013;10;22;Maanantai;34;3;37;6;6;12
89;07.10.2013;2013;10;23;Maanantai;9;7;16;1;0;1
89;08.10.2013;2013;10;00;Tiistai;1;3;4;1;2;3
89;08.10.2013;2013;10;01;Tiistai;2;4;6;1;0;1
89;08.10.2013;2013;10;02;Tiistai;1;1;2;0;1;1
89;08.10.2013;2013;10;03;Tiistai;0;2;2;0;1;1
89;08.10.2013;2013;10;04;Tiistai;3;5;8;0;0;0
89;08.10.2013;2013;10;05;Tiistai;5;12;17;0;2;2
89;08.10.2013;2013;10;06;Tiistai;20;65;85;1;7;8
89;08.10.2013;2013;10;07;Tiistai;51;193;244;10;28;38
89;08.10.2013;2013;10;08;Tiistai;83;314;397;11;28;39
89;08.10.2013;2013;10;09;Tiistai;60;157;217;14;38;52
89;08.10.2013;2013;10;10;Tiistai;56;101;157;24;43;67
89;08.10.2013;2013;10;11;Tiistai;65;103;168;44;25;69
89;08.10.2013;2013;10;12;Tiistai;75;112;187;17;19;36
89;08.10.2013;2013;10;13;Tiistai;117;117;234;16;16;32
89;08.10.2013;2013;10;14;Tiistai;143;111;254;20;29;49
89;08.10.2013;2013;10;15;Tiistai;221;113;334;25;24;49
89;08.10.2013;2013;10;16;Tiistai;291;152;443;34;25;59
89;08.10.2013;2013;10;17;Tiistai;204;106;310;25;34;59
89;08.10.2013;2013;10;18;Tiistai;124;94;218;51;45;96
89;08.10.2013;2013;10;19;Tiistai;110;59;169;35;45;80
89;08.10.2013;2013;10;20;Tiistai;93;55;148;29;33;62
89;08.10.2013;2013;10;21;Tiistai;51;39;90;13;16;29
89;08.10.2013;2013;10;22;Tiistai;27;16;43;7;3;10
89;08.10.2013;2013;10;23;Tiistai;7;12;19;2;0;2
89;09.10.2013;2013;10;00;Keskiviikko;3;2;5;0;0;0
89;09.10.2013;2013;10;01;Keskiviikko;4;1;5;0;2;2
89;09.10.2013;2013;10;02;Keskiviikko;4;0;4;2;0;2
89;09.10.2013;2013;10;03;Keskiviikko;5;3;8;0;0;0
89;09.10.2013;2013;10;04;Keskiviikko;2;3;5;0;0;0
89;09.10.2013;2013;10;05;Keskiviikko;3;15;18;1;0;1
89;09.10.2013;2013;10;06;Keskiviikko;21;47;68;2;8;10
89;09.10.2013;2013;10;07;Keskiviikko;41;167;208;4;14;18
89;09.10.2013;2013;10;08;Keskiviikko;71;270;341;9;37;46
89;09.10.2013;2013;10;09;Keskiviikko;49;135;184;8;21;29
89;09.10.2013;2013;10;10;Keskiviikko;55;88;143;16;49;65
89;09.10.2013;2013;10;11;Keskiviikko;66;98;164;30;27;57
89;09.10.2013;2013;10;12;Keskiviikko;72;93;165;17;19;36
89;09.10.2013;2013;10;13;Keskiviikko;104;103;207;25;28;53
89;09.10.2013;2013;10;14;Keskiviikko;142;106;248;14;12;26
89;09.10.2013;2013;10;15;Keskiviikko;152;67;219;18;12;30
89;09.10.2013;2013;10;16;Keskiviikko;278;93;371;26;16;42
89;09.10.2013;2013;10;17;Keskiviikko;133;70;203;18;29;47
89;09.10.2013;2013;10;18;Keskiviikko;111;55;166;24;22;46
89;09.10.2013;2013;10;19;Keskiviikko;84;47;131;22;29;51
89;09.10.2013;2013;10;20;Keskiviikko;57;47;104;20;17;37
89;09.10.2013;2013;10;21;Keskiviikko;40;18;58;14;12;26
89;09.10.2013;2013;10;22;Keskiviikko;23;6;29;6;6;12
89;09.10.2013;2013;10;23;Keskiviikko;5;8;13;1;2;3
89;10.10.2013;2013;10;00;Torstai;7;3;10;1;1;2
89;10.10.2013;2013;10;01;Torstai;2;4;6;0;1;1
89;10.10.2013;2013;10;02;Torstai;2;0;2;1;0;1
89;10.10.2013;2013;10;03;Torstai;2;1;3;1;1;2
89;10.10.2013;2013;10;04;Torstai;5;5;10;1;1;2
89;10.10.2013;2013;10;05;Torstai;7;14;21;0;2;2
89;10.10.2013;2013;10;06;Torstai;18;56;74;4;5;9
89;10.10.2013;2013;10;07;Torstai;44;168;212;3;22;25
89;10.10.2013;2013;10;08;Torstai;80;290;370;10;31;41
89;10.10.2013;2013;10;09;Torstai;54;161;215;11;41;52
89;10.10.2013;2013;10;10;Torstai;59;120;179;8;24;32
89;10.10.2013;2013;10;11;Torstai;93;120;213;18;30;48
89;10.10.2013;2013;10;12;Torstai;118;102;220;23;21;44
89;10.10.2013;2013;10;13;Torstai;97;142;239;24;37;61
89;10.10.2013;2013;10;14;Torstai;167;156;323;27;26;53
89;10.10.2013;2013;10;15;Torstai;220;122;342;19;11;30
89;10.10.2013;2013;10;16;Torstai;291;144;435;36;24;60
89;10.10.2013;2013;10;17;Torstai;196;112;308;30;38;68
89;10.10.2013;2013;10;18;Torstai;115;107;222;32;31;63
89;10.10.2013;2013;10;19;Torstai;86;78;164;34;27;61
89;10.10.2013;2013;10;20;Torstai;72;53;125;26;25;51
89;10.10.2013;2013;10;21;Torstai;68;39;107;24;20;44
89;10.10.2013;2013;10;22;Torstai;25;20;45;11;6;17
89;10.10.2013;2013;10;23;Torstai;18;29;47;6;5;11
89;11.10.2013;2013;10;00;Perjantai;10;4;14;2;2;4
89;11.10.2013;2013;10;01;Perjantai;12;3;15;1;1;2
89;11.10.2013;2013;10;02;Perjantai;8;3;11;1;0;1
89;11.10.2013;2013;10;03;Perjantai;7;3;10;2;0;2
89;11.10.2013;2013;10;04;Perjantai;9;5;14;1;0;1
89;11.10.2013;2013;10;05;Perjantai;3;21;24;0;1;1
89;11.10.2013;2013;10;06;Perjantai;15;52;67;5;9;14
89;11.10.2013;2013;10;07;Perjantai;49;162;211;5;15;20
89;11.10.2013;2013;10;08;Perjantai;57;256;313;9;34;43
89;11.10.2013;2013;10;09;Perjantai;40;151;191;8;26;34
89;11.10.2013;2013;10;10;Perjantai;63;120;183;18;25;43
89;11.10.2013;2013;10;11;Perjantai;85;111;196;17;26;43
89;11.10.2013;2013;10;12;Perjantai;108;115;223;10;22;32
89;11.10.2013;2013;10;13;Perjantai;129;115;244;31;25;56
89;11.10.2013;2013;10;14;Perjantai;207;115;322;23;29;52
89;11.10.2013;2013;10;15;Perjantai;210;128;338;26;23;49
89;11.10.2013;2013;10;16;Perjantai;201;118;319;14;31;45
89;11.10.2013;2013;10;17;Perjantai;124;118;242;26;41;67
89;11.10.2013;2013;10;18;Perjantai;109;101;210;34;38;72
89;11.10.2013;2013;10;19;Perjantai;91;45;136;21;12;33
89;11.10.2013;2013;10;20;Perjantai;59;42;101;10;19;29
89;11.10.2013;2013;10;21;Perjantai;37;38;75;8;8;16
89;11.10.2013;2013;10;22;Perjantai;33;28;61;7;11;18
89;11.10.2013;2013;10;23;Perjantai;22;27;49;1;5;6
89;12.10.2013;2013;10;00;Lauantai;10;20;30;3;4;7
89;12.10.2013;2013;10;01;Lauantai;20;18;38;6;3;9
89;12.10.2013;2013;10;02;Lauantai;26;7;33;11;0;11
89;12.10.2013;2013;10;03;Lauantai;17;8;25;7;1;8
89;12.10.2013;2013;10;04;Lauantai;26;5;31;6;1;7
89;12.10.2013;2013;10;05;Lauantai;9;4;13;1;1;2
89;12.10.2013;2013;10;06;Lauantai;7;9;16;1;0;1
89;12.10.2013;2013;10;07;Lauantai;5;18;23;1;6;7
89;12.10.2013;2013;10;08;Lauantai;15;30;45;9;9;18
89;12.10.2013;2013;10;09;Lauantai;14;95;109;9;24;33
89;12.10.2013;2013;10;10;Lauantai;52;81;133;18;22;40
89;12.10.2013;2013;10;11;Lauantai;49;105;154;18;47;65
89;12.10.2013;2013;10;12;Lauantai;71;112;183;21;42;63
89;12.10.2013;2013;10;13;Lauantai;97;112;209;22;27;49
89;12.10.2013;2013;10;14;Lauantai;74;118;192;26;39;65
89;12.10.2013;2013;10;15;Lauantai;133;85;218;35;29;64
89;12.10.2013;2013;10;16;Lauantai;92;83;175;29;51;80
89;12.10.2013;2013;10;17;Lauantai;94;75;169;23;35;58
89;12.10.2013;2013;10;18;Lauantai;85;65;150;33;29;62
89;12.10.2013;2013;10;19;Lauantai;51;34;85;22;18;40
89;12.10.2013;2013;10;20;Lauantai;39;37;76;18;19;37
89;12.10.2013;2013;10;21;Lauantai;44;33;77;6;9;15
89;12.10.2013;2013;10;22;Lauantai;35;29;64;5;9;14
89;12.10.2013;2013;10;23;Lauantai;21;53;74;4;5;9
89;13.10.2013;2013;10;00;Sunnuntai;23;38;61;4;15;19
89;13.10.2013;2013;10;01;Sunnuntai;32;10;42;3;3;6
89;13.10.2013;2013;10;02;Sunnuntai;21;7;28;8;0;8
89;13.10.2013;2013;10;03;Sunnuntai;23;6;29;13;1;14
89;13.10.2013;2013;10;04;Sunnuntai;26;1;27;9;0;9
89;13.10.2013;2013;10;05;Sunnuntai;14;2;16;2;2;4
89;13.10.2013;2013;10;06;Sunnuntai;7;7;14;0;2;2
89;13.10.2013;2013;10;07;Sunnuntai;2;4;6;3;2;5
89;13.10.2013;2013;10;08;Sunnuntai;8;7;15;6;14;20
89;13.10.2013;2013;10;09;Sunnuntai;8;19;27;12;18;30
89;13.10.2013;2013;10;10;Sunnuntai;13;34;47;16;20;36
89;13.10.2013;2013;10;11;Sunnuntai;23;65;88;20;33;53
89;13.10.2013;2013;10;12;Sunnuntai;49;120;169;24;45;69
89;13.10.2013;2013;10;13;Sunnuntai;102;85;187;29;48;77
89;13.10.2013;2013;10;14;Sunnuntai;96;83;179;29;37;66
89;13.10.2013;2013;10;15;Sunnuntai;99;78;177;49;50;99
89;13.10.2013;2013;10;16;Sunnuntai;91;100;191;24;40;64
89;13.10.2013;2013;10;17;Sunnuntai;77;67;144;39;30;69
89;13.10.2013;2013;10;18;Sunnuntai;74;58;132;17;23;40
89;13.10.2013;2013;10;19;Sunnuntai;62;34;96;28;25;53
89;13.10.2013;2013;10;20;Sunnuntai;38;23;61;9;14;23
89;13.10.2013;2013;10;21;Sunnuntai;30;12;42;11;6;17
89;13.10.2013;2013;10;22;Sunnuntai;18;10;28;3;4;7
89;13.10.2013;2013;10;23;Sunnuntai;3;10;13;1;0;1
89;14.10.2013;2013;10;00;Maanantai;3;4;7;1;1;2
89;14.10.2013;2013;10;01;Maanantai;2;0;2;0;0;0
89;14.10.2013;2013;10;02;Maanantai;2;0;2;1;0;1
89;14.10.2013;2013;10;03;Maanantai;1;0;1;1;0;1
89;14.10.2013;2013;10;04;Maanantai;2;5;7;1;0;1
89;14.10.2013;2013;10;05;Maanantai;2;12;14;0;2;2
89;14.10.2013;2013;10;06;Maanantai;17;41;58;3;4;7
89;14.10.2013;2013;10;07;Maanantai;37;171;208;1;28;29
89;14.10.2013;2013;10;08;Maanantai;74;255;329;16;26;42
89;14.10.2013;2013;10;09;Maanantai;49;163;212;12;37;49
89;14.10.2013;2013;10;10;Maanantai;54;109;163;18;33;51
89;14.10.2013;2013;10;11;Maanantai;69;76;145;17;23;40
89;14.10.2013;2013;10;12;Maanantai;65;97;162;17;21;38
89;14.10.2013;2013;10;13;Maanantai;96;96;192;21;41;62
89;14.10.2013;2013;10;14;Maanantai;148;93;241;31;16;47
89;14.10.2013;2013;10;15;Maanantai;209;87;296;31;19;50
89;14.10.2013;2013;10;16;Maanantai;275;112;387;29;22;51
89;14.10.2013;2013;10;17;Maanantai;146;86;232;23;34;57
89;14.10.2013;2013;10;18;Maanantai;96;60;156;39;30;69
89;14.10.2013;2013;10;19;Maanantai;70;56;126;30;22;52
89;14.10.2013;2013;10;20;Maanantai;63;38;101;15;26;41
89;14.10.2013;2013;10;21;Maanantai;51;24;75;12;10;22
89;14.10.2013;2013;10;22;Maanantai;17;5;22;6;1;7
89;14.10.2013;2013;10;23;Maanantai;9;7;16;4;2;6
89;15.10.2013;2013;10;00;Tiistai;0;5;5;2;1;3
89;15.10.2013;2013;10;01;Tiistai;3;0;3;0;1;1
89;15.10.2013;2013;10;02;Tiistai;0;1;1;0;0;0
89;15.10.2013;2013;10;03;Tiistai;4;1;5;0;0;0
89;15.10.2013;2013;10;04;Tiistai;3;4;7;0;0;0
89;15.10.2013;2013;10;05;Tiistai;0;10;10;0;1;1
89;15.10.2013;2013;10;06;Tiistai;19;49;68;6;4;10
89;15.10.2013;2013;10;07;Tiistai;33;196;229;5;32;37
89;15.10.2013;2013;10;08;Tiistai;78;274;352;9;33;42
89;15.10.2013;2013;10;09;Tiistai;53;146;199;14;22;36
89;15.10.2013;2013;10;10;Tiistai;53;92;145;16;28;44
89;15.10.2013;2013;10;11;Tiistai;64;120;184;21;38;59
89;15.10.2013;2013;10;12;Tiistai;79;100;179;26;21;47
89;15.10.2013;2013;10;13;Tiistai;120;92;212;18;29;47
89;15.10.2013;2013;10;14;Tiistai;130;114;244;16;29;45
89;15.10.2013;2013;10;15;Tiistai;195;103;298;40;22;62
89;15.10.2013;2013;10;16;Tiistai;254;146;400;32;18;50
89;15.10.2013;2013;10;17;Tiistai;168;109;277;28;40;68
89;15.10.2013;2013;10;18;Tiistai;122;73;195;37;38;75
89;15.10.2013;2013;10;19;Tiistai;92;53;145;38;28;66
89;15.10.2013;2013;10;20;Tiistai;83;36;119;24;18;42
89;15.10.2013;2013;10;21;Tiistai;47;28;75;13;8;21
89;15.10.2013;2013;10;22;Tiistai;20;11;31;2;6;8
89;15.10.2013;2013;10;23;Tiistai;10;8;18;1;1;2
89;16.10.2013;2013;10;00;Keskiviikko;8;5;13;0;0;0
89;16.10.2013;2013;10;01;Keskiviikko;3;3;6;1;0;1
89;16.10.2013;2013;10;02;Keskiviikko;0;2;2;0;0;0
89;16.10.2013;2013;10;03;Keskiviikko;3;2;5;0;1;1
89;16.10.2013;2013;10;04;Keskiviikko;2;1;3;1;0;1
89;16.10.2013;2013;10;05;Keskiviikko;2;12;14;1;4;5
89;16.10.2013;2013;10;06;Keskiviikko;18;46;64;3;10;13
89;16.10.2013;2013;10;07;Keskiviikko;38;160;198;3;29;32
89;16.10.2013;2013;10;08;Keskiviikko;72;275;347;10;44;54
89;16.10.2013;2013;10;09;Keskiviikko;54;138;192;13;32;45
89;16.10.2013;2013;10;10;Keskiviikko;43;90;133;20;42;62
89;16.10.2013;2013;10;11;Keskiviikko;64;87;151;21;32;53
89;16.10.2013;2013;10;12;Keskiviikko;78;119;197;35;33;68
89;16.10.2013;2013;10;13;Keskiviikko;97;92;189;18;26;44
89;16.10.2013;2013;10;14;Keskiviikko;111;96;207;36;24;60
89;16.10.2013;2013;10;15;Keskiviikko;180;96;276;24;27;51
89;16.10.2013;2013;10;16;Keskiviikko;252;121;373;34;30;64
89;16.10.2013;2013;10;17;Keskiviikko;170;85;255;31;30;61
89;16.10.2013;2013;10;18;Keskiviikko;117;74;191;32;43;75
89;16.10.2013;2013;10;19;Keskiviikko;86;55;141;24;20;44
89;16.10.2013;2013;10;20;Keskiviikko;71;41;112;16;15;31
89;16.10.2013;2013;10;21;Keskiviikko;44;37;81;9;7;16
89;16.10.2013;2013;10;22;Keskiviikko;32;17;49;4;2;6
89;16.10.2013;2013;10;23;Keskiviikko;9;10;19;0;2;2
89;17.10.2013;2013;10;00;Torstai;5;5;10;0;0;0
89;17.10.2013;2013;10;01;Torstai;1;2;3;0;1;1
89;17.10.2013;2013;10;02;Torstai;5;4;9;1;1;2
89;17.10.2013;2013;10;03;Torstai;14;2;16;3;0;3
89;17.10.2013;2013;10;04;Torstai;4;3;7;0;0;0
89;17.10.2013;2013;10;05;Torstai;4;9;13;3;0;3
89;17.10.2013;2013;10;06;Torstai;17;40;57;2;6;8
89;17.10.2013;2013;10;07;Torstai;33;170;203;3;29;32
89;17.10.2013;2013;10;08;Torstai;68;230;298;14;46;60
89;17.10.2013;2013;10;09;Torstai;40;119;159;9;23;32
89;17.10.2013;2013;10;10;Torstai;57;78;135;17;28;45
89;17.10.2013;2013;10;11;Torstai;62;89;151;21;37;58
89;17.10.2013;2013;10;12;Torstai;69;91;160;23;41;64
89;17.10.2013;2013;10;13;Torstai;65;96;161;18;47;65
89;17.10.2013;2013;10;14;Torstai;131;80;211;32;32;64
89;17.10.2013;2013;10;15;Torstai;148;91;239;38;19;57
89;17.10.2013;2013;10;16;Torstai;231;109;340;38;26;64
89;17.10.2013;2013;10;17;Torstai;121;92;213;35;31;66
89;17.10.2013;2013;10;18;Torstai;98;70;168;27;31;58
89;17.10.2013;2013;10;19;Torstai;77;51;128;27;22;49
89;17.10.2013;2013;10;20;Torstai;72;46;118;20;16;36
89;17.10.2013;2013;10;21;Torstai;40;26;66;13;9;22
89;17.10.2013;2013;10;22;Torstai;17;19;36;10;5;15
89;17.10.2013;2013;10;23;Torstai;11;9;20;3;3;6
89;18.10.2013;2013;10;00;Perjantai;10;6;16;0;3;3
89;18.10.2013;2013;10;01;Perjantai;5;0;5;3;0;3
89;18.10.2013;2013;10;02;Perjantai;5;0;5;1;0;1
89;18.10.2013;2013;10;03;Perjantai;2;3;5;0;1;1
89;18.10.2013;2013;10;04;Perjantai;11;1;12;1;0;1
89;18.10.2013;2013;10;05;Perjantai;2;12;14;2;2;4
89;18.10.2013;2013;10;06;Perjantai;15;35;50;2;6;8
89;18.10.2013;2013;10;07;Perjantai;27;121;148;6;30;36
89;18.10.2013;2013;10;08;Perjantai;57;220;277;11;30;41
89;18.10.2013;2013;10;09;Perjantai;37;119;156;12;34;46
89;18.10.2013;2013;10;10;Perjantai;35;89;124;14;28;42
89;18.10.2013;2013;10;11;Perjantai;51;73;124;20;34;54
89;18.10.2013;2013;10;12;Perjantai;63;64;127;24;30;54
89;18.10.2013;2013;10;13;Perjantai;113;95;208;31;24;55
89;18.10.2013;2013;10;14;Perjantai;144;101;245;21;32;53
89;18.10.2013;2013;10;15;Perjantai;168;81;249;23;22;45
89;18.10.2013;2013;10;16;Perjantai;169;91;260;28;14;42
89;18.10.2013;2013;10;17;Perjantai;88;66;154;27;12;39
89;18.10.2013;2013;10;18;Perjantai;63;49;112;27;22;49
89;18.10.2013;2013;10;19;Perjantai;60;44;104;18;15;33
89;18.10.2013;2013;10;20;Perjantai;52;34;86;14;17;31
89;18.10.2013;2013;10;21;Perjantai;35;24;59;9;10;19
89;18.10.2013;2013;10;22;Perjantai;31;22;53;8;8;16
89;18.10.2013;2013;10;23;Perjantai;10;34;44;2;7;9
89;19.10.2013;2013;10;00;Lauantai;19;12;31;3;3;6
89;19.10.2013;2013;10;01;Lauantai;23;7;30;3;5;8
89;19.10.2013;2013;10;02;Lauantai;15;7;22;8;0;8
89;19.10.2013;2013;10;03;Lauantai;19;2;21;3;0;3
89;19.10.2013;2013;10;04;Lauantai;13;8;21;9;1;10
89;19.10.2013;2013;10;05;Lauantai;6;5;11;1;0;1
89;19.10.2013;2013;10;06;Lauantai;3;8;11;1;4;5
89;19.10.2013;2013;10;07;Lauantai;4;10;14;1;3;4
89;19.10.2013;2013;10;08;Lauantai;8;13;21;6;14;20
89;19.10.2013;2013;10;09;Lauantai;4;34;38;13;23;36
89;19.10.2013;2013;10;10;Lauantai;15;41;56;21;42;63
89;19.10.2013;2013;10;11;Lauantai;26;38;64;18;35;53
89;19.10.2013;2013;10;12;Lauantai;34;52;86;46;45;91
89;19.10.2013;2013;10;13;Lauantai;29;46;75;29;35;64
89;19.10.2013;2013;10;14;Lauantai;45;40;85;41;42;83
89;19.10.2013;2013;10;15;Lauantai;40;57;97;29;21;50
89;19.10.2013;2013;10;16;Lauantai;56;51;107;28;25;53
89;19.10.2013;2013;10;17;Lauantai;40;41;81;18;19;37
89;19.10.2013;2013;10;18;Lauantai;36;35;71;27;18;45
89;19.10.2013;2013;10;19;Lauantai;27;27;54;10;9;19
89;19.10.2013;2013;10;20;Lauantai;32;22;54;13;15;28
89;19.10.2013;2013;10;21;Lauantai;20;27;47;7;6;13
89;19.10.2013;2013;10;22;Lauantai;13;18;31;3;2;5
89;19.10.2013;2013;10;23;Lauantai;16;15;31;2;6;8
89;20.10.2013;2013;10;00;Sunnuntai;12;21;33;2;7;9
89;20.10.2013;2013;10;01;Sunnuntai;18;8;26;2;5;7
89;20.10.2013;2013;10;02;Sunnuntai;13;9;22;5;1;6
89;20.10.2013;2013;10;03;Sunnuntai;13;2;15;7;0;7
89;20.10.2013;2013;10;04;Sunnuntai;18;4;22;10;0;10
89;20.10.2013;2013;10;05;Sunnuntai;2;0;2;0;0;0
89;20.10.2013;2013;10;06;Sunnuntai;2;2;4;1;2;3
89;20.10.2013;2013;10;07;Sunnuntai;4;5;9;5;1;6
89;20.10.2013;2013;10;08;Sunnuntai;4;2;6;3;3;6
89;20.10.2013;2013;10;09;Sunnuntai;2;12;14;9;20;29
89;20.10.2013;2013;10;10;Sunnuntai;12;19;31;26;37;63
89;20.10.2013;2013;10;11;Sunnuntai;13;31;44;42;49;91
89;20.10.2013;2013;10;12;Sunnuntai;18;61;79;47;65;112
89;20.10.2013;2013;10;13;Sunnuntai;46;43;89;46;52;98
89;20.10.2013;2013;10;14;Sunnuntai;48;51;99;46;51;97
89;20.10.2013;2013;10;15;Sunnuntai;46;40;86;45;46;91
89;20.10.2013;2013;10;16;Sunnuntai;36;52;88;41;41;82
89;20.10.2013;2013;10;17;Sunnuntai;50;30;80;17;29;46
89;20.10.2013;2013;10;18;Sunnuntai;41;19;60;29;25;54
89;20.10.2013;2013;10;19;Sunnuntai;35;21;56;13;17;30
89;20.10.2013;2013;10;20;Sunnuntai;21;8;29;7;11;18
89;20.10.2013;2013;10;21;Sunnuntai;21;18;39;6;5;11
89;20.10.2013;2013;10;22;Sunnuntai;15;13;28;3;3;6
89;20.10.2013;2013;10;23;Sunnuntai;12;5;17;0;1;1
89;21.10.2013;2013;10;00;Maanantai;4;2;6;1;0;1
89;21.10.2013;2013;10;01;Maanantai;0;0;0;1;1;2
89;21.10.2013;2013;10;02;Maanantai;1;0;1;0;1;1
89;21.10.2013;2013;10;03;Maanantai;3;5;8;0;0;0
89;21.10.2013;2013;10;04;Maanantai;5;2;7;1;0;1
89;21.10.2013;2013;10;05;Maanantai;5;10;15;0;4;4
89;21.10.2013;2013;10;06;Maanantai;17;31;48;2;0;2
89;21.10.2013;2013;10;07;Maanantai;21;101;122;7;30;37
89;21.10.2013;2013;10;08;Maanantai;23;122;145;8;41;49
89;21.10.2013;2013;10;09;Maanantai;23;103;126;13;41;54
89;21.10.2013;2013;10;10;Maanantai;32;60;92;12;24;36
89;21.10.2013;2013;10;11;Maanantai;68;58;126;19;43;62
89;21.10.2013;2013;10;12;Maanantai;45;68;113;34;36;70
89;21.10.2013;2013;10;13;Maanantai;48;78;126;32;29;61
89;21.10.2013;2013;10;14;Maanantai;73;58;131;28;51;79
89;21.10.2013;2013;10;15;Maanantai;108;58;166;47;37;84
89;21.10.2013;2013;10;16;Maanantai;155;55;210;35;28;63
89;21.10.2013;2013;10;17;Maanantai;108;54;162;35;33;68
89;21.10.2013;2013;10;18;Maanantai;64;28;92;40;22;62
89;21.10.2013;2013;10;19;Maanantai;41;27;68;37;24;61
89;21.10.2013;2013;10;20;Maanantai;32;13;45;16;14;30
89;21.10.2013;2013;10;21;Maanantai;25;18;43;11;7;18
89;21.10.2013;2013;10;22;Maanantai;14;13;27;6;4;10
89;21.10.2013;2013;10;23;Maanantai;3;8;11;3;2;5
89;22.10.2013;2013;10;00;Tiistai;4;5;9;0;1;1
89;22.10.2013;2013;10;01;Tiistai;1;2;3;2;1;3
89;22.10.2013;2013;10;02;Tiistai;2;0;2;1;0;1
89;22.10.2013;2013;10;03;Tiistai;4;5;9;0;0;0
89;22.10.2013;2013;10;04;Tiistai;6;3;9;2;0;2
89;22.10.2013;2013;10;05;Tiistai;4;13;17;0;4;4
89;22.10.2013;2013;10;06;Tiistai;12;28;40;2;6;8
89;22.10.2013;2013;10;07;Tiistai;24;96;120;4;31;35
89;22.10.2013;2013;10;08;Tiistai;36;129;165;6;25;31
89;22.10.2013;2013;10;09;Tiistai;30;74;104;13;35;48
89;22.10.2013;2013;10;10;Tiistai;24;60;84;25;31;56
89;22.10.2013;2013;10;11;Tiistai;42;75;117;27;34;61
89;22.10.2013;2013;10;12;Tiistai;47;62;109;32;42;74
89;22.10.2013;2013;10;13;Tiistai;50;68;118;31;33;64
89;22.10.2013;2013;10;14;Tiistai;90;66;156;42;32;74
89;22.10.2013;2013;10;15;Tiistai;116;68;184;37;17;54
89;22.10.2013;2013;10;16;Tiistai;134;71;205;31;23;54
89;22.10.2013;2013;10;17;Tiistai;92;65;157;25;20;45
89;22.10.2013;2013;10;18;Tiistai;59;50;109;25;25;50
89;22.10.2013;2013;10;19;Tiistai;42;33;75;19;30;49
89;22.10.2013;2013;10;20;Tiistai;42;15;57;11;12;23
89;22.10.2013;2013;10;21;Tiistai;52;21;73;11;10;21
89;22.10.2013;2013;10;22;Tiistai;16;16;32;5;6;11
89;22.10.2013;2013;10;23;Tiistai;12;9;21;0;1;1
89;23.10.2013;2013;10;00;Keskiviikko;3;2;5;0;1;1
89;23.10.2013;2013;10;01;Keskiviikko;3;3;6;1;0;1
89;23.10.2013;2013;10;02;Keskiviikko;4;1;5;2;0;2
89;23.10.2013;2013;10;03;Keskiviikko;1;2;3;1;0;1
89;23.10.2013;2013;10;04;Keskiviikko;5;2;7;0;0;0
89;23.10.2013;2013;10;05;Keskiviikko;7;14;21;0;0;0
89;23.10.2013;2013;10;06;Keskiviikko;12;26;38;3;2;5
89;23.10.2013;2013;10;07;Keskiviikko;23;86;109;3;28;31
89;23.10.2013;2013;10;08;Keskiviikko;19;110;129;12;38;50
89;23.10.2013;2013;10;09;Keskiviikko;18;56;74;8;28;36
89;23.10.2013;2013;10;10;Keskiviikko;18;40;58;5;11;16
89;23.10.2013;2013;10;11;Keskiviikko;24;14;38;7;9;16
89;23.10.2013;2013;10;12;Keskiviikko;18;27;45;13;16;29
89;23.10.2013;2013;10;13;Keskiviikko;22;23;45;12;9;21
89;23.10.2013;2013;10;14;Keskiviikko;33;27;60;9;13;22
89;23.10.2013;2013;10;15;Keskiviikko;59;39;98;21;14;35
89;23.10.2013;2013;10;16;Keskiviikko;84;37;121;20;14;34
89;23.10.2013;2013;10;17;Keskiviikko;58;36;94;23;8;31
89;23.10.2013;2013;10;18;Keskiviikko;30;28;58;20;17;37
89;23.10.2013;2013;10;19;Keskiviikko;38;26;64;13;13;26
89;23.10.2013;2013;10;20;Keskiviikko;39;13;52;6;7;13
89;23.10.2013;2013;10;21;Keskiviikko;23;18;41;11;8;19
89;23.10.2013;2013;10;22;Keskiviikko;6;8;14;6;9;15
89;23.10.2013;2013;10;23;Keskiviikko;1;11;12;0;1;1
89;24.10.2013;2013;10;00;Torstai;8;5;13;3;1;4
89;24.10.2013;2013;10;01;Torstai;1;5;6;0;1;1
89;24.10.2013;2013;10;02;Torstai;11;2;13;4;3;7
89;24.10.2013;2013;10;03;Torstai;6;3;9;0;1;1
89;24.10.2013;2013;10;04;Torstai;4;4;8;2;0;2
89;24.10.2013;2013;10;05;Torstai;1;13;14;0;1;1
89;24.10.2013;2013;10;06;Torstai;14;27;41;1;8;9
89;24.10.2013;2013;10;07;Torstai;13;97;110;3;18;21
89;24.10.2013;2013;10;08;Torstai;22;128;150;5;34;39
89;24.10.2013;2013;10;09;Torstai;18;72;90;17;21;38
89;24.10.2013;2013;10;10;Torstai;31;60;91;27;19;46
89;24.10.2013;2013;10;11;Torstai;36;41;77;16;27;43
89;24.10.2013;2013;10;12;Torstai;51;44;95;18;16;34
89;24.10.2013;2013;10;13;Torstai;44;37;81;11;8;19
89;24.10.2013;2013;10;14;Torstai;49;37;86;5;8;13
89;24.10.2013;2013;10;15;Torstai;81;44;125;16;8;24
89;24.10.2013;2013;10;16;Torstai;110;47;157;21;12;33
89;24.10.2013;2013;10;17;Torstai;56;28;84;11;15;26
89;24.10.2013;2013;10;18;Torstai;53;34;87;18;7;25
89;24.10.2013;2013;10;19;Torstai;38;30;68;16;11;27
89;24.10.2013;2013;10;20;Torstai;31;21;52;16;17;33
89;24.10.2013;2013;10;21;Torstai;20;21;41;5;12;17
89;24.10.2013;2013;10;22;Torstai;14;21;35;12;4;16
89;24.10.2013;2013;10;23;Torstai;7;12;19;1;5;6
89;25.10.2013;2013;10;00;Perjantai;8;3;11;2;1;3
89;25.10.2013;2013;10;01;Perjantai;6;8;14;6;4;10
89;25.10.2013;2013;10;02;Perjantai;8;1;9;7;0;7
89;25.10.2013;2013;10;03;Perjantai;3;2;5;2;2;4
89;25.10.2013;2013;10;04;Perjantai;7;3;10;2;0;2
89;25.10.2013;2013;10;05;Perjantai;5;10;15;3;5;8
89;25.10.2013;2013;10;06;Perjantai;10;32;42;4;1;5
89;25.10.2013;2013;10;07;Perjantai;21;78;99;4;17;21
89;25.10.2013;2013;10;08;Perjantai;17;104;121;7;29;36
89;25.10.2013;2013;10;09;Perjantai;16;64;80;1;17;18
89;25.10.2013;2013;10;10;Perjantai;28;60;88;12;16;28
89;25.10.2013;2013;10;11;Perjantai;44;62;106;17;27;44
89;25.10.2013;2013;10;12;Perjantai;52;61;113;20;23;43
89;25.10.2013;2013;10;13;Perjantai;55;59;114;20;17;37
89;25.10.2013;2013;10;14;Perjantai;63;59;122;22;20;42
89;25.10.2013;2013;10;15;Perjantai;99;62;161;21;17;38
89;25.10.2013;2013;10;16;Perjantai;114;57;171;28;17;45
89;25.10.2013;2013;10;17;Perjantai;89;52;141;29;26;55
89;25.10.2013;2013;10;18;Perjantai;54;41;95;33;26;59
89;25.10.2013;2013;10;19;Perjantai;41;32;73;25;20;45
89;25.10.2013;2013;10;20;Perjantai;38;30;68;9;14;23
89;25.10.2013;2013;10;21;Perjantai;30;29;59;5;8;13
89;25.10.2013;2013;10;22;Perjantai;27;17;44;9;2;11
89;25.10.2013;2013;10;23;Perjantai;16;24;40;3;7;10
89;26.10.2013;2013;10;00;Lauantai;21;12;33;4;7;11
89;26.10.2013;2013;10;01;Lauantai;18;10;28;3;1;4
89;26.10.2013;2013;10;02;Lauantai;10;1;11;10;0;10
89;26.10.2013;2013;10;03;Lauantai;12;2;14;4;1;5
89;26.10.2013;2013;10;04;Lauantai;19;2;21;1;1;2
89;26.10.2013;2013;10;05;Lauantai;4;4;8;0;2;2
89;26.10.2013;2013;10;06;Lauantai;4;9;13;2;4;6
89;26.10.2013;2013;10;07;Lauantai;4;13;17;1;4;5
89;26.10.2013;2013;10;08;Lauantai;3;28;31;8;2;10
89;26.10.2013;2013;10;09;Lauantai;11;45;56;20;25;45
89;26.10.2013;2013;10;10;Lauantai;19;50;69;18;32;50
89;26.10.2013;2013;10;11;Lauantai;42;69;111;23;34;57
89;26.10.2013;2013;10;12;Lauantai;48;71;119;27;46;73
89;26.10.2013;2013;10;13;Lauantai;62;85;147;28;44;72
89;26.10.2013;2013;10;14;Lauantai;48;54;102;37;17;54
89;26.10.2013;2013;10;15;Lauantai;65;65;130;23;40;63
89;26.10.2013;2013;10;16;Lauantai;59;64;123;16;19;35
89;26.10.2013;2013;10;17;Lauantai;61;35;96;22;18;40
89;26.10.2013;2013;10;18;Lauantai;46;56;102;24;15;39
89;26.10.2013;2013;10;19;Lauantai;45;35;80;11;10;21
89;26.10.2013;2013;10;20;Lauantai;29;29;58;12;10;22
89;26.10.2013;2013;10;21;Lauantai;26;15;41;5;10;15
89;26.10.2013;2013;10;22;Lauantai;13;11;24;5;2;7
89;26.10.2013;2013;10;23;Lauantai;15;22;37;1;12;13
89;27.10.2013;2013;10;00;Sunnuntai;8;16;24;5;9;14
89;27.10.2013;2013;10;01;Sunnuntai;8;6;14;3;2;5
89;27.10.2013;2013;10;02;Sunnuntai;12;8;20;5;1;6
89;27.10.2013;2013;10;03;Sunnuntai;27;6;33;16;2;18
89;27.10.2013;2013;10;04;Sunnuntai;13;2;15;4;0;4
89;27.10.2013;2013;10;05;Sunnuntai;3;1;4;1;0;1
89;27.10.2013;2013;10;06;Sunnuntai;3;6;9;1;1;2
89;27.10.2013;2013;10;07;Sunnuntai;4;6;10;6;3;9
89;27.10.2013;2013;10;08;Sunnuntai;3;6;9;7;12;19
89;27.10.2013;2013;10;09;Sunnuntai;16;21;37;29;19;48
89;27.10.2013;2013;10;10;Sunnuntai;14;36;50;27;47;74
89;27.10.2013;2013;10;11;Sunnuntai;39;37;76;45;51;96
89;27.10.2013;2013;10;12;Sunnuntai;43;64;107;37;59;96
89;27.10.2013;2013;10;13;Sunnuntai;47;49;96;30;53;83
89;27.10.2013;2013;10;14;Sunnuntai;58;51;109;34;32;66
89;27.10.2013;2013;10;15;Sunnuntai;49;35;84;33;45;78
89;27.10.2013;2013;10;16;Sunnuntai;31;37;68;30;23;53
89;27.10.2013;2013;10;17;Sunnuntai;47;45;92;27;28;55
89;27.10.2013;2013;10;18;Sunnuntai;54;30;84;26;19;45
89;27.10.2013;2013;10;19;Sunnuntai;30;24;54;19;22;41
89;27.10.2013;2013;10;20;Sunnuntai;30;17;47;14;11;25
89;27.10.2013;2013;10;21;Sunnuntai;19;13;32;6;8;14
89;27.10.2013;2013;10;22;Sunnuntai;12;7;19;5;6;11
89;27.10.2013;2013;10;23;Sunnuntai;6;10;16;0;3;3
89;28.10.2013;2013;10;00;Maanantai;3;2;5;2;1;3
89;28.10.2013;2013;10;01;Maanantai;1;5;6;1;3;4
89;28.10.2013;2013;10;02;Maanantai;2;1;3;1;0;1
89;28.10.2013;2013;10;03;Maanantai;2;2;4;2;0;2
89;28.10.2013;2013;10;04;Maanantai;8;4;12;2;0;2
89;28.10.2013;2013;10;05;Maanantai;5;9;14;1;1;2
89;28.10.2013;2013;10;06;Maanantai;16;26;42;3;10;13
89;28.10.2013;2013;10;07;Maanantai;47;145;192;4;28;32
89;28.10.2013;2013;10;08;Maanantai;66;264;330;9;42;51
89;28.10.2013;2013;10;09;Maanantai;41;111;152;7;22;29
89;28.10.2013;2013;10;10;Maanantai;53;83;136;15;26;41
89;28.10.2013;2013;10;11;Maanantai;54;49;103;12;30;42
89;28.10.2013;2013;10;12;Maanantai;45;50;95;21;20;41
89;28.10.2013;2013;10;13;Maanantai;77;58;135;20;31;51
89;28.10.2013;2013;10;14;Maanantai;107;89;196;33;20;53
89;28.10.2013;2013;10;15;Maanantai;142;64;206;34;20;54
89;28.10.2013;2013;10;16;Maanantai;224;73;297;36;16;52
89;28.10.2013;2013;10;17;Maanantai;120;77;197;34;35;69
89;28.10.2013;2013;10;18;Maanantai;84;62;146;35;38;73
89;28.10.2013;2013;10;19;Maanantai;66;54;120;37;27;64
89;28.10.2013;2013;10;20;Maanantai;43;45;88;27;33;60
89;28.10.2013;2013;10;21;Maanantai;51;30;81;11;10;21
89;28.10.2013;2013;10;22;Maanantai;16;5;21;5;8;13
89;28.10.2013;2013;10;23;Maanantai;4;1;5;1;1;2
89;29.10.2013;2013;10;00;Tiistai;3;1;4;4;2;6
89;29.10.2013;2013;10;01;Tiistai;1;0;1;0;0;0
89;29.10.2013;2013;10;02;Tiistai;1;3;4;0;0;0
89;29.10.2013;2013;10;03;Tiistai;2;2;4;1;0;1
89;29.10.2013;2013;10;04;Tiistai;4;3;7;0;1;1
89;29.10.2013;2013;10;05;Tiistai;2;12;14;0;0;0
89;29.10.2013;2013;10;06;Tiistai;16;28;44;5;6;11
89;29.10.2013;2013;10;07;Tiistai;49;163;212;5;22;27
89;29.10.2013;2013;10;08;Tiistai;66;231;297;8;44;52
89;29.10.2013;2013;10;09;Tiistai;36;101;137;6;28;34
89;29.10.2013;2013;10;10;Tiistai;43;80;123;14;16;30
89;29.10.2013;2013;10;11;Tiistai;50;84;134;28;30;58
89;29.10.2013;2013;10;12;Tiistai;56;94;150;24;31;55
89;29.10.2013;2013;10;13;Tiistai;75;88;163;28;38;66
89;29.10.2013;2013;10;14;Tiistai;120;87;207;41;34;75
89;29.10.2013;2013;10;15;Tiistai;174;97;271;33;29;62
89;29.10.2013;2013;10;16;Tiistai;246;97;343;37;31;68
89;29.10.2013;2013;10;17;Tiistai;107;65;172;33;28;61
89;29.10.2013;2013;10;18;Tiistai;81;56;137;36;28;64
89;29.10.2013;2013;10;19;Tiistai;65;46;111;39;32;71
89;29.10.2013;2013;10;20;Tiistai;63;49;112;18;17;35
89;29.10.2013;2013;10;21;Tiistai;48;27;75;15;10;25
89;29.10.2013;2013;10;22;Tiistai;22;6;28;7;4;11
89;29.10.2013;2013;10;23;Tiistai;8;5;13;3;5;8
89;30.10.2013;2013;10;00;Keskiviikko;3;2;5;0;1;1
89;30.10.2013;2013;10;01;Keskiviikko;4;1;5;2;0;2
89;30.10.2013;2013;10;02;Keskiviikko;0;1;1;1;0;1
89;30.10.2013;2013;10;03;Keskiviikko;2;2;4;0;0;0
89;30.10.2013;2013;10;04;Keskiviikko;3;3;6;0;0;0
89;30.10.2013;2013;10;05;Keskiviikko;6;10;16;4;2;6
89;30.10.2013;2013;10;06;Keskiviikko;22;38;60;6;5;11
89;30.10.2013;2013;10;07;Keskiviikko;43;185;228;6;33;39
89;30.10.2013;2013;10;08;Keskiviikko;75;273;348;10;36;46
89;30.10.2013;2013;10;09;Keskiviikko;45;143;188;13;28;41
89;30.10.2013;2013;10;10;Keskiviikko;53;98;151;9;28;37
89;30.10.2013;2013;10;11;Keskiviikko;46;103;149;22;32;54
89;30.10.2013;2013;10;12;Keskiviikko;63;100;163;24;32;56
89;30.10.2013;2013;10;13;Keskiviikko;103;93;196;16;17;33
89;30.10.2013;2013;10;14;Keskiviikko;152;75;227;22;26;48
89;30.10.2013;2013;10;15;Keskiviikko;177;86;263;33;17;50
89;30.10.2013;2013;10;16;Keskiviikko;288;130;418;29;16;45
89;30.10.2013;2013;10;17;Keskiviikko;145;69;214;28;34;62
89;30.10.2013;2013;10;18;Keskiviikko;100;71;171;36;24;60
89;30.10.2013;2013;10;19;Keskiviikko;67;51;118;29;22;51
89;30.10.2013;2013;10;20;Keskiviikko;70;42;112;23;29;52
89;30.10.2013;2013;10;21;Keskiviikko;61;23;84;17;14;31
89;30.10.2013;2013;10;22;Keskiviikko;20;9;29;4;3;7
89;30.10.2013;2013;10;23;Keskiviikko;7;7;14;1;4;5
89;31.10.2013;2013;10;00;Torstai;2;3;5;1;3;4
89;31.10.2013;2013;10;01;Torstai;4;2;6;1;5;6
89;31.10.2013;2013;10;02;Torstai;5;1;6;2;1;3
89;31.10.2013;2013;10;03;Torstai;2;1;3;5;1;6
89;31.10.2013;2013;10;04;Torstai;5;4;9;2;0;2
89;31.10.2013;2013;10;05;Torstai;3;11;14;0;0;0
89;31.10.2013;2013;10;06;Torstai;19;40;59;3;2;5
89;31.10.2013;2013;10;07;Torstai;44;151;195;3;30;33
89;31.10.2013;2013;10;08;Torstai;76;265;341;17;33;50
89;31.10.2013;2013;10;09;Torstai;45;118;163;13;26;39
89;31.10.2013;2013;10;10;Torstai;37;92;129;16;22;38
89;31.10.2013;2013;10;11;Torstai;58;76;134;20;30;50
89;31.10.2013;2013;10;12;Torstai;78;83;161;25;25;50
89;31.10.2013;2013;10;13;Torstai;79;86;165;32;24;56
89;31.10.2013;2013;10;14;Torstai;138;84;222;18;33;51
89;31.10.2013;2013;10;15;Torstai;166;92;258;27;28;55
89;31.10.2013;2013;10;16;Torstai;228;120;348;38;24;62
89;31.10.2013;2013;10;17;Torstai;132;79;211;40;10;50
89;31.10.2013;2013;10;18;Torstai;79;59;138;36;24;60
89;31.10.2013;2013;10;19;Torstai;70;51;121;31;18;49
89;31.10.2013;2013;10;20;Torstai;47;42;89;23;21;44
89;31.10.2013;2013;10;21;Torstai;67;19;86;9;5;14
89;31.10.2013;2013;10;22;Torstai;27;24;51;5;5;10
89;31.10.2013;2013;10;23;Torstai;7;7;14;2;3;5
89;01.11.2013;2013;11;00;Perjantai;9;7;16;0;2;2
89;01.11.2013;2013;11;01;Perjantai;3;0;3;3;0;3
89;01.11.2013;2013;11;02;Perjantai;5;2;7;3;2;5
89;01.11.2013;2013;11;03;Perjantai;9;2;11;1;0;1
89;01.11.2013;2013;11;04;Perjantai;8;5;13;0;0;0
89;01.11.2013;2013;11;05;Perjantai;7;6;13;1;1;2
89;01.11.2013;2013;11;06;Perjantai;13;29;42;3;4;7
89;01.11.2013;2013;11;07;Perjantai;36;132;168;5;27;32
89;01.11.2013;2013;11;08;Perjantai;67;224;291;10;40;50
89;01.11.2013;2013;11;09;Perjantai;38;134;172;7;28;35
89;01.11.2013;2013;11;10;Perjantai;52;86;138;16;27;43
89;01.11.2013;2013;11;11;Perjantai;49;73;122;16;22;38
89;01.11.2013;2013;11;12;Perjantai;68;59;127;16;21;37
89;01.11.2013;2013;11;13;Perjantai;98;80;178;23;15;38
89;01.11.2013;2013;11;14;Perjantai;144;79;223;22;15;37
89;01.11.2013;2013;11;15;Perjantai;146;93;239;31;12;43
89;01.11.2013;2013;11;16;Perjantai;172;72;244;25;17;42
89;01.11.2013;2013;11;17;Perjantai;87;57;144;24;18;42
89;01.11.2013;2013;11;18;Perjantai;49;52;101;16;19;35
89;01.11.2013;2013;11;19;Perjantai;49;35;84;17;13;30
89;01.11.2013;2013;11;20;Perjantai;46;35;81;7;8;15
89;01.11.2013;2013;11;21;Perjantai;30;26;56;5;10;15
89;01.11.2013;2013;11;22;Perjantai;25;32;57;5;11;16
89;01.11.2013;2013;11;23;Perjantai;23;39;62;5;6;11
89;02.11.2013;2013;11;00;Lauantai;22;17;39;6;6;12
89;02.11.2013;2013;11;01;Lauantai;15;8;23;4;4;8
89;02.11.2013;2013;11;02;Lauantai;20;2;22;6;1;7
89;02.11.2013;2013;11;03;Lauantai;10;5;15;12;2;14
89;02.11.2013;2013;11;04;Lauantai;12;1;13;7;0;7
89;02.11.2013;2013;11;05;Lauantai;3;2;5;0;0;0
89;02.11.2013;2013;11;06;Lauantai;5;9;14;1;3;4
89;02.11.2013;2013;11;07;Lauantai;4;6;10;3;5;8
89;02.11.2013;2013;11;08;Lauantai;7;10;17;8;6;14
89;02.11.2013;2013;11;09;Lauantai;17;29;46;20;18;38
89;02.11.2013;2013;11;10;Lauantai;27;43;70;25;27;52
89;02.11.2013;2013;11;11;Lauantai;33;42;75;26;57;83
89;02.11.2013;2013;11;12;Lauantai;43;62;105;37;46;83
89;02.11.2013;2013;11;13;Lauantai;43;57;100;32;40;72
89;02.11.2013;2013;11;14;Lauantai;58;42;100;39;56;95
89;02.11.2013;2013;11;15;Lauantai;60;56;116;23;24;47
89;02.11.2013;2013;11;16;Lauantai;48;61;109;31;32;63
89;02.11.2013;2013;11;17;Lauantai;49;38;87;25;34;59
89;02.11.2013;2013;11;18;Lauantai;40;41;81;27;23;50
89;02.11.2013;2013;11;19;Lauantai;48;36;84;14;12;26
89;02.11.2013;2013;11;20;Lauantai;27;44;71;13;17;30
89;02.11.2013;2013;11;21;Lauantai;30;32;62;9;17;26
89;02.11.2013;2013;11;22;Lauantai;21;14;35;6;10;16
89;02.11.2013;2013;11;23;Lauantai;11;24;35;6;9;15
89;03.11.2013;2013;11;00;Sunnuntai;13;11;24;4;7;11
89;03.11.2013;2013;11;01;Sunnuntai;25;13;38;4;7;11
89;03.11.2013;2013;11;02;Sunnuntai;28;2;30;5;0;5
89;03.11.2013;2013;11;03;Sunnuntai;14;3;17;13;0;13
89;03.11.2013;2013;11;04;Sunnuntai;21;7;28;14;1;15
89;03.11.2013;2013;11;05;Sunnuntai;10;2;12;1;0;1
89;03.11.2013;2013;11;06;Sunnuntai;4;4;8;2;2;4
89;03.11.2013;2013;11;07;Sunnuntai;1;4;5;2;5;7
89;03.11.2013;2013;11;08;Sunnuntai;7;13;20;4;12;16
89;03.11.2013;2013;11;09;Sunnuntai;7;16;23;22;25;47
89;03.11.2013;2013;11;10;Sunnuntai;17;29;46;21;44;65
89;03.11.2013;2013;11;11;Sunnuntai;28;59;87;47;64;111
89;03.11.2013;2013;11;12;Sunnuntai;38;76;114;54;70;124
89;03.11.2013;2013;11;13;Sunnuntai;58;69;127;35;71;106
89;03.11.2013;2013;11;14;Sunnuntai;64;66;130;38;47;85
89;03.11.2013;2013;11;15;Sunnuntai;65;43;108;36;30;66
89;03.11.2013;2013;11;16;Sunnuntai;39;57;96;36;26;62
89;03.11.2013;2013;11;17;Sunnuntai;57;46;103;30;27;57
89;03.11.2013;2013;11;18;Sunnuntai;52;31;83;20;20;40
89;03.11.2013;2013;11;19;Sunnuntai;56;24;80;30;21;51
89;03.11.2013;2013;11;20;Sunnuntai;33;20;53;5;13;18
89;03.11.2013;2013;11;21;Sunnuntai;25;16;41;16;7;23
89;03.11.2013;2013;11;22;Sunnuntai;14;8;22;8;4;12
89;03.11.2013;2013;11;23;Sunnuntai;7;2;9;0;5;5
89;04.11.2013;2013;11;00;Maanantai;4;2;6;3;0;3
89;04.11.2013;2013;11;01;Maanantai;1;0;1;0;0;0
89;04.11.2013;2013;11;02;Maanantai;3;3;6;0;0;0
89;04.11.2013;2013;11;03;Maanantai;2;2;4;0;0;0
89;04.11.2013;2013;11;04;Maanantai;5;3;8;0;0;0
89;04.11.2013;2013;11;05;Maanantai;6;18;24;0;0;0
89;04.11.2013;2013;11;06;Maanantai;17;31;48;3;10;13
89;04.11.2013;2013;11;07;Maanantai;36;142;178;4;36;40
89;04.11.2013;2013;11;08;Maanantai;70;245;315;11;37;48
89;04.11.2013;2013;11;09;Maanantai;42;140;182;11;40;51
89;04.11.2013;2013;11;10;Maanantai;44;79;123;21;29;50
89;04.11.2013;2013;11;11;Maanantai;54;77;131;17;20;37
89;04.11.2013;2013;11;12;Maanantai;73;90;163;17;27;44
89;04.11.2013;2013;11;13;Maanantai;78;89;167;27;35;62
89;04.11.2013;2013;11;14;Maanantai;125;62;187;30;17;47
89;04.11.2013;2013;11;15;Maanantai;142;73;215;21;15;36
89;04.11.2013;2013;11;16;Maanantai;186;77;263;31;13;44
89;04.11.2013;2013;11;17;Maanantai;95;52;147;29;12;41
89;04.11.2013;2013;11;18;Maanantai;60;36;96;24;17;41
89;04.11.2013;2013;11;19;Maanantai;51;38;89;24;16;40
89;04.11.2013;2013;11;20;Maanantai;41;32;73;10;13;23
89;04.11.2013;2013;11;21;Maanantai;41;24;65;12;9;21
89;04.11.2013;2013;11;22;Maanantai;20;4;24;2;2;4
89;04.11.2013;2013;11;23;Maanantai;5;3;8;0;0;0
89;05.11.2013;2013;11;00;Tiistai;4;1;5;2;1;3
89;05.11.2013;2013;11;01;Tiistai;2;1;3;0;0;0
89;05.11.2013;2013;11;02;Tiistai;3;0;3;1;2;3
89;05.11.2013;2013;11;03;Tiistai;0;2;2;1;0;1
89;05.11.2013;2013;11;04;Tiistai;1;3;4;1;1;2
89;05.11.2013;2013;11;05;Tiistai;6;13;19;4;4;8
89;05.11.2013;2013;11;06;Tiistai;14;33;47;5;4;9
89;05.11.2013;2013;11;07;Tiistai;29;115;144;2;41;43
89;05.11.2013;2013;11;08;Tiistai;72;215;287;16;56;72
89;05.11.2013;2013;11;09;Tiistai;36;94;130;12;35;47
89;05.11.2013;2013;11;10;Tiistai;32;58;90;30;25;55
89;05.11.2013;2013;11;11;Tiistai;35;65;100;13;23;36
89;05.11.2013;2013;11;12;Tiistai;57;69;126;25;20;45
89;05.11.2013;2013;11;13;Tiistai;54;61;115;21;25;46
89;05.11.2013;2013;11;14;Tiistai;90;52;142;39;12;51
89;05.11.2013;2013;11;15;Tiistai;125;60;185;43;29;72
89;05.11.2013;2013;11;16;Tiistai;212;90;302;48;16;64
89;05.11.2013;2013;11;17;Tiistai;108;73;181;25;20;45
89;05.11.2013;2013;11;18;Tiistai;67;57;124;18;23;41
89;05.11.2013;2013;11;19;Tiistai;54;30;84;16;10;26
89;05.11.2013;2013;11;20;Tiistai;50;27;77;15;14;29
89;05.11.2013;2013;11;21;Tiistai;31;21;52;7;4;11
89;05.11.2013;2013;11;22;Tiistai;11;6;17;4;3;7
89;05.11.2013;2013;11;23;Tiistai;12;6;18;5;1;6
89;06.11.2013;2013;11;00;Keskiviikko;2;4;6;0;1;1
89;06.11.2013;2013;11;01;Keskiviikko;3;1;4;0;0;0
89;06.11.2013;2013;11;02;Keskiviikko;1;1;2;1;0;1
89;06.11.2013;2013;11;03;Keskiviikko;4;4;8;0;0;0
89;06.11.2013;2013;11;04;Keskiviikko;2;2;4;0;0;0
89;06.11.2013;2013;11;05;Keskiviikko;3;13;16;0;1;1
89;06.11.2013;2013;11;06;Keskiviikko;11;30;41;6;4;10
89;06.11.2013;2013;11;07;Keskiviikko;29;117;146;2;35;37
89;06.11.2013;2013;11;08;Keskiviikko;52;194;246;12;47;59
89;06.11.2013;2013;11;09;Keskiviikko;22;94;116;11;32;43
89;06.11.2013;2013;11;10;Keskiviikko;40;63;103;9;30;39
89;06.11.2013;2013;11;11;Keskiviikko;38;80;118;15;27;42
89;06.11.2013;2013;11;12;Keskiviikko;59;51;110;23;27;50
89;06.11.2013;2013;11;13;Keskiviikko;97;62;159;29;23;52
89;06.11.2013;2013;11;14;Keskiviikko;109;59;168;23;15;38
89;06.11.2013;2013;11;15;Keskiviikko;126;59;185;22;14;36
89;06.11.2013;2013;11;16;Keskiviikko;193;79;272;42;18;60
89;06.11.2013;2013;11;17;Keskiviikko;108;73;181;28;29;57
89;06.11.2013;2013;11;18;Keskiviikko;72;61;133;30;47;77
89;06.11.2013;2013;11;19;Keskiviikko;65;65;130;25;30;55
89;06.11.2013;2013;11;20;Keskiviikko;58;37;95;24;9;33
89;06.11.2013;2013;11;21;Keskiviikko;42;24;66;16;13;29
89;06.11.2013;2013;11;22;Keskiviikko;18;12;30;5;4;9
89;06.11.2013;2013;11;23;Keskiviikko;3;6;9;2;7;9
89;07.11.2013;2013;11;00;Torstai;5;7;12;1;2;3
89;07.11.2013;2013;11;01;Torstai;2;1;3;1;0;1
89;07.11.2013;2013;11;02;Torstai;4;1;5;2;0;2
89;07.11.2013;2013;11;03;Torstai;4;2;6;1;0;1
89;07.11.2013;2013;11;04;Torstai;4;0;4;0;0;0
89;07.11.2013;2013;11;05;Torstai;3;17;20;4;2;6
89;07.11.2013;2013;11;06;Torstai;13;35;48;2;6;8
89;07.11.2013;2013;11;07;Torstai;39;125;164;6;38;44
89;07.11.2013;2013;11;08;Torstai;61;207;268;12;45;57
89;07.11.2013;2013;11;09;Torstai;38;95;133;14;35;49
89;07.11.2013;2013;11;10;Torstai;38;69;107;18;32;50
89;07.11.2013;2013;11;11;Torstai;51;51;102;28;32;60
89;07.11.2013;2013;11;12;Torstai;38;70;108;24;33;57
89;07.11.2013;2013;11;13;Torstai;64;70;134;25;31;56
89;07.11.2013;2013;11;14;Torstai;106;68;174;29;28;57
89;07.11.2013;2013;11;15;Torstai;151;73;224;33;19;52
89;07.11.2013;2013;11;16;Torstai;194;103;297;51;29;80
89;07.11.2013;2013;11;17;Torstai;132;64;196;40;23;63
89;07.11.2013;2013;11;18;Torstai;76;63;139;36;26;62
89;07.11.2013;2013;11;19;Torstai;66;38;104;34;19;53
89;07.11.2013;2013;11;20;Torstai;47;37;84;22;19;41
89;07.11.2013;2013;11;21;Torstai;44;27;71;16;4;20
89;07.11.2013;2013;11;22;Torstai;20;14;34;8;5;13
89;07.11.2013;2013;11;23;Torstai;11;16;27;0;1;1
89;08.11.2013;2013;11;00;Perjantai;6;5;11;3;0;3
89;08.11.2013;2013;11;01;Perjantai;9;1;10;2;0;2
89;08.11.2013;2013;11;02;Perjantai;9;0;9;0;2;2
89;08.11.2013;2013;11;03;Perjantai;7;3;10;1;1;2
89;08.11.2013;2013;11;04;Perjantai;5;2;7;0;0;0
89;08.11.2013;2013;11;05;Perjantai;2;15;17;0;2;2
89;08.11.2013;2013;11;06;Perjantai;14;36;50;1;2;3
89;08.11.2013;2013;11;07;Perjantai;32;130;162;8;30;38
89;08.11.2013;2013;11;08;Perjantai;51;205;256;9;45;54
89;08.11.2013;2013;11;09;Perjantai;33;108;141;14;26;40
89;08.11.2013;2013;11;10;Perjantai;33;90;123;21;26;47
89;08.11.2013;2013;11;11;Perjantai;45;76;121;31;14;45
89;08.11.2013;2013;11;12;Perjantai;51;74;125;21;37;58
89;08.11.2013;2013;11;13;Perjantai;90;81;171;23;24;47
89;08.11.2013;2013;11;14;Perjantai;119;54;173;30;36;66
89;08.11.2013;2013;11;15;Perjantai;160;78;238;28;18;46
89;08.11.2013;2013;11;16;Perjantai;123;70;193;23;22;45
89;08.11.2013;2013;11;17;Perjantai;103;51;154;28;17;45
89;08.11.2013;2013;11;18;Perjantai;49;44;93;18;16;34
89;08.11.2013;2013;11;19;Perjantai;53;33;86;16;16;32
89;08.11.2013;2013;11;20;Perjantai;47;35;82;11;10;21
89;08.11.2013;2013;11;21;Perjantai;37;19;56;3;9;12
89;08.11.2013;2013;11;22;Perjantai;23;25;48;5;3;8
89;08.11.2013;2013;11;23;Perjantai;11;13;24;6;10;16
89;09.11.2013;2013;11;00;Lauantai;10;7;17;7;6;13
89;09.11.2013;2013;11;01;Lauantai;18;8;26;4;3;7
89;09.11.2013;2013;11;02;Lauantai;11;2;13;5;4;9
89;09.11.2013;2013;11;03;Lauantai;13;3;16;7;1;8
89;09.11.2013;2013;11;04;Lauantai;9;2;11;9;0;9
89;09.11.2013;2013;11;05;Lauantai;6;5;11;1;1;2
89;09.11.2013;2013;11;06;Lauantai;3;11;14;1;2;3
89;09.11.2013;2013;11;07;Lauantai;5;6;11;2;5;7
89;09.11.2013;2013;11;08;Lauantai;9;20;29;10;11;21
89;09.11.2013;2013;11;09;Lauantai;10;46;56;20;26;46
89;09.11.2013;2013;11;10;Lauantai;23;59;82;12;28;40
89;09.11.2013;2013;11;11;Lauantai;32;60;92;28;30;58
89;09.11.2013;2013;11;12;Lauantai;37;71;108;19;35;54
89;09.11.2013;2013;11;13;Lauantai;53;70;123;28;40;68
89;09.11.2013;2013;11;14;Lauantai;72;58;130;17;19;36
89;09.11.2013;2013;11;15;Lauantai;77;54;131;20;18;38
89;09.11.2013;2013;11;16;Lauantai;50;32;82;26;18;44
89;09.11.2013;2013;11;17;Lauantai;39;29;68;21;16;37
89;09.11.2013;2013;11;18;Lauantai;47;30;77;22;25;47
89;09.11.2013;2013;11;19;Lauantai;26;42;68;16;16;32
89;09.11.2013;2013;11;20;Lauantai;22;26;48;10;20;30
89;09.11.2013;2013;11;21;Lauantai;26;26;52;13;4;17
89;09.11.2013;2013;11;22;Lauantai;17;25;42;6;5;11
89;09.11.2013;2013;11;23;Lauantai;13;17;30;1;4;5
89;10.11.2013;2013;11;00;Sunnuntai;10;27;37;5;2;7
89;10.11.2013;2013;11;01;Sunnuntai;24;9;33;4;5;9
89;10.11.2013;2013;11;02;Sunnuntai;13;2;15;5;3;8
89;10.11.2013;2013;11;03;Sunnuntai;16;2;18;4;1;5
89;10.11.2013;2013;11;04;Sunnuntai;17;2;19;6;1;7
89;10.11.2013;2013;11;05;Sunnuntai;6;1;7;1;0;1
89;10.11.2013;2013;11;06;Sunnuntai;3;8;11;1;3;4
89;10.11.2013;2013;11;07;Sunnuntai;5;6;11;1;1;2
89;10.11.2013;2013;11;08;Sunnuntai;4;6;10;5;8;13
89;10.11.2013;2013;11;09;Sunnuntai;8;12;20;6;4;10
89;10.11.2013;2013;11;10;Sunnuntai;9;10;19;11;18;29
89;10.11.2013;2013;11;11;Sunnuntai;13;13;26;20;20;40
89;10.11.2013;2013;11;12;Sunnuntai;13;22;35;20;21;41
89;10.11.2013;2013;11;13;Sunnuntai;19;23;42;16;24;40
89;10.11.2013;2013;11;14;Sunnuntai;24;25;49;15;22;37
89;10.11.2013;2013;11;15;Sunnuntai;34;27;61;14;15;29
89;10.11.2013;2013;11;16;Sunnuntai;27;23;50;24;27;51
89;10.11.2013;2013;11;17;Sunnuntai;30;16;46;24;23;47
89;10.11.2013;2013;11;18;Sunnuntai;17;12;29;20;21;41
89;10.11.2013;2013;11;19;Sunnuntai;19;18;37;15;16;31
89;10.11.2013;2013;11;20;Sunnuntai;23;15;38;13;12;25
89;10.11.2013;2013;11;21;Sunnuntai;16;10;26;9;10;19
89;10.11.2013;2013;11;22;Sunnuntai;17;5;22;6;4;10
89;10.11.2013;2013;11;23;Sunnuntai;4;1;5;8;3;11
89;11.11.2013;2013;11;00;Maanantai;3;1;4;2;1;3
89;11.11.2013;2013;11;01;Maanantai;6;3;9;1;0;1
89;11.11.2013;2013;11;02;Maanantai;2;0;2;0;0;0
89;11.11.2013;2013;11;03;Maanantai;0;1;1;0;0;0
89;11.11.2013;2013;11;04;Maanantai;1;3;4;1;0;1
89;11.11.2013;2013;11;05;Maanantai;4;13;17;0;0;0
89;11.11.2013;2013;11;06;Maanantai;13;28;41;1;4;5
89;11.11.2013;2013;11;07;Maanantai;20;153;173;3;34;37
89;11.11.2013;2013;11;08;Maanantai;65;238;303;7;45;52
89;11.11.2013;2013;11;09;Maanantai;47;129;176;10;37;47
89;11.11.2013;2013;11;10;Maanantai;34;83;117;17;31;48
89;11.11.2013;2013;11;11;Maanantai;55;73;128;25;35;60
89;11.11.2013;2013;11;12;Maanantai;70;81;151;21;35;56
89;11.11.2013;2013;11;13;Maanantai;84;91;175;24;41;65
89;11.11.2013;2013;11;14;Maanantai;111;74;185;34;37;71
89;11.11.2013;2013;11;15;Maanantai;159;85;244;37;23;60
89;11.11.2013;2013;11;16;Maanantai;218;87;305;42;14;56
89;11.11.2013;2013;11;17;Maanantai;103;66;169;24;33;57
89;11.11.2013;2013;11;18;Maanantai;78;55;133;41;27;68
89;11.11.2013;2013;11;19;Maanantai;75;37;112;38;30;68
89;11.11.2013;2013;11;20;Maanantai;43;38;81;24;17;41
89;11.11.2013;2013;11;21;Maanantai;54;18;72;16;8;24
89;11.11.2013;2013;11;22;Maanantai;14;8;22;6;5;11
89;11.11.2013;2013;11;23;Maanantai;11;2;13;1;1;2
89;12.11.2013;2013;11;00;Tiistai;1;0;1;1;0;1
89;12.11.2013;2013;11;01;Tiistai;0;0;0;0;1;1
89;12.11.2013;2013;11;02;Tiistai;3;0;3;1;0;1
89;12.11.2013;2013;11;03;Tiistai;4;3;7;0;1;1
89;12.11.2013;2013;11;04;Tiistai;0;5;5;0;0;0
89;12.11.2013;2013;11;05;Tiistai;5;8;13;1;2;3
89;12.11.2013;2013;11;06;Tiistai;15;32;47;4;8;12
89;12.11.2013;2013;11;07;Tiistai;37;116;153;3;30;33
89;12.11.2013;2013;11;08;Tiistai;56;211;267;10;31;41
89;12.11.2013;2013;11;09;Tiistai;29;95;124;18;54;72
89;12.11.2013;2013;11;10;Tiistai;30;64;94;14;25;39
89;12.11.2013;2013;11;11;Tiistai;49;74;123;25;28;53
89;12.11.2013;2013;11;12;Tiistai;47;64;111;17;21;38
89;12.11.2013;2013;11;13;Tiistai;76;59;135;22;23;45
89;12.11.2013;2013;11;14;Tiistai;92;58;150;37;28;65
89;12.11.2013;2013;11;15;Tiistai;134;77;211;27;24;51
89;12.11.2013;2013;11;16;Tiistai;198;92;290;39;21;60
89;12.11.2013;2013;11;17;Tiistai;99;64;163;34;26;60
89;12.11.2013;2013;11;18;Tiistai;87;59;146;32;28;60
89;12.11.2013;2013;11;19;Tiistai;74;47;121;35;37;72
89;12.11.2013;2013;11;20;Tiistai;63;34;97;20;34;54
89;12.11.2013;2013;11;21;Tiistai;47;24;71;18;11;29
89;12.11.2013;2013;11;22;Tiistai;16;14;30;8;4;12
89;12.11.2013;2013;11;23;Tiistai;6;13;19;5;0;5
89;13.11.2013;2013;11;00;Keskiviikko;3;6;9;1;0;1
89;13.11.2013;2013;11;01;Keskiviikko;2;2;4;0;1;1
89;13.11.2013;2013;11;02;Keskiviikko;5;1;6;0;0;0
89;13.11.2013;2013;11;03;Keskiviikko;4;1;5;0;0;0
89;13.11.2013;2013;11;04;Keskiviikko;2;3;5;2;0;2
89;13.11.2013;2013;11;05;Keskiviikko;6;6;12;0;0;0
89;13.11.2013;2013;11;06;Keskiviikko;13;30;43;3;3;6
89;13.11.2013;2013;11;07;Keskiviikko;33;135;168;8;37;45
89;13.11.2013;2013;11;08;Keskiviikko;60;221;281;10;37;47
89;13.11.2013;2013;11;09;Keskiviikko;44;125;169;7;37;44
89;13.11.2013;2013;11;10;Keskiviikko;38;99;137;19;28;47
89;13.11.2013;2013;11;11;Keskiviikko;67;98;165;26;40;66
89;13.11.2013;2013;11;12;Keskiviikko;62;102;164;28;39;67
89;13.11.2013;2013;11;13;Keskiviikko;76;87;163;32;29;61
89;13.11.2013;2013;11;14;Keskiviikko;122;55;177;35;34;69
89;13.11.2013;2013;11;15;Keskiviikko;155;64;219;36;23;59
89;13.11.2013;2013;11;16;Keskiviikko;192;84;276;37;28;65
89;13.11.2013;2013;11;17;Keskiviikko;121;69;190;23;27;50
89;13.11.2013;2013;11;18;Keskiviikko;71;74;145;25;46;71
89;13.11.2013;2013;11;19;Keskiviikko;62;46;108;28;33;61
89;13.11.2013;2013;11;20;Keskiviikko;67;43;110;18;18;36
89;13.11.2013;2013;11;21;Keskiviikko;45;15;60;16;9;25
89;13.11.2013;2013;11;22;Keskiviikko;21;15;36;6;8;14
89;13.11.2013;2013;11;23;Keskiviikko;10;11;21;7;8;15
89;14.11.2013;2013;11;00;Torstai;5;2;7;1;0;1
89;14.11.2013;2013;11;01;Torstai;4;0;4;3;0;3
89;14.11.2013;2013;11;02;Torstai;3;4;7;0;0;0
89;14.11.2013;2013;11;03;Torstai;1;1;2;4;0;4
89;14.11.2013;2013;11;04;Torstai;2;1;3;1;0;1
89;14.11.2013;2013;11;05;Torstai;7;10;17;1;1;2
89;14.11.2013;2013;11;06;Torstai;13;33;46;2;4;6
89;14.11.2013;2013;11;07;Torstai;34;127;161;4;37;41
89;14.11.2013;2013;11;08;Torstai;51;207;258;8;33;41
89;14.11.2013;2013;11;09;Torstai;28;101;129;8;42;50
89;14.11.2013;2013;11;10;Torstai;40;78;118;25;27;52
89;14.11.2013;2013;11;11;Torstai;37;55;92;16;31;47
89;14.11.2013;2013;11;12;Torstai;55;82;137;16;24;40
89;14.11.2013;2013;11;13;Torstai;60;74;134;27;33;60
89;14.11.2013;2013;11;14;Torstai;104;70;174;28;32;60
89;14.11.2013;2013;11;15;Torstai;155;88;243;32;23;55
89;14.11.2013;2013;11;16;Torstai;168;84;252;37;22;59
89;14.11.2013;2013;11;17;Torstai;107;68;175;30;26;56
89;14.11.2013;2013;11;18;Torstai;76;54;130;26;29;55
89;14.11.2013;2013;11;19;Torstai;59;39;98;26;20;46
89;14.11.2013;2013;11;20;Torstai;51;31;82;13;12;25
89;14.11.2013;2013;11;21;Torstai;53;14;67;9;8;17
89;14.11.2013;2013;11;22;Torstai;19;10;29;2;5;7
89;14.11.2013;2013;11;23;Torstai;6;10;16;5;2;7
89;15.11.2013;2013;11;00;Perjantai;3;3;6;3;3;6
89;15.11.2013;2013;11;01;Perjantai;7;1;8;1;1;2
89;15.11.2013;2013;11;02;Perjantai;5;1;6;3;0;3
89;15.11.2013;2013;11;03;Perjantai;5;2;7;0;0;0
89;15.11.2013;2013;11;04;Perjantai;6;1;7;1;0;1
89;15.11.2013;2013;11;05;Perjantai;4;7;11;0;1;1
89;15.11.2013;2013;11;06;Perjantai;15;32;47;4;6;10
89;15.11.2013;2013;11;07;Perjantai;30;112;142;4;28;32
89;15.11.2013;2013;11;08;Perjantai;49;182;231;14;36;50
89;15.11.2013;2013;11;09;Perjantai;32;95;127;6;35;41
89;15.11.2013;2013;11;10;Perjantai;39;60;99;8;20;28
89;15.11.2013;2013;11;11;Perjantai;38;73;111;22;33;55
89;15.11.2013;2013;11;12;Perjantai;54;70;124;24;26;50
89;15.11.2013;2013;11;13;Perjantai;79;69;148;17;30;47
89;15.11.2013;2013;11;14;Perjantai;110;67;177;36;23;59
89;15.11.2013;2013;11;15;Perjantai;122;88;210;28;21;49
89;15.11.2013;2013;11;16;Perjantai;157;69;226;20;11;31
89;15.11.2013;2013;11;17;Perjantai;83;65;148;27;14;41
89;15.11.2013;2013;11;18;Perjantai;44;56;100;24;25;49
89;15.11.2013;2013;11;19;Perjantai;60;24;84;23;19;42
89;15.11.2013;2013;11;20;Perjantai;44;37;81;10;12;22
89;15.11.2013;2013;11;21;Perjantai;45;35;80;5;6;11
89;15.11.2013;2013;11;22;Perjantai;21;13;34;13;2;15
89;15.11.2013;2013;11;23;Perjantai;35;10;45;5;2;7
89;16.11.2013;2013;11;00;Lauantai;17;18;35;3;2;5
89;16.11.2013;2013;11;01;Lauantai;15;7;22;5;1;6
89;16.11.2013;2013;11;02;Lauantai;21;8;29;5;3;8
89;16.11.2013;2013;11;03;Lauantai;9;1;10;4;1;5
89;16.11.2013;2013;11;04;Lauantai;14;2;16;9;0;9
89;16.11.2013;2013;11;05;Lauantai;7;9;16;5;2;7
89;16.11.2013;2013;11;06;Lauantai;6;4;10;1;2;3
89;16.11.2013;2013;11;07;Lauantai;6;14;20;3;2;5
89;16.11.2013;2013;11;08;Lauantai;10;23;33;4;9;13
89;16.11.2013;2013;11;09;Lauantai;11;46;57;7;15;22
89;16.11.2013;2013;11;10;Lauantai;20;43;63;14;28;42
89;16.11.2013;2013;11;11;Lauantai;34;79;113;24;32;56
89;16.11.2013;2013;11;12;Lauantai;52;78;130;21;48;69
89;16.11.2013;2013;11;13;Lauantai;56;88;144;14;43;57
89;16.11.2013;2013;11;14;Lauantai;75;63;138;27;46;73
89;16.11.2013;2013;11;15;Lauantai;83;73;156;42;35;77
89;16.11.2013;2013;11;16;Lauantai;69;46;115;23;21;44
89;16.11.2013;2013;11;17;Lauantai;50;46;96;14;16;30
89;16.11.2013;2013;11;18;Lauantai;37;51;88;7;13;20
89;16.11.2013;2013;11;19;Lauantai;47;35;82;9;13;22
89;16.11.2013;2013;11;20;Lauantai;28;26;54;15;15;30
89;16.11.2013;2013;11;21;Lauantai;23;12;35;1;6;7
89;16.11.2013;2013;11;22;Lauantai;26;9;35;4;9;13
89;16.11.2013;2013;11;23;Lauantai;15;21;36;2;4;6
89;17.11.2013;2013;11;00;Sunnuntai;12;15;27;6;8;14
89;17.11.2013;2013;11;01;Sunnuntai;14;5;19;5;1;6
89;17.11.2013;2013;11;02;Sunnuntai;25;10;35;10;1;11
89;17.11.2013;2013;11;03;Sunnuntai;8;1;9;11;1;12
89;17.11.2013;2013;11;04;Sunnuntai;7;2;9;8;1;9
89;17.11.2013;2013;11;05;Sunnuntai;11;2;13;5;0;5
89;17.11.2013;2013;11;06;Sunnuntai;3;4;7;1;0;1
89;17.11.2013;2013;11;07;Sunnuntai;4;5;9;0;1;1
89;17.11.2013;2013;11;08;Sunnuntai;2;7;9;3;4;7
89;17.11.2013;2013;11;09;Sunnuntai;7;9;16;7;6;13
89;17.11.2013;2013;11;10;Sunnuntai;5;22;27;11;16;27
89;17.11.2013;2013;11;11;Sunnuntai;17;28;45;8;33;41
89;17.11.2013;2013;11;12;Sunnuntai;23;35;58;20;36;56
89;17.11.2013;2013;11;13;Sunnuntai;36;49;85;18;45;63
89;17.11.2013;2013;11;14;Sunnuntai;49;42;91;22;51;73
89;17.11.2013;2013;11;15;Sunnuntai;48;26;74;25;37;62
89;17.11.2013;2013;11;16;Sunnuntai;40;40;80;24;27;51
89;17.11.2013;2013;11;17;Sunnuntai;32;24;56;17;17;34
89;17.11.2013;2013;11;18;Sunnuntai;39;29;68;14;14;28
89;17.11.2013;2013;11;19;Sunnuntai;38;18;56;14;24;38
89;17.11.2013;2013;11;20;Sunnuntai;21;27;48;9;14;23
89;17.11.2013;2013;11;21;Sunnuntai;15;9;24;7;9;16
89;17.11.2013;2013;11;22;Sunnuntai;12;7;19;5;4;9
89;17.11.2013;2013;11;23;Sunnuntai;5;4;9;0;2;2
89;18.11.2013;2013;11;00;Maanantai;5;5;10;2;0;2
89;18.11.2013;2013;11;01;Maanantai;5;1;6;1;1;2
89;18.11.2013;2013;11;02;Maanantai;2;2;4;0;0;0
89;18.11.2013;2013;11;03;Maanantai;1;2;3;0;0;0
89;18.11.2013;2013;11;04;Maanantai;2;0;2;0;1;1
89;18.11.2013;2013;11;05;Maanantai;5;13;18;1;0;1
89;18.11.2013;2013;11;06;Maanantai;16;32;48;1;5;6
89;18.11.2013;2013;11;07;Maanantai;35;129;164;6;24;30
89;18.11.2013;2013;11;08;Maanantai;47;209;256;11;48;59
89;18.11.2013;2013;11;09;Maanantai;48;118;166;4;28;32
89;18.11.2013;2013;11;10;Maanantai;45;87;132;14;39;53
89;18.11.2013;2013;11;11;Maanantai;56;72;128;20;31;51
89;18.11.2013;2013;11;12;Maanantai;44;83;127;21;31;52
89;18.11.2013;2013;11;13;Maanantai;56;70;126;13;36;49
89;18.11.2013;2013;11;14;Maanantai;104;62;166;42;22;64
89;18.11.2013;2013;11;15;Maanantai;151;68;219;43;22;65
89;18.11.2013;2013;11;16;Maanantai;203;77;280;32;27;59
89;18.11.2013;2013;11;17;Maanantai;118;56;174;38;22;60
89;18.11.2013;2013;11;18;Maanantai;78;57;135;38;20;58
89;18.11.2013;2013;11;19;Maanantai;55;40;95;27;30;57
89;18.11.2013;2013;11;20;Maanantai;57;46;103;17;12;29
89;18.11.2013;2013;11;21;Maanantai;45;17;62;18;13;31
89;18.11.2013;2013;11;22;Maanantai;27;6;33;4;5;9
89;18.11.2013;2013;11;23;Maanantai;4;2;6;0;3;3
89;19.11.2013;2013;11;00;Tiistai;2;0;2;1;1;2
89;19.11.2013;2013;11;01;Tiistai;1;3;4;1;0;1
89;19.11.2013;2013;11;02;Tiistai;1;1;2;1;0;1
89;19.11.2013;2013;11;03;Tiistai;0;0;0;1;0;1
89;19.11.2013;2013;11;04;Tiistai;3;5;8;0;0;0
89;19.11.2013;2013;11;05;Tiistai;3;9;12;2;0;2
89;19.11.2013;2013;11;06;Tiistai;11;33;44;0;3;3
89;19.11.2013;2013;11;07;Tiistai;40;126;166;2;36;38
89;19.11.2013;2013;11;08;Tiistai;48;177;225;7;43;50
89;19.11.2013;2013;11;09;Tiistai;35;107;142;15;24;39
89;19.11.2013;2013;11;10;Tiistai;31;60;91;9;23;32
89;19.11.2013;2013;11;11;Tiistai;46;58;104;18;32;50
89;19.11.2013;2013;11;12;Tiistai;52;69;121;18;25;43
89;19.11.2013;2013;11;13;Tiistai;54;47;101;15;25;40
89;19.11.2013;2013;11;14;Tiistai;82;61;143;25;16;41
89;19.11.2013;2013;11;15;Tiistai;113;69;182;19;17;36
89;19.11.2013;2013;11;16;Tiistai;170;84;254;27;21;48
89;19.11.2013;2013;11;17;Tiistai;108;50;158;19;9;28
89;19.11.2013;2013;11;18;Tiistai;62;48;110;14;13;27
89;19.11.2013;2013;11;19;Tiistai;56;24;80;14;14;28
89;19.11.2013;2013;11;20;Tiistai;39;34;73;18;17;35
89;19.11.2013;2013;11;21;Tiistai;43;23;66;9;7;16
89;19.11.2013;2013;11;22;Tiistai;9;9;18;9;2;11
89;19.11.2013;2013;11;23;Tiistai;8;2;10;0;2;2
89;20.11.2013;2013;11;00;Keskiviikko;5;2;7;0;0;0
89;20.11.2013;2013;11;01;Keskiviikko;1;0;1;0;0;0
89;20.11.2013;2013;11;02;Keskiviikko;0;1;1;0;1;1
89;20.11.2013;2013;11;03;Keskiviikko;3;1;4;0;0;0
89;20.11.2013;2013;11;04;Keskiviikko;2;3;5;1;0;1
89;20.11.2013;2013;11;05;Keskiviikko;2;12;14;0;2;2
89;20.11.2013;2013;11;06;Keskiviikko;22;37;59;6;7;13
89;20.11.2013;2013;11;07;Keskiviikko;34;141;175;2;43;45
89;20.11.2013;2013;11;08;Keskiviikko;49;218;267;9;38;47
89;20.11.2013;2013;11;09;Keskiviikko;26;106;132;7;36;43
89;20.11.2013;2013;11;10;Keskiviikko;37;65;102;16;27;43
89;20.11.2013;2013;11;11;Keskiviikko;34;72;106;25;45;70
89;20.11.2013;2013;11;12;Keskiviikko;59;74;133;36;36;72
89;20.11.2013;2013;11;13;Keskiviikko;62;77;139;46;40;86
89;20.11.2013;2013;11;14;Keskiviikko;106;56;162;34;25;59
89;20.11.2013;2013;11;15;Keskiviikko;138;78;216;26;17;43
89;20.11.2013;2013;11;16;Keskiviikko;209;75;284;43;29;72
89;20.11.2013;2013;11;17;Keskiviikko;113;63;176;24;31;55
89;20.11.2013;2013;11;18;Keskiviikko;69;51;120;39;29;68
89;20.11.2013;2013;11;19;Keskiviikko;66;35;101;37;25;62
89;20.11.2013;2013;11;20;Keskiviikko;60;52;112;28;20;48
89;20.11.2013;2013;11;21;Keskiviikko;36;29;65;10;13;23
89;20.11.2013;2013;11;22;Keskiviikko;23;17;40;7;7;14
89;20.11.2013;2013;11;23;Keskiviikko;13;6;19;0;3;3
89;21.11.2013;2013;11;00;Torstai;8;3;11;3;0;3
89;21.11.2013;2013;11;01;Torstai;7;1;8;5;0;5
89;21.11.2013;2013;11;02;Torstai;1;4;5;2;1;3
89;21.11.2013;2013;11;03;Torstai;9;2;11;2;2;4
89;21.11.2013;2013;11;04;Torstai;2;2;4;2;0;2
89;21.11.2013;2013;11;05;Torstai;3;12;15;1;2;3
89;21.11.2013;2013;11;06;Torstai;12;23;35;2;5;7
89;21.11.2013;2013;11;07;Torstai;30;112;142;1;35;36
89;21.11.2013;2013;11;08;Torstai;56;179;235;8;40;48
89;21.11.2013;2013;11;09;Torstai;32;100;132;20;44;64
89;21.11.2013;2013;11;10;Torstai;36;65;101;18;31;49
89;21.11.2013;2013;11;11;Torstai;56;48;104;14;30;44
89;21.11.2013;2013;11;12;Torstai;44;77;121;21;23;44
89;21.11.2013;2013;11;13;Torstai;68;65;133;29;30;59
89;21.11.2013;2013;11;14;Torstai;91;51;142;27;34;61
89;21.11.2013;2013;11;15;Torstai;121;71;192;33;23;56
89;21.11.2013;2013;11;16;Torstai;173;95;268;46;22;68
89;21.11.2013;2013;11;17;Torstai;85;69;154;26;13;39
89;21.11.2013;2013;11;18;Torstai;74;55;129;23;19;42
89;21.11.2013;2013;11;19;Torstai;54;29;83;24;22;46
89;21.11.2013;2013;11;20;Torstai;47;28;75;20;11;31
89;21.11.2013;2013;11;21;Torstai;45;13;58;12;9;21
89;21.11.2013;2013;11;22;Torstai;19;8;27;6;9;15
89;21.11.2013;2013;11;23;Torstai;6;4;10;1;4;5
89;22.11.2013;2013;11;00;Perjantai;8;4;12;4;3;7
89;22.11.2013;2013;11;01;Perjantai;2;0;2;5;1;6
89;22.11.2013;2013;11;02;Perjantai;4;0;4;2;0;2
89;22.11.2013;2013;11;03;Perjantai;5;6;11;2;1;3
89;22.11.2013;2013;11;04;Perjantai;4;2;6;1;2;3
89;22.11.2013;2013;11;05;Perjantai;6;11;17;3;2;5
89;22.11.2013;2013;11;06;Perjantai;11;27;38;1;7;8
89;22.11.2013;2013;11;07;Perjantai;28;100;128;2;30;32
89;22.11.2013;2013;11;08;Perjantai;41;176;217;8;50;58
89;22.11.2013;2013;11;09;Perjantai;22;105;127;19;30;49
89;22.11.2013;2013;11;10;Perjantai;21;68;89;13;27;40
89;22.11.2013;2013;11;11;Perjantai;41;44;85;28;32;60
89;22.11.2013;2013;11;12;Perjantai;41;83;124;26;32;58
89;22.11.2013;2013;11;13;Perjantai;81;71;152;42;27;69
89;22.11.2013;2013;11;14;Perjantai;111;65;176;35;29;64
89;22.11.2013;2013;11;15;Perjantai;85;71;156;27;26;53
89;22.11.2013;2013;11;16;Perjantai;122;71;193;24;19;43
89;22.11.2013;2013;11;17;Perjantai;69;71;140;28;59;87
89;22.11.2013;2013;11;18;Perjantai;56;47;103;31;31;62
89;22.11.2013;2013;11;19;Perjantai;72;60;132;37;24;61
89;22.11.2013;2013;11;20;Perjantai;64;21;85;33;8;41
89;22.11.2013;2013;11;21;Perjantai;31;26;57;14;8;22
89;22.11.2013;2013;11;22;Perjantai;28;25;53;17;4;21
89;22.11.2013;2013;11;23;Perjantai;20;8;28;12;4;16
89;23.11.2013;2013;11;00;Lauantai;14;10;24;7;7;14
89;23.11.2013;2013;11;01;Lauantai;22;9;31;5;3;8
89;23.11.2013;2013;11;02;Lauantai;11;7;18;6;2;8
89;23.11.2013;2013;11;03;Lauantai;12;3;15;11;0;11
89;23.11.2013;2013;11;04;Lauantai;17;0;17;13;0;13
89;23.11.2013;2013;11;05;Lauantai;4;4;8;1;0;1
89;23.11.2013;2013;11;06;Lauantai;4;15;19;5;3;8
89;23.11.2013;2013;11;07;Lauantai;4;8;12;0;13;13
89;23.11.2013;2013;11;08;Lauantai;8;23;31;7;7;14
89;23.11.2013;2013;11;09;Lauantai;7;41;48;6;14;20
89;23.11.2013;2013;11;10;Lauantai;13;35;48;7;25;32
89;23.11.2013;2013;11;11;Lauantai;26;39;65;15;27;42
89;23.11.2013;2013;11;12;Lauantai;35;48;83;21;42;63
89;23.11.2013;2013;11;13;Lauantai;27;37;64;21;29;50
89;23.11.2013;2013;11;14;Lauantai;33;32;65;26;30;56
89;23.11.2013;2013;11;15;Lauantai;42;34;76;17;18;35
89;23.11.2013;2013;11;16;Lauantai;36;23;59;18;17;35
89;23.11.2013;2013;11;17;Lauantai;32;40;72;18;26;44
89;23.11.2013;2013;11;18;Lauantai;26;26;52;21;13;34
89;23.11.2013;2013;11;19;Lauantai;35;15;50;18;14;32
89;23.11.2013;2013;11;20;Lauantai;22;23;45;19;11;30
89;23.11.2013;2013;11;21;Lauantai;11;24;35;10;5;15
89;23.11.2013;2013;11;22;Lauantai;22;14;36;5;8;13
89;23.11.2013;2013;11;23;Lauantai;14;18;32;7;14;21
89;24.11.2013;2013;11;00;Sunnuntai;11;28;39;5;7;12
89;24.11.2013;2013;11;01;Sunnuntai;14;10;24;1;3;4
89;24.11.2013;2013;11;02;Sunnuntai;19;2;21;9;3;12
89;24.11.2013;2013;11;03;Sunnuntai;9;3;12;12;2;14
89;24.11.2013;2013;11;04;Sunnuntai;25;4;29;10;1;11
89;24.11.2013;2013;11;05;Sunnuntai;7;0;7;8;4;12
89;24.11.2013;2013;11;06;Sunnuntai;4;9;13;1;0;1
89;24.11.2013;2013;11;07;Sunnuntai;3;0;3;5;2;7
89;24.11.2013;2013;11;08;Sunnuntai;3;7;10;6;5;11
89;24.11.2013;2013;11;09;Sunnuntai;7;11;18;10;14;24
89;24.11.2013;2013;11;10;Sunnuntai;15;12;27;32;46;78
89;24.11.2013;2013;11;11;Sunnuntai;11;33;44;58;77;135
89;24.11.2013;2013;11;12;Sunnuntai;21;45;66;91;90;181
89;24.11.2013;2013;11;13;Sunnuntai;21;51;72;92;107;199
89;24.11.2013;2013;11;14;Sunnuntai;45;27;72;83;81;164
89;24.11.2013;2013;11;15;Sunnuntai;41;34;75;64;44;108
89;24.11.2013;2013;11;16;Sunnuntai;35;25;60;43;36;79
89;24.11.2013;2013;11;17;Sunnuntai;35;31;66;34;33;67
89;24.11.2013;2013;11;18;Sunnuntai;36;22;58;34;32;66
89;24.11.2013;2013;11;19;Sunnuntai;33;19;52;38;34;72
89;24.11.2013;2013;11;20;Sunnuntai;21;13;34;39;15;54
89;24.11.2013;2013;11;21;Sunnuntai;24;11;35;14;16;30
89;24.11.2013;2013;11;22;Sunnuntai;13;8;21;7;6;13
89;24.11.2013;2013;11;23;Sunnuntai;1;7;8;4;4;8
89;25.11.2013;2013;11;00;Maanantai;6;0;6;5;2;7
89;25.11.2013;2013;11;01;Maanantai;1;0;1;1;1;2
89;25.11.2013;2013;11;02;Maanantai;2;1;3;1;2;3
89;25.11.2013;2013;11;03;Maanantai;1;3;4;1;0;1
89;25.11.2013;2013;11;04;Maanantai;3;2;5;2;0;2
89;25.11.2013;2013;11;05;Maanantai;2;10;12;2;0;2
89;25.11.2013;2013;11;06;Maanantai;16;30;46;2;10;12
89;25.11.2013;2013;11;07;Maanantai;28;108;136;6;29;35
89;25.11.2013;2013;11;08;Maanantai;33;180;213;8;43;51
89;25.11.2013;2013;11;09;Maanantai;24;106;130;8;49;57
89;25.11.2013;2013;11;10;Maanantai;38;68;106;23;26;49
89;25.11.2013;2013;11;11;Maanantai;43;55;98;20;33;53
89;25.11.2013;2013;11;12;Maanantai;48;80;128;26;32;58
89;25.11.2013;2013;11;13;Maanantai;59;67;126;23;27;50
89;25.11.2013;2013;11;14;Maanantai;90;52;142;35;31;66
89;25.11.2013;2013;11;15;Maanantai;133;67;200;34;26;60
89;25.11.2013;2013;11;16;Maanantai;163;64;227;36;15;51
89;25.11.2013;2013;11;17;Maanantai;112;53;165;26;29;55
89;25.11.2013;2013;11;18;Maanantai;72;43;115;35;14;49
89;25.11.2013;2013;11;19;Maanantai;59;30;89;28;30;58
89;25.11.2013;2013;11;20;Maanantai;42;35;77;22;17;39
89;25.11.2013;2013;11;21;Maanantai;41;21;62;13;14;27
89;25.11.2013;2013;11;22;Maanantai;25;7;32;6;4;10
89;25.11.2013;2013;11;23;Maanantai;6;13;19;2;2;4
89;26.11.2013;2013;11;00;Tiistai;1;1;2;2;0;2
89;26.11.2013;2013;11;01;Tiistai;4;3;7;0;0;0
89;26.11.2013;2013;11;02;Tiistai;1;1;2;3;1;4
89;26.11.2013;2013;11;03;Tiistai;1;1;2;0;0;0
89;26.11.2013;2013;11;04;Tiistai;1;0;1;0;0;0
89;26.11.2013;2013;11;05;Tiistai;2;10;12;2;0;2
89;26.11.2013;2013;11;06;Tiistai;12;28;40;6;6;12
89;26.11.2013;2013;11;07;Tiistai;28;112;140;5;37;42
89;26.11.2013;2013;11;08;Tiistai;40;190;230;19;42;61
89;26.11.2013;2013;11;09;Tiistai;25;99;124;10;48;58
89;26.11.2013;2013;11;10;Tiistai;33;62;95;22;34;56
89;26.11.2013;2013;11;11;Tiistai;35;44;79;28;40;68
89;26.11.2013;2013;11;12;Tiistai;48;76;124;36;29;65
89;26.11.2013;2013;11;13;Tiistai;66;67;133;30;43;73
89;26.11.2013;2013;11;14;Tiistai;98;52;150;44;23;67
89;26.11.2013;2013;11;15;Tiistai;145;58;203;40;40;80
89;26.11.2013;2013;11;16;Tiistai;166;74;240;33;30;63
89;26.11.2013;2013;11;17;Tiistai;100;65;165;32;43;75
89;26.11.2013;2013;11;18;Tiistai;62;52;114;53;29;82
89;26.11.2013;2013;11;19;Tiistai;52;24;76;21;26;47
89;26.11.2013;2013;11;20;Tiistai;50;29;79;17;13;30
89;26.11.2013;2013;11;21;Tiistai;37;14;51;9;8;17
89;26.11.2013;2013;11;22;Tiistai;15;8;23;9;2;11
89;26.11.2013;2013;11;23;Tiistai;10;2;12;1;3;4
89;27.11.2013;2013;11;00;Keskiviikko;4;4;8;0;1;1
89;27.11.2013;2013;11;01;Keskiviikko;2;4;6;0;0;0
89;27.11.2013;2013;11;02;Keskiviikko;2;0;2;1;0;1
89;27.11.2013;2013;11;03;Keskiviikko;3;1;4;2;0;2
89;27.11.2013;2013;11;04;Keskiviikko;6;5;11;2;2;4
89;27.11.2013;2013;11;05;Keskiviikko;5;7;12;0;1;1
89;27.11.2013;2013;11;06;Keskiviikko;12;26;38;4;6;10
89;27.11.2013;2013;11;07;Keskiviikko;24;84;108;2;40;42
89;27.11.2013;2013;11;08;Keskiviikko;36;159;195;11;43;54
89;27.11.2013;2013;11;09;Keskiviikko;22;96;118;12;51;63
89;27.11.2013;2013;11;10;Keskiviikko;27;53;80;19;33;52
89;27.11.2013;2013;11;11;Keskiviikko;36;64;100;27;33;60
89;27.11.2013;2013;11;12;Keskiviikko;35;36;71;15;23;38
89;27.11.2013;2013;11;13;Keskiviikko;47;54;101;21;18;39
89;27.11.2013;2013;11;14;Keskiviikko;89;27;116;28;19;47
89;27.11.2013;2013;11;15;Keskiviikko;66;41;107;34;14;48
89;27.11.2013;2013;11;16;Keskiviikko;110;42;152;20;19;39
89;27.11.2013;2013;11;17;Keskiviikko;79;37;116;30;11;41
89;27.11.2013;2013;11;18;Keskiviikko;44;25;69;14;15;29
89;27.11.2013;2013;11;19;Keskiviikko;26;9;35;16;9;25
89;27.11.2013;2013;11;20;Keskiviikko;24;21;45;14;7;21
89;27.11.2013;2013;11;21;Keskiviikko;28;7;35;10;8;18
89;27.11.2013;2013;11;22;Keskiviikko;15;7;22;8;11;19
89;27.11.2013;2013;11;23;Keskiviikko;7;4;11;2;3;5
89;28.11.2013;2013;11;00;Torstai;4;1;5;3;1;4
89;28.11.2013;2013;11;01;Torstai;2;0;2;2;0;2
89;28.11.2013;2013;11;02;Torstai;4;2;6;1;0;1
89;28.11.2013;2013;11;03;Torstai;0;2;2;1;0;1
89;28.11.2013;2013;11;04;Torstai;6;2;8;4;3;7
89;28.11.2013;2013;11;05;Torstai;4;11;15;1;0;1
89;28.11.2013;2013;11;06;Torstai;10;17;27;2;7;9
89;28.11.2013;2013;11;07;Torstai;16;54;70;0;31;31
89;28.11.2013;2013;11;08;Torstai;24;86;110;9;54;63
89;28.11.2013;2013;11;09;Torstai;17;65;82;9;24;33
89;28.11.2013;2013;11;10;Torstai;12;28;40;13;29;42
89;28.11.2013;2013;11;11;Torstai;23;29;52;20;41;61
89;28.11.2013;2013;11;12;Torstai;26;48;74;25;31;56
89;28.11.2013;2013;11;13;Torstai;40;33;73;19;24;43
89;28.11.2013;2013;11;14;Torstai;56;30;86;21;26;47
89;28.11.2013;2013;11;15;Torstai;72;53;125;26;19;45
89;28.11.2013;2013;11;16;Torstai;78;50;128;40;20;60
89;28.11.2013;2013;11;17;Torstai;47;37;84;35;19;54
89;28.11.2013;2013;11;18;Torstai;32;20;52;21;24;45
89;28.11.2013;2013;11;19;Torstai;43;17;60;26;22;48
89;28.11.2013;2013;11;20;Torstai;28;19;47;18;11;29
89;28.11.2013;2013;11;21;Torstai;34;15;49;14;12;26
89;28.11.2013;2013;11;22;Torstai;17;5;22;7;4;11
89;28.11.2013;2013;11;23;Torstai;8;11;19;3;3;6
89;29.11.2013;2013;11;00;Perjantai;9;0;9;1;2;3
89;29.11.2013;2013;11;01;Perjantai;2;1;3;1;3;4
89;29.11.2013;2013;11;02;Perjantai;3;0;3;5;0;5
89;29.11.2013;2013;11;03;Perjantai;0;1;1;2;0;2
89;29.11.2013;2013;11;04;Perjantai;7;6;13;4;0;4
89;29.11.2013;2013;11;05;Perjantai;4;7;11;1;0;1
89;29.11.2013;2013;11;06;Perjantai;10;25;35;6;10;16
89;29.11.2013;2013;11;07;Perjantai;19;66;85;2;31;33
89;29.11.2013;2013;11;08;Perjantai;26;115;141;10;44;54
89;29.11.2013;2013;11;09;Perjantai;22;78;100;21;43;64
89;29.11.2013;2013;11;10;Perjantai;32;51;83;29;32;61
89;29.11.2013;2013;11;11;Perjantai;33;55;88;17;53;70
89;29.11.2013;2013;11;12;Perjantai;57;59;116;20;53;73
89;29.11.2013;2013;11;13;Perjantai;57;38;95;32;27;59
89;29.11.2013;2013;11;14;Perjantai;66;33;99;45;37;82
89;29.11.2013;2013;11;15;Perjantai;83;55;138;25;28;53
89;29.11.2013;2013;11;16;Perjantai;88;51;139;20;19;39
89;29.11.2013;2013;11;17;Perjantai;48;34;82;35;20;55
89;29.11.2013;2013;11;18;Perjantai;47;32;79;27;29;56
89;29.11.2013;2013;11;19;Perjantai;31;21;52;16;19;35
89;29.11.2013;2013;11;20;Perjantai;33;11;44;19;10;29
89;29.11.2013;2013;11;21;Perjantai;20;20;40;10;9;19
89;29.11.2013;2013;11;22;Perjantai;19;4;23;8;5;13
89;29.11.2013;2013;11;23;Perjantai;11;7;18;6;7;13
89;30.11.2013;2013;11;00;Lauantai;10;5;15;7;10;17
89;30.11.2013;2013;11;01;Lauantai;10;5;15;8;5;13
89;30.11.2013;2013;11;02;Lauantai;5;0;5;12;0;12
89;30.11.2013;2013;11;03;Lauantai;7;5;12;8;0;8
89;30.11.2013;2013;11;04;Lauantai;3;2;5;4;1;5
89;30.11.2013;2013;11;05;Lauantai;5;3;8;1;2;3
89;30.11.2013;2013;11;06;Lauantai;2;6;8;6;4;10
89;30.11.2013;2013;11;07;Lauantai;0;9;9;0;10;10
89;30.11.2013;2013;11;08;Lauantai;9;19;28;6;14;20
89;30.11.2013;2013;11;09;Lauantai;7;31;38;12;27;39
89;30.11.2013;2013;11;10;Lauantai;11;30;41;3;29;32
89;30.11.2013;2013;11;11;Lauantai;9;17;26;15;31;46
89;30.11.2013;2013;11;12;Lauantai;23;52;75;29;37;66
89;30.11.2013;2013;11;13;Lauantai;30;29;59;27;40;67
89;30.11.2013;2013;11;14;Lauantai;31;54;85;39;44;83
89;30.11.2013;2013;11;15;Lauantai;33;38;71;40;27;67
89;30.11.2013;2013;11;16;Lauantai;45;38;83;28;29;57
89;30.11.2013;2013;11;17;Lauantai;27;37;64;25;38;63
89;30.11.2013;2013;11;18;Lauantai;31;31;62;39;13;52
89;30.11.2013;2013;11;19;Lauantai;24;17;41;21;15;36
89;30.11.2013;2013;11;20;Lauantai;22;10;32;12;14;26
89;30.11.2013;2013;11;21;Lauantai;16;15;31;6;9;15
89;30.11.2013;2013;11;22;Lauantai;16;20;36;7;8;15
89;30.11.2013;2013;11;23;Lauantai;10;12;22;5;12;17
89;01.12.2013;2013;12;00;Sunnuntai;12;12;24;5;8;13
89;01.12.2013;2013;12;01;Sunnuntai;10;12;22;5;1;6
89;01.12.2013;2013;12;02;Sunnuntai;17;2;19;12;2;14
89;01.12.2013;2013;12;03;Sunnuntai;12;2;14;6;0;6
89;01.12.2013;2013;12;04;Sunnuntai;9;1;10;11;1;12
89;01.12.2013;2013;12;05;Sunnuntai;2;1;3;2;1;3
89;01.12.2013;2013;12;06;Sunnuntai;2;1;3;0;2;2
89;01.12.2013;2013;12;07;Sunnuntai;4;0;4;1;0;1
89;01.12.2013;2013;12;08;Sunnuntai;12;0;12;7;0;7
89;01.12.2013;2013;12;09;Sunnuntai;10;0;10;28;0;28
89;01.12.2013;2013;12;10;Sunnuntai;27;0;27;34;0;34
89;01.12.2013;2013;12;11;Sunnuntai;51;2;53;46;0;46
89;01.12.2013;2013;12;12;Sunnuntai;40;0;40;50;0;50
89;01.12.2013;2013;12;13;Sunnuntai;64;2;66;64;0;64
89;01.12.2013;2013;12;14;Sunnuntai;87;2;89;96;0;96
89;01.12.2013;2013;12;15;Sunnuntai;50;1;51;41;0;41
89;01.12.2013;2013;12;16;Sunnuntai;61;3;64;45;0;45
89;01.12.2013;2013;12;17;Sunnuntai;46;0;46;51;0;51
89;01.12.2013;2013;12;18;Sunnuntai;45;0;45;38;0;38
89;01.12.2013;2013;12;19;Sunnuntai;26;1;27;38;0;38
89;01.12.2013;2013;12;20;Sunnuntai;30;0;30;31;0;31
89;01.12.2013;2013;12;21;Sunnuntai;14;0;14;21;0;21
89;01.12.2013;2013;12;22;Sunnuntai;9;0;9;9;0;9
89;01.12.2013;2013;12;23;Sunnuntai;6;0;6;5;0;5
89;02.12.2013;2013;12;00;Maanantai;3;0;3;4;0;4
89;02.12.2013;2013;12;01;Maanantai;2;0;2;2;0;2
89;02.12.2013;2013;12;02;Maanantai;4;0;4;3;0;3
89;02.12.2013;2013;12;03;Maanantai;4;0;4;0;0;0
89;02.12.2013;2013;12;04;Maanantai;2;0;2;2;0;2
89;02.12.2013;2013;12;05;Maanantai;14;0;14;2;0;2
89;02.12.2013;2013;12;06;Maanantai;37;0;37;7;0;7
89;02.12.2013;2013;12;07;Maanantai;116;1;117;44;0;44
89;02.12.2013;2013;12;08;Maanantai;208;1;209;63;0;63
89;02.12.2013;2013;12;09;Maanantai;127;0;127;61;0;61
89;02.12.2013;2013;12;10;Maanantai;87;1;88;54;0;54
89;02.12.2013;2013;12;11;Maanantai;89;0;89;57;0;57
89;02.12.2013;2013;12;12;Maanantai;90;1;91;58;0;58
89;02.12.2013;2013;12;13;Maanantai;106;0;106;57;0;57
89;02.12.2013;2013;12;14;Maanantai;133;0;133;49;0;49
89;02.12.2013;2013;12;15;Maanantai;174;0;174;60;0;60
89;02.12.2013;2013;12;16;Maanantai;203;0;203;57;0;57
89;02.12.2013;2013;12;17;Maanantai;125;1;126;53;0;53
89;02.12.2013;2013;12;18;Maanantai;95;0;95;62;0;62
89;02.12.2013;2013;12;19;Maanantai;70;0;70;66;0;66
89;02.12.2013;2013;12;20;Maanantai;61;1;62;35;0;35
89;02.12.2013;2013;12;21;Maanantai;45;0;45;27;0;27
89;02.12.2013;2013;12;22;Maanantai;25;0;25;10;0;10
89;02.12.2013;2013;12;23;Maanantai;6;0;6;4;0;4
89;03.12.2013;2013;12;00;Tiistai;0;0;0;3;0;3
89;03.12.2013;2013;12;01;Tiistai;1;0;1;0;0;0
89;03.12.2013;2013;12;02;Tiistai;4;0;4;1;0;1
89;03.12.2013;2013;12;03;Tiistai;2;0;2;1;0;1
89;03.12.2013;2013;12;04;Tiistai;4;1;5;0;0;0
89;03.12.2013;2013;12;05;Tiistai;5;10;15;3;1;4
89;03.12.2013;2013;12;06;Tiistai;13;29;42;1;9;10
89;03.12.2013;2013;12;07;Tiistai;27;106;133;6;41;47
89;03.12.2013;2013;12;08;Tiistai;37;172;209;15;51;66
89;03.12.2013;2013;12;09;Tiistai;36;95;131;11;41;52
89;03.12.2013;2013;12;10;Tiistai;31;59;90;25;39;64
89;03.12.2013;2013;12;11;Tiistai;45;51;96;22;34;56
89;03.12.2013;2013;12;12;Tiistai;49;45;94;17;20;37
89;03.12.2013;2013;12;13;Tiistai;51;54;105;19;25;44
89;03.12.2013;2013;12;14;Tiistai;79;51;130;22;10;32
89;03.12.2013;2013;12;15;Tiistai;78;60;138;29;18;47
89;03.12.2013;2013;12;16;Tiistai;153;60;213;30;13;43
89;03.12.2013;2013;12;17;Tiistai;92;47;139;26;20;46
89;03.12.2013;2013;12;18;Tiistai;58;41;99;26;12;38
89;03.12.2013;2013;12;19;Tiistai;48;27;75;18;18;36
89;03.12.2013;2013;12;20;Tiistai;38;18;56;18;14;32
89;03.12.2013;2013;12;21;Tiistai;26;8;34;14;7;21
89;03.12.2013;2013;12;22;Tiistai;16;7;23;7;5;12
89;03.12.2013;2013;12;23;Tiistai;6;1;7;5;3;8
89;04.12.2013;2013;12;00;Keskiviikko;3;4;7;0;2;2
89;04.12.2013;2013;12;01;Keskiviikko;1;0;1;1;0;1
89;04.12.2013;2013;12;02;Keskiviikko;2;1;3;0;1;1
89;04.12.2013;2013;12;03;Keskiviikko;4;2;6;0;0;0
89;04.12.2013;2013;12;04;Keskiviikko;3;5;8;2;0;2
89;04.12.2013;2013;12;05;Keskiviikko;4;8;12;1;0;1
89;04.12.2013;2013;12;06;Keskiviikko;9;22;31;6;5;11
89;04.12.2013;2013;12;07;Keskiviikko;23;87;110;5;37;42
89;04.12.2013;2013;12;08;Keskiviikko;43;153;196;13;40;53
89;04.12.2013;2013;12;09;Keskiviikko;19;85;104;8;39;47
89;04.12.2013;2013;12;10;Keskiviikko;29;62;91;8;44;52
89;04.12.2013;2013;12;11;Keskiviikko;27;63;90;15;24;39
89;04.12.2013;2013;12;12;Keskiviikko;41;49;90;16;32;48
89;04.12.2013;2013;12;13;Keskiviikko;42;59;101;18;28;46
89;04.12.2013;2013;12;14;Keskiviikko;77;49;126;39;27;66
89;04.12.2013;2013;12;15;Keskiviikko;85;49;134;58;23;81
89;04.12.2013;2013;12;16;Keskiviikko;148;71;219;51;13;64
89;04.12.2013;2013;12;17;Keskiviikko;87;38;125;39;21;60
89;04.12.2013;2013;12;18;Keskiviikko;53;49;102;32;38;70
89;04.12.2013;2013;12;19;Keskiviikko;38;36;74;29;33;62
89;04.12.2013;2013;12;20;Keskiviikko;25;27;52;32;14;46
89;04.12.2013;2013;12;21;Keskiviikko;46;20;66;13;9;22
89;04.12.2013;2013;12;22;Keskiviikko;21;7;28;13;5;18
89;04.12.2013;2013;12;23;Keskiviikko;10;13;23;2;4;6
89;05.12.2013;2013;12;00;Torstai;4;1;5;3;3;6
89;05.12.2013;2013;12;01;Torstai;9;2;11;1;0;1
89;05.12.2013;2013;12;02;Torstai;3;0;3;1;0;1
89;05.12.2013;2013;12;03;Torstai;3;1;4;7;1;8
89;05.12.2013;2013;12;04;Torstai;6;3;9;1;1;2
89;05.12.2013;2013;12;05;Torstai;2;8;10;1;1;2
89;05.12.2013;2013;12;06;Torstai;13;19;32;1;1;2
89;05.12.2013;2013;12;07;Torstai;25;77;102;12;37;49
89;05.12.2013;2013;12;08;Torstai;34;158;192;13;47;60
89;05.12.2013;2013;12;09;Torstai;21;62;83;10;38;48
89;05.12.2013;2013;12;10;Torstai;28;64;92;18;28;46
89;05.12.2013;2013;12;11;Torstai;27;55;82;23;42;65
89;05.12.2013;2013;12;12;Torstai;49;42;91;25;26;51
89;05.12.2013;2013;12;13;Torstai;53;59;112;30;26;56
89;05.12.2013;2013;12;14;Torstai;92;50;142;29;24;53
89;05.12.2013;2013;12;15;Torstai;100;71;171;37;19;56
89;05.12.2013;2013;12;16;Torstai;100;56;156;31;21;52
89;05.12.2013;2013;12;17;Torstai;75;44;119;27;23;50
89;05.12.2013;2013;12;18;Torstai;47;40;87;29;13;42
89;05.12.2013;2013;12;19;Torstai;37;27;64;34;20;54
89;05.12.2013;2013;12;20;Torstai;30;27;57;14;12;26
89;05.12.2013;2013;12;21;Torstai;27;14;41;10;10;20
89;05.12.2013;2013;12;22;Torstai;12;11;23;7;8;15
89;05.12.2013;2013;12;23;Torstai;7;4;11;9;17;26
89;06.12.2013;2013;12;00;Perjantai;8;8;16;4;2;6
89;06.12.2013;2013;12;01;Perjantai;18;4;22;7;1;8
89;06.12.2013;2013;12;02;Perjantai;10;5;15;14;3;17
89;06.12.2013;2013;12;03;Perjantai;16;1;17;8;1;9
89;06.12.2013;2013;12;04;Perjantai;9;0;9;5;2;7
89;06.12.2013;2013;12;05;Perjantai;7;2;9;5;2;7
89;06.12.2013;2013;12;06;Perjantai;3;9;12;2;2;4
89;06.12.2013;2013;12;07;Perjantai;3;2;5;3;2;5
89;06.12.2013;2013;12;08;Perjantai;0;5;5;5;9;14
89;06.12.2013;2013;12;09;Perjantai;5;10;15;8;13;21
89;06.12.2013;2013;12;10;Perjantai;4;12;16;30;26;56
89;06.12.2013;2013;12;11;Perjantai;12;22;34;20;38;58
89;06.12.2013;2013;12;12;Perjantai;15;23;38;34;40;74
89;06.12.2013;2013;12;13;Perjantai;21;24;45;40;35;75
89;06.12.2013;2013;12;14;Perjantai;23;18;41;41;33;74
89;06.12.2013;2013;12;15;Perjantai;26;15;41;30;29;59
89;06.12.2013;2013;12;16;Perjantai;14;25;39;23;23;46
89;06.12.2013;2013;12;17;Perjantai;21;27;48;16;28;44
89;06.12.2013;2013;12;18;Perjantai;19;12;31;14;14;28
89;06.12.2013;2013;12;19;Perjantai;21;5;26;11;12;23
89;06.12.2013;2013;12;20;Perjantai;9;11;20;13;12;25
89;06.12.2013;2013;12;21;Perjantai;10;14;24;11;7;18
89;06.12.2013;2013;12;22;Perjantai;13;15;28;3;4;7
89;06.12.2013;2013;12;23;Perjantai;7;9;16;4;9;13
89;07.12.2013;2013;12;00;Lauantai;9;4;13;5;5;10
89;07.12.2013;2013;12;01;Lauantai;11;4;15;1;3;4
89;07.12.2013;2013;12;02;Lauantai;5;1;6;3;0;3
89;07.12.2013;2013;12;03;Lauantai;14;1;15;4;1;5
89;07.12.2013;2013;12;04;Lauantai;5;2;7;12;1;13
89;07.12.2013;2013;12;05;Lauantai;1;3;4;4;0;4
89;07.12.2013;2013;12;06;Lauantai;3;8;11;3;3;6
89;07.12.2013;2013;12;07;Lauantai;2;7;9;2;8;10
89;07.12.2013;2013;12;08;Lauantai;2;11;13;5;2;7
89;07.12.2013;2013;12;09;Lauantai;8;27;35;7;17;24
89;07.12.2013;2013;12;10;Lauantai;12;39;51;10;30;40
89;07.12.2013;2013;12;11;Lauantai;21;40;61;8;39;47
89;07.12.2013;2013;12;12;Lauantai;25;42;67;21;52;73
89;07.12.2013;2013;12;13;Lauantai;36;47;83;25;37;62
89;07.12.2013;2013;12;14;Lauantai;31;15;46;27;26;53
89;07.12.2013;2013;12;15;Lauantai;35;34;69;25;41;66
89;07.12.2013;2013;12;16;Lauantai;34;21;55;29;13;42
89;07.12.2013;2013;12;17;Lauantai;27;16;43;26;19;45
89;07.12.2013;2013;12;18;Lauantai;28;16;44;19;11;30
89;07.12.2013;2013;12;19;Lauantai;14;18;32;10;20;30
89;07.12.2013;2013;12;20;Lauantai;15;16;31;7;7;14
89;07.12.2013;2013;12;21;Lauantai;7;15;22;2;5;7
89;07.12.2013;2013;12;22;Lauantai;9;12;21;1;9;10
89;07.12.2013;2013;12;23;Lauantai;8;15;23;4;4;8
89;08.12.2013;2013;12;00;Sunnuntai;9;8;17;1;2;3
89;08.12.2013;2013;12;01;Sunnuntai;10;6;16;2;3;5
89;08.12.2013;2013;12;02;Sunnuntai;10;7;17;7;2;9
89;08.12.2013;2013;12;03;Sunnuntai;9;0;9;6;0;6
89;08.12.2013;2013;12;04;Sunnuntai;11;0;11;10;0;10
89;08.12.2013;2013;12;05;Sunnuntai;3;0;3;1;1;2
89;08.12.2013;2013;12;06;Sunnuntai;3;1;4;2;1;3
89;08.12.2013;2013;12;07;Sunnuntai;1;2;3;1;1;2
89;08.12.2013;2013;12;08;Sunnuntai;0;5;5;4;2;6
89;08.12.2013;2013;12;09;Sunnuntai;3;6;9;6;10;16
89;08.12.2013;2013;12;10;Sunnuntai;5;13;18;11;19;30
89;08.12.2013;2013;12;11;Sunnuntai;11;24;35;20;23;43
89;08.12.2013;2013;12;12;Sunnuntai;8;22;30;16;45;61
89;08.12.2013;2013;12;13;Sunnuntai;16;35;51;24;25;49
89;08.12.2013;2013;12;14;Sunnuntai;25;29;54;26;32;58
89;08.12.2013;2013;12;15;Sunnuntai;23;14;37;27;16;43
89;08.12.2013;2013;12;16;Sunnuntai;17;16;33;26;30;56
89;08.12.2013;2013;12;17;Sunnuntai;24;25;49;23;8;31
89;08.12.2013;2013;12;18;Sunnuntai;29;8;37;26;18;44
89;08.12.2013;2013;12;19;Sunnuntai;15;14;29;19;14;33
89;08.12.2013;2013;12;20;Sunnuntai;21;5;26;14;14;28
89;08.12.2013;2013;12;21;Sunnuntai;16;6;22;9;4;13
89;08.12.2013;2013;12;22;Sunnuntai;8;5;13;3;3;6
89;08.12.2013;2013;12;23;Sunnuntai;6;1;7;2;1;3
89;09.12.2013;2013;12;00;Maanantai;4;4;8;2;1;3
89;09.12.2013;2013;12;01;Maanantai;1;0;1;0;0;0
89;09.12.2013;2013;12;02;Maanantai;3;0;3;0;0;0
89;09.12.2013;2013;12;03;Maanantai;1;3;4;1;0;1
89;09.12.2013;2013;12;04;Maanantai;4;4;8;1;0;1
89;09.12.2013;2013;12;05;Maanantai;5;10;15;0;0;0
89;09.12.2013;2013;12;06;Maanantai;14;27;41;2;6;8
89;09.12.2013;2013;12;07;Maanantai;24;94;118;4;39;43
89;09.12.2013;2013;12;08;Maanantai;33;153;186;9;50;59
89;09.12.2013;2013;12;09;Maanantai;14;77;91;6;47;53
89;09.12.2013;2013;12;10;Maanantai;20;53;73;17;31;48
89;09.12.2013;2013;12;11;Maanantai;25;57;82;11;35;46
89;09.12.2013;2013;12;12;Maanantai;24;41;65;20;28;48
89;09.12.2013;2013;12;13;Maanantai;49;42;91;31;34;65
89;09.12.2013;2013;12;14;Maanantai;74;43;117;32;27;59
89;09.12.2013;2013;12;15;Maanantai;94;49;143;34;19;53
89;09.12.2013;2013;12;16;Maanantai;125;59;184;36;17;53
89;09.12.2013;2013;12;17;Maanantai;80;23;103;27;10;37
89;09.12.2013;2013;12;18;Maanantai;53;35;88;24;14;38
89;09.12.2013;2013;12;19;Maanantai;37;21;58;21;15;36
89;09.12.2013;2013;12;20;Maanantai;33;18;51;14;2;16
89;09.12.2013;2013;12;21;Maanantai;31;15;46;11;11;22
89;09.12.2013;2013;12;22;Maanantai;15;4;19;2;3;5
89;09.12.2013;2013;12;23;Maanantai;5;4;9;4;0;4
89;10.12.2013;2013;12;00;Tiistai;1;3;4;0;1;1
89;10.12.2013;2013;12;01;Tiistai;1;0;1;0;0;0
89;10.12.2013;2013;12;02;Tiistai;3;0;3;2;0;2
89;10.12.2013;2013;12;03;Tiistai;0;3;3;0;0;0
89;10.12.2013;2013;12;04;Tiistai;2;3;5;1;0;1
89;10.12.2013;2013;12;05;Tiistai;3;7;10;0;0;0
89;10.12.2013;2013;12;06;Tiistai;15;32;47;0;5;5
89;10.12.2013;2013;12;07;Tiistai;27;98;125;7;42;49
89;10.12.2013;2013;12;08;Tiistai;33;163;196;11;41;52
89;10.12.2013;2013;12;09;Tiistai;24;92;116;6;47;53
89;10.12.2013;2013;12;10;Tiistai;18;42;60;16;28;44
89;10.12.2013;2013;12;11;Tiistai;27;53;80;19;30;49
89;10.12.2013;2013;12;12;Tiistai;26;42;68;24;24;48
89;10.12.2013;2013;12;13;Tiistai;46;39;85;20;25;45
89;10.12.2013;2013;12;14;Tiistai;64;41;105;41;32;73
89;10.12.2013;2013;12;15;Tiistai;91;52;143;35;18;53
89;10.12.2013;2013;12;16;Tiistai;146;48;194;34;21;55
89;10.12.2013;2013;12;17;Tiistai;85;29;114;37;23;60
89;10.12.2013;2013;12;18;Tiistai;43;23;66;28;27;55
89;10.12.2013;2013;12;19;Tiistai;41;28;69;29;22;51
89;10.12.2013;2013;12;20;Tiistai;31;28;59;29;19;48
89;10.12.2013;2013;12;21;Tiistai;33;18;51;20;15;35
89;10.12.2013;2013;12;22;Tiistai;13;10;23;12;3;15
89;10.12.2013;2013;12;23;Tiistai;7;4;11;1;5;6
89;11.12.2013;2013;12;00;Keskiviikko;4;1;5;1;0;1
89;11.12.2013;2013;12;01;Keskiviikko;5;2;7;2;0;2
89;11.12.2013;2013;12;02;Keskiviikko;4;1;5;0;2;2
89;11.12.2013;2013;12;03;Keskiviikko;2;0;2;0;0;0
89;11.12.2013;2013;12;04;Keskiviikko;4;1;5;3;4;7
89;11.12.2013;2013;12;05;Keskiviikko;3;11;14;3;0;3
89;11.12.2013;2013;12;06;Keskiviikko;12;18;30;3;8;11
89;11.12.2013;2013;12;07;Keskiviikko;19;106;125;5;37;42
89;11.12.2013;2013;12;08;Keskiviikko;38;164;202;11;48;59
89;11.12.2013;2013;12;09;Keskiviikko;18;87;105;7;34;41
89;11.12.2013;2013;12;10;Keskiviikko;26;62;88;19;33;52
89;11.12.2013;2013;12;11;Keskiviikko;36;59;95;13;36;49
89;11.12.2013;2013;12;12;Keskiviikko;40;54;94;19;36;55
89;11.12.2013;2013;12;13;Keskiviikko;49;46;95;21;24;45
89;11.12.2013;2013;12;14;Keskiviikko;65;42;107;20;14;34
89;11.12.2013;2013;12;15;Keskiviikko;88;34;122;34;18;52
89;11.12.2013;2013;12;16;Keskiviikko;141;46;187;24;17;41
89;11.12.2013;2013;12;17;Keskiviikko;64;52;116;30;15;45
89;11.12.2013;2013;12;18;Keskiviikko;40;32;72;19;11;30
89;11.12.2013;2013;12;19;Keskiviikko;45;15;60;14;16;30
89;11.12.2013;2013;12;20;Keskiviikko;36;16;52;17;5;22
89;11.12.2013;2013;12;21;Keskiviikko;26;7;33;9;10;19
89;11.12.2013;2013;12;22;Keskiviikko;12;2;14;4;5;9
89;11.12.2013;2013;12;23;Keskiviikko;3;8;11;5;4;9
89;12.12.2013;2013;12;00;Torstai;5;6;11;3;1;4
89;12.12.2013;2013;12;01;Torstai;6;0;6;2;0;2
89;12.12.2013;2013;12;02;Torstai;4;0;4;5;1;6
89;12.12.2013;2013;12;03;Torstai;5;5;10;1;0;1
89;12.12.2013;2013;12;04;Torstai;8;2;10;7;1;8
89;12.12.2013;2013;12;05;Torstai;5;7;12;2;0;2
89;12.12.2013;2013;12;06;Torstai;13;24;37;2;9;11
89;12.12.2013;2013;12;07;Torstai;17;71;88;6;52;58
89;12.12.2013;2013;12;08;Torstai;21;128;149;7;50;57
89;12.12.2013;2013;12;09;Torstai;26;72;98;10;28;38
89;12.12.2013;2013;12;10;Torstai;21;55;76;19;33;52
89;12.12.2013;2013;12;11;Torstai;23;36;59;15;31;46
89;12.12.2013;2013;12;12;Torstai;34;65;99;22;40;62
89;12.12.2013;2013;12;13;Torstai;31;42;73;18;25;43
89;12.12.2013;2013;12;14;Torstai;66;27;93;34;14;48
89;12.12.2013;2013;12;15;Torstai;70;36;106;40;15;55
89;12.12.2013;2013;12;16;Torstai;99;39;138;35;12;47
89;12.12.2013;2013;12;17;Torstai;57;26;83;32;9;41
89;12.12.2013;2013;12;18;Torstai;33;11;44;25;14;39
89;12.12.2013;2013;12;19;Torstai;31;19;50;22;10;32
89;12.12.2013;2013;12;20;Torstai;20;20;40;18;4;22
89;12.12.2013;2013;12;21;Torstai;19;12;31;6;10;16
89;12.12.2013;2013;12;22;Torstai;12;5;17;3;3;6
89;12.12.2013;2013;12;23;Torstai;9;5;14;4;3;7
89;13.12.2013;2013;12;00;Perjantai;5;2;7;2;1;3
89;13.12.2013;2013;12;01;Perjantai;3;0;3;1;0;1
89;13.12.2013;2013;12;02;Perjantai;2;0;2;0;0;0
89;13.12.2013;2013;12;03;Perjantai;2;1;3;0;1;1
89;13.12.2013;2013;12;04;Perjantai;1;2;3;4;4;8
89;13.12.2013;2013;12;05;Perjantai;4;7;11;0;2;2
89;13.12.2013;2013;12;06;Perjantai;11;20;31;6;5;11
89;13.12.2013;2013;12;07;Perjantai;19;77;96;3;37;40
89;13.12.2013;2013;12;08;Perjantai;30;109;139;7;45;52
89;13.12.2013;2013;12;09;Perjantai;20;77;97;7;65;72
89;13.12.2013;2013;12;10;Perjantai;24;32;56;35;33;68
89;13.12.2013;2013;12;11;Perjantai;18;47;65;10;32;42
89;13.12.2013;2013;12;12;Perjantai;34;62;96;18;32;50
89;13.12.2013;2013;12;13;Perjantai;47;58;105;32;35;67
89;13.12.2013;2013;12;14;Perjantai;76;44;120;39;24;63
89;13.12.2013;2013;12;15;Perjantai;99;51;150;37;14;51
89;13.12.2013;2013;12;16;Perjantai;84;50;134;35;21;56
89;13.12.2013;2013;12;17;Perjantai;54;32;86;27;13;40
89;13.12.2013;2013;12;18;Perjantai;38;37;75;22;21;43
89;13.12.2013;2013;12;19;Perjantai;34;25;59;13;15;28
89;13.12.2013;2013;12;20;Perjantai;28;20;48;15;13;28
89;13.12.2013;2013;12;21;Perjantai;28;21;49;11;18;29
89;13.12.2013;2013;12;22;Perjantai;19;14;33;4;4;8
89;13.12.2013;2013;12;23;Perjantai;16;19;35;9;4;13
89;14.12.2013;2013;12;00;Lauantai;13;11;24;6;13;19
89;14.12.2013;2013;12;01;Lauantai;12;5;17;9;5;14
89;14.12.2013;2013;12;02;Lauantai;10;1;11;5;2;7
89;14.12.2013;2013;12;03;Lauantai;18;2;20;9;0;9
89;14.12.2013;2013;12;04;Lauantai;12;4;16;8;1;9
89;14.12.2013;2013;12;05;Lauantai;2;3;5;6;1;7
89;14.12.2013;2013;12;06;Lauantai;5;17;22;2;2;4
89;14.12.2013;2013;12;07;Lauantai;6;7;13;4;3;7
89;14.12.2013;2013;12;08;Lauantai;3;18;21;5;13;18
89;14.12.2013;2013;12;09;Lauantai;4;31;35;9;30;39
89;14.12.2013;2013;12;10;Lauantai;7;22;29;19;33;52
89;14.12.2013;2013;12;11;Lauantai;21;56;77;15;37;52
89;14.12.2013;2013;12;12;Lauantai;35;48;83;29;53;82
89;14.12.2013;2013;12;13;Lauantai;27;52;79;25;33;58
89;14.12.2013;2013;12;14;Lauantai;36;42;78;24;28;52
89;14.12.2013;2013;12;15;Lauantai;40;19;59;39;22;61
89;14.12.2013;2013;12;16;Lauantai;37;33;70;40;29;69
89;14.12.2013;2013;12;17;Lauantai;33;18;51;30;13;43
89;14.12.2013;2013;12;18;Lauantai;23;16;39;17;18;35
89;14.12.2013;2013;12;19;Lauantai;17;16;33;11;10;21
89;14.12.2013;2013;12;20;Lauantai;13;13;26;13;11;24
89;14.12.2013;2013;12;21;Lauantai;14;13;27;6;6;12
89;14.12.2013;2013;12;22;Lauantai;9;7;16;1;8;9
89;14.12.2013;2013;12;23;Lauantai;10;11;21;5;5;10
89;15.12.2013;2013;12;00;Sunnuntai;9;12;21;3;6;9
89;15.12.2013;2013;12;01;Sunnuntai;9;4;13;0;2;2
89;15.12.2013;2013;12;02;Sunnuntai;10;2;12;6;2;8
89;15.12.2013;2013;12;03;Sunnuntai;8;3;11;8;0;8
89;15.12.2013;2013;12;04;Sunnuntai;17;3;20;15;0;15
89;15.12.2013;2013;12;05;Sunnuntai;2;1;3;3;0;3
89;15.12.2013;2013;12;06;Sunnuntai;5;4;9;1;3;4
89;15.12.2013;2013;12;07;Sunnuntai;2;4;6;2;4;6
89;15.12.2013;2013;12;08;Sunnuntai;2;5;7;5;10;15
89;15.12.2013;2013;12;09;Sunnuntai;1;10;11;11;20;31
89;15.12.2013;2013;12;10;Sunnuntai;10;7;17;24;19;43
89;15.12.2013;2013;12;11;Sunnuntai;6;21;27;29;45;74
89;15.12.2013;2013;12;12;Sunnuntai;10;31;41;20;37;57
89;15.12.2013;2013;12;13;Sunnuntai;14;41;55;44;55;99
89;15.12.2013;2013;12;14;Sunnuntai;35;54;89;30;52;82
89;15.12.2013;2013;12;15;Sunnuntai;29;33;62;34;32;66
89;15.12.2013;2013;12;16;Sunnuntai;45;38;83;35;38;73
89;15.12.2013;2013;12;17;Sunnuntai;26;13;39;27;32;59
89;15.12.2013;2013;12;18;Sunnuntai;31;9;40;50;13;63
89;15.12.2013;2013;12;19;Sunnuntai;20;10;30;31;14;45
89;15.12.2013;2013;12;20;Sunnuntai;24;16;40;15;12;27
89;15.12.2013;2013;12;21;Sunnuntai;16;6;22;11;8;19
89;15.12.2013;2013;12;22;Sunnuntai;10;4;14;4;4;8
89;15.12.2013;2013;12;23;Sunnuntai;5;2;7;6;4;10
89;16.12.2013;2013;12;00;Maanantai;5;2;7;2;2;4
89;16.12.2013;2013;12;01;Maanantai;3;2;5;1;0;1
89;16.12.2013;2013;12;02;Maanantai;2;1;3;1;1;2
89;16.12.2013;2013;12;03;Maanantai;0;4;4;0;0;0
89;16.12.2013;2013;12;04;Maanantai;4;0;4;2;3;5
89;16.12.2013;2013;12;05;Maanantai;1;8;9;2;1;3
89;16.12.2013;2013;12;06;Maanantai;18;22;40;6;11;17
89;16.12.2013;2013;12;07;Maanantai;22;97;119;6;44;50
89;16.12.2013;2013;12;08;Maanantai;32;182;214;11;51;62
89;16.12.2013;2013;12;09;Maanantai;23;100;123;12;43;55
89;16.12.2013;2013;12;10;Maanantai;29;49;78;20;42;62
89;16.12.2013;2013;12;11;Maanantai;43;53;96;29;44;73
89;16.12.2013;2013;12;12;Maanantai;33;49;82;32;32;64
89;16.12.2013;2013;12;13;Maanantai;50;64;114;33;31;64
89;16.12.2013;2013;12;14;Maanantai;83;54;137;35;37;72
89;16.12.2013;2013;12;15;Maanantai;123;51;174;30;22;52
89;16.12.2013;2013;12;16;Maanantai;147;54;201;41;17;58
89;16.12.2013;2013;12;17;Maanantai;81;42;123;38;19;57
89;16.12.2013;2013;12;18;Maanantai;49;30;79;26;5;31
89;16.12.2013;2013;12;19;Maanantai;41;21;62;21;9;30
89;16.12.2013;2013;12;20;Maanantai;32;13;45;15;8;23
89;16.12.2013;2013;12;21;Maanantai;22;10;32;11;11;22
89;16.12.2013;2013;12;22;Maanantai;16;7;23;5;2;7
89;16.12.2013;2013;12;23;Maanantai;6;2;8;3;1;4
89;17.12.2013;2013;12;00;Tiistai;2;0;2;1;2;3
89;17.12.2013;2013;12;01;Tiistai;2;2;4;0;0;0
89;17.12.2013;2013;12;02;Tiistai;1;0;1;1;0;1
89;17.12.2013;2013;12;03;Tiistai;2;2;4;0;0;0
89;17.12.2013;2013;12;04;Tiistai;5;7;12;5;4;9
89;17.12.2013;2013;12;05;Tiistai;3;7;10;1;1;2
89;17.12.2013;2013;12;06;Tiistai;9;23;32;4;10;14
89;17.12.2013;2013;12;07;Tiistai;16;55;71;4;41;45
89;17.12.2013;2013;12;08;Tiistai;20;127;147;6;62;68
89;17.12.2013;2013;12;09;Tiistai;21;64;85;13;35;48
89;17.12.2013;2013;12;10;Tiistai;7;28;35;15;26;41
89;17.12.2013;2013;12;11;Tiistai;23;43;66;23;27;50
89;17.12.2013;2013;12;12;Tiistai;34;46;80;26;44;70
89;17.12.2013;2013;12;13;Tiistai;49;56;105;27;36;63
89;17.12.2013;2013;12;14;Tiistai;59;33;92;46;32;78
89;17.12.2013;2013;12;15;Tiistai;87;53;140;43;21;64
89;17.12.2013;2013;12;16;Tiistai;121;44;165;45;29;74
89;17.12.2013;2013;12;17;Tiistai;54;46;100;40;24;64
89;17.12.2013;2013;12;18;Tiistai;46;31;77;30;24;54
89;17.12.2013;2013;12;19;Tiistai;55;15;70;46;17;63
89;17.12.2013;2013;12;20;Tiistai;35;14;49;17;17;34
89;17.12.2013;2013;12;21;Tiistai;25;15;40;8;13;21
89;17.12.2013;2013;12;22;Tiistai;16;1;17;5;3;8
89;17.12.2013;2013;12;23;Tiistai;6;4;10;3;3;6
89;18.12.2013;2013;12;00;Keskiviikko;3;3;6;3;2;5
89;18.12.2013;2013;12;01;Keskiviikko;3;4;7;0;1;1
89;18.12.2013;2013;12;02;Keskiviikko;1;1;2;0;1;1
89;18.12.2013;2013;12;03;Keskiviikko;1;3;4;0;0;0
89;18.12.2013;2013;12;04;Keskiviikko;2;2;4;1;0;1
89;18.12.2013;2013;12;05;Keskiviikko;5;15;20;7;2;9
89;18.12.2013;2013;12;06;Keskiviikko;14;21;35;2;5;7
89;18.12.2013;2013;12;07;Keskiviikko;18;98;116;2;30;32
89;18.12.2013;2013;12;08;Keskiviikko;31;149;180;9;55;64
89;18.12.2013;2013;12;09;Keskiviikko;25;72;97;10;44;54
89;18.12.2013;2013;12;10;Keskiviikko;26;49;75;8;38;46
89;18.12.2013;2013;12;11;Keskiviikko;30;60;90;20;32;52
89;18.12.2013;2013;12;12;Keskiviikko;38;61;99;22;31;53
89;18.12.2013;2013;12;13;Keskiviikko;51;69;120;25;23;48
89;18.12.2013;2013;12;14;Keskiviikko;81;40;121;34;28;62
89;18.12.2013;2013;12;15;Keskiviikko;115;53;168;43;16;59
89;18.12.2013;2013;12;16;Keskiviikko;149;60;209;35;30;65
89;18.12.2013;2013;12;17;Keskiviikko;82;48;130;32;22;54
89;18.12.2013;2013;12;18;Keskiviikko;51;42;93;40;22;62
89;18.12.2013;2013;12;19;Keskiviikko;44;12;56;27;15;42
89;18.12.2013;2013;12;20;Keskiviikko;37;24;61;33;15;48
89;18.12.2013;2013;12;21;Keskiviikko;25;20;45;11;15;26
89;18.12.2013;2013;12;22;Keskiviikko;15;2;17;4;8;12
89;18.12.2013;2013;12;23;Keskiviikko;5;5;10;3;3;6
89;19.12.2013;2013;12;00;Torstai;9;4;13;3;0;3
89;19.12.2013;2013;12;01;Torstai;2;6;8;3;1;4
89;19.12.2013;2013;12;02;Torstai;4;0;4;0;0;0
89;19.12.2013;2013;12;03;Torstai;5;3;8;2;0;2
89;19.12.2013;2013;12;04;Torstai;16;3;19;1;0;1
89;19.12.2013;2013;12;05;Torstai;10;6;16;1;2;3
89;19.12.2013;2013;12;06;Torstai;11;28;39;8;10;18
89;19.12.2013;2013;12;07;Torstai;26;102;128;4;41;45
89;19.12.2013;2013;12;08;Torstai;26;134;160;12;46;58
89;19.12.2013;2013;12;09;Torstai;22;62;84;17;35;52
89;19.12.2013;2013;12;10;Torstai;25;44;69;14;27;41
89;19.12.2013;2013;12;11;Torstai;28;63;91;19;32;51
89;19.12.2013;2013;12;12;Torstai;26;51;77;37;30;67
89;19.12.2013;2013;12;13;Torstai;50;67;117;24;27;51
89;19.12.2013;2013;12;14;Torstai;69;52;121;29;17;46
89;19.12.2013;2013;12;15;Torstai;93;44;137;39;26;65
89;19.12.2013;2013;12;16;Torstai;135;58;193;38;19;57
89;19.12.2013;2013;12;17;Torstai;79;50;129;35;10;45
89;19.12.2013;2013;12;18;Torstai;64;32;96;16;15;31
89;19.12.2013;2013;12;19;Torstai;37;14;51;25;9;34
89;19.12.2013;2013;12;20;Torstai;37;11;48;19;9;28
89;19.12.2013;2013;12;21;Torstai;31;5;36;3;14;17
89;19.12.2013;2013;12;22;Torstai;13;10;23;10;9;19
89;19.12.2013;2013;12;23;Torstai;5;11;16;4;5;9
89;20.12.2013;2013;12;00;Perjantai;6;3;9;4;3;7
89;20.12.2013;2013;12;01;Perjantai;2;1;3;2;1;3
89;20.12.2013;2013;12;02;Perjantai;7;0;7;1;1;2
89;20.12.2013;2013;12;03;Perjantai;1;2;3;1;0;1
89;20.12.2013;2013;12;04;Perjantai;3;3;6;7;3;10
89;20.12.2013;2013;12;05;Perjantai;6;13;19;3;2;5
89;20.12.2013;2013;12;06;Perjantai;7;27;34;3;4;7
89;20.12.2013;2013;12;07;Perjantai;18;68;86;1;28;29
89;20.12.2013;2013;12;08;Perjantai;26;119;145;10;37;47
89;20.12.2013;2013;12;09;Perjantai;11;68;79;9;35;44
89;20.12.2013;2013;12;10;Perjantai;27;38;65;21;29;50
89;20.12.2013;2013;12;11;Perjantai;40;58;98;20;35;55
89;20.12.2013;2013;12;12;Perjantai;36;65;101;30;34;64
89;20.12.2013;2013;12;13;Perjantai;63;49;112;22;27;49
89;20.12.2013;2013;12;14;Perjantai;83;41;124;34;21;55
89;20.12.2013;2013;12;15;Perjantai;78;35;113;26;18;44
89;20.12.2013;2013;12;16;Perjantai;77;47;124;39;21;60
89;20.12.2013;2013;12;17;Perjantai;58;36;94;20;13;33
89;20.12.2013;2013;12;18;Perjantai;39;28;67;20;22;42
89;20.12.2013;2013;12;19;Perjantai;48;29;77;14;18;32
89;20.12.2013;2013;12;20;Perjantai;25;16;41;16;9;25
89;20.12.2013;2013;12;21;Perjantai;19;20;39;10;5;15
89;20.12.2013;2013;12;22;Perjantai;17;11;28;9;9;18
89;20.12.2013;2013;12;23;Perjantai;6;7;13;5;3;8
89;21.12.2013;2013;12;00;Lauantai;22;7;29;15;2;17
89;21.12.2013;2013;12;01;Lauantai;4;7;11;4;5;9
89;21.12.2013;2013;12;02;Lauantai;11;6;17;5;10;15
89;21.12.2013;2013;12;03;Lauantai;10;0;10;13;0;13
89;21.12.2013;2013;12;04;Lauantai;10;4;14;11;0;11
89;21.12.2013;2013;12;05;Lauantai;4;0;4;3;2;5
89;21.12.2013;2013;12;06;Lauantai;3;10;13;0;5;5
89;21.12.2013;2013;12;07;Lauantai;6;11;17;0;4;4
89;21.12.2013;2013;12;08;Lauantai;7;21;28;7;10;17
89;21.12.2013;2013;12;09;Lauantai;6;28;34;8;11;19
89;21.12.2013;2013;12;10;Lauantai;12;32;44;8;21;29
89;21.12.2013;2013;12;11;Lauantai;20;41;61;16;35;51
89;21.12.2013;2013;12;12;Lauantai;19;54;73;25;30;55
89;21.12.2013;2013;12;13;Lauantai;31;33;64;17;33;50
89;21.12.2013;2013;12;14;Lauantai;42;44;86;24;24;48
89;21.12.2013;2013;12;15;Lauantai;30;25;55;26;24;50
89;21.12.2013;2013;12;16;Lauantai;37;17;54;26;16;42
89;21.12.2013;2013;12;17;Lauantai;29;21;50;24;17;41
89;21.12.2013;2013;12;18;Lauantai;38;24;62;23;22;45
89;21.12.2013;2013;12;19;Lauantai;25;10;35;16;17;33
89;21.12.2013;2013;12;20;Lauantai;19;22;41;12;10;22
89;21.12.2013;2013;12;21;Lauantai;11;23;34;13;17;30
89;21.12.2013;2013;12;22;Lauantai;14;10;24;2;4;6
89;21.12.2013;2013;12;23;Lauantai;9;13;22;3;9;12
89;22.12.2013;2013;12;00;Sunnuntai;6;8;14;6;7;13
89;22.12.2013;2013;12;01;Sunnuntai;16;1;17;3;6;9
89;22.12.2013;2013;12;02;Sunnuntai;13;7;20;12;0;12
89;22.12.2013;2013;12;03;Sunnuntai;15;1;16;5;1;6
89;22.12.2013;2013;12;04;Sunnuntai;10;1;11;10;0;10
89;22.12.2013;2013;12;05;Sunnuntai;4;1;5;3;0;3
89;22.12.2013;2013;12;06;Sunnuntai;1;7;8;3;4;7
89;22.12.2013;2013;12;07;Sunnuntai;2;1;3;2;3;5
89;22.12.2013;2013;12;08;Sunnuntai;1;5;6;8;13;21
89;22.12.2013;2013;12;09;Sunnuntai;0;9;9;14;11;25
89;22.12.2013;2013;12;10;Sunnuntai;4;11;15;17;22;39
89;22.12.2013;2013;12;11;Sunnuntai;13;29;42;24;45;69
89;22.12.2013;2013;12;12;Sunnuntai;16;36;52;19;53;72
89;22.12.2013;2013;12;13;Sunnuntai;20;28;48;28;39;67
89;22.12.2013;2013;12;14;Sunnuntai;29;41;70;35;36;71
89;22.12.2013;2013;12;15;Sunnuntai;35;21;56;23;31;54
89;22.12.2013;2013;12;16;Sunnuntai;42;26;68;32;31;63
89;22.12.2013;2013;12;17;Sunnuntai;21;12;33;29;19;48
89;22.12.2013;2013;12;18;Sunnuntai;27;14;41;25;11;36
89;22.12.2013;2013;12;19;Sunnuntai;16;11;27;11;15;26
89;22.12.2013;2013;12;20;Sunnuntai;7;4;11;4;8;12
89;22.12.2013;2013;12;21;Sunnuntai;14;15;29;11;14;25
89;22.12.2013;2013;12;22;Sunnuntai;6;2;8;4;2;6
89;22.12.2013;2013;12;23;Sunnuntai;6;2;8;3;3;6
89;23.12.2013;2013;12;00;Maanantai;1;1;2;1;2;3
89;23.12.2013;2013;12;01;Maanantai;3;0;3;1;2;3
89;23.12.2013;2013;12;02;Maanantai;5;3;8;1;0;1
89;23.12.2013;2013;12;03;Maanantai;0;1;1;2;1;3
89;23.12.2013;2013;12;04;Maanantai;0;5;5;4;1;5
89;23.12.2013;2013;12;05;Maanantai;5;7;12;0;1;1
89;23.12.2013;2013;12;06;Maanantai;5;8;13;2;5;7
89;23.12.2013;2013;12;07;Maanantai;5;18;23;1;11;12
89;23.12.2013;2013;12;08;Maanantai;5;21;26;4;6;10
89;23.12.2013;2013;12;09;Maanantai;13;31;44;4;24;28
89;23.12.2013;2013;12;10;Maanantai;8;23;31;15;14;29
89;23.12.2013;2013;12;11;Maanantai;19;25;44;13;38;51
89;23.12.2013;2013;12;12;Maanantai;20;37;57;15;23;38
89;23.12.2013;2013;12;13;Maanantai;26;33;59;17;13;30
89;23.12.2013;2013;12;14;Maanantai;38;20;58;34;19;53
89;23.12.2013;2013;12;15;Maanantai;41;24;65;31;22;53
89;23.12.2013;2013;12;16;Maanantai;34;33;67;24;23;47
89;23.12.2013;2013;12;17;Maanantai;31;19;50;24;12;36
89;23.12.2013;2013;12;18;Maanantai;20;12;32;22;18;40
89;23.12.2013;2013;12;19;Maanantai;18;7;25;19;8;27
89;23.12.2013;2013;12;20;Maanantai;13;10;23;16;7;23
89;23.12.2013;2013;12;21;Maanantai;9;5;14;8;3;11
89;23.12.2013;2013;12;22;Maanantai;8;2;10;6;0;6
89;23.12.2013;2013;12;23;Maanantai;0;2;2;1;1;2
89;24.12.2013;2013;12;00;Tiistai;4;1;5;1;0;1
89;24.12.2013;2013;12;01;Tiistai;2;3;5;1;1;2
89;24.12.2013;2013;12;02;Tiistai;3;0;3;0;0;0
89;24.12.2013;2013;12;03;Tiistai;0;1;1;0;1;1
89;24.12.2013;2013;12;04;Tiistai;0;0;0;0;0;0
89;24.12.2013;2013;12;05;Tiistai;1;3;4;0;1;1
89;24.12.2013;2013;12;06;Tiistai;1;8;9;2;4;6
89;24.12.2013;2013;12;07;Tiistai;2;6;8;4;3;7
89;24.12.2013;2013;12;08;Tiistai;3;6;9;10;13;23
89;24.12.2013;2013;12;09;Tiistai;7;8;15;7;13;20
89;24.12.2013;2013;12;10;Tiistai;9;14;23;17;24;41
89;24.12.2013;2013;12;11;Tiistai;14;16;30;25;16;41
89;24.12.2013;2013;12;12;Tiistai;13;11;24;17;31;48
89;24.12.2013;2013;12;13;Tiistai;16;10;26;18;27;45
89;24.12.2013;2013;12;14;Tiistai;12;12;24;16;18;34
89;24.12.2013;2013;12;15;Tiistai;8;6;14;23;18;41
89;24.12.2013;2013;12;16;Tiistai;9;2;11;16;6;22
89;24.12.2013;2013;12;17;Tiistai;11;8;19;9;3;12
89;24.12.2013;2013;12;18;Tiistai;3;7;10;12;9;21
89;24.12.2013;2013;12;19;Tiistai;6;3;9;4;12;16
89;24.12.2013;2013;12;20;Tiistai;6;3;9;8;10;18
89;24.12.2013;2013;12;21;Tiistai;6;5;11;9;3;12
89;24.12.2013;2013;12;22;Tiistai;5;2;7;3;1;4
89;24.12.2013;2013;12;23;Tiistai;2;3;5;1;1;2
89;25.12.2013;2013;12;00;Keskiviikko;3;0;3;2;0;2
89;25.12.2013;2013;12;01;Keskiviikko;1;3;4;1;0;1
89;25.12.2013;2013;12;02;Keskiviikko;2;3;5;0;1;1
89;25.12.2013;2013;12;03;Keskiviikko;2;0;2;1;1;2
89;25.12.2013;2013;12;04;Keskiviikko;2;0;2;1;0;1
89;25.12.2013;2013;12;05;Keskiviikko;1;0;1;0;0;0
89;25.12.2013;2013;12;06;Keskiviikko;3;3;6;0;2;2
89;25.12.2013;2013;12;07;Keskiviikko;2;4;6;1;1;2
89;25.12.2013;2013;12;08;Keskiviikko;1;0;1;2;2;4
89;25.12.2013;2013;12;09;Keskiviikko;1;2;3;4;3;7
89;25.12.2013;2013;12;10;Keskiviikko;2;4;6;7;7;14
89;25.12.2013;2013;12;11;Keskiviikko;1;3;4;19;6;25
89;25.12.2013;2013;12;12;Keskiviikko;4;7;11;19;25;44
89;25.12.2013;2013;12;13;Keskiviikko;4;9;13;22;19;41
89;25.12.2013;2013;12;14;Keskiviikko;6;4;10;19;9;28
89;25.12.2013;2013;12;15;Keskiviikko;12;6;18;10;16;26
89;25.12.2013;2013;12;16;Keskiviikko;7;5;12;9;26;35
89;25.12.2013;2013;12;17;Keskiviikko;5;11;16;18;12;30
89;25.12.2013;2013;12;18;Keskiviikko;8;11;19;15;15;30
89;25.12.2013;2013;12;19;Keskiviikko;4;4;8;10;10;20
89;25.12.2013;2013;12;20;Keskiviikko;8;2;10;7;7;14
89;25.12.2013;2013;12;21;Keskiviikko;6;3;9;2;9;11
89;25.12.2013;2013;12;22;Keskiviikko;2;6;8;5;6;11
89;25.12.2013;2013;12;23;Keskiviikko;4;0;4;2;3;5
89;26.12.2013;2013;12;00;Torstai;2;0;2;2;1;3
89;26.12.2013;2013;12;01;Torstai;0;2;2;1;0;1
89;26.12.2013;2013;12;02;Torstai;2;2;4;2;0;2
89;26.12.2013;2013;12;03;Torstai;2;0;2;1;0;1
89;26.12.2013;2013;12;04;Torstai;3;0;3;4;0;4
89;26.12.2013;2013;12;05;Torstai;3;3;6;0;3;3
89;26.12.2013;2013;12;06;Torstai;1;4;5;2;4;6
89;26.12.2013;2013;12;07;Torstai;4;5;9;1;3;4
89;26.12.2013;2013;12;08;Torstai;0;2;2;5;4;9
89;26.12.2013;2013;12;09;Torstai;1;3;4;4;11;15
89;26.12.2013;2013;12;10;Torstai;2;10;12;15;13;28
89;26.12.2013;2013;12;11;Torstai;5;6;11;27;40;67
89;26.12.2013;2013;12;12;Torstai;8;13;21;46;42;88
89;26.12.2013;2013;12;13;Torstai;13;22;35;45;38;83
89;26.12.2013;2013;12;14;Torstai;18;15;33;36;28;64
89;26.12.2013;2013;12;15;Torstai;17;1;18;32;16;48
89;26.12.2013;2013;12;16;Torstai;18;10;28;13;15;28
89;26.12.2013;2013;12;17;Torstai;13;9;22;9;15;24
89;26.12.2013;2013;12;18;Torstai;11;7;18;20;15;35
89;26.12.2013;2013;12;19;Torstai;7;18;25;24;15;39
89;26.12.2013;2013;12;20;Torstai;6;15;21;10;10;20
89;26.12.2013;2013;12;21;Torstai;9;13;22;6;13;19
89;26.12.2013;2013;12;22;Torstai;4;19;23;7;23;30
89;26.12.2013;2013;12;23;Torstai;2;4;6;5;9;14
89;27.12.2013;2013;12;00;Perjantai;5;7;12;5;4;9
89;27.12.2013;2013;12;01;Perjantai;7;3;10;7;4;11
89;27.12.2013;2013;12;02;Perjantai;14;2;16;8;0;8
89;27.12.2013;2013;12;03;Perjantai;7;1;8;10;1;11
89;27.12.2013;2013;12;04;Perjantai;7;2;9;17;0;17
89;27.12.2013;2013;12;05;Perjantai;3;6;9;2;0;2
89;27.12.2013;2013;12;06;Perjantai;6;16;22;0;6;6
89;27.12.2013;2013;12;07;Perjantai;8;28;36;6;9;15
89;27.12.2013;2013;12;08;Perjantai;6;14;20;7;16;23
89;27.12.2013;2013;12;09;Perjantai;7;19;26;6;16;22
89;27.12.2013;2013;12;10;Perjantai;14;23;37;17;31;48
89;27.12.2013;2013;12;11;Perjantai;15;42;57;29;47;76
89;27.12.2013;2013;12;12;Perjantai;27;43;70;32;51;83
89;27.12.2013;2013;12;13;Perjantai;40;55;95;25;49;74
89;27.12.2013;2013;12;14;Perjantai;37;31;68;32;31;63
89;27.12.2013;2013;12;15;Perjantai;50;31;81;32;25;57
89;27.12.2013;2013;12;16;Perjantai;50;34;84;35;18;53
89;27.12.2013;2013;12;17;Perjantai;33;23;56;15;17;32
89;27.12.2013;2013;12;18;Perjantai;27;18;45;16;14;30
89;27.12.2013;2013;12;19;Perjantai;26;13;39;9;6;15
89;27.12.2013;2013;12;20;Perjantai;17;11;28;19;8;27
89;27.12.2013;2013;12;21;Perjantai;19;9;28;16;5;21
89;27.12.2013;2013;12;22;Perjantai;7;8;15;4;14;18
89;27.12.2013;2013;12;23;Perjantai;7;10;17;5;5;10
89;28.12.2013;2013;12;00;Lauantai;11;5;16;3;4;7
89;28.12.2013;2013;12;01;Lauantai;8;3;11;8;1;9
89;28.12.2013;2013;12;02;Lauantai;3;4;7;8;3;11
89;28.12.2013;2013;12;03;Lauantai;3;0;3;9;1;10
89;28.12.2013;2013;12;04;Lauantai;5;2;7;9;0;9
89;28.12.2013;2013;12;05;Lauantai;6;1;7;2;0;2
89;28.12.2013;2013;12;06;Lauantai;2;4;6;2;1;3
89;28.12.2013;2013;12;07;Lauantai;3;5;8;1;1;2
89;28.12.2013;2013;12;08;Lauantai;3;2;5;1;4;5
89;28.12.2013;2013;12;09;Lauantai;2;14;16;3;5;8
89;28.12.2013;2013;12;10;Lauantai;5;17;22;8;18;26
89;28.12.2013;2013;12;11;Lauantai;10;24;34;13;19;32
89;28.12.2013;2013;12;12;Lauantai;15;31;46;27;52;79
89;28.12.2013;2013;12;13;Lauantai;17;43;60;51;39;90
89;28.12.2013;2013;12;14;Lauantai;45;33;78;45;54;99
89;28.12.2013;2013;12;15;Lauantai;38;27;65;40;18;58
89;28.12.2013;2013;12;16;Lauantai;30;15;45;33;18;51
89;28.12.2013;2013;12;17;Lauantai;25;14;39;26;12;38
89;28.12.2013;2013;12;18;Lauantai;13;26;39;28;18;46
89;28.12.2013;2013;12;19;Lauantai;13;14;27;24;19;43
89;28.12.2013;2013;12;20;Lauantai;14;8;22;22;19;41
89;28.12.2013;2013;12;21;Lauantai;12;20;32;9;15;24
89;28.12.2013;2013;12;22;Lauantai;6;4;10;5;9;14
89;28.12.2013;2013;12;23;Lauantai;6;4;10;1;7;8
89;29.12.2013;2013;12;00;Sunnuntai;10;5;15;1;7;8
89;29.12.2013;2013;12;01;Sunnuntai;7;5;12;4;4;8
89;29.12.2013;2013;12;02;Sunnuntai;6;1;7;5;1;6
89;29.12.2013;2013;12;03;Sunnuntai;5;0;5;7;0;7
89;29.12.2013;2013;12;04;Sunnuntai;5;1;6;8;0;8
89;29.12.2013;2013;12;05;Sunnuntai;5;0;5;0;0;0
89;29.12.2013;2013;12;06;Sunnuntai;3;3;6;3;1;4
89;29.12.2013;2013;12;07;Sunnuntai;8;4;12;3;1;4
89;29.12.2013;2013;12;08;Sunnuntai;2;2;4;1;5;6
89;29.12.2013;2013;12;09;Sunnuntai;4;7;11;10;7;17
89;29.12.2013;2013;12;10;Sunnuntai;6;11;17;17;24;41
89;29.12.2013;2013;12;11;Sunnuntai;9;26;35;41;38;79
89;29.12.2013;2013;12;12;Sunnuntai;21;40;61;40;53;93
89;29.12.2013;2013;12;13;Sunnuntai;35;47;82;49;58;107
89;29.12.2013;2013;12;14;Sunnuntai;31;35;66;67;48;115
89;29.12.2013;2013;12;15;Sunnuntai;37;29;66;37;32;69
89;29.12.2013;2013;12;16;Sunnuntai;26;19;45;40;23;63
89;29.12.2013;2013;12;17;Sunnuntai;21;20;41;28;19;47
89;29.12.2013;2013;12;18;Sunnuntai;24;21;45;28;16;44
89;29.12.2013;2013;12;19;Sunnuntai;21;15;36;20;10;30
89;29.12.2013;2013;12;20;Sunnuntai;12;10;22;17;16;33
89;29.12.2013;2013;12;21;Sunnuntai;9;8;17;15;8;23
89;29.12.2013;2013;12;22;Sunnuntai;13;2;15;7;8;15
89;29.12.2013;2013;12;23;Sunnuntai;9;8;17;7;5;12
89;06.01.2014;2014;01;00;Maanantai;6;8;14;4;4;8
89;06.01.2014;2014;01;01;Maanantai;7;5;12;1;5;6
89;06.01.2014;2014;01;02;Maanantai;2;1;3;0;0;0
89;06.01.2014;2014;01;03;Maanantai;8;0;8;5;0;5
89;06.01.2014;2014;01;04;Maanantai;8;2;10;2;0;2
89;06.01.2014;2014;01;05;Maanantai;4;2;6;5;1;6
89;06.01.2014;2014;01;06;Maanantai;5;6;11;0;2;2
89;06.01.2014;2014;01;07;Maanantai;3;4;7;4;6;10
89;06.01.2014;2014;01;08;Maanantai;5;9;14;5;6;11
89;06.01.2014;2014;01;09;Maanantai;9;15;24;14;10;24
89;06.01.2014;2014;01;10;Maanantai;8;17;25;30;23;53
89;06.01.2014;2014;01;11;Maanantai;12;20;32;37;50;87
89;06.01.2014;2014;01;12;Maanantai;22;50;72;36;54;90
89;06.01.2014;2014;01;13;Maanantai;33;33;66;51;56;107
89;06.01.2014;2014;01;14;Maanantai;39;40;79;67;63;130
89;06.01.2014;2014;01;15;Maanantai;24;31;55;52;35;87
89;06.01.2014;2014;01;16;Maanantai;38;19;57;41;41;82
89;06.01.2014;2014;01;17;Maanantai;28;23;51;35;33;68
89;06.01.2014;2014;01;18;Maanantai;18;19;37;32;34;66
89;06.01.2014;2014;01;19;Maanantai;20;16;36;37;44;81
89;06.01.2014;2014;01;20;Maanantai;18;7;25;22;26;48
89;06.01.2014;2014;01;21;Maanantai;13;8;21;11;9;20
89;06.01.2014;2014;01;22;Maanantai;5;5;10;2;5;7
89;06.01.2014;2014;01;23;Maanantai;3;4;7;1;1;2
89;07.01.2014;2014;01;00;Tiistai;5;2;7;1;0;1
89;07.01.2014;2014;01;01;Tiistai;4;1;5;3;4;7
89;07.01.2014;2014;01;02;Tiistai;0;0;0;0;1;1
89;07.01.2014;2014;01;03;Tiistai;1;0;1;0;1;1
89;07.01.2014;2014;01;04;Tiistai;0;1;1;1;0;1
89;07.01.2014;2014;01;05;Tiistai;4;7;11;2;2;4
89;07.01.2014;2014;01;06;Tiistai;16;29;45;5;12;17
89;07.01.2014;2014;01;07;Tiistai;24;91;115;8;43;51
89;07.01.2014;2014;01;08;Tiistai;29;165;194;18;58;76
89;07.01.2014;2014;01;09;Tiistai;19;84;103;25;59;84
89;07.01.2014;2014;01;10;Tiistai;31;52;83;21;37;58
89;07.01.2014;2014;01;11;Tiistai;37;64;101;30;25;55
89;07.01.2014;2014;01;12;Tiistai;33;47;80;26;34;60
89;07.01.2014;2014;01;13;Tiistai;51;54;105;33;36;69
89;07.01.2014;2014;01;14;Tiistai;80;37;117;32;31;63
89;07.01.2014;2014;01;15;Tiistai;104;45;149;46;15;61
89;07.01.2014;2014;01;16;Tiistai;148;53;201;45;23;68
89;07.01.2014;2014;01;17;Tiistai;75;44;119;34;26;60
89;07.01.2014;2014;01;18;Tiistai;39;32;71;32;28;60
89;07.01.2014;2014;01;19;Tiistai;38;23;61;24;16;40
89;07.01.2014;2014;01;20;Tiistai;36;20;56;21;18;39
89;07.01.2014;2014;01;21;Tiistai;22;13;35;11;9;20
89;07.01.2014;2014;01;22;Tiistai;7;5;12;4;3;7
89;07.01.2014;2014;01;23;Tiistai;7;2;9;5;2;7
89;08.01.2014;2014;01;00;Keskiviikko;4;3;7;1;3;4
89;08.01.2014;2014;01;01;Keskiviikko;4;2;6;1;0;1
89;08.01.2014;2014;01;02;Keskiviikko;2;1;3;1;0;1
89;08.01.2014;2014;01;03;Keskiviikko;0;1;1;1;0;1
89;08.01.2014;2014;01;04;Keskiviikko;2;5;7;1;0;1
89;08.01.2014;2014;01;05;Keskiviikko;6;5;11;2;3;5
89;08.01.2014;2014;01;06;Keskiviikko;19;24;43;4;7;11
89;08.01.2014;2014;01;07;Keskiviikko;15;94;109;6;41;47
89;08.01.2014;2014;01;08;Keskiviikko;32;163;195;17;60;77
89;08.01.2014;2014;01;09;Keskiviikko;26;66;92;9;42;51
89;08.01.2014;2014;01;10;Keskiviikko;33;59;92;30;30;60
89;08.01.2014;2014;01;11;Keskiviikko;33;72;105;32;41;73
89;08.01.2014;2014;01;12;Keskiviikko;40;43;83;26;35;61
89;08.01.2014;2014;01;13;Keskiviikko;49;46;95;27;21;48
89;08.01.2014;2014;01;14;Keskiviikko;64;45;109;27;28;55
89;08.01.2014;2014;01;15;Keskiviikko;92;48;140;44;20;64
89;08.01.2014;2014;01;16;Keskiviikko;155;52;207;43;20;63
89;08.01.2014;2014;01;17;Keskiviikko;70;45;115;47;22;69
89;08.01.2014;2014;01;18;Keskiviikko;52;27;79;36;21;57
89;08.01.2014;2014;01;19;Keskiviikko;45;27;72;17;26;43
89;08.01.2014;2014;01;20;Keskiviikko;34;20;54;26;8;34
89;08.01.2014;2014;01;21;Keskiviikko;27;17;44;22;10;32
89;08.01.2014;2014;01;22;Keskiviikko;31;12;43;4;3;7
89;08.01.2014;2014;01;23;Keskiviikko;2;2;4;6;2;8
89;09.01.2014;2014;01;00;Torstai;9;0;9;1;1;2
89;09.01.2014;2014;01;01;Torstai;3;0;3;0;0;0
89;09.01.2014;2014;01;02;Torstai;1;1;2;1;0;1
89;09.01.2014;2014;01;03;Torstai;3;1;4;0;0;0
89;09.01.2014;2014;01;04;Torstai;3;1;4;1;0;1
89;09.01.2014;2014;01;05;Torstai;3;4;7;4;0;4
89;09.01.2014;2014;01;06;Torstai;15;33;48;4;9;13
89;09.01.2014;2014;01;07;Torstai;20;103;123;7;39;46
89;09.01.2014;2014;01;08;Torstai;34;151;185;15;58;73
89;09.01.2014;2014;01;09;Torstai;17;67;84;12;37;49
89;09.01.2014;2014;01;10;Torstai;29;61;90;29;32;61
89;09.01.2014;2014;01;11;Torstai;22;48;70;20;39;59
89;09.01.2014;2014;01;12;Torstai;32;43;75;27;38;65
89;09.01.2014;2014;01;13;Torstai;32;47;79;28;33;61
89;09.01.2014;2014;01;14;Torstai;65;30;95;46;29;75
89;09.01.2014;2014;01;15;Torstai;128;61;189;48;25;73
89;09.01.2014;2014;01;16;Torstai;130;54;184;52;23;75
89;09.01.2014;2014;01;17;Torstai;78;42;120;38;25;63
89;09.01.2014;2014;01;18;Torstai;68;37;105;30;18;48
89;09.01.2014;2014;01;19;Torstai;54;30;84;47;21;68
89;09.01.2014;2014;01;20;Torstai;36;21;57;20;30;50
89;09.01.2014;2014;01;21;Torstai;34;12;46;11;8;19
89;09.01.2014;2014;01;22;Torstai;13;11;24;3;6;9
89;09.01.2014;2014;01;23;Torstai;10;3;13;6;3;9
89;10.01.2014;2014;01;00;Perjantai;0;3;3;3;3;6
89;10.01.2014;2014;01;01;Perjantai;2;1;3;0;1;1
89;10.01.2014;2014;01;02;Perjantai;1;1;2;0;0;0
89;10.01.2014;2014;01;03;Perjantai;4;0;4;1;0;1
89;10.01.2014;2014;01;04;Perjantai;3;0;3;2;0;2
89;10.01.2014;2014;01;05;Perjantai;7;0;7;9;0;9
89;10.01.2014;2014;01;06;Perjantai;42;0;42;10;0;10
89;10.01.2014;2014;01;07;Perjantai;104;1;105;45;0;45
89;10.01.2014;2014;01;08;Perjantai;161;1;162;63;0;63
89;10.01.2014;2014;01;09;Perjantai;108;0;108;58;0;58
89;10.01.2014;2014;01;10;Perjantai;67;0;67;46;0;46
89;10.01.2014;2014;01;11;Perjantai;77;1;78;54;0;54
89;10.01.2014;2014;01;12;Perjantai;103;1;104;44;1;45
89;10.01.2014;2014;01;13;Perjantai;96;0;96;58;0;58
89;10.01.2014;2014;01;14;Perjantai;132;1;133;53;1;54
89;10.01.2014;2014;01;15;Perjantai;159;0;159;46;0;46
89;10.01.2014;2014;01;16;Perjantai;167;3;170;51;0;51
89;10.01.2014;2014;01;17;Perjantai;98;2;100;43;0;43
89;10.01.2014;2014;01;18;Perjantai;73;0;73;39;0;39
89;10.01.2014;2014;01;19;Perjantai;54;1;55;28;0;28
89;10.01.2014;2014;01;20;Perjantai;48;0;48;18;0;18
89;10.01.2014;2014;01;21;Perjantai;24;0;24;20;0;20
89;10.01.2014;2014;01;22;Perjantai;24;0;24;16;0;16
89;10.01.2014;2014;01;23;Perjantai;17;0;17;6;0;6
89;11.01.2014;2014;01;00;Lauantai;17;0;17;6;0;6
89;11.01.2014;2014;01;01;Lauantai;20;0;20;5;0;5
89;11.01.2014;2014;01;02;Lauantai;12;0;12;7;0;7
89;11.01.2014;2014;01;03;Lauantai;17;0;17;6;0;6
89;11.01.2014;2014;01;04;Lauantai;14;0;14;9;0;9
89;11.01.2014;2014;01;05;Lauantai;6;0;6;4;0;4
89;11.01.2014;2014;01;06;Lauantai;13;0;13;3;0;3
89;11.01.2014;2014;01;07;Lauantai;20;0;20;12;0;12
89;11.01.2014;2014;01;08;Lauantai;16;0;16;6;0;6
89;11.01.2014;2014;01;09;Lauantai;14;3;17;34;0;34
89;11.01.2014;2014;01;10;Lauantai;33;1;34;27;0;27
89;11.01.2014;2014;01;11;Lauantai;40;0;40;41;0;41
89;11.01.2014;2014;01;12;Lauantai;46;1;47;75;0;75
89;11.01.2014;2014;01;13;Lauantai;63;1;64;78;0;78
89;11.01.2014;2014;01;14;Lauantai;81;0;81;64;0;64
89;11.01.2014;2014;01;15;Lauantai;57;1;58;55;0;55
89;11.01.2014;2014;01;16;Lauantai;56;0;56;59;0;59
89;11.01.2014;2014;01;17;Lauantai;36;1;37;30;0;30
89;11.01.2014;2014;01;18;Lauantai;50;2;52;31;0;31
89;11.01.2014;2014;01;19;Lauantai;35;0;35;21;0;21
89;11.01.2014;2014;01;20;Lauantai;29;1;30;25;0;25
89;11.01.2014;2014;01;21;Lauantai;19;0;19;23;0;23
89;11.01.2014;2014;01;22;Lauantai;11;0;11;11;0;11
89;11.01.2014;2014;01;23;Lauantai;23;1;24;13;0;13
89;12.01.2014;2014;01;00;Sunnuntai;24;0;24;13;0;13
89;12.01.2014;2014;01;01;Sunnuntai;7;0;7;6;0;6
89;12.01.2014;2014;01;02;Sunnuntai;9;0;9;4;0;4
89;12.01.2014;2014;01;03;Sunnuntai;7;0;7;6;0;6
89;12.01.2014;2014;01;04;Sunnuntai;10;0;10;4;0;4
89;12.01.2014;2014;01;05;Sunnuntai;2;0;2;1;0;1
89;12.01.2014;2014;01;06;Sunnuntai;7;0;7;4;0;4
89;12.01.2014;2014;01;07;Sunnuntai;9;0;9;3;0;3
89;12.01.2014;2014;01;08;Sunnuntai;8;0;8;20;0;20
89;12.01.2014;2014;01;09;Sunnuntai;9;0;9;14;0;14
89;12.01.2014;2014;01;10;Sunnuntai;16;0;16;52;0;52
89;12.01.2014;2014;01;11;Sunnuntai;36;1;37;70;0;70
89;12.01.2014;2014;01;12;Sunnuntai;51;0;51;71;0;71
89;12.01.2014;2014;01;13;Sunnuntai;62;0;62;86;0;86
89;12.01.2014;2014;01;14;Sunnuntai;56;0;56;92;0;92
89;12.01.2014;2014;01;15;Sunnuntai;48;1;49;62;0;62
89;12.01.2014;2014;01;16;Sunnuntai;51;1;52;45;2;47
89;12.01.2014;2014;01;17;Sunnuntai;43;0;43;44;3;47
89;12.01.2014;2014;01;18;Sunnuntai;40;3;43;42;2;44
89;12.01.2014;2014;01;19;Sunnuntai;37;2;39;32;6;38
89;12.01.2014;2014;01;20;Sunnuntai;27;0;27;26;3;29
89;12.01.2014;2014;01;21;Sunnuntai;18;0;18;13;3;16
89;12.01.2014;2014;01;22;Sunnuntai;10;0;10;9;1;10
89;12.01.2014;2014;01;23;Sunnuntai;2;0;2;1;1;2
89;13.01.2014;2014;01;00;Maanantai;5;0;5;1;1;2
89;13.01.2014;2014;01;01;Maanantai;5;0;5;0;0;0
89;13.01.2014;2014;01;02;Maanantai;2;0;2;1;1;2
89;13.01.2014;2014;01;03;Maanantai;3;0;3;2;0;2
89;13.01.2014;2014;01;04;Maanantai;2;0;2;1;1;2
89;13.01.2014;2014;01;05;Maanantai;12;1;13;0;0;0
89;13.01.2014;2014;01;06;Maanantai;39;2;41;7;4;11
89;13.01.2014;2014;01;07;Maanantai;87;10;97;29;15;44
89;13.01.2014;2014;01;08;Maanantai;171;21;192;50;15;65
89;13.01.2014;2014;01;09;Maanantai;93;12;105;31;7;38
89;13.01.2014;2014;01;10;Maanantai;68;6;74;27;3;30
89;13.01.2014;2014;01;11;Maanantai;57;8;65;40;15;55
89;13.01.2014;2014;01;12;Maanantai;56;8;64;33;16;49
89;13.01.2014;2014;01;13;Maanantai;76;9;85;34;14;48
89;13.01.2014;2014;01;14;Maanantai;77;4;81;53;6;59
89;13.01.2014;2014;01;15;Maanantai;135;8;143;45;12;57
89;13.01.2014;2014;01;16;Maanantai;190;9;199;43;7;50
89;13.01.2014;2014;01;17;Maanantai;98;9;107;36;11;47
89;13.01.2014;2014;01;18;Maanantai;72;5;77;43;11;54
89;13.01.2014;2014;01;19;Maanantai;75;5;80;29;14;43
89;13.01.2014;2014;01;20;Maanantai;44;3;47;21;8;29
89;13.01.2014;2014;01;21;Maanantai;47;0;47;22;4;26
89;13.01.2014;2014;01;22;Maanantai;25;0;25;4;1;5
89;13.01.2014;2014;01;23;Maanantai;3;0;3;3;6;9
89;14.01.2014;2014;01;00;Tiistai;8;1;9;1;0;1
89;14.01.2014;2014;01;01;Tiistai;3;0;3;0;0;0
89;14.01.2014;2014;01;02;Tiistai;2;0;2;2;0;2
89;14.01.2014;2014;01;03;Tiistai;3;0;3;2;0;2
89;14.01.2014;2014;01;04;Tiistai;0;0;0;1;0;1
89;14.01.2014;2014;01;05;Tiistai;12;0;12;0;0;0
89;14.01.2014;2014;01;06;Tiistai;34;7;41;4;10;14
89;14.01.2014;2014;01;07;Tiistai;104;11;115;35;15;50
89;14.01.2014;2014;01;08;Tiistai;143;30;173;49;24;73
89;14.01.2014;2014;01;09;Tiistai;83;29;112;14;25;39
89;14.01.2014;2014;01;10;Tiistai;53;11;64;24;10;34
89;14.01.2014;2014;01;11;Tiistai;55;16;71;36;18;54
89;14.01.2014;2014;01;12;Tiistai;57;13;70;46;10;56
89;14.01.2014;2014;01;13;Tiistai;61;11;72;36;12;48
89;14.01.2014;2014;01;14;Tiistai;85;4;89;52;10;62
89;14.01.2014;2014;01;15;Tiistai;123;18;141;49;7;56
89;14.01.2014;2014;01;16;Tiistai;155;16;171;54;16;70
89;14.01.2014;2014;01;17;Tiistai;104;11;115;45;9;54
89;14.01.2014;2014;01;18;Tiistai;79;9;88;33;9;42
89;14.01.2014;2014;01;19;Tiistai;53;2;55;27;8;35
89;14.01.2014;2014;01;20;Tiistai;36;2;38;20;4;24
89;14.01.2014;2014;01;21;Tiistai;36;5;41;19;9;28
89;14.01.2014;2014;01;22;Tiistai;10;1;11;6;3;9
89;14.01.2014;2014;01;23;Tiistai;4;1;5;5;0;5
89;15.01.2014;2014;01;00;Keskiviikko;1;0;1;2;1;3
89;15.01.2014;2014;01;01;Keskiviikko;0;0;0;0;0;0
89;15.01.2014;2014;01;02;Keskiviikko;1;0;1;0;0;0
89;15.01.2014;2014;01;03;Keskiviikko;2;0;2;0;1;1
89;15.01.2014;2014;01;04;Keskiviikko;1;1;2;1;0;1
89;15.01.2014;2014;01;05;Keskiviikko;11;1;12;1;0;1
89;15.01.2014;2014;01;06;Keskiviikko;28;6;34;7;6;13
89;15.01.2014;2014;01;07;Keskiviikko;80;22;102;27;27;54
89;15.01.2014;2014;01;08;Keskiviikko;131;41;172;38;18;56
89;15.01.2014;2014;01;09;Keskiviikko;58;28;86;32;14;46
89;15.01.2014;2014;01;10;Keskiviikko;40;11;51;33;12;45
89;15.01.2014;2014;01;11;Keskiviikko;45;5;50;30;19;49
89;15.01.2014;2014;01;12;Keskiviikko;50;13;63;33;17;50
89;15.01.2014;2014;01;13;Keskiviikko;61;11;72;35;17;52
89;15.01.2014;2014;01;14;Keskiviikko;103;9;112;49;10;59
89;15.01.2014;2014;01;15;Keskiviikko;106;13;119;50;12;62
89;15.01.2014;2014;01;16;Keskiviikko;148;9;157;48;17;65
89;15.01.2014;2014;01;17;Keskiviikko;86;16;102;27;12;39
89;15.01.2014;2014;01;18;Keskiviikko;49;13;62;32;15;47
89;15.01.2014;2014;01;19;Keskiviikko;48;3;51;35;8;43
89;15.01.2014;2014;01;20;Keskiviikko;48;3;51;23;8;31
89;15.01.2014;2014;01;21;Keskiviikko;32;5;37;16;9;25
89;15.01.2014;2014;01;22;Keskiviikko;14;2;16;4;4;8
89;15.01.2014;2014;01;23;Keskiviikko;9;5;14;5;2;7
89;16.01.2014;2014;01;00;Torstai;6;0;6;3;1;4
89;16.01.2014;2014;01;01;Torstai;2;0;2;2;0;2
89;16.01.2014;2014;01;02;Torstai;3;0;3;0;1;1
89;16.01.2014;2014;01;03;Torstai;3;2;5;1;2;3
89;16.01.2014;2014;01;04;Torstai;1;1;2;1;0;1
89;16.01.2014;2014;01;05;Torstai;9;2;11;6;2;8
89;16.01.2014;2014;01;06;Torstai;24;10;34;3;10;13
89;16.01.2014;2014;01;07;Torstai;69;20;89;20;22;42
89;16.01.2014;2014;01;08;Torstai;95;53;148;26;33;59
89;16.01.2014;2014;01;09;Torstai;51;20;71;24;24;48
89;16.01.2014;2014;01;10;Torstai;36;17;53;24;23;47
89;16.01.2014;2014;01;11;Torstai;23;14;37;28;15;43
89;16.01.2014;2014;01;12;Torstai;47;13;60;17;25;42
89;16.01.2014;2014;01;13;Torstai;50;12;62;38;19;57
89;16.01.2014;2014;01;14;Torstai;82;10;92;40;18;58
89;16.01.2014;2014;01;15;Torstai;104;14;118;35;21;56
89;16.01.2014;2014;01;16;Torstai;134;8;142;58;14;72
89;16.01.2014;2014;01;17;Torstai;89;10;99;27;15;42
89;16.01.2014;2014;01;18;Torstai;63;8;71;30;9;39
89;16.01.2014;2014;01;19;Torstai;50;11;61;22;14;36
89;16.01.2014;2014;01;20;Torstai;34;6;40;29;9;38
89;16.01.2014;2014;01;21;Torstai;32;2;34;9;10;19
89;16.01.2014;2014;01;22;Torstai;15;4;19;1;2;3
89;16.01.2014;2014;01;23;Torstai;6;1;7;4;4;8
89;17.01.2014;2014;01;00;Perjantai;0;0;0;2;1;3
89;17.01.2014;2014;01;01;Perjantai;4;0;4;1;0;1
89;17.01.2014;2014;01;02;Perjantai;0;0;0;1;0;1
89;17.01.2014;2014;01;03;Perjantai;4;0;4;2;1;3
89;17.01.2014;2014;01;04;Perjantai;4;0;4;2;1;3
89;17.01.2014;2014;01;05;Perjantai;8;0;8;0;0;0
89;17.01.2014;2014;01;06;Perjantai;34;7;41;5;8;13
89;17.01.2014;2014;01;07;Perjantai;73;32;105;21;25;46
89;17.01.2014;2014;01;08;Perjantai;117;38;155;28;28;56
89;17.01.2014;2014;01;09;Perjantai;60;24;84;15;19;34
89;17.01.2014;2014;01;10;Perjantai;43;16;59;13;22;35
89;17.01.2014;2014;01;11;Perjantai;44;26;70;23;15;38
89;17.01.2014;2014;01;12;Perjantai;36;18;54;31;21;52
89;17.01.2014;2014;01;13;Perjantai;61;16;77;43;23;66
89;17.01.2014;2014;01;14;Perjantai;97;11;108;37;16;53
89;17.01.2014;2014;01;15;Perjantai;112;24;136;33;23;56
89;17.01.2014;2014;01;16;Perjantai;109;15;124;19;14;33
89;17.01.2014;2014;01;17;Perjantai;83;13;96;33;10;43
89;17.01.2014;2014;01;18;Perjantai;42;10;52;27;15;42
89;17.01.2014;2014;01;19;Perjantai;33;9;42;11;9;20
89;17.01.2014;2014;01;20;Perjantai;33;6;39;11;6;17
89;17.01.2014;2014;01;21;Perjantai;17;8;25;7;7;14
89;17.01.2014;2014;01;22;Perjantai;14;0;14;9;8;17
89;17.01.2014;2014;01;23;Perjantai;15;4;19;7;1;8
89;18.01.2014;2014;01;00;Lauantai;6;6;12;1;1;2
89;18.01.2014;2014;01;01;Lauantai;3;1;4;3;2;5
89;18.01.2014;2014;01;02;Lauantai;9;0;9;7;3;10
89;18.01.2014;2014;01;03;Lauantai;1;2;3;6;1;7
89;18.01.2014;2014;01;04;Lauantai;6;0;6;8;0;8
89;18.01.2014;2014;01;05;Lauantai;3;0;3;0;0;0
89;18.01.2014;2014;01;06;Lauantai;10;1;11;1;2;3
89;18.01.2014;2014;01;07;Lauantai;6;1;7;1;1;2
89;18.01.2014;2014;01;08;Lauantai;9;2;11;5;5;10
89;18.01.2014;2014;01;09;Lauantai;16;10;26;4;13;17
89;18.01.2014;2014;01;10;Lauantai;21;19;40;10;22;32
89;18.01.2014;2014;01;11;Lauantai;21;5;26;25;20;45
89;18.01.2014;2014;01;12;Lauantai;25;18;43;29;34;63
89;18.01.2014;2014;01;13;Lauantai;41;8;49;39;35;74
89;18.01.2014;2014;01;14;Lauantai;37;10;47;51;27;78
89;18.01.2014;2014;01;15;Lauantai;34;16;50;28;15;43
89;18.01.2014;2014;01;16;Lauantai;47;7;54;24;10;34
89;18.01.2014;2014;01;17;Lauantai;24;16;40;12;10;22
89;18.01.2014;2014;01;18;Lauantai;29;10;39;15;12;27
89;18.01.2014;2014;01;19;Lauantai;18;11;29;9;5;14
89;18.01.2014;2014;01;20;Lauantai;19;7;26;8;4;12
89;18.01.2014;2014;01;21;Lauantai;4;4;8;5;2;7
89;18.01.2014;2014;01;22;Lauantai;10;5;15;4;2;6
89;18.01.2014;2014;01;23;Lauantai;4;2;6;3;1;4
89;19.01.2014;2014;01;00;Sunnuntai;5;4;9;9;4;13
89;19.01.2014;2014;01;01;Sunnuntai;8;1;9;6;4;10
89;19.01.2014;2014;01;02;Sunnuntai;6;4;10;3;1;4
89;19.01.2014;2014;01;03;Sunnuntai;6;0;6;1;0;1
89;19.01.2014;2014;01;04;Sunnuntai;9;0;9;13;0;13
89;19.01.2014;2014;01;05;Sunnuntai;2;0;2;0;1;1
89;19.01.2014;2014;01;06;Sunnuntai;2;0;2;0;0;0
89;19.01.2014;2014;01;07;Sunnuntai;4;0;4;1;0;1
89;19.01.2014;2014;01;08;Sunnuntai;5;0;5;5;4;9
89;19.01.2014;2014;01;09;Sunnuntai;7;1;8;11;6;17
89;19.01.2014;2014;01;10;Sunnuntai;13;4;17;22;8;30
89;19.01.2014;2014;01;11;Sunnuntai;8;12;20;14;26;40
89;19.01.2014;2014;01;12;Sunnuntai;27;12;39;30;30;60
89;19.01.2014;2014;01;13;Sunnuntai;42;15;57;30;29;59
89;19.01.2014;2014;01;14;Sunnuntai;37;24;61;49;26;75
89;19.01.2014;2014;01;15;Sunnuntai;25;10;35;36;23;59
89;19.01.2014;2014;01;16;Sunnuntai;20;9;29;19;13;32
89;19.01.2014;2014;01;17;Sunnuntai;23;5;28;21;8;29
89;19.01.2014;2014;01;18;Sunnuntai;22;5;27;20;10;30
89;19.01.2014;2014;01;19;Sunnuntai;19;4;23;16;5;21
89;19.01.2014;2014;01;20;Sunnuntai;13;7;20;10;8;18
89;19.01.2014;2014;01;21;Sunnuntai;17;2;19;9;4;13
89;19.01.2014;2014;01;22;Sunnuntai;4;0;4;4;3;7
89;19.01.2014;2014;01;23;Sunnuntai;4;1;5;1;1;2
89;20.01.2014;2014;01;00;Maanantai;1;1;2;0;2;2
89;20.01.2014;2014;01;01;Maanantai;0;0;0;0;1;1
89;20.01.2014;2014;01;02;Maanantai;1;0;1;1;2;3
89;20.01.2014;2014;01;03;Maanantai;0;2;2;0;0;0
89;20.01.2014;2014;01;04;Maanantai;0;0;0;0;0;0
89;20.01.2014;2014;01;05;Maanantai;14;1;15;0;0;0
89;20.01.2014;2014;01;06;Maanantai;22;11;33;6;10;16
89;20.01.2014;2014;01;07;Maanantai;66;34;100;20;32;52
89;20.01.2014;2014;01;08;Maanantai;97;59;156;25;41;66
89;20.01.2014;2014;01;09;Maanantai;43;26;69;19;34;53
89;20.01.2014;2014;01;10;Maanantai;33;29;62;20;18;38
89;20.01.2014;2014;01;11;Maanantai;30;27;57;22;31;53
89;20.01.2014;2014;01;12;Maanantai;48;25;73;25;38;63
89;20.01.2014;2014;01;13;Maanantai;62;18;80;27;29;56
89;20.01.2014;2014;01;14;Maanantai;78;17;95;50;14;64
89;20.01.2014;2014;01;15;Maanantai;103;21;124;44;14;58
89;20.01.2014;2014;01;16;Maanantai;167;16;183;54;22;76
89;20.01.2014;2014;01;17;Maanantai;89;11;100;35;21;56
89;20.01.2014;2014;01;18;Maanantai;63;19;82;42;17;59
89;20.01.2014;2014;01;19;Maanantai;63;17;80;34;22;56
89;20.01.2014;2014;01;20;Maanantai;32;8;40;29;17;46
89;20.01.2014;2014;01;21;Maanantai;40;6;46;20;12;32
89;20.01.2014;2014;01;22;Maanantai;26;0;26;3;5;8
89;20.01.2014;2014;01;23;Maanantai;9;2;11;2;1;3
89;21.01.2014;2014;01;00;Tiistai;3;2;5;1;0;1
89;21.01.2014;2014;01;01;Tiistai;2;3;5;0;0;0
89;21.01.2014;2014;01;02;Tiistai;1;0;1;0;1;1
89;21.01.2014;2014;01;03;Tiistai;0;3;3;1;0;1
89;21.01.2014;2014;01;04;Tiistai;0;0;0;1;0;1
89;21.01.2014;2014;01;05;Tiistai;8;4;12;1;0;1
89;21.01.2014;2014;01;06;Tiistai;24;25;49;2;9;11
89;21.01.2014;2014;01;07;Tiistai;65;41;106;25;37;62
89;21.01.2014;2014;01;08;Tiistai;80;93;173;23;54;77
89;21.01.2014;2014;01;09;Tiistai;38;56;94;14;45;59
89;21.01.2014;2014;01;10;Tiistai;33;46;79;16;30;46
89;21.01.2014;2014;01;11;Tiistai;37;36;73;38;38;76
89;21.01.2014;2014;01;12;Tiistai;36;30;66;28;32;60
89;21.01.2014;2014;01;13;Tiistai;45;22;67;29;46;75
89;21.01.2014;2014;01;14;Tiistai;59;36;95;33;23;56
89;21.01.2014;2014;01;15;Tiistai;112;34;146;35;28;63
89;21.01.2014;2014;01;16;Tiistai;146;29;175;44;20;64
89;21.01.2014;2014;01;17;Tiistai;102;19;121;40;21;61
89;21.01.2014;2014;01;18;Tiistai;50;25;75;27;25;52
89;21.01.2014;2014;01;19;Tiistai;44;16;60;36;37;73
89;21.01.2014;2014;01;20;Tiistai;40;10;50;31;17;48
89;21.01.2014;2014;01;21;Tiistai;33;7;40;15;7;22
89;21.01.2014;2014;01;22;Tiistai;15;2;17;3;2;5
89;21.01.2014;2014;01;23;Tiistai;4;2;6;2;4;6
89;22.01.2014;2014;01;00;Keskiviikko;1;1;2;2;1;3
89;22.01.2014;2014;01;01;Keskiviikko;1;0;1;2;1;3
89;22.01.2014;2014;01;02;Keskiviikko;1;0;1;0;0;0
89;22.01.2014;2014;01;03;Keskiviikko;1;2;3;0;0;0
89;22.01.2014;2014;01;04;Keskiviikko;5;0;5;0;0;0
89;22.01.2014;2014;01;05;Keskiviikko;6;3;9;1;3;4
89;22.01.2014;2014;01;06;Keskiviikko;24;12;36;4;13;17
89;22.01.2014;2014;01;07;Keskiviikko;40;62;102;6;38;44
89;22.01.2014;2014;01;08;Keskiviikko;66;121;187;11;55;66
89;22.01.2014;2014;01;09;Keskiviikko;50;48;98;12;43;55
89;22.01.2014;2014;01;10;Keskiviikko;36;42;78;14;26;40
89;22.01.2014;2014;01;11;Keskiviikko;28;27;55;33;33;66
89;22.01.2014;2014;01;12;Keskiviikko;43;31;74;24;38;62
89;22.01.2014;2014;01;13;Keskiviikko;45;30;75;25;41;66
89;22.01.2014;2014;01;14;Keskiviikko;75;29;104;51;30;81
89;22.01.2014;2014;01;15;Keskiviikko;85;35;120;35;24;59
89;22.01.2014;2014;01;16;Keskiviikko;158;26;184;54;28;82
89;22.01.2014;2014;01;17;Keskiviikko;89;27;116;35;22;57
89;22.01.2014;2014;01;18;Keskiviikko;59;25;84;30;20;50
89;22.01.2014;2014;01;19;Keskiviikko;51;13;64;30;15;45
89;22.01.2014;2014;01;20;Keskiviikko;54;16;70;24;15;39
89;22.01.2014;2014;01;21;Keskiviikko;27;11;38;14;9;23
89;22.01.2014;2014;01;22;Keskiviikko;24;5;29;2;4;6
89;22.01.2014;2014;01;23;Keskiviikko;11;0;11;1;4;5
89;23.01.2014;2014;01;00;Torstai;1;2;3;1;1;2
89;23.01.2014;2014;01;01;Torstai;2;2;4;1;1;2
89;23.01.2014;2014;01;02;Torstai;0;2;2;4;1;5
89;23.01.2014;2014;01;03;Torstai;2;0;2;1;0;1
89;23.01.2014;2014;01;04;Torstai;1;0;1;4;0;4
89;23.01.2014;2014;01;05;Torstai;6;4;10;2;1;3
89;23.01.2014;2014;01;06;Torstai;23;15;38;4;9;13
89;23.01.2014;2014;01;07;Torstai;53;53;106;11;36;47
89;23.01.2014;2014;01;08;Torstai;64;101;165;12;45;57
89;23.01.2014;2014;01;09;Torstai;34;50;84;12;28;40
89;23.01.2014;2014;01;10;Torstai;24;44;68;12;22;34
89;23.01.2014;2014;01;11;Torstai;29;34;63;12;30;42
89;23.01.2014;2014;01;12;Torstai;36;28;64;19;42;61
89;23.01.2014;2014;01;13;Torstai;43;29;72;24;22;46
89;23.01.2014;2014;01;14;Torstai;80;26;106;36;20;56
89;23.01.2014;2014;01;15;Torstai;96;37;133;29;27;56
89;23.01.2014;2014;01;16;Torstai;121;27;148;44;20;64
89;23.01.2014;2014;01;17;Torstai;73;24;97;35;19;54
89;23.01.2014;2014;01;18;Torstai;47;21;68;33;11;44
89;23.01.2014;2014;01;19;Torstai;48;15;63;25;26;51
89;23.01.2014;2014;01;20;Torstai;37;17;54;20;11;31
89;23.01.2014;2014;01;21;Torstai;27;4;31;11;10;21
89;23.01.2014;2014;01;22;Torstai;11;4;15;9;3;12
89;23.01.2014;2014;01;23;Torstai;4;2;6;2;0;2
89;24.01.2014;2014;01;00;Perjantai;5;0;5;0;2;2
89;24.01.2014;2014;01;01;Perjantai;1;0;1;1;2;3
89;24.01.2014;2014;01;02;Perjantai;2;1;3;4;3;7
89;24.01.2014;2014;01;03;Perjantai;4;2;6;0;0;0
89;24.01.2014;2014;01;04;Perjantai;2;0;2;2;0;2
89;24.01.2014;2014;01;05;Perjantai;6;2;8;0;0;0
89;24.01.2014;2014;01;06;Perjantai;27;11;38;7;6;13
89;24.01.2014;2014;01;07;Perjantai;60;59;119;9;25;34
89;24.01.2014;2014;01;08;Perjantai;75;110;185;20;35;55
89;24.01.2014;2014;01;09;Perjantai;45;46;91;22;20;42
89;24.01.2014;2014;01;10;Perjantai;27;39;66;12;24;36
89;24.01.2014;2014;01;11;Perjantai;42;40;82;23;27;50
89;24.01.2014;2014;01;12;Perjantai;48;41;89;33;32;65
89;24.01.2014;2014;01;13;Perjantai;62;45;107;26;21;47
89;24.01.2014;2014;01;14;Perjantai;118;35;153;38;30;68
89;24.01.2014;2014;01;15;Perjantai;103;51;154;27;22;49
89;24.01.2014;2014;01;16;Perjantai;117;35;152;27;11;38
89;24.01.2014;2014;01;17;Perjantai;60;31;91;27;25;52
89;24.01.2014;2014;01;18;Perjantai;50;47;97;21;16;37
89;24.01.2014;2014;01;19;Perjantai;28;19;47;18;17;35
89;24.01.2014;2014;01;20;Perjantai;31;11;42;21;10;31
89;24.01.2014;2014;01;21;Perjantai;25;15;40;17;11;28
89;24.01.2014;2014;01;22;Perjantai;19;15;34;4;6;10
89;24.01.2014;2014;01;23;Perjantai;16;13;29;6;8;14
89;25.01.2014;2014;01;00;Lauantai;11;5;16;6;5;11
89;25.01.2014;2014;01;01;Lauantai;11;1;12;2;2;4
89;25.01.2014;2014;01;02;Lauantai;10;2;12;10;0;10
89;25.01.2014;2014;01;03;Lauantai;14;3;17;2;3;5
89;25.01.2014;2014;01;04;Lauantai;11;0;11;9;0;9
89;25.01.2014;2014;01;05;Lauantai;6;0;6;0;0;0
89;25.01.2014;2014;01;06;Lauantai;4;4;8;2;4;6
89;25.01.2014;2014;01;07;Lauantai;3;5;8;5;0;5
89;25.01.2014;2014;01;08;Lauantai;10;18;28;4;11;15
89;25.01.2014;2014;01;09;Lauantai;19;42;61;10;16;26
89;25.01.2014;2014;01;10;Lauantai;19;35;54;19;38;57
89;25.01.2014;2014;01;11;Lauantai;27;42;69;23;38;61
89;25.01.2014;2014;01;12;Lauantai;41;74;115;27;41;68
89;25.01.2014;2014;01;13;Lauantai;30;51;81;40;46;86
89;25.01.2014;2014;01;14;Lauantai;47;46;93;32;35;67
89;25.01.2014;2014;01;15;Lauantai;45;39;84;30;22;52
89;25.01.2014;2014;01;16;Lauantai;59;20;79;21;27;48
89;25.01.2014;2014;01;17;Lauantai;35;24;59;12;24;36
89;25.01.2014;2014;01;18;Lauantai;36;22;58;19;12;31
89;25.01.2014;2014;01;19;Lauantai;27;16;43;18;15;33
89;25.01.2014;2014;01;20;Lauantai;18;17;35;7;14;21
89;25.01.2014;2014;01;21;Lauantai;10;16;26;15;12;27
89;25.01.2014;2014;01;22;Lauantai;7;8;15;7;12;19
89;25.01.2014;2014;01;23;Lauantai;6;13;19;7;35;42
89;26.01.2014;2014;01;00;Sunnuntai;6;8;14;4;2;6
89;26.01.2014;2014;01;01;Sunnuntai;6;2;8;5;3;8
89;26.01.2014;2014;01;02;Sunnuntai;8;3;11;3;0;3
89;26.01.2014;2014;01;03;Sunnuntai;15;1;16;15;1;16
89;26.01.2014;2014;01;04;Sunnuntai;10;1;11;2;0;2
89;26.01.2014;2014;01;05;Sunnuntai;5;1;6;3;0;3
89;26.01.2014;2014;01;06;Sunnuntai;3;5;8;0;3;3
89;26.01.2014;2014;01;07;Sunnuntai;1;6;7;4;2;6
89;26.01.2014;2014;01;08;Sunnuntai;0;5;5;7;6;13
89;26.01.2014;2014;01;09;Sunnuntai;4;12;16;13;12;25
89;26.01.2014;2014;01;10;Sunnuntai;14;21;35;24;32;56
89;26.01.2014;2014;01;11;Sunnuntai;10;30;40;36;37;73
89;26.01.2014;2014;01;12;Sunnuntai;19;35;54;42;67;109
89;26.01.2014;2014;01;13;Sunnuntai;43;33;76;45;57;102
89;26.01.2014;2014;01;14;Sunnuntai;40;41;81;57;31;88
89;26.01.2014;2014;01;15;Sunnuntai;23;25;48;32;43;75
89;26.01.2014;2014;01;16;Sunnuntai;35;20;55;38;24;62
89;26.01.2014;2014;01;17;Sunnuntai;30;29;59;27;32;59
89;26.01.2014;2014;01;18;Sunnuntai;32;19;51;27;21;48
89;26.01.2014;2014;01;19;Sunnuntai;27;18;45;23;26;49
89;26.01.2014;2014;01;20;Sunnuntai;23;5;28;18;22;40
89;26.01.2014;2014;01;21;Sunnuntai;15;10;25;8;8;16
89;26.01.2014;2014;01;22;Sunnuntai;7;2;9;2;3;5
89;26.01.2014;2014;01;23;Sunnuntai;3;5;8;2;2;4
89;27.01.2014;2014;01;00;Maanantai;2;1;3;1;2;3
89;27.01.2014;2014;01;01;Maanantai;2;1;3;1;2;3
89;27.01.2014;2014;01;02;Maanantai;2;0;2;0;0;0
89;27.01.2014;2014;01;03;Maanantai;0;1;1;0;0;0
89;27.01.2014;2014;01;04;Maanantai;3;2;5;1;0;1
89;27.01.2014;2014;01;05;Maanantai;3;9;12;0;0;0
89;27.01.2014;2014;01;06;Maanantai;12;31;43;5;10;15
89;27.01.2014;2014;01;07;Maanantai;29;93;122;6;39;45
89;27.01.2014;2014;01;08;Maanantai;41;142;183;16;52;68
89;27.01.2014;2014;01;09;Maanantai;25;82;107;14;52;66
89;27.01.2014;2014;01;10;Maanantai;38;59;97;21;27;48
89;27.01.2014;2014;01;11;Maanantai;36;49;85;29;28;57
89;27.01.2014;2014;01;12;Maanantai;51;47;98;27;32;59
89;27.01.2014;2014;01;13;Maanantai;54;57;111;27;35;62
89;27.01.2014;2014;01;14;Maanantai;83;49;132;43;27;70
89;27.01.2014;2014;01;15;Maanantai;114;60;174;34;27;61
89;27.01.2014;2014;01;16;Maanantai;130;53;183;52;26;78
89;27.01.2014;2014;01;17;Maanantai;88;65;153;40;26;66
89;27.01.2014;2014;01;18;Maanantai;53;30;83;26;13;39
89;27.01.2014;2014;01;19;Maanantai;45;24;69;25;26;51
89;27.01.2014;2014;01;20;Maanantai;28;27;55;23;15;38
89;27.01.2014;2014;01;21;Maanantai;28;16;44;19;9;28
89;27.01.2014;2014;01;22;Maanantai;17;7;24;2;3;5
89;27.01.2014;2014;01;23;Maanantai;3;1;4;0;3;3
89;28.01.2014;2014;01;00;Tiistai;2;0;2;1;4;5
89;28.01.2014;2014;01;01;Tiistai;0;1;1;1;0;1
89;28.01.2014;2014;01;02;Tiistai;0;0;0;0;0;0
89;28.01.2014;2014;01;03;Tiistai;0;3;3;0;1;1
89;28.01.2014;2014;01;04;Tiistai;0;3;3;0;0;0
89;28.01.2014;2014;01;05;Tiistai;3;5;8;2;0;2
89;28.01.2014;2014;01;06;Tiistai;16;22;38;3;8;11
89;28.01.2014;2014;01;07;Tiistai;31;101;132;5;34;39
89;28.01.2014;2014;01;08;Tiistai;28;145;173;15;70;85
89;28.01.2014;2014;01;09;Tiistai;24;87;111;9;41;50
89;28.01.2014;2014;01;10;Tiistai;30;60;90;20;37;57
89;28.01.2014;2014;01;11;Tiistai;41;55;96;23;33;56
89;28.01.2014;2014;01;12;Tiistai;37;42;79;36;23;59
89;28.01.2014;2014;01;13;Tiistai;32;48;80;37;49;86
89;28.01.2014;2014;01;14;Tiistai;79;26;105;40;31;71
89;28.01.2014;2014;01;15;Tiistai;86;65;151;38;28;66
89;28.01.2014;2014;01;16;Tiistai;122;55;177;40;17;57
89;28.01.2014;2014;01;17;Tiistai;73;40;113;40;30;70
89;28.01.2014;2014;01;18;Tiistai;52;36;88;24;22;46
89;28.01.2014;2014;01;19;Tiistai;48;22;70;24;32;56
89;28.01.2014;2014;01;20;Tiistai;32;26;58;22;9;31
89;28.01.2014;2014;01;21;Tiistai;35;10;45;14;5;19
89;28.01.2014;2014;01;22;Tiistai;13;7;20;6;2;8
89;28.01.2014;2014;01;23;Tiistai;10;7;17;2;0;2
89;29.01.2014;2014;01;00;Keskiviikko;1;1;2;1;0;1
89;29.01.2014;2014;01;01;Keskiviikko;1;0;1;1;0;1
89;29.01.2014;2014;01;02;Keskiviikko;0;1;1;0;0;0
89;29.01.2014;2014;01;03;Keskiviikko;0;3;3;0;1;1
89;29.01.2014;2014;01;04;Keskiviikko;0;3;3;0;0;0
89;29.01.2014;2014;01;05;Keskiviikko;5;5;10;0;1;1
89;29.01.2014;2014;01;06;Keskiviikko;18;28;46;2;5;7
89;29.01.2014;2014;01;07;Keskiviikko;25;80;105;1;37;38
89;29.01.2014;2014;01;08;Keskiviikko;32;166;198;11;48;59
89;29.01.2014;2014;01;09;Keskiviikko;21;62;83;8;41;49
89;29.01.2014;2014;01;10;Keskiviikko;19;49;68;14;18;32
89;29.01.2014;2014;01;11;Keskiviikko;30;38;68;24;33;57
89;29.01.2014;2014;01;12;Keskiviikko;29;49;78;24;38;62
89;29.01.2014;2014;01;13;Keskiviikko;38;49;87;25;36;61
89;29.01.2014;2014;01;14;Keskiviikko;66;37;103;28;35;63
89;29.01.2014;2014;01;15;Keskiviikko;76;56;132;42;18;60
89;29.01.2014;2014;01;16;Keskiviikko;116;45;161;37;31;68
89;29.01.2014;2014;01;17;Keskiviikko;75;41;116;25;21;46
89;29.01.2014;2014;01;18;Keskiviikko;53;31;84;33;31;64
89;29.01.2014;2014;01;19;Keskiviikko;43;25;68;19;15;34
89;29.01.2014;2014;01;20;Keskiviikko;25;17;42;22;15;37
89;29.01.2014;2014;01;21;Keskiviikko;24;15;39;20;14;34
89;29.01.2014;2014;01;22;Keskiviikko;13;9;22;8;6;14
89;29.01.2014;2014;01;23;Keskiviikko;4;3;7;3;1;4
89;30.01.2014;2014;01;00;Torstai;3;3;6;6;2;8
89;30.01.2014;2014;01;01;Torstai;1;3;4;0;0;0
89;30.01.2014;2014;01;02;Torstai;2;0;2;0;0;0
89;30.01.2014;2014;01;03;Torstai;1;1;2;2;0;2
89;30.01.2014;2014;01;04;Torstai;2;2;4;0;1;1
89;30.01.2014;2014;01;05;Torstai;4;7;11;0;0;0
89;30.01.2014;2014;01;06;Torstai;14;18;32;1;6;7
89;30.01.2014;2014;01;07;Torstai;26;73;99;9;51;60
89;30.01.2014;2014;01;08;Torstai;25;122;147;7;52;59
89;30.01.2014;2014;01;09;Torstai;18;54;72;9;34;43
89;30.01.2014;2014;01;10;Torstai;23;46;69;15;23;38
89;30.01.2014;2014;01;11;Torstai;19;31;50;13;26;39
89;30.01.2014;2014;01;12;Torstai;26;43;69;22;28;50
89;30.01.2014;2014;01;13;Torstai;43;32;75;23;24;47
89;30.01.2014;2014;01;14;Torstai;68;35;103;38;23;61
89;30.01.2014;2014;01;15;Torstai;75;41;116;30;22;52
89;30.01.2014;2014;01;16;Torstai;96;46;142;37;17;54
89;30.01.2014;2014;01;17;Torstai;71;43;114;33;21;54
89;30.01.2014;2014;01;18;Torstai;48;31;79;24;13;37
89;30.01.2014;2014;01;19;Torstai;38;26;64;17;15;32
89;30.01.2014;2014;01;20;Torstai;24;18;42;11;10;21
89;30.01.2014;2014;01;21;Torstai;28;10;38;10;4;14
89;30.01.2014;2014;01;22;Torstai;17;2;19;3;4;7
89;30.01.2014;2014;01;23;Torstai;3;4;7;1;1;2
89;31.01.2014;2014;01;00;Perjantai;3;1;4;2;1;3
89;31.01.2014;2014;01;01;Perjantai;1;3;4;0;0;0
89;31.01.2014;2014;01;02;Perjantai;0;2;2;0;0;0
89;31.01.2014;2014;01;03;Perjantai;2;0;2;0;0;0
89;31.01.2014;2014;01;04;Perjantai;2;1;3;0;0;0
89;31.01.2014;2014;01;05;Perjantai;2;10;12;1;1;2
89;31.01.2014;2014;01;06;Perjantai;15;20;35;4;12;16
89;31.01.2014;2014;01;07;Perjantai;18;66;84;3;30;33
89;31.01.2014;2014;01;08;Perjantai;22;116;138;17;56;73
89;31.01.2014;2014;01;09;Perjantai;19;67;86;7;37;44
89;31.01.2014;2014;01;10;Perjantai;16;35;51;14;23;37
89;31.01.2014;2014;01;11;Perjantai;25;46;71;13;30;43
89;31.01.2014;2014;01;12;Perjantai;26;35;61;17;27;44
89;31.01.2014;2014;01;13;Perjantai;36;35;71;28;32;60
89;31.01.2014;2014;01;14;Perjantai;56;27;83;29;29;58
89;31.01.2014;2014;01;15;Perjantai;81;58;139;28;28;56
89;31.01.2014;2014;01;16;Perjantai;85;38;123;23;24;47
89;31.01.2014;2014;01;17;Perjantai;46;28;74;21;21;42
89;31.01.2014;2014;01;18;Perjantai;37;27;64;18;14;32
89;31.01.2014;2014;01;19;Perjantai;37;19;56;24;11;35
89;31.01.2014;2014;01;20;Perjantai;17;9;26;10;9;19
89;31.01.2014;2014;01;21;Perjantai;20;14;34;3;9;12
89;31.01.2014;2014;01;22;Perjantai;9;8;17;3;4;7
89;31.01.2014;2014;01;23;Perjantai;12;6;18;6;8;14
89;01.02.2014;2014;02;00;Lauantai;7;9;16;1;3;4
89;01.02.2014;2014;02;01;Lauantai;9;10;19;5;2;7
89;01.02.2014;2014;02;02;Lauantai;3;0;3;5;1;6
89;01.02.2014;2014;02;03;Lauantai;4;3;7;4;1;5
89;01.02.2014;2014;02;04;Lauantai;9;1;10;7;1;8
89;01.02.2014;2014;02;05;Lauantai;2;0;2;1;0;1
89;01.02.2014;2014;02;06;Lauantai;1;9;10;2;4;6
89;01.02.2014;2014;02;07;Lauantai;0;9;9;2;4;6
89;01.02.2014;2014;02;08;Lauantai;2;17;19;7;6;13
89;01.02.2014;2014;02;09;Lauantai;4;24;28;15;27;42
89;01.02.2014;2014;02;10;Lauantai;5;22;27;13;33;46
89;01.02.2014;2014;02;11;Lauantai;10;21;31;18;25;43
89;01.02.2014;2014;02;12;Lauantai;26;35;61;30;54;84
89;01.02.2014;2014;02;13;Lauantai;16;31;47;37;45;82
89;01.02.2014;2014;02;14;Lauantai;33;44;77;34;38;72
89;01.02.2014;2014;02;15;Lauantai;40;36;76;31;26;57
89;01.02.2014;2014;02;16;Lauantai;34;23;57;36;31;67
89;01.02.2014;2014;02;17;Lauantai;27;27;54;31;14;45
89;01.02.2014;2014;02;18;Lauantai;25;21;46;20;23;43
89;01.02.2014;2014;02;19;Lauantai;15;22;37;14;21;35
89;01.02.2014;2014;02;20;Lauantai;11;11;22;10;10;20
89;01.02.2014;2014;02;21;Lauantai;10;15;25;8;7;15
89;01.02.2014;2014;02;22;Lauantai;10;15;25;4;6;10
89;01.02.2014;2014;02;23;Lauantai;14;4;18;13;4;17
89;02.02.2014;2014;02;00;Sunnuntai;15;11;26;10;4;14
89;02.02.2014;2014;02;01;Sunnuntai;20;1;21;2;4;6
89;02.02.2014;2014;02;02;Sunnuntai;11;1;12;5;4;9
89;02.02.2014;2014;02;03;Sunnuntai;14;6;20;7;1;8
89;02.02.2014;2014;02;04;Sunnuntai;15;1;16;5;0;5
89;02.02.2014;2014;02;05;Sunnuntai;5;0;5;3;0;3
89;02.02.2014;2014;02;06;Sunnuntai;2;12;14;5;2;7
89;02.02.2014;2014;02;07;Sunnuntai;2;1;3;3;4;7
89;02.02.2014;2014;02;08;Sunnuntai;5;3;8;6;8;14
89;02.02.2014;2014;02;09;Sunnuntai;4;10;14;13;24;37
89;02.02.2014;2014;02;10;Sunnuntai;12;15;27;28;30;58
89;02.02.2014;2014;02;11;Sunnuntai;8;23;31;51;53;104
89;02.02.2014;2014;02;12;Sunnuntai;17;30;47;51;67;118
89;02.02.2014;2014;02;13;Sunnuntai;30;37;67;43;47;90
89;02.02.2014;2014;02;14;Sunnuntai;32;29;61;58;49;107
89;02.02.2014;2014;02;15;Sunnuntai;23;21;44;53;39;92
89;02.02.2014;2014;02;16;Sunnuntai;38;20;58;52;30;82
89;02.02.2014;2014;02;17;Sunnuntai;26;18;44;33;21;54
89;02.02.2014;2014;02;18;Sunnuntai;27;13;40;30;25;55
89;02.02.2014;2014;02;19;Sunnuntai;16;17;33;27;28;55
89;02.02.2014;2014;02;20;Sunnuntai;15;13;28;19;15;34
89;02.02.2014;2014;02;21;Sunnuntai;27;3;30;6;10;16
89;02.02.2014;2014;02;22;Sunnuntai;11;0;11;6;3;9
89;02.02.2014;2014;02;23;Sunnuntai;0;4;4;4;5;9
89;03.02.2014;2014;02;00;Maanantai;3;3;6;1;2;3
89;03.02.2014;2014;02;01;Maanantai;1;1;2;2;0;2
89;03.02.2014;2014;02;02;Maanantai;1;1;2;0;1;1
89;03.02.2014;2014;02;03;Maanantai;1;2;3;0;1;1
89;03.02.2014;2014;02;04;Maanantai;2;2;4;6;5;11
89;03.02.2014;2014;02;05;Maanantai;7;6;13;1;0;1
89;03.02.2014;2014;02;06;Maanantai;13;21;34;0;9;9
89;03.02.2014;2014;02;07;Maanantai;19;100;119;7;43;50
89;03.02.2014;2014;02;08;Maanantai;25;162;187;15;44;59
89;03.02.2014;2014;02;09;Maanantai;21;90;111;17;58;75
89;03.02.2014;2014;02;10;Maanantai;31;57;88;16;45;61
89;03.02.2014;2014;02;11;Maanantai;25;46;71;31;37;68
89;03.02.2014;2014;02;12;Maanantai;34;47;81;32;42;74
89;03.02.2014;2014;02;13;Maanantai;47;60;107;34;40;74
89;03.02.2014;2014;02;14;Maanantai;81;45;126;43;29;72
89;03.02.2014;2014;02;15;Maanantai;87;40;127;42;20;62
89;03.02.2014;2014;02;16;Maanantai;122;54;176;57;29;86
89;03.02.2014;2014;02;17;Maanantai;90;38;128;53;18;71
89;03.02.2014;2014;02;18;Maanantai;61;40;101;35;36;71
89;03.02.2014;2014;02;19;Maanantai;57;29;86;38;34;72
89;03.02.2014;2014;02;20;Maanantai;44;23;67;36;27;63
89;03.02.2014;2014;02;21;Maanantai;26;11;37;20;15;35
89;03.02.2014;2014;02;22;Maanantai;14;3;17;4;9;13
89;03.02.2014;2014;02;23;Maanantai;2;4;6;1;4;5
89;04.02.2014;2014;02;00;Tiistai;1;3;4;0;1;1
89;04.02.2014;2014;02;01;Tiistai;2;0;2;0;1;1
89;04.02.2014;2014;02;02;Tiistai;2;1;3;1;0;1
89;04.02.2014;2014;02;03;Tiistai;2;1;3;0;0;0
89;04.02.2014;2014;02;04;Tiistai;1;2;3;0;0;0
89;04.02.2014;2014;02;05;Tiistai;4;4;8;1;2;3
89;04.02.2014;2014;02;06;Tiistai;14;26;40;14;6;20
89;04.02.2014;2014;02;07;Tiistai;23;102;125;10;46;56
89;04.02.2014;2014;02;08;Tiistai;34;171;205;11;58;69
89;04.02.2014;2014;02;09;Tiistai;17;79;96;20;54;74
89;04.02.2014;2014;02;10;Tiistai;26;65;91;25;35;60
89;04.02.2014;2014;02;11;Tiistai;30;54;84;29;38;67
89;04.02.2014;2014;02;12;Tiistai;39;42;81;18;31;49
89;04.02.2014;2014;02;13;Tiistai;52;43;95;30;27;57
89;04.02.2014;2014;02;14;Tiistai;50;40;90;50;29;79
89;04.02.2014;2014;02;15;Tiistai;98;61;159;37;22;59
89;04.02.2014;2014;02;16;Tiistai;138;50;188;51;28;79
89;04.02.2014;2014;02;17;Tiistai;93;56;149;49;23;72
89;04.02.2014;2014;02;18;Tiistai;49;37;86;36;40;76
89;04.02.2014;2014;02;19;Tiistai;51;28;79;41;26;67
89;04.02.2014;2014;02;20;Tiistai;56;18;74;40;19;59
89;04.02.2014;2014;02;21;Tiistai;27;9;36;22;10;32
89;04.02.2014;2014;02;22;Tiistai;12;11;23;2;4;6
89;04.02.2014;2014;02;23;Tiistai;15;5;20;2;0;2
89;05.02.2014;2014;02;00;Keskiviikko;3;2;5;1;3;4
89;05.02.2014;2014;02;01;Keskiviikko;5;0;5;3;2;5
89;05.02.2014;2014;02;02;Keskiviikko;2;3;5;1;0;1
89;05.02.2014;2014;02;03;Keskiviikko;2;1;3;0;0;0
89;05.02.2014;2014;02;04;Keskiviikko;1;4;5;0;0;0
89;05.02.2014;2014;02;05;Keskiviikko;4;5;9;0;1;1
89;05.02.2014;2014;02;06;Keskiviikko;16;28;44;7;7;14
89;05.02.2014;2014;02;07;Keskiviikko;27;96;123;11;50;61
89;05.02.2014;2014;02;08;Keskiviikko;34;184;218;16;54;70
89;05.02.2014;2014;02;09;Keskiviikko;21;103;124;16;49;65
89;05.02.2014;2014;02;10;Keskiviikko;26;54;80;17;33;50
89;05.02.2014;2014;02;11;Keskiviikko;29;41;70;21;33;54
89;05.02.2014;2014;02;12;Keskiviikko;47;64;111;37;32;69
89;05.02.2014;2014;02;13;Keskiviikko;63;57;120;30;33;63
89;05.02.2014;2014;02;14;Keskiviikko;74;37;111;40;27;67
89;05.02.2014;2014;02;15;Keskiviikko;99;58;157;45;37;82
89;05.02.2014;2014;02;16;Keskiviikko;148;57;205;46;22;68
89;05.02.2014;2014;02;17;Keskiviikko;92;56;148;40;28;68
89;05.02.2014;2014;02;18;Keskiviikko;65;44;109;42;35;77
89;05.02.2014;2014;02;19;Keskiviikko;62;29;91;35;28;63
89;05.02.2014;2014;02;20;Keskiviikko;40;23;63;44;19;63
89;05.02.2014;2014;02;21;Keskiviikko;32;14;46;17;12;29
89;05.02.2014;2014;02;22;Keskiviikko;22;21;43;9;9;18
89;05.02.2014;2014;02;23;Keskiviikko;3;5;8;2;2;4
89;06.02.2014;2014;02;00;Torstai;5;3;8;0;1;1
89;06.02.2014;2014;02;01;Torstai;12;3;15;2;1;3
89;06.02.2014;2014;02;02;Torstai;7;5;12;1;0;1
89;06.02.2014;2014;02;03;Torstai;6;2;8;3;0;3
89;06.02.2014;2014;02;04;Torstai;2;3;5;1;0;1
89;06.02.2014;2014;02;05;Torstai;3;4;7;0;2;2
89;06.02.2014;2014;02;06;Torstai;15;19;34;7;8;15
89;06.02.2014;2014;02;07;Torstai;19;119;138;10;51;61
89;06.02.2014;2014;02;08;Torstai;36;161;197;18;58;76
89;06.02.2014;2014;02;09;Torstai;21;72;93;16;38;54
89;06.02.2014;2014;02;10;Torstai;37;40;77;18;31;49
89;06.02.2014;2014;02;11;Torstai;29;42;71;29;38;67
89;06.02.2014;2014;02;12;Torstai;45;58;103;19;40;59
89;06.02.2014;2014;02;13;Torstai;41;56;97;28;34;62
89;06.02.2014;2014;02;14;Torstai;76;37;113;32;31;63
89;06.02.2014;2014;02;15;Torstai;95;59;154;38;33;71
89;06.02.2014;2014;02;16;Torstai;127;63;190;62;29;91
89;06.02.2014;2014;02;17;Torstai;76;47;123;40;31;71
89;06.02.2014;2014;02;18;Torstai;54;34;88;55;16;71
89;06.02.2014;2014;02;19;Torstai;53;24;77;32;30;62
89;06.02.2014;2014;02;20;Torstai;36;29;65;34;20;54
89;06.02.2014;2014;02;21;Torstai;29;18;47;10;8;18
89;06.02.2014;2014;02;22;Torstai;13;9;22;8;8;16
89;06.02.2014;2014;02;23;Torstai;16;4;20;8;3;11
89;07.02.2014;2014;02;00;Perjantai;5;4;9;1;1;2
89;07.02.2014;2014;02;01;Perjantai;1;0;1;3;0;3
89;07.02.2014;2014;02;02;Perjantai;3;1;4;2;1;3
89;07.02.2014;2014;02;03;Perjantai;3;3;6;1;0;1
89;07.02.2014;2014;02;04;Perjantai;2;2;4;0;0;0
89;07.02.2014;2014;02;05;Perjantai;4;3;7;0;1;1
89;07.02.2014;2014;02;06;Perjantai;11;23;34;7;6;13
89;07.02.2014;2014;02;07;Perjantai;22;107;129;4;36;40
89;07.02.2014;2014;02;08;Perjantai;36;136;172;17;56;73
89;07.02.2014;2014;02;09;Perjantai;22;78;100;16;29;45
89;07.02.2014;2014;02;10;Perjantai;28;60;88;22;31;53
89;07.02.2014;2014;02;11;Perjantai;35;47;82;17;29;46
89;07.02.2014;2014;02;12;Perjantai;37;60;97;20;34;54
89;07.02.2014;2014;02;13;Perjantai;57;51;108;24;31;55
89;07.02.2014;2014;02;14;Perjantai;89;51;140;38;26;64
89;07.02.2014;2014;02;15;Perjantai;100;50;150;28;29;57
89;07.02.2014;2014;02;16;Perjantai;102;36;138;25;27;52
89;07.02.2014;2014;02;17;Perjantai;63;38;101;36;24;60
89;07.02.2014;2014;02;18;Perjantai;40;35;75;25;25;50
89;07.02.2014;2014;02;19;Perjantai;31;13;44;20;18;38
89;07.02.2014;2014;02;20;Perjantai;35;17;52;23;15;38
89;07.02.2014;2014;02;21;Perjantai;20;21;41;6;10;16
89;07.02.2014;2014;02;22;Perjantai;19;15;34;12;4;16
89;07.02.2014;2014;02;23;Perjantai;12;7;19;3;7;10
89;08.02.2014;2014;02;00;Lauantai;8;10;18;2;6;8
89;08.02.2014;2014;02;01;Lauantai;9;4;13;5;3;8
89;08.02.2014;2014;02;02;Lauantai;5;2;7;16;0;16
89;08.02.2014;2014;02;03;Lauantai;15;0;15;7;1;8
89;08.02.2014;2014;02;04;Lauantai;11;3;14;5;0;5
89;08.02.2014;2014;02;05;Lauantai;8;2;10;2;3;5
89;08.02.2014;2014;02;06;Lauantai;3;6;9;3;2;5
89;08.02.2014;2014;02;07;Lauantai;6;5;11;5;4;9
89;08.02.2014;2014;02;08;Lauantai;5;25;30;10;11;21
89;08.02.2014;2014;02;09;Lauantai;6;21;27;9;19;28
89;08.02.2014;2014;02;10;Lauantai;26;17;43;22;16;38
89;08.02.2014;2014;02;11;Lauantai;38;1;39;20;0;20
89;08.02.2014;2014;02;12;Lauantai;54;0;54;53;0;53
89;08.02.2014;2014;02;13;Lauantai;54;1;55;62;0;62
89;08.02.2014;2014;02;14;Lauantai;54;0;54;60;0;60
89;08.02.2014;2014;02;15;Lauantai;46;0;46;63;0;63
89;08.02.2014;2014;02;16;Lauantai;71;1;72;73;1;74
89;08.02.2014;2014;02;17;Lauantai;14;19;33;28;13;41
89;08.02.2014;2014;02;18;Lauantai;20;16;36;20;17;37
89;08.02.2014;2014;02;19;Lauantai;25;18;43;23;23;46
89;08.02.2014;2014;02;20;Lauantai;12;8;20;14;11;25
89;08.02.2014;2014;02;21;Lauantai;9;16;25;6;5;11
89;08.02.2014;2014;02;22;Lauantai;15;9;24;8;10;18
89;08.02.2014;2014;02;23;Lauantai;13;9;22;7;11;18
89;09.02.2014;2014;02;00;Sunnuntai;6;18;24;7;4;11
89;09.02.2014;2014;02;01;Sunnuntai;12;13;25;4;5;9
89;09.02.2014;2014;02;02;Sunnuntai;10;3;13;6;3;9
89;09.02.2014;2014;02;03;Sunnuntai;11;3;14;6;0;6
89;09.02.2014;2014;02;04;Sunnuntai;13;3;16;16;0;16
89;09.02.2014;2014;02;05;Sunnuntai;1;0;1;1;0;1
89;09.02.2014;2014;02;06;Sunnuntai;1;2;3;2;1;3
89;09.02.2014;2014;02;07;Sunnuntai;5;3;8;5;5;10
89;09.02.2014;2014;02;08;Sunnuntai;2;7;9;9;10;19
89;09.02.2014;2014;02;09;Sunnuntai;4;11;15;15;15;30
89;09.02.2014;2014;02;10;Sunnuntai;13;11;24;32;29;61
89;09.02.2014;2014;02;11;Sunnuntai;9;27;36;32;39;71
89;09.02.2014;2014;02;12;Sunnuntai;17;33;50;35;39;74
89;09.02.2014;2014;02;13;Sunnuntai;33;33;66;41;59;100
89;09.02.2014;2014;02;14;Sunnuntai;30;31;61;48;48;96
89;09.02.2014;2014;02;15;Sunnuntai;39;22;61;48;50;98
89;09.02.2014;2014;02;16;Sunnuntai;31;26;57;27;28;55
89;09.02.2014;2014;02;17;Sunnuntai;26;16;42;25;21;46
89;09.02.2014;2014;02;18;Sunnuntai;30;9;39;30;20;50
89;09.02.2014;2014;02;19;Sunnuntai;18;17;35;26;24;50
89;09.02.2014;2014;02;20;Sunnuntai;18;11;29;13;18;31
89;09.02.2014;2014;02;21;Sunnuntai;12;6;18;12;14;26
89;09.02.2014;2014;02;22;Sunnuntai;8;4;12;15;2;17
89;09.02.2014;2014;02;23;Sunnuntai;7;4;11;4;8;12
89;10.02.2014;2014;02;00;Maanantai;1;1;2;4;3;7
89;10.02.2014;2014;02;01;Maanantai;2;1;3;0;0;0
89;10.02.2014;2014;02;02;Maanantai;1;0;1;0;0;0
89;10.02.2014;2014;02;03;Maanantai;0;2;2;0;0;0
89;10.02.2014;2014;02;04;Maanantai;2;3;5;1;1;2
89;10.02.2014;2014;02;05;Maanantai;3;6;9;0;1;1
89;10.02.2014;2014;02;06;Maanantai;13;23;36;5;6;11
89;10.02.2014;2014;02;07;Maanantai;27;100;127;6;37;43
89;10.02.2014;2014;02;08;Maanantai;41;146;187;12;50;62
89;10.02.2014;2014;02;09;Maanantai;24;107;131;9;36;45
89;10.02.2014;2014;02;10;Maanantai;29;48;77;23;36;59
89;10.02.2014;2014;02;11;Maanantai;31;54;85;18;29;47
89;10.02.2014;2014;02;12;Maanantai;35;38;73;27;33;60
89;10.02.2014;2014;02;13;Maanantai;55;42;97;25;28;53
89;10.02.2014;2014;02;14;Maanantai;81;52;133;41;35;76
89;10.02.2014;2014;02;15;Maanantai;100;69;169;57;20;77
89;10.02.2014;2014;02;16;Maanantai;154;42;196;51;26;77
89;10.02.2014;2014;02;17;Maanantai;81;37;118;41;27;68
89;10.02.2014;2014;02;18;Maanantai;62;31;93;32;34;66
89;10.02.2014;2014;02;19;Maanantai;35;23;58;40;26;66
89;10.02.2014;2014;02;20;Maanantai;26;22;48;27;28;55
89;10.02.2014;2014;02;21;Maanantai;30;17;47;18;13;31
89;10.02.2014;2014;02;22;Maanantai;18;3;21;10;7;17
89;10.02.2014;2014;02;23;Maanantai;6;4;10;2;8;10
89;11.02.2014;2014;02;00;Tiistai;2;2;4;3;3;6
89;11.02.2014;2014;02;01;Tiistai;3;0;3;0;0;0
89;11.02.2014;2014;02;02;Tiistai;0;0;0;0;1;1
89;11.02.2014;2014;02;03;Tiistai;0;2;2;0;0;0
89;11.02.2014;2014;02;04;Tiistai;0;3;3;1;1;2
89;11.02.2014;2014;02;05;Tiistai;6;7;13;2;1;3
89;11.02.2014;2014;02;06;Tiistai;14;23;37;5;12;17
89;11.02.2014;2014;02;07;Tiistai;26;92;118;7;46;53
89;11.02.2014;2014;02;08;Tiistai;31;137;168;9;51;60
89;11.02.2014;2014;02;09;Tiistai;31;82;113;16;32;48
89;11.02.2014;2014;02;10;Tiistai;25;49;74;33;38;71
89;11.02.2014;2014;02;11;Tiistai;38;41;79;22;28;50
89;11.02.2014;2014;02;12;Tiistai;21;41;62;20;20;40
89;11.02.2014;2014;02;13;Tiistai;39;36;75;18;19;37
89;11.02.2014;2014;02;14;Tiistai;59;32;91;29;20;49
89;11.02.2014;2014;02;15;Tiistai;89;44;133;33;26;59
89;11.02.2014;2014;02;16;Tiistai;108;56;164;40;20;60
89;11.02.2014;2014;02;17;Tiistai;84;44;128;31;21;52
89;11.02.2014;2014;02;18;Tiistai;44;29;73;37;18;55
89;11.02.2014;2014;02;19;Tiistai;46;17;63;20;22;42
89;11.02.2014;2014;02;20;Tiistai;24;18;42;15;23;38
89;11.02.2014;2014;02;21;Tiistai;34;16;50;14;5;19
89;11.02.2014;2014;02;22;Tiistai;17;5;22;11;3;14
89;11.02.2014;2014;02;23;Tiistai;4;2;6;1;3;4
89;12.02.2014;2014;02;00;Keskiviikko;2;3;5;3;2;5
89;12.02.2014;2014;02;01;Keskiviikko;3;1;4;1;2;3
89;12.02.2014;2014;02;02;Keskiviikko;2;0;2;1;0;1
89;12.02.2014;2014;02;03;Keskiviikko;0;1;1;0;0;0
89;12.02.2014;2014;02;04;Keskiviikko;2;8;10;4;3;7
89;12.02.2014;2014;02;05;Keskiviikko;1;5;6;1;2;3
89;12.02.2014;2014;02;06;Keskiviikko;11;30;41;7;8;15
89;12.02.2014;2014;02;07;Keskiviikko;30;97;127;6;49;55
89;12.02.2014;2014;02;08;Keskiviikko;36;131;167;10;57;67
89;12.02.2014;2014;02;09;Keskiviikko;24;78;102;6;44;50
89;12.02.2014;2014;02;10;Keskiviikko;20;61;81;21;41;62
89;12.02.2014;2014;02;11;Keskiviikko;29;44;73;17;35;52
89;12.02.2014;2014;02;12;Keskiviikko;32;59;91;39;37;76
89;12.02.2014;2014;02;13;Keskiviikko;54;51;105;24;26;50
89;12.02.2014;2014;02;14;Keskiviikko;74;45;119;40;21;61
89;12.02.2014;2014;02;15;Keskiviikko;104;51;155;46;29;75
89;12.02.2014;2014;02;16;Keskiviikko;137;51;188;57;27;84
89;12.02.2014;2014;02;17;Keskiviikko;101;39;140;47;38;85
89;12.02.2014;2014;02;18;Keskiviikko;57;36;93;42;23;65
89;12.02.2014;2014;02;19;Keskiviikko;54;31;85;39;23;62
89;12.02.2014;2014;02;20;Keskiviikko;33;25;58;17;17;34
89;12.02.2014;2014;02;21;Keskiviikko;34;21;55;20;11;31
89;12.02.2014;2014;02;22;Keskiviikko;11;10;21;7;8;15
89;12.02.2014;2014;02;23;Keskiviikko;8;4;12;2;4;6
89;13.02.2014;2014;02;00;Torstai;5;2;7;3;1;4
89;13.02.2014;2014;02;01;Torstai;1;4;5;1;0;1
89;13.02.2014;2014;02;02;Torstai;4;0;4;1;0;1
89;13.02.2014;2014;02;03;Torstai;0;2;2;2;0;2
89;13.02.2014;2014;02;04;Torstai;2;4;6;0;0;0
89;13.02.2014;2014;02;05;Torstai;3;5;8;0;1;1
89;13.02.2014;2014;02;06;Torstai;15;26;41;3;6;9
89;13.02.2014;2014;02;07;Torstai;23;92;115;7;39;46
89;13.02.2014;2014;02;08;Torstai;38;147;185;15;62;77
89;13.02.2014;2014;02;09;Torstai;25;77;102;13;45;58
89;13.02.2014;2014;02;10;Torstai;21;37;58;13;24;37
89;13.02.2014;2014;02;11;Torstai;17;38;55;15;33;48
89;13.02.2014;2014;02;12;Torstai;27;38;65;17;27;44
89;13.02.2014;2014;02;13;Torstai;33;49;82;26;64;90
89;13.02.2014;2014;02;14;Torstai;69;40;109;64;31;95
89;13.02.2014;2014;02;15;Torstai;96;36;132;70;32;102
89;13.02.2014;2014;02;16;Torstai;125;66;191;41;13;54
89;13.02.2014;2014;02;17;Torstai;81;48;129;45;28;73
89;13.02.2014;2014;02;18;Torstai;62;35;97;25;28;53
89;13.02.2014;2014;02;19;Torstai;42;37;79;36;26;62
89;13.02.2014;2014;02;20;Torstai;40;27;67;25;29;54
89;13.02.2014;2014;02;21;Torstai;35;22;57;16;14;30
89;13.02.2014;2014;02;22;Torstai;15;24;39;10;5;15
89;13.02.2014;2014;02;23;Torstai;4;5;9;3;6;9
89;14.02.2014;2014;02;00;Perjantai;5;2;7;2;2;4
89;14.02.2014;2014;02;01;Perjantai;5;1;6;4;0;4
89;14.02.2014;2014;02;02;Perjantai;7;0;7;1;1;2
89;14.02.2014;2014;02;03;Perjantai;4;3;7;4;0;4
89;14.02.2014;2014;02;04;Perjantai;8;1;9;9;1;10
89;14.02.2014;2014;02;05;Perjantai;5;11;16;0;3;3
89;14.02.2014;2014;02;06;Perjantai;13;27;40;1;7;8
89;14.02.2014;2014;02;07;Perjantai;14;86;100;3;47;50
89;14.02.2014;2014;02;08;Perjantai;32;140;172;8;38;46
89;14.02.2014;2014;02;09;Perjantai;26;76;102;11;39;50
89;14.02.2014;2014;02;10;Perjantai;16;54;70;22;31;53
89;14.02.2014;2014;02;11;Perjantai;27;56;83;22;32;54
89;14.02.2014;2014;02;12;Perjantai;38;48;86;15;24;39
89;14.02.2014;2014;02;13;Perjantai;60;40;100;42;30;72
89;14.02.2014;2014;02;14;Perjantai;83;45;128;42;27;69
89;14.02.2014;2014;02;15;Perjantai;116;66;182;48;19;67
89;14.02.2014;2014;02;16;Perjantai;90;46;136;34;20;54
89;14.02.2014;2014;02;17;Perjantai;62;40;102;46;24;70
89;14.02.2014;2014;02;18;Perjantai;38;41;79;22;21;43
89;14.02.2014;2014;02;19;Perjantai;36;17;53;22;19;41
89;14.02.2014;2014;02;20;Perjantai;29;18;47;28;12;40
89;14.02.2014;2014;02;21;Perjantai;24;19;43;12;9;21
89;14.02.2014;2014;02;22;Perjantai;17;17;34;9;24;33
89;14.02.2014;2014;02;23;Perjantai;12;18;30;6;6;12
89;15.02.2014;2014;02;00;Lauantai;11;8;19;13;13;26
89;15.02.2014;2014;02;01;Lauantai;11;8;19;4;2;6
89;15.02.2014;2014;02;02;Lauantai;11;2;13;5;3;8
89;15.02.2014;2014;02;03;Lauantai;18;1;19;7;1;8
89;15.02.2014;2014;02;04;Lauantai;9;1;10;8;1;9
89;15.02.2014;2014;02;05;Lauantai;5;6;11;4;0;4
89;15.02.2014;2014;02;06;Lauantai;2;7;9;0;5;5
89;15.02.2014;2014;02;07;Lauantai;3;4;7;6;8;14
89;15.02.2014;2014;02;08;Lauantai;6;17;23;8;16;24
89;15.02.2014;2014;02;09;Lauantai;9;35;44;10;25;35
89;15.02.2014;2014;02;10;Lauantai;18;26;44;17;19;36
89;15.02.2014;2014;02;11;Lauantai;24;28;52;33;45;78
89;15.02.2014;2014;02;12;Lauantai;31;38;69;32;31;63
89;15.02.2014;2014;02;13;Lauantai;26;43;69;32;36;68
89;15.02.2014;2014;02;14;Lauantai;38;33;71;39;42;81
89;15.02.2014;2014;02;15;Lauantai;44;37;81;33;38;71
89;15.02.2014;2014;02;16;Lauantai;37;35;72;34;26;60
89;15.02.2014;2014;02;17;Lauantai;31;24;55;25;18;43
89;15.02.2014;2014;02;18;Lauantai;29;33;62;22;27;49
89;15.02.2014;2014;02;19;Lauantai;21;11;32;21;15;36
89;15.02.2014;2014;02;20;Lauantai;21;17;38;4;12;16
89;15.02.2014;2014;02;21;Lauantai;18;30;48;6;13;19
89;15.02.2014;2014;02;22;Lauantai;13;29;42;9;6;15
89;15.02.2014;2014;02;23;Lauantai;12;9;21;7;7;14
89;16.02.2014;2014;02;00;Sunnuntai;9;11;20;3;6;9
89;16.02.2014;2014;02;01;Sunnuntai;3;5;8;4;2;6
89;16.02.2014;2014;02;02;Sunnuntai;18;2;20;10;2;12
89;16.02.2014;2014;02;03;Sunnuntai;10;1;11;3;3;6
89;16.02.2014;2014;02;04;Sunnuntai;12;2;14;5;0;5
89;16.02.2014;2014;02;05;Sunnuntai;8;2;10;0;1;1
89;16.02.2014;2014;02;06;Sunnuntai;4;5;9;3;2;5
89;16.02.2014;2014;02;07;Sunnuntai;3;1;4;3;3;6
89;16.02.2014;2014;02;08;Sunnuntai;4;8;12;7;4;11
89;16.02.2014;2014;02;09;Sunnuntai;2;7;9;11;14;25
89;16.02.2014;2014;02;10;Sunnuntai;7;13;20;20;23;43
89;16.02.2014;2014;02;11;Sunnuntai;10;17;27;40;66;106
89;16.02.2014;2014;02;12;Sunnuntai;17;25;42;25;28;53
89;16.02.2014;2014;02;13;Sunnuntai;21;32;53;21;37;58
89;16.02.2014;2014;02;14;Sunnuntai;31;22;53;43;33;76
89;16.02.2014;2014;02;15;Sunnuntai;25;29;54;42;42;84
89;16.02.2014;2014;02;16;Sunnuntai;29;11;40;56;42;98
89;16.02.2014;2014;02;17;Sunnuntai;20;27;47;27;22;49
89;16.02.2014;2014;02;18;Sunnuntai;23;30;53;23;30;53
89;16.02.2014;2014;02;19;Sunnuntai;25;6;31;23;20;43
89;16.02.2014;2014;02;20;Sunnuntai;20;7;27;12;7;19
89;16.02.2014;2014;02;21;Sunnuntai;12;7;19;13;8;21
89;16.02.2014;2014;02;22;Sunnuntai;9;7;16;5;9;14
89;16.02.2014;2014;02;23;Sunnuntai;7;7;14;6;3;9
89;17.02.2014;2014;02;00;Maanantai;1;5;6;0;0;0
89;17.02.2014;2014;02;01;Maanantai;3;1;4;2;1;3
89;17.02.2014;2014;02;02;Maanantai;0;0;0;1;1;2
89;17.02.2014;2014;02;03;Maanantai;3;2;5;1;1;2
89;17.02.2014;2014;02;04;Maanantai;0;5;5;1;1;2
89;17.02.2014;2014;02;05;Maanantai;3;5;8;0;1;1
89;17.02.2014;2014;02;06;Maanantai;15;28;43;2;6;8
89;17.02.2014;2014;02;07;Maanantai;25;97;122;6;49;55
89;17.02.2014;2014;02;08;Maanantai;26;158;184;15;48;63
89;17.02.2014;2014;02;09;Maanantai;32;73;105;18;55;73
89;17.02.2014;2014;02;10;Maanantai;30;47;77;32;41;73
89;17.02.2014;2014;02;11;Maanantai;33;55;88;33;39;72
89;17.02.2014;2014;02;12;Maanantai;36;34;70;32;28;60
89;17.02.2014;2014;02;13;Maanantai;46;48;94;29;33;62
89;17.02.2014;2014;02;14;Maanantai;66;35;101;35;32;67
89;17.02.2014;2014;02;15;Maanantai;114;52;166;39;22;61
89;17.02.2014;2014;02;16;Maanantai;136;53;189;45;27;72
89;17.02.2014;2014;02;17;Maanantai;74;32;106;42;20;62
89;17.02.2014;2014;02;18;Maanantai;38;33;71;27;30;57
89;17.02.2014;2014;02;19;Maanantai;52;24;76;23;20;43
89;17.02.2014;2014;02;20;Maanantai;24;16;40;15;21;36
89;17.02.2014;2014;02;21;Maanantai;32;13;45;12;18;30
89;17.02.2014;2014;02;22;Maanantai;19;5;24;6;11;17
89;17.02.2014;2014;02;23;Maanantai;7;1;8;2;1;3
89;18.02.2014;2014;02;00;Tiistai;2;2;4;2;2;4
89;18.02.2014;2014;02;01;Tiistai;2;0;2;0;1;1
89;18.02.2014;2014;02;02;Tiistai;1;0;1;0;0;0
89;18.02.2014;2014;02;03;Tiistai;1;2;3;0;1;1
89;18.02.2014;2014;02;04;Tiistai;1;2;3;1;0;1
89;18.02.2014;2014;02;05;Tiistai;3;5;8;2;1;3
89;18.02.2014;2014;02;06;Tiistai;15;25;40;3;5;8
89;18.02.2014;2014;02;07;Tiistai;18;96;114;2;41;43
89;18.02.2014;2014;02;08;Tiistai;36;144;180;6;41;47
89;18.02.2014;2014;02;09;Tiistai;27;62;89;21;37;58
89;18.02.2014;2014;02;10;Tiistai;18;57;75;24;41;65
89;18.02.2014;2014;02;11;Tiistai;35;45;80;28;24;52
89;18.02.2014;2014;02;12;Tiistai;34;45;79;33;34;67
89;18.02.2014;2014;02;13;Tiistai;44;36;80;29;31;60
89;18.02.2014;2014;02;14;Tiistai;69;53;122;30;29;59
89;18.02.2014;2014;02;15;Tiistai;103;55;158;34;18;52
89;18.02.2014;2014;02;16;Tiistai;138;62;200;55;24;79
89;18.02.2014;2014;02;17;Tiistai;89;50;139;40;29;69
89;18.02.2014;2014;02;18;Tiistai;62;37;99;33;28;61
89;18.02.2014;2014;02;19;Tiistai;55;20;75;37;35;72
89;18.02.2014;2014;02;20;Tiistai;33;31;64;29;24;53
89;18.02.2014;2014;02;21;Tiistai;32;15;47;11;6;17
89;18.02.2014;2014;02;22;Tiistai;20;7;27;9;3;12
89;18.02.2014;2014;02;23;Tiistai;11;6;17;0;2;2
89;19.02.2014;2014;02;00;Keskiviikko;3;1;4;9;8;17
89;19.02.2014;2014;02;01;Keskiviikko;4;0;4;2;0;2
89;19.02.2014;2014;02;02;Keskiviikko;3;1;4;0;0;0
89;19.02.2014;2014;02;03;Keskiviikko;2;1;3;0;0;0
89;19.02.2014;2014;02;04;Keskiviikko;1;2;3;0;0;0
89;19.02.2014;2014;02;05;Keskiviikko;5;7;12;0;1;1
89;19.02.2014;2014;02;06;Keskiviikko;15;25;40;4;4;8
89;19.02.2014;2014;02;07;Keskiviikko;21;93;114;2;44;46
89;19.02.2014;2014;02;08;Keskiviikko;38;172;210;10;55;65
89;19.02.2014;2014;02;09;Keskiviikko;32;60;92;9;58;67
89;19.02.2014;2014;02;10;Keskiviikko;26;76;102;39;34;73
89;19.02.2014;2014;02;11;Keskiviikko;30;54;84;26;28;54
89;19.02.2014;2014;02;12;Keskiviikko;39;40;79;27;43;70
89;19.02.2014;2014;02;13;Keskiviikko;55;42;97;44;30;74
89;19.02.2014;2014;02;14;Keskiviikko;71;42;113;43;25;68
89;19.02.2014;2014;02;15;Keskiviikko;99;48;147;39;29;68
89;19.02.2014;2014;02;16;Keskiviikko;112;54;166;57;29;86
89;19.02.2014;2014;02;17;Keskiviikko;93;45;138;58;29;87
89;19.02.2014;2014;02;18;Keskiviikko;54;30;84;37;39;76
89;19.02.2014;2014;02;19;Keskiviikko;31;23;54;26;20;46
89;19.02.2014;2014;02;20;Keskiviikko;26;20;46;21;17;38
89;19.02.2014;2014;02;21;Keskiviikko;29;10;39;11;14;25
89;19.02.2014;2014;02;22;Keskiviikko;12;10;22;9;4;13
89;19.02.2014;2014;02;23;Keskiviikko;3;2;5;1;4;5
89;20.02.2014;2014;02;00;Torstai;6;1;7;4;0;4
89;20.02.2014;2014;02;01;Torstai;0;0;0;1;2;3
89;20.02.2014;2014;02;02;Torstai;2;0;2;0;2;2
89;20.02.2014;2014;02;03;Torstai;3;1;4;3;0;3
89;20.02.2014;2014;02;04;Torstai;0;4;4;3;0;3
89;20.02.2014;2014;02;05;Torstai;3;8;11;0;1;1
89;20.02.2014;2014;02;06;Torstai;15;22;37;2;4;6
89;20.02.2014;2014;02;07;Torstai;23;105;128;4;38;42
89;20.02.2014;2014;02;08;Torstai;46;156;202;12;51;63
89;20.02.2014;2014;02;09;Torstai;29;83;112;13;44;57
89;20.02.2014;2014;02;10;Torstai;15;59;74;21;38;59
89;20.02.2014;2014;02;11;Torstai;21;38;59;26;22;48
89;20.02.2014;2014;02;12;Torstai;40;57;97;19;26;45
89;20.02.2014;2014;02;13;Torstai;42;30;72;16;38;54
89;20.02.2014;2014;02;14;Torstai;63;40;103;50;32;82
89;20.02.2014;2014;02;15;Torstai;84;51;135;33;22;55
89;20.02.2014;2014;02;16;Torstai;125;64;189;49;29;78
89;20.02.2014;2014;02;17;Torstai;68;46;114;32;24;56
89;20.02.2014;2014;02;18;Torstai;56;46;102;26;20;46
89;20.02.2014;2014;02;19;Torstai;56;29;85;23;23;46
89;20.02.2014;2014;02;20;Torstai;47;30;77;27;12;39
89;20.02.2014;2014;02;21;Torstai;29;10;39;15;6;21
89;20.02.2014;2014;02;22;Torstai;15;17;32;10;7;17
89;20.02.2014;2014;02;23;Torstai;6;6;12;1;3;4
89;21.02.2014;2014;02;00;Perjantai;1;1;2;0;1;1
89;21.02.2014;2014;02;01;Perjantai;4;1;5;1;0;1
89;21.02.2014;2014;02;02;Perjantai;1;1;2;1;1;2
89;21.02.2014;2014;02;03;Perjantai;1;2;3;0;0;0
89;21.02.2014;2014;02;04;Perjantai;2;4;6;0;0;0
89;21.02.2014;2014;02;05;Perjantai;4;6;10;1;2;3
89;21.02.2014;2014;02;06;Perjantai;12;24;36;7;8;15
89;21.02.2014;2014;02;07;Perjantai;23;92;115;4;35;39
89;21.02.2014;2014;02;08;Perjantai;33;144;177;10;51;61
89;21.02.2014;2014;02;09;Perjantai;22;68;90;13;37;50
89;21.02.2014;2014;02;10;Perjantai;29;54;83;22;42;64
89;21.02.2014;2014;02;11;Perjantai;34;48;82;19;45;64
89;21.02.2014;2014;02;12;Perjantai;48;33;81;39;32;71
89;21.02.2014;2014;02;13;Perjantai;81;65;146;37;31;68
89;21.02.2014;2014;02;14;Perjantai;89;49;138;31;21;52
89;21.02.2014;2014;02;15;Perjantai;84;37;121;36;15;51
89;21.02.2014;2014;02;16;Perjantai;73;37;110;29;24;53
89;21.02.2014;2014;02;17;Perjantai;66;46;112;27;19;46
89;21.02.2014;2014;02;18;Perjantai;37;39;76;19;23;42
89;21.02.2014;2014;02;19;Perjantai;34;20;54;23;23;46
89;21.02.2014;2014;02;20;Perjantai;28;21;49;18;16;34
89;21.02.2014;2014;02;21;Perjantai;22;13;35;5;9;14
89;21.02.2014;2014;02;22;Perjantai;14;14;28;10;17;27
89;21.02.2014;2014;02;23;Perjantai;12;6;18;2;6;8
89;22.02.2014;2014;02;00;Lauantai;2;7;9;9;6;15
89;22.02.2014;2014;02;01;Lauantai;6;5;11;5;5;10
89;22.02.2014;2014;02;02;Lauantai;1;2;3;16;0;16
89;22.02.2014;2014;02;03;Lauantai;11;0;11;3;0;3
89;22.02.2014;2014;02;04;Lauantai;11;3;14;6;2;8
89;22.02.2014;2014;02;05;Lauantai;5;3;8;0;0;0
89;22.02.2014;2014;02;06;Lauantai;3;12;15;2;0;2
89;22.02.2014;2014;02;07;Lauantai;5;4;9;1;2;3
89;22.02.2014;2014;02;08;Lauantai;4;10;14;10;8;18
89;22.02.2014;2014;02;09;Lauantai;5;23;28;15;14;29
89;22.02.2014;2014;02;10;Lauantai;9;22;31;19;29;48
89;22.02.2014;2014;02;11;Lauantai;11;35;46;17;37;54
89;22.02.2014;2014;02;12;Lauantai;20;52;72;17;47;64
89;22.02.2014;2014;02;13;Lauantai;33;39;72;39;31;70
89;22.02.2014;2014;02;14;Lauantai;39;25;64;28;35;63
89;22.02.2014;2014;02;15;Lauantai;50;28;78;32;28;60
89;22.02.2014;2014;02;16;Lauantai;47;23;70;44;30;74
89;22.02.2014;2014;02;17;Lauantai;20;7;27;22;17;39
89;22.02.2014;2014;02;18;Lauantai;14;18;32;15;18;33
89;22.02.2014;2014;02;19;Lauantai;9;18;27;19;12;31
89;22.02.2014;2014;02;20;Lauantai;18;3;21;17;17;34
89;22.02.2014;2014;02;21;Lauantai;9;17;26;6;9;15
89;22.02.2014;2014;02;22;Lauantai;9;16;25;7;8;15
89;22.02.2014;2014;02;23;Lauantai;6;5;11;10;6;16
89;23.02.2014;2014;02;00;Sunnuntai;4;8;12;1;7;8
89;23.02.2014;2014;02;01;Sunnuntai;4;2;6;6;1;7
89;23.02.2014;2014;02;02;Sunnuntai;5;2;7;11;2;13
89;23.02.2014;2014;02;03;Sunnuntai;14;1;15;13;1;14
89;23.02.2014;2014;02;04;Sunnuntai;11;0;11;15;1;16
89;23.02.2014;2014;02;05;Sunnuntai;4;2;6;1;0;1
89;23.02.2014;2014;02;06;Sunnuntai;7;7;14;0;1;1
89;23.02.2014;2014;02;07;Sunnuntai;3;2;5;3;7;10
89;23.02.2014;2014;02;08;Sunnuntai;4;4;8;9;5;14
89;23.02.2014;2014;02;09;Sunnuntai;3;12;15;14;8;22
89;23.02.2014;2014;02;10;Sunnuntai;5;15;20;17;28;45
89;23.02.2014;2014;02;11;Sunnuntai;17;26;43;37;33;70
89;23.02.2014;2014;02;12;Sunnuntai;14;35;49;46;58;104
89;23.02.2014;2014;02;13;Sunnuntai;43;28;71;45;40;85
89;23.02.2014;2014;02;14;Sunnuntai;32;32;64;25;34;59
89;23.02.2014;2014;02;15;Sunnuntai;14;27;41;30;28;58
89;23.02.2014;2014;02;16;Sunnuntai;31;26;57;29;26;55
89;23.02.2014;2014;02;17;Sunnuntai;33;26;59;35;31;66
89;23.02.2014;2014;02;18;Sunnuntai;17;27;44;25;30;55
89;23.02.2014;2014;02;19;Sunnuntai;26;17;43;32;17;49
89;23.02.2014;2014;02;20;Sunnuntai;9;5;14;20;11;31
89;23.02.2014;2014;02;21;Sunnuntai;11;7;18;7;7;14
89;23.02.2014;2014;02;22;Sunnuntai;10;3;13;5;2;7
89;23.02.2014;2014;02;23;Sunnuntai;2;3;5;2;2;4
89;24.02.2014;2014;02;00;Maanantai;8;3;11;2;0;2
89;24.02.2014;2014;02;01;Maanantai;4;0;4;1;0;1
89;24.02.2014;2014;02;02;Maanantai;2;0;2;1;0;1
89;24.02.2014;2014;02;03;Maanantai;3;3;6;0;0;0
89;24.02.2014;2014;02;04;Maanantai;5;9;14;2;1;3
89;24.02.2014;2014;02;05;Maanantai;3;7;10;0;1;1
89;24.02.2014;2014;02;06;Maanantai;15;20;35;3;11;14
89;24.02.2014;2014;02;07;Maanantai;16;88;104;6;41;47
89;24.02.2014;2014;02;08;Maanantai;30;133;163;5;58;63
89;24.02.2014;2014;02;09;Maanantai;24;66;90;12;52;64
89;24.02.2014;2014;02;10;Maanantai;20;45;65;34;35;69
89;24.02.2014;2014;02;11;Maanantai;19;47;66;17;37;54
89;24.02.2014;2014;02;12;Maanantai;27;40;67;26;26;52
89;24.02.2014;2014;02;13;Maanantai;34;50;84;38;46;84
89;24.02.2014;2014;02;14;Maanantai;77;48;125;58;35;93
89;24.02.2014;2014;02;15;Maanantai;76;59;135;56;21;77
89;24.02.2014;2014;02;16;Maanantai;127;43;170;52;38;90
89;24.02.2014;2014;02;17;Maanantai;74;52;126;48;36;84
89;24.02.2014;2014;02;18;Maanantai;43;46;89;46;35;81
89;24.02.2014;2014;02;19;Maanantai;42;43;85;41;22;63
89;24.02.2014;2014;02;20;Maanantai;37;19;56;38;15;53
89;24.02.2014;2014;02;21;Maanantai;33;18;51;12;5;17
89;24.02.2014;2014;02;22;Maanantai;16;7;23;6;11;17
89;24.02.2014;2014;02;23;Maanantai;4;6;10;3;2;5
89;25.02.2014;2014;02;00;Tiistai;1;2;3;3;1;4
89;25.02.2014;2014;02;01;Tiistai;2;1;3;1;0;1
89;25.02.2014;2014;02;02;Tiistai;3;0;3;0;0;0
89;25.02.2014;2014;02;03;Tiistai;0;1;1;3;0;3
89;25.02.2014;2014;02;04;Tiistai;3;2;5;1;2;3
89;25.02.2014;2014;02;05;Tiistai;4;6;10;1;0;1
89;25.02.2014;2014;02;06;Tiistai;20;32;52;1;6;7
89;25.02.2014;2014;02;07;Tiistai;20;121;141;10;40;50
89;25.02.2014;2014;02;08;Tiistai;45;149;194;11;57;68
89;25.02.2014;2014;02;09;Tiistai;26;77;103;15;44;59
89;25.02.2014;2014;02;10;Tiistai;22;63;85;21;32;53
89;25.02.2014;2014;02;11;Tiistai;39;50;89;27;32;59
89;25.02.2014;2014;02;12;Tiistai;41;54;95;42;52;94
89;25.02.2014;2014;02;13;Tiistai;44;57;101;40;27;67
89;25.02.2014;2014;02;14;Tiistai;71;48;119;53;40;93
89;25.02.2014;2014;02;15;Tiistai;111;50;161;47;28;75
89;25.02.2014;2014;02;16;Tiistai;134;76;210;61;33;94
89;25.02.2014;2014;02;17;Tiistai;96;58;154;31;28;59
89;25.02.2014;2014;02;18;Tiistai;54;43;97;48;26;74
89;25.02.2014;2014;02;19;Tiistai;61;33;94;45;22;67
89;25.02.2014;2014;02;20;Tiistai;50;20;70;27;17;44
89;25.02.2014;2014;02;21;Tiistai;30;13;43;14;15;29
89;25.02.2014;2014;02;22;Tiistai;17;11;28;13;10;23
89;25.02.2014;2014;02;23;Tiistai;7;4;11;3;1;4
89;26.02.2014;2014;02;00;Keskiviikko;5;2;7;3;1;4
89;26.02.2014;2014;02;01;Keskiviikko;2;3;5;0;0;0
89;26.02.2014;2014;02;02;Keskiviikko;1;5;6;0;1;1
89;26.02.2014;2014;02;03;Keskiviikko;1;4;5;1;1;2
89;26.02.2014;2014;02;04;Keskiviikko;2;1;3;2;0;2
89;26.02.2014;2014;02;05;Keskiviikko;6;9;15;3;1;4
89;26.02.2014;2014;02;06;Keskiviikko;14;28;42;4;6;10
89;26.02.2014;2014;02;07;Keskiviikko;28;102;130;6;48;54
89;26.02.2014;2014;02;08;Keskiviikko;51;163;214;9;49;58
89;26.02.2014;2014;02;09;Keskiviikko;24;84;108;15;52;67
89;26.02.2014;2014;02;10;Keskiviikko;23;64;87;19;40;59
89;26.02.2014;2014;02;11;Keskiviikko;28;67;95;41;39;80
89;26.02.2014;2014;02;12;Keskiviikko;50;47;97;39;59;98
89;26.02.2014;2014;02;13;Keskiviikko;74;61;135;52;41;93
89;26.02.2014;2014;02;14;Keskiviikko;85;53;138;53;33;86
89;26.02.2014;2014;02;15;Keskiviikko;106;59;165;64;33;97
89;26.02.2014;2014;02;16;Keskiviikko;167;71;238;55;31;86
89;26.02.2014;2014;02;17;Keskiviikko;101;67;168;46;34;80
89;26.02.2014;2014;02;18;Keskiviikko;63;45;108;35;26;61
89;26.02.2014;2014;02;19;Keskiviikko;54;20;74;39;26;65
89;26.02.2014;2014;02;20;Keskiviikko;42;27;69;24;22;46
89;26.02.2014;2014;02;21;Keskiviikko;36;30;66;14;5;19
89;26.02.2014;2014;02;22;Keskiviikko;17;16;33;13;7;20
89;26.02.2014;2014;02;23;Keskiviikko;10;2;12;4;3;7
89;27.02.2014;2014;02;00;Torstai;5;2;7;5;1;6
89;27.02.2014;2014;02;01;Torstai;1;1;2;0;0;0
89;27.02.2014;2014;02;02;Torstai;3;2;5;2;0;2
89;27.02.2014;2014;02;03;Torstai;4;4;8;1;1;2
89;27.02.2014;2014;02;04;Torstai;2;4;6;0;0;0
89;27.02.2014;2014;02;05;Torstai;2;8;10;1;0;1
89;27.02.2014;2014;02;06;Torstai;16;36;52;4;5;9
89;27.02.2014;2014;02;07;Torstai;39;126;165;6;43;49
89;27.02.2014;2014;02;08;Torstai;34;191;225;12;52;64
89;27.02.2014;2014;02;09;Torstai;19;108;127;7;38;45
89;27.02.2014;2014;02;10;Torstai;42;79;121;20;29;49
89;27.02.2014;2014;02;11;Torstai;45;53;98;29;27;56
89;27.02.2014;2014;02;12;Torstai;45;59;104;31;44;75
89;27.02.2014;2014;02;13;Torstai;55;68;123;26;24;50
89;27.02.2014;2014;02;14;Torstai;91;48;139;43;20;63
89;27.02.2014;2014;02;15;Torstai;107;65;172;55;30;85
89;27.02.2014;2014;02;16;Torstai;143;68;211;53;29;82
89;27.02.2014;2014;02;17;Torstai;89;62;151;43;26;69
89;27.02.2014;2014;02;18;Torstai;60;45;105;36;30;66
89;27.02.2014;2014;02;19;Torstai;48;33;81;36;16;52
89;27.02.2014;2014;02;20;Torstai;38;23;61;34;23;57
89;27.02.2014;2014;02;21;Torstai;46;19;65;12;12;24
89;27.02.2014;2014;02;22;Torstai;15;7;22;12;5;17
89;27.02.2014;2014;02;23;Torstai;5;4;9;1;0;1
89;28.02.2014;2014;02;00;Perjantai;3;1;4;4;1;5
89;28.02.2014;2014;02;01;Perjantai;4;1;5;2;0;2
89;28.02.2014;2014;02;02;Perjantai;2;1;3;2;1;3
89;28.02.2014;2014;02;03;Perjantai;1;0;1;5;0;5
89;28.02.2014;2014;02;04;Perjantai;3;4;7;5;0;5
89;28.02.2014;2014;02;05;Perjantai;5;12;17;2;2;4
89;28.02.2014;2014;02;06;Perjantai;15;23;38;4;5;9
89;28.02.2014;2014;02;07;Perjantai;18;93;111;9;29;38
89;28.02.2014;2014;02;08;Perjantai;30;132;162;20;42;62
89;28.02.2014;2014;02;09;Perjantai;23;72;95;16;39;55
89;28.02.2014;2014;02;10;Perjantai;26;63;89;16;30;46
89;28.02.2014;2014;02;11;Perjantai;30;59;89;28;39;67
89;28.02.2014;2014;02;12;Perjantai;48;68;116;21;33;54
89;28.02.2014;2014;02;13;Perjantai;57;46;103;24;30;54
89;28.02.2014;2014;02;14;Perjantai;93;54;147;36;26;62
89;28.02.2014;2014;02;15;Perjantai;113;52;165;37;25;62
89;28.02.2014;2014;02;16;Perjantai;98;54;152;27;24;51
89;28.02.2014;2014;02;17;Perjantai;62;41;103;36;27;63
89;28.02.2014;2014;02;18;Perjantai;44;30;74;28;24;52
89;28.02.2014;2014;02;19;Perjantai;40;30;70;22;18;40
89;28.02.2014;2014;02;20;Perjantai;20;12;32;16;8;24
89;28.02.2014;2014;02;21;Perjantai;27;21;48;9;12;21
89;28.02.2014;2014;02;22;Perjantai;18;19;37;8;7;15
89;28.02.2014;2014;02;23;Perjantai;14;8;22;1;3;4
89;01.03.2014;2014;03;00;Lauantai;11;12;23;3;5;8
89;01.03.2014;2014;03;01;Lauantai;5;3;8;7;3;10
89;01.03.2014;2014;03;02;Lauantai;8;3;11;5;2;7
89;01.03.2014;2014;03;03;Lauantai;12;2;14;9;2;11
89;01.03.2014;2014;03;04;Lauantai;5;0;5;3;1;4
89;01.03.2014;2014;03;05;Lauantai;3;1;4;3;2;5
89;01.03.2014;2014;03;06;Lauantai;1;7;8;5;4;9
89;01.03.2014;2014;03;07;Lauantai;3;7;10;4;10;14
89;01.03.2014;2014;03;08;Lauantai;3;20;23;17;18;35
89;01.03.2014;2014;03;09;Lauantai;10;25;35;15;23;38
89;01.03.2014;2014;03;10;Lauantai;17;36;53;26;36;62
89;01.03.2014;2014;03;11;Lauantai;31;45;76;33;48;81
89;01.03.2014;2014;03;12;Lauantai;39;49;88;38;39;77
89;01.03.2014;2014;03;13;Lauantai;48;46;94;40;38;78
89;01.03.2014;2014;03;14;Lauantai;66;38;104;35;27;62
89;01.03.2014;2014;03;15;Lauantai;49;34;83;41;30;71
89;01.03.2014;2014;03;16;Lauantai;45;31;76;49;30;79
89;01.03.2014;2014;03;17;Lauantai;31;30;61;25;27;52
89;01.03.2014;2014;03;18;Lauantai;26;23;49;25;17;42
89;01.03.2014;2014;03;19;Lauantai;35;16;51;23;15;38
89;01.03.2014;2014;03;20;Lauantai;30;27;57;10;13;23
89;01.03.2014;2014;03;21;Lauantai;20;21;41;10;13;23
89;01.03.2014;2014;03;22;Lauantai;4;11;15;7;10;17
89;01.03.2014;2014;03;23;Lauantai;14;20;34;5;12;17
89;02.03.2014;2014;03;00;Sunnuntai;8;15;23;7;10;17
89;02.03.2014;2014;03;01;Sunnuntai;12;9;21;4;5;9
89;02.03.2014;2014;03;02;Sunnuntai;13;5;18;6;2;8
89;02.03.2014;2014;03;03;Sunnuntai;18;5;23;5;0;5
89;02.03.2014;2014;03;04;Sunnuntai;11;1;12;10;0;10
89;02.03.2014;2014;03;05;Sunnuntai;2;0;2;3;1;4
89;02.03.2014;2014;03;06;Sunnuntai;2;8;10;2;1;3
89;02.03.2014;2014;03;07;Sunnuntai;5;1;6;3;0;3
89;02.03.2014;2014;03;08;Sunnuntai;7;9;16;9;7;16
89;02.03.2014;2014;03;09;Sunnuntai;8;13;21;17;26;43
89;02.03.2014;2014;03;10;Sunnuntai;11;36;47;33;46;79
89;02.03.2014;2014;03;11;Sunnuntai;33;27;60;40;31;71
89;02.03.2014;2014;03;12;Sunnuntai;16;59;75;61;75;136
89;02.03.2014;2014;03;13;Sunnuntai;54;55;109;59;83;142
89;02.03.2014;2014;03;14;Sunnuntai;52;50;102;68;55;123
89;02.03.2014;2014;03;15;Sunnuntai;53;28;81;62;65;127
89;02.03.2014;2014;03;16;Sunnuntai;46;38;84;60;42;102
89;02.03.2014;2014;03;17;Sunnuntai;32;28;60;36;29;65
89;02.03.2014;2014;03;18;Sunnuntai;35;23;58;28;28;56
89;02.03.2014;2014;03;19;Sunnuntai;22;11;33;27;15;42
89;02.03.2014;2014;03;20;Sunnuntai;20;13;33;13;8;21
89;02.03.2014;2014;03;21;Sunnuntai;18;18;36;9;6;15
89;02.03.2014;2014;03;22;Sunnuntai;9;7;16;6;3;9
89;02.03.2014;2014;03;23;Sunnuntai;3;3;6;2;4;6
89;03.03.2014;2014;03;00;Maanantai;7;1;8;1;1;2
89;03.03.2014;2014;03;01;Maanantai;2;1;3;1;0;1
89;03.03.2014;2014;03;02;Maanantai;2;1;3;1;0;1
89;03.03.2014;2014;03;03;Maanantai;3;4;7;0;0;0
89;03.03.2014;2014;03;04;Maanantai;2;2;4;2;0;2
89;03.03.2014;2014;03;05;Maanantai;2;10;12;0;2;2
89;03.03.2014;2014;03;06;Maanantai;17;26;43;2;5;7
89;03.03.2014;2014;03;07;Maanantai;14;89;103;4;31;35
89;03.03.2014;2014;03;08;Maanantai;17;110;127;10;36;46
89;03.03.2014;2014;03;09;Maanantai;21;76;97;9;32;41
89;03.03.2014;2014;03;10;Maanantai;18;39;57;26;31;57
89;03.03.2014;2014;03;11;Maanantai;36;39;75;27;28;55
89;03.03.2014;2014;03;12;Maanantai;31;57;88;36;42;78
89;03.03.2014;2014;03;13;Maanantai;41;48;89;34;31;65
89;03.03.2014;2014;03;14;Maanantai;63;44;107;30;26;56
89;03.03.2014;2014;03;15;Maanantai;89;50;139;43;32;75
89;03.03.2014;2014;03;16;Maanantai;109;59;168;42;21;63
89;03.03.2014;2014;03;17;Maanantai;74;35;109;34;19;53
89;03.03.2014;2014;03;18;Maanantai;46;27;73;30;31;61
89;03.03.2014;2014;03;19;Maanantai;25;19;44;35;14;49
89;03.03.2014;2014;03;20;Maanantai;34;22;56;24;20;44
89;03.03.2014;2014;03;21;Maanantai;23;19;42;15;11;26
89;03.03.2014;2014;03;22;Maanantai;15;5;20;3;3;6
89;03.03.2014;2014;03;23;Maanantai;5;1;6;3;1;4
89;04.03.2014;2014;03;00;Tiistai;6;3;9;0;0;0
89;04.03.2014;2014;03;01;Tiistai;4;1;5;2;1;3
89;04.03.2014;2014;03;02;Tiistai;1;0;1;1;0;1
89;04.03.2014;2014;03;03;Tiistai;2;4;6;0;0;0
89;04.03.2014;2014;03;04;Tiistai;0;3;3;0;0;0
89;04.03.2014;2014;03;05;Tiistai;1;10;11;2;0;2
89;04.03.2014;2014;03;06;Tiistai;12;28;40;4;5;9
89;04.03.2014;2014;03;07;Tiistai;21;97;118;3;27;30
89;04.03.2014;2014;03;08;Tiistai;24;106;130;12;33;45
89;04.03.2014;2014;03;09;Tiistai;18;55;73;12;42;54
89;04.03.2014;2014;03;10;Tiistai;22;37;59;37;43;80
89;04.03.2014;2014;03;11;Tiistai;35;62;97;28;31;59
89;04.03.2014;2014;03;12;Tiistai;34;55;89;36;39;75
89;04.03.2014;2014;03;13;Tiistai;61;70;131;24;29;53
89;04.03.2014;2014;03;14;Tiistai;46;72;118;33;32;65
89;04.03.2014;2014;03;15;Tiistai;90;47;137;40;21;61
89;04.03.2014;2014;03;16;Tiistai;120;38;158;45;31;76
89;04.03.2014;2014;03;17;Tiistai;72;36;108;31;15;46
89;04.03.2014;2014;03;18;Tiistai;46;30;76;30;23;53
89;04.03.2014;2014;03;19;Tiistai;38;20;58;29;19;48
89;04.03.2014;2014;03;20;Tiistai;34;19;53;19;13;32
89;04.03.2014;2014;03;21;Tiistai;24;19;43;12;9;21
89;04.03.2014;2014;03;22;Tiistai;14;4;18;6;3;9
89;04.03.2014;2014;03;23;Tiistai;10;5;15;1;4;5
89;05.03.2014;2014;03;00;Keskiviikko;4;8;12;2;0;2
89;05.03.2014;2014;03;01;Keskiviikko;9;0;9;1;1;2
89;05.03.2014;2014;03;02;Keskiviikko;7;2;9;2;0;2
89;05.03.2014;2014;03;03;Keskiviikko;14;5;19;4;1;5
89;05.03.2014;2014;03;04;Keskiviikko;5;4;9;2;0;2
89;05.03.2014;2014;03;05;Keskiviikko;5;8;13;0;1;1
89;05.03.2014;2014;03;06;Keskiviikko;12;26;38;3;1;4
89;05.03.2014;2014;03;07;Keskiviikko;14;83;97;4;36;40
89;05.03.2014;2014;03;08;Keskiviikko;12;99;111;13;31;44
89;05.03.2014;2014;03;09;Keskiviikko;16;67;83;15;35;50
89;05.03.2014;2014;03;10;Keskiviikko;30;43;73;31;34;65
89;05.03.2014;2014;03;11;Keskiviikko;48;57;105;20;35;55
89;05.03.2014;2014;03;12;Keskiviikko;36;67;103;30;61;91
89;05.03.2014;2014;03;13;Keskiviikko;64;33;97;40;27;67
89;05.03.2014;2014;03;14;Keskiviikko;55;60;115;43;18;61
89;05.03.2014;2014;03;15;Keskiviikko;74;38;112;34;19;53
89;05.03.2014;2014;03;16;Keskiviikko;101;52;153;35;28;63
89;05.03.2014;2014;03;17;Keskiviikko;90;52;142;41;34;75
89;05.03.2014;2014;03;18;Keskiviikko;52;46;98;38;18;56
89;05.03.2014;2014;03;19;Keskiviikko;44;22;66;26;24;50
89;05.03.2014;2014;03;20;Keskiviikko;41;19;60;21;23;44
89;05.03.2014;2014;03;21;Keskiviikko;29;18;47;12;17;29
89;05.03.2014;2014;03;22;Keskiviikko;12;7;19;10;5;15
89;05.03.2014;2014;03;23;Keskiviikko;10;2;12;4;7;11
89;06.03.2014;2014;03;00;Torstai;7;7;14;1;1;2
89;06.03.2014;2014;03;01;Torstai;4;1;5;2;3;5
89;06.03.2014;2014;03;02;Torstai;5;0;5;2;2;4
89;06.03.2014;2014;03;03;Torstai;2;1;3;3;0;3
89;06.03.2014;2014;03;04;Torstai;4;4;8;4;2;6
89;06.03.2014;2014;03;05;Torstai;1;8;9;5;2;7
89;06.03.2014;2014;03;06;Torstai;16;20;36;2;8;10
89;06.03.2014;2014;03;07;Torstai;16;79;95;4;30;34
89;06.03.2014;2014;03;08;Torstai;20;110;130;10;33;43
89;06.03.2014;2014;03;09;Torstai;21;53;74;11;17;28
89;06.03.2014;2014;03;10;Torstai;13;44;57;21;35;56
89;06.03.2014;2014;03;11;Torstai;29;42;71;29;35;64
89;06.03.2014;2014;03;12;Torstai;43;58;101;18;37;55
89;06.03.2014;2014;03;13;Torstai;38;57;95;39;29;68
89;06.03.2014;2014;03;14;Torstai;55;38;93;40;23;63
89;06.03.2014;2014;03;15;Torstai;72;43;115;26;14;40
89;06.03.2014;2014;03;16;Torstai;115;52;167;35;24;59
89;06.03.2014;2014;03;17;Torstai;63;37;100;43;21;64
89;06.03.2014;2014;03;18;Torstai;45;19;64;38;30;68
89;06.03.2014;2014;03;19;Torstai;36;28;64;20;15;35
89;06.03.2014;2014;03;20;Torstai;34;17;51;25;10;35
89;06.03.2014;2014;03;21;Torstai;24;16;40;11;16;27
89;06.03.2014;2014;03;22;Torstai;13;12;25;5;3;8
89;06.03.2014;2014;03;23;Torstai;6;7;13;2;2;4
89;07.03.2014;2014;03;00;Perjantai;4;4;8;1;1;2
89;07.03.2014;2014;03;01;Perjantai;1;1;2;1;2;3
89;07.03.2014;2014;03;02;Perjantai;2;8;10;5;0;5
89;07.03.2014;2014;03;03;Perjantai;3;1;4;2;2;4
89;07.03.2014;2014;03;04;Perjantai;7;2;9;2;0;2
89;07.03.2014;2014;03;05;Perjantai;4;7;11;2;0;2
89;07.03.2014;2014;03;06;Perjantai;13;23;36;4;1;5
89;07.03.2014;2014;03;07;Perjantai;9;65;74;5;27;32
89;07.03.2014;2014;03;08;Perjantai;14;89;103;11;30;41
89;07.03.2014;2014;03;09;Perjantai;24;48;72;5;24;29
89;07.03.2014;2014;03;10;Perjantai;24;37;61;22;25;47
89;07.03.2014;2014;03;11;Perjantai;27;43;70;26;25;51
89;07.03.2014;2014;03;12;Perjantai;37;40;77;23;25;48
89;07.03.2014;2014;03;13;Perjantai;49;64;113;20;24;44
89;07.03.2014;2014;03;14;Perjantai;45;55;100;20;23;43
89;07.03.2014;2014;03;15;Perjantai;82;49;131;30;18;48
89;07.03.2014;2014;03;16;Perjantai;80;44;124;31;24;55
89;07.03.2014;2014;03;17;Perjantai;55;42;97;43;21;64
89;07.03.2014;2014;03;18;Perjantai;47;38;85;22;33;55
89;07.03.2014;2014;03;19;Perjantai;29;19;48;16;10;26
89;07.03.2014;2014;03;20;Perjantai;24;15;39;9;1;10
89;07.03.2014;2014;03;21;Perjantai;14;15;29;6;2;8
89;07.03.2014;2014;03;22;Perjantai;12;6;18;3;7;10
89;07.03.2014;2014;03;23;Perjantai;5;3;8;0;1;1
89;08.03.2014;2014;03;00;Lauantai;4;10;14;3;3;6
89;08.03.2014;2014;03;01;Lauantai;6;6;12;8;2;10
89;08.03.2014;2014;03;02;Lauantai;8;3;11;8;1;9
89;08.03.2014;2014;03;03;Lauantai;11;3;14;7;0;7
89;08.03.2014;2014;03;04;Lauantai;6;4;10;8;0;8
89;08.03.2014;2014;03;05;Lauantai;3;3;6;0;0;0
89;08.03.2014;2014;03;06;Lauantai;5;11;16;1;2;3
89;08.03.2014;2014;03;07;Lauantai;3;11;14;2;3;5
89;08.03.2014;2014;03;08;Lauantai;7;24;31;8;8;16
89;08.03.2014;2014;03;09;Lauantai;9;29;38;18;23;41
89;08.03.2014;2014;03;10;Lauantai;10;47;57;23;39;62
89;08.03.2014;2014;03;11;Lauantai;42;47;89;25;37;62
89;08.03.2014;2014;03;12;Lauantai;42;56;98;48;44;92
89;08.03.2014;2014;03;13;Lauantai;36;61;97;63;62;125
89;08.03.2014;2014;03;14;Lauantai;70;47;117;62;54;116
89;08.03.2014;2014;03;15;Lauantai;57;48;105;49;46;95
89;08.03.2014;2014;03;16;Lauantai;43;45;88;48;27;75
89;08.03.2014;2014;03;17;Lauantai;39;32;71;41;22;63
89;08.03.2014;2014;03;18;Lauantai;35;26;61;23;23;46
89;08.03.2014;2014;03;19;Lauantai;31;14;45;18;8;26
89;08.03.2014;2014;03;20;Lauantai;19;15;34;14;12;26
89;08.03.2014;2014;03;21;Lauantai;16;19;35;4;8;12
89;08.03.2014;2014;03;22;Lauantai;12;9;21;2;10;12
89;08.03.2014;2014;03;23;Lauantai;9;18;27;1;4;5
89;09.03.2014;2014;03;00;Sunnuntai;8;7;15;5;8;13
89;09.03.2014;2014;03;01;Sunnuntai;15;4;19;1;2;3
89;09.03.2014;2014;03;02;Sunnuntai;7;7;14;2;0;2
89;09.03.2014;2014;03;03;Sunnuntai;18;0;18;6;1;7
89;09.03.2014;2014;03;04;Sunnuntai;7;2;9;9;0;9
89;09.03.2014;2014;03;05;Sunnuntai;3;2;5;2;0;2
89;09.03.2014;2014;03;06;Sunnuntai;6;5;11;2;0;2
89;09.03.2014;2014;03;07;Sunnuntai;1;3;4;6;4;10
89;09.03.2014;2014;03;08;Sunnuntai;4;13;17;12;9;21
89;09.03.2014;2014;03;09;Sunnuntai;10;20;30;16;34;50
89;09.03.2014;2014;03;10;Sunnuntai;15;30;45;43;37;80
89;09.03.2014;2014;03;11;Sunnuntai;36;62;98;53;49;102
89;09.03.2014;2014;03;12;Sunnuntai;33;44;77;51;69;120
89;09.03.2014;2014;03;13;Sunnuntai;51;57;108;67;65;132
89;09.03.2014;2014;03;14;Sunnuntai;59;37;96;40;41;81
89;09.03.2014;2014;03;15;Sunnuntai;46;48;94;60;47;107
89;09.03.2014;2014;03;16;Sunnuntai;41;32;73;44;34;78
89;09.03.2014;2014;03;17;Sunnuntai;38;32;70;39;30;69
89;09.03.2014;2014;03;18;Sunnuntai;41;48;89;32;20;52
89;09.03.2014;2014;03;19;Sunnuntai;17;31;48;36;38;74
89;09.03.2014;2014;03;20;Sunnuntai;27;14;41;20;17;37
89;09.03.2014;2014;03;21;Sunnuntai;35;9;44;15;6;21
89;09.03.2014;2014;03;22;Sunnuntai;19;14;33;5;3;8
89;09.03.2014;2014;03;23;Sunnuntai;4;8;12;3;0;3
89;10.03.2014;2014;03;00;Maanantai;5;3;8;4;1;5
89;10.03.2014;2014;03;01;Maanantai;6;1;7;0;1;1
89;10.03.2014;2014;03;02;Maanantai;0;0;0;3;2;5
89;10.03.2014;2014;03;03;Maanantai;3;2;5;2;1;3
89;10.03.2014;2014;03;04;Maanantai;4;0;4;3;0;3
89;10.03.2014;2014;03;05;Maanantai;3;10;13;1;0;1
89;10.03.2014;2014;03;06;Maanantai;22;26;48;4;5;9
89;10.03.2014;2014;03;07;Maanantai;34;112;146;3;32;35
89;10.03.2014;2014;03;08;Maanantai;49;194;243;13;40;53
89;10.03.2014;2014;03;09;Maanantai;25;92;117;14;63;77
89;10.03.2014;2014;03;10;Maanantai;38;72;110;35;35;70
89;10.03.2014;2014;03;11;Maanantai;41;57;98;23;35;58
89;10.03.2014;2014;03;12;Maanantai;50;74;124;30;30;60
89;10.03.2014;2014;03;13;Maanantai;66;70;136;44;37;81
89;10.03.2014;2014;03;14;Maanantai;75;65;140;48;49;97
89;10.03.2014;2014;03;15;Maanantai;134;60;194;63;37;100
89;10.03.2014;2014;03;16;Maanantai;178;70;248;41;34;75
89;10.03.2014;2014;03;17;Maanantai;106;62;168;52;30;82
89;10.03.2014;2014;03;18;Maanantai;52;59;111;46;47;93
89;10.03.2014;2014;03;19;Maanantai;57;22;79;36;28;64
89;10.03.2014;2014;03;20;Maanantai;41;22;63;34;16;50
89;10.03.2014;2014;03;21;Maanantai;43;15;58;24;8;32
89;10.03.2014;2014;03;22;Maanantai;16;7;23;9;2;11
89;10.03.2014;2014;03;23;Maanantai;5;1;6;2;1;3
89;11.03.2014;2014;03;00;Tiistai;4;2;6;2;0;2
89;11.03.2014;2014;03;01;Tiistai;2;0;2;0;0;0
89;11.03.2014;2014;03;02;Tiistai;1;0;1;0;0;0
89;11.03.2014;2014;03;03;Tiistai;0;3;3;2;0;2
89;11.03.2014;2014;03;04;Tiistai;1;1;2;0;1;1
89;11.03.2014;2014;03;05;Tiistai;2;12;14;2;0;2
89;11.03.2014;2014;03;06;Tiistai;17;37;54;0;8;8
89;11.03.2014;2014;03;07;Tiistai;29;142;171;4;27;31
89;11.03.2014;2014;03;08;Tiistai;48;209;257;14;49;63
89;11.03.2014;2014;03;09;Tiistai;33;109;142;14;33;47
89;11.03.2014;2014;03;10;Tiistai;40;55;95;23;35;58
89;11.03.2014;2014;03;11;Tiistai;59;74;133;33;44;77
89;11.03.2014;2014;03;12;Tiistai;61;76;137;29;27;56
89;11.03.2014;2014;03;13;Tiistai;82;80;162;44;36;80
89;11.03.2014;2014;03;14;Tiistai;90;66;156;44;28;72
89;11.03.2014;2014;03;15;Tiistai;133;68;201;38;30;68
89;11.03.2014;2014;03;16;Tiistai;198;76;274;42;25;67
89;11.03.2014;2014;03;17;Tiistai;113;87;200;40;42;82
89;11.03.2014;2014;03;18;Tiistai;92;50;142;44;45;89
89;11.03.2014;2014;03;19;Tiistai;74;34;108;32;29;61
89;11.03.2014;2014;03;20;Tiistai;51;26;77;37;24;61
89;11.03.2014;2014;03;21;Tiistai;67;18;85;10;9;19
89;11.03.2014;2014;03;22;Tiistai;10;10;20;6;3;9
89;11.03.2014;2014;03;23;Tiistai;3;8;11;2;4;6
89;12.03.2014;2014;03;00;Keskiviikko;5;1;6;2;2;4
89;12.03.2014;2014;03;01;Keskiviikko;3;1;4;1;0;1
89;12.03.2014;2014;03;02;Keskiviikko;4;1;5;0;1;1
89;12.03.2014;2014;03;03;Keskiviikko;2;3;5;0;1;1
89;12.03.2014;2014;03;04;Keskiviikko;2;2;4;0;0;0
89;12.03.2014;2014;03;05;Keskiviikko;3;8;11;1;2;3
89;12.03.2014;2014;03;06;Keskiviikko;17;23;40;3;4;7
89;12.03.2014;2014;03;07;Keskiviikko;36;137;173;2;20;22
89;12.03.2014;2014;03;08;Keskiviikko;46;177;223;12;41;53
89;12.03.2014;2014;03;09;Keskiviikko;27;83;110;18;32;50
89;12.03.2014;2014;03;10;Keskiviikko;39;70;109;23;31;54
89;12.03.2014;2014;03;11;Keskiviikko;41;70;111;32;35;67
89;12.03.2014;2014;03;12;Keskiviikko;55;62;117;24;22;46
89;12.03.2014;2014;03;13;Keskiviikko;48;64;112;27;30;57
89;12.03.2014;2014;03;14;Keskiviikko;109;57;166;45;30;75
89;12.03.2014;2014;03;15;Keskiviikko;113;86;199;48;37;85
89;12.03.2014;2014;03;16;Keskiviikko;156;84;240;54;28;82
89;12.03.2014;2014;03;17;Keskiviikko;115;72;187;54;44;98
89;12.03.2014;2014;03;18;Keskiviikko;80;67;147;52;37;89
89;12.03.2014;2014;03;19;Keskiviikko;73;28;101;31;26;57
89;12.03.2014;2014;03;20;Keskiviikko;52;31;83;29;14;43
89;12.03.2014;2014;03;21;Keskiviikko;39;26;65;20;11;31
89;12.03.2014;2014;03;22;Keskiviikko;13;7;20;9;6;15
89;12.03.2014;2014;03;23;Keskiviikko;8;4;12;4;2;6
89;13.03.2014;2014;03;00;Torstai;8;2;10;3;0;3
89;13.03.2014;2014;03;01;Torstai;2;2;4;1;1;2
89;13.03.2014;2014;03;02;Torstai;4;1;5;0;0;0
89;13.03.2014;2014;03;03;Torstai;3;2;5;0;0;0
89;13.03.2014;2014;03;04;Torstai;1;7;8;0;0;0
89;13.03.2014;2014;03;05;Torstai;4;9;13;1;2;3
89;13.03.2014;2014;03;06;Torstai;19;30;49;2;8;10
89;13.03.2014;2014;03;07;Torstai;33;151;184;11;39;50
89;13.03.2014;2014;03;08;Torstai;55;202;257;21;39;60
89;13.03.2014;2014;03;09;Torstai;38;128;166;18;45;63
89;13.03.2014;2014;03;10;Torstai;38;62;100;30;31;61
89;13.03.2014;2014;03;11;Torstai;54;68;122;39;26;65
89;13.03.2014;2014;03;12;Torstai;47;86;133;20;27;47
89;13.03.2014;2014;03;13;Torstai;63;72;135;29;29;58
89;13.03.2014;2014;03;14;Torstai;101;65;166;39;24;63
89;13.03.2014;2014;03;15;Torstai;140;81;221;42;30;72
89;13.03.2014;2014;03;16;Torstai;183;90;273;56;19;75
89;13.03.2014;2014;03;17;Torstai;121;63;184;38;29;67
89;13.03.2014;2014;03;18;Torstai;71;49;120;25;25;50
89;13.03.2014;2014;03;19;Torstai;52;22;74;22;9;31
89;13.03.2014;2014;03;20;Torstai;51;20;71;20;12;32
89;13.03.2014;2014;03;21;Torstai;30;16;46;12;5;17
89;13.03.2014;2014;03;22;Torstai;26;10;36;6;4;10
89;13.03.2014;2014;03;23;Torstai;10;9;19;1;4;5
89;14.03.2014;2014;03;00;Perjantai;8;2;10;3;2;5
89;14.03.2014;2014;03;01;Perjantai;4;3;7;3;0;3
89;14.03.2014;2014;03;02;Perjantai;7;0;7;3;0;3
89;14.03.2014;2014;03;03;Perjantai;3;3;6;1;0;1
89;14.03.2014;2014;03;04;Perjantai;0;2;2;2;0;2
89;14.03.2014;2014;03;05;Perjantai;5;6;11;0;2;2
89;14.03.2014;2014;03;06;Perjantai;15;32;47;7;10;17
89;14.03.2014;2014;03;07;Perjantai;30;132;162;5;29;34
89;14.03.2014;2014;03;08;Perjantai;57;174;231;10;40;50
89;14.03.2014;2014;03;09;Perjantai;31;92;123;11;44;55
89;14.03.2014;2014;03;10;Perjantai;34;47;81;18;34;52
89;14.03.2014;2014;03;11;Perjantai;45;79;124;12;33;45
89;14.03.2014;2014;03;12;Perjantai;60;87;147;27;30;57
89;14.03.2014;2014;03;13;Perjantai;77;64;141;29;26;55
89;14.03.2014;2014;03;14;Perjantai;110;68;178;45;32;77
89;14.03.2014;2014;03;15;Perjantai;126;65;191;42;23;65
89;14.03.2014;2014;03;16;Perjantai;124;58;182;30;35;65
89;14.03.2014;2014;03;17;Perjantai;77;52;129;31;21;52
89;14.03.2014;2014;03;18;Perjantai;60;44;104;37;33;70
89;14.03.2014;2014;03;19;Perjantai;60;34;94;26;12;38
89;14.03.2014;2014;03;20;Perjantai;42;20;62;19;13;32
89;14.03.2014;2014;03;21;Perjantai;23;30;53;9;9;18
89;14.03.2014;2014;03;22;Perjantai;26;13;39;5;12;17
89;14.03.2014;2014;03;23;Perjantai;13;14;27;8;7;15
89;15.03.2014;2014;03;00;Lauantai;12;10;22;7;9;16
89;15.03.2014;2014;03;01;Lauantai;10;4;14;2;1;3
89;15.03.2014;2014;03;02;Lauantai;8;4;12;6;4;10
89;15.03.2014;2014;03;03;Lauantai;5;3;8;4;1;5
89;15.03.2014;2014;03;04;Lauantai;12;2;14;5;0;5
89;15.03.2014;2014;03;05;Lauantai;8;3;11;3;2;5
89;15.03.2014;2014;03;06;Lauantai;5;15;20;2;4;6
89;15.03.2014;2014;03;07;Lauantai;3;11;14;9;5;14
89;15.03.2014;2014;03;08;Lauantai;12;26;38;10;8;18
89;15.03.2014;2014;03;09;Lauantai;11;46;57;16;31;47
89;15.03.2014;2014;03;10;Lauantai;22;42;64;33;43;76
89;15.03.2014;2014;03;11;Lauantai;29;68;97;35;54;89
89;15.03.2014;2014;03;12;Lauantai;52;72;124;47;55;102
89;15.03.2014;2014;03;13;Lauantai;53;50;103;38;29;67
89;15.03.2014;2014;03;14;Lauantai;59;62;121;49;35;84
89;15.03.2014;2014;03;15;Lauantai;58;46;104;31;33;64
89;15.03.2014;2014;03;16;Lauantai;58;35;93;31;15;46
89;15.03.2014;2014;03;17;Lauantai;42;32;74;23;19;42
89;15.03.2014;2014;03;18;Lauantai;55;27;82;16;26;42
89;15.03.2014;2014;03;19;Lauantai;25;25;50;13;13;26
89;15.03.2014;2014;03;20;Lauantai;21;17;38;9;15;24
89;15.03.2014;2014;03;21;Lauantai;20;21;41;8;4;12
89;15.03.2014;2014;03;22;Lauantai;20;5;25;5;3;8
89;15.03.2014;2014;03;23;Lauantai;12;21;33;2;6;8
89;16.03.2014;2014;03;00;Sunnuntai;6;10;16;3;5;8
89;16.03.2014;2014;03;01;Sunnuntai;9;6;15;8;2;10
89;16.03.2014;2014;03;02;Sunnuntai;9;5;14;3;2;5
89;16.03.2014;2014;03;03;Sunnuntai;11;3;14;6;0;6
89;16.03.2014;2014;03;04;Sunnuntai;14;2;16;10;1;11
89;16.03.2014;2014;03;05;Sunnuntai;7;3;10;2;1;3
89;16.03.2014;2014;03;06;Sunnuntai;6;11;17;1;3;4
89;16.03.2014;2014;03;07;Sunnuntai;2;2;4;2;4;6
89;16.03.2014;2014;03;08;Sunnuntai;1;6;7;14;14;28
89;16.03.2014;2014;03;09;Sunnuntai;8;25;33;28;34;62
89;16.03.2014;2014;03;10;Sunnuntai;11;30;41;44;49;93
89;16.03.2014;2014;03;11;Sunnuntai;25;39;64;64;53;117
89;16.03.2014;2014;03;12;Sunnuntai;30;41;71;74;86;160
89;16.03.2014;2014;03;13;Sunnuntai;32;45;77;69;87;156
89;16.03.2014;2014;03;14;Sunnuntai;47;53;100;65;59;124
89;16.03.2014;2014;03;15;Sunnuntai;60;59;119;41;63;104
89;16.03.2014;2014;03;16;Sunnuntai;36;43;79;49;35;84
89;16.03.2014;2014;03;17;Sunnuntai;47;37;84;38;28;66
89;16.03.2014;2014;03;18;Sunnuntai;49;29;78;35;32;67
89;16.03.2014;2014;03;19;Sunnuntai;27;24;51;21;24;45
89;16.03.2014;2014;03;20;Sunnuntai;29;14;43;11;16;27
89;16.03.2014;2014;03;21;Sunnuntai;20;14;34;14;5;19
89;16.03.2014;2014;03;22;Sunnuntai;11;4;15;2;3;5
89;16.03.2014;2014;03;23;Sunnuntai;3;3;6;1;3;4
89;17.03.2014;2014;03;00;Maanantai;4;3;7;1;1;2
89;17.03.2014;2014;03;01;Maanantai;1;0;1;0;0;0
89;17.03.2014;2014;03;02;Maanantai;1;0;1;1;0;1
89;17.03.2014;2014;03;03;Maanantai;1;2;3;0;0;0
89;17.03.2014;2014;03;04;Maanantai;2;3;5;2;0;2
89;17.03.2014;2014;03;05;Maanantai;2;7;9;0;3;3
89;17.03.2014;2014;03;06;Maanantai;13;30;43;0;7;7
89;17.03.2014;2014;03;07;Maanantai;24;114;138;2;29;31
89;17.03.2014;2014;03;08;Maanantai;41;177;218;11;46;57
89;17.03.2014;2014;03;09;Maanantai;34;108;142;10;47;57
89;17.03.2014;2014;03;10;Maanantai;45;53;98;23;37;60
89;17.03.2014;2014;03;11;Maanantai;41;81;122;27;27;54
89;17.03.2014;2014;03;12;Maanantai;49;81;130;35;30;65
89;17.03.2014;2014;03;13;Maanantai;69;67;136;47;24;71
89;17.03.2014;2014;03;14;Maanantai;109;68;177;56;31;87
89;17.03.2014;2014;03;15;Maanantai;136;71;207;52;34;86
89;17.03.2014;2014;03;16;Maanantai;181;77;258;50;33;83
89;17.03.2014;2014;03;17;Maanantai;99;73;172;43;40;83
89;17.03.2014;2014;03;18;Maanantai;73;46;119;50;41;91
89;17.03.2014;2014;03;19;Maanantai;63;41;104;34;26;60
89;17.03.2014;2014;03;20;Maanantai;36;29;65;35;31;66
89;17.03.2014;2014;03;21;Maanantai;47;19;66;18;10;28
89;17.03.2014;2014;03;22;Maanantai;19;6;25;9;5;14
89;17.03.2014;2014;03;23;Maanantai;6;2;8;3;1;4
89;18.03.2014;2014;03;00;Tiistai;4;0;4;5;0;5
89;18.03.2014;2014;03;01;Tiistai;1;1;2;0;1;1
89;18.03.2014;2014;03;02;Tiistai;1;0;1;0;0;0
89;18.03.2014;2014;03;03;Tiistai;1;2;3;0;0;0
89;18.03.2014;2014;03;04;Tiistai;3;4;7;0;0;0
89;18.03.2014;2014;03;05;Tiistai;2;7;9;0;1;1
89;18.03.2014;2014;03;06;Tiistai;11;34;45;1;8;9
89;18.03.2014;2014;03;07;Tiistai;30;139;169;2;32;34
89;18.03.2014;2014;03;08;Tiistai;42;181;223;17;63;80
89;18.03.2014;2014;03;09;Tiistai;33;102;135;22;44;66
89;18.03.2014;2014;03;10;Tiistai;36;62;98;27;39;66
89;18.03.2014;2014;03;11;Tiistai;52;67;119;34;48;82
89;18.03.2014;2014;03;12;Tiistai;45;71;116;39;39;78
89;18.03.2014;2014;03;13;Tiistai;52;68;120;29;22;51
89;18.03.2014;2014;03;14;Tiistai;84;60;144;36;16;52
89;18.03.2014;2014;03;15;Tiistai;150;58;208;38;22;60
89;18.03.2014;2014;03;16;Tiistai;186;65;251;55;36;91
89;18.03.2014;2014;03;17;Tiistai;79;70;149;40;42;82
89;18.03.2014;2014;03;18;Tiistai;84;47;131;40;47;87
89;18.03.2014;2014;03;19;Tiistai;54;41;95;50;39;89
89;18.03.2014;2014;03;20;Tiistai;60;22;82;24;14;38
89;18.03.2014;2014;03;21;Tiistai;31;13;44;12;12;24
89;18.03.2014;2014;03;22;Tiistai;6;8;14;3;4;7
89;18.03.2014;2014;03;23;Tiistai;8;3;11;1;1;2
89;19.03.2014;2014;03;00;Keskiviikko;2;3;5;2;0;2
89;19.03.2014;2014;03;01;Keskiviikko;1;1;2;0;0;0
89;19.03.2014;2014;03;02;Keskiviikko;1;0;1;0;0;0
89;19.03.2014;2014;03;03;Keskiviikko;4;1;5;1;1;2
89;19.03.2014;2014;03;04;Keskiviikko;4;3;7;1;0;1
89;19.03.2014;2014;03;05;Keskiviikko;6;7;13;1;1;2
89;19.03.2014;2014;03;06;Keskiviikko;17;42;59;3;6;9
89;19.03.2014;2014;03;07;Keskiviikko;25;135;160;8;36;44
89;19.03.2014;2014;03;08;Keskiviikko;54;225;279;12;54;66
89;19.03.2014;2014;03;09;Keskiviikko;35;96;131;18;41;59
89;19.03.2014;2014;03;10;Keskiviikko;32;63;95;24;37;61
89;19.03.2014;2014;03;11;Keskiviikko;41;59;100;30;45;75
89;19.03.2014;2014;03;12;Keskiviikko;46;72;118;33;47;80
89;19.03.2014;2014;03;13;Keskiviikko;62;60;122;40;25;65
89;19.03.2014;2014;03;14;Keskiviikko;94;58;152;46;37;83
89;19.03.2014;2014;03;15;Keskiviikko;142;88;230;46;32;78
89;19.03.2014;2014;03;16;Keskiviikko;155;93;248;53;41;94
89;19.03.2014;2014;03;17;Keskiviikko;108;69;177;50;40;90
89;19.03.2014;2014;03;18;Keskiviikko;57;57;114;49;32;81
89;19.03.2014;2014;03;19;Keskiviikko;49;30;79;51;32;83
89;19.03.2014;2014;03;20;Keskiviikko;62;18;80;22;26;48
89;19.03.2014;2014;03;21;Keskiviikko;30;18;48;13;9;22
89;19.03.2014;2014;03;22;Keskiviikko;15;14;29;5;1;6
89;19.03.2014;2014;03;23;Keskiviikko;14;7;21;3;8;11
89;20.03.2014;2014;03;00;Torstai;5;3;8;1;1;2
89;20.03.2014;2014;03;01;Torstai;0;2;2;1;0;1
89;20.03.2014;2014;03;02;Torstai;5;2;7;3;1;4
89;20.03.2014;2014;03;03;Torstai;0;1;1;3;0;3
89;20.03.2014;2014;03;04;Torstai;5;5;10;0;0;0
89;20.03.2014;2014;03;05;Torstai;1;5;6;1;0;1
89;20.03.2014;2014;03;06;Torstai;16;29;45;0;7;7
89;20.03.2014;2014;03;07;Torstai;25;137;162;5;42;47
89;20.03.2014;2014;03;08;Torstai;46;201;247;18;49;67
89;20.03.2014;2014;03;09;Torstai;31;104;135;11;37;48
89;20.03.2014;2014;03;10;Torstai;36;60;96;34;36;70
89;20.03.2014;2014;03;11;Torstai;44;63;107;27;44;71
89;20.03.2014;2014;03;12;Torstai;66;69;135;42;31;73
89;20.03.2014;2014;03;13;Torstai;67;69;136;39;40;79
89;20.03.2014;2014;03;14;Torstai;115;81;196;44;43;87
89;20.03.2014;2014;03;15;Torstai;141;72;213;53;37;90
89;20.03.2014;2014;03;16;Torstai;176;81;257;50;32;82
89;20.03.2014;2014;03;17;Torstai;102;79;181;28;37;65
89;20.03.2014;2014;03;18;Torstai;73;59;132;30;31;61
89;20.03.2014;2014;03;19;Torstai;71;40;111;37;34;71
89;20.03.2014;2014;03;20;Torstai;53;28;81;25;24;49
89;20.03.2014;2014;03;21;Torstai;45;14;59;11;11;22
89;20.03.2014;2014;03;22;Torstai;23;7;30;6;6;12
89;20.03.2014;2014;03;23;Torstai;13;5;18;2;1;3
89;21.03.2014;2014;03;00;Perjantai;7;0;7;3;0;3
89;21.03.2014;2014;03;01;Perjantai;4;0;4;1;0;1
89;21.03.2014;2014;03;02;Perjantai;4;0;4;1;0;1
89;21.03.2014;2014;03;03;Perjantai;2;0;2;2;0;2
89;21.03.2014;2014;03;04;Perjantai;6;0;6;8;0;8
89;21.03.2014;2014;03;05;Perjantai;10;0;10;1;0;1
89;21.03.2014;2014;03;06;Perjantai;32;0;32;10;0;10
89;21.03.2014;2014;03;07;Perjantai;105;1;106;39;0;39
89;21.03.2014;2014;03;08;Perjantai;190;0;190;55;0;55
89;21.03.2014;2014;03;09;Perjantai;105;0;105;59;0;59
89;21.03.2014;2014;03;10;Perjantai;47;0;47;40;0;40
89;21.03.2014;2014;03;11;Perjantai;85;1;86;38;0;38
89;21.03.2014;2014;03;12;Perjantai;63;0;63;40;0;40
89;21.03.2014;2014;03;13;Perjantai;98;0;98;48;0;48
89;21.03.2014;2014;03;14;Perjantai;123;0;123;74;0;74
89;21.03.2014;2014;03;15;Perjantai;140;0;140;61;0;61
89;21.03.2014;2014;03;16;Perjantai;144;0;144;60;0;60
89;21.03.2014;2014;03;17;Perjantai;84;0;84;48;0;48
89;21.03.2014;2014;03;18;Perjantai;83;0;83;49;0;49
89;21.03.2014;2014;03;19;Perjantai;49;0;49;35;0;35
89;21.03.2014;2014;03;20;Perjantai;46;0;46;22;0;22
89;21.03.2014;2014;03;21;Perjantai;52;0;52;19;0;19
89;21.03.2014;2014;03;22;Perjantai;27;0;27;23;0;23
89;21.03.2014;2014;03;23;Perjantai;19;0;19;14;0;14
89;22.03.2014;2014;03;00;Lauantai;29;0;29;13;0;13
89;22.03.2014;2014;03;01;Lauantai;11;0;11;11;0;11
89;22.03.2014;2014;03;02;Lauantai;10;0;10;11;0;11
89;22.03.2014;2014;03;03;Lauantai;10;0;10;14;0;14
89;22.03.2014;2014;03;04;Lauantai;16;0;16;6;0;6
89;22.03.2014;2014;03;05;Lauantai;5;0;5;3;0;3
89;22.03.2014;2014;03;06;Lauantai;18;0;18;5;0;5
89;22.03.2014;2014;03;07;Lauantai;15;0;15;12;0;12
89;22.03.2014;2014;03;08;Lauantai;20;3;23;22;5;27
89;22.03.2014;2014;03;09;Lauantai;13;34;47;22;30;52
89;22.03.2014;2014;03;10;Lauantai;20;41;61;36;61;97
89;22.03.2014;2014;03;11;Lauantai;35;35;70;37;62;99
89;22.03.2014;2014;03;12;Lauantai;44;62;106;30;49;79
89;22.03.2014;2014;03;13;Lauantai;49;57;106;45;50;95
89;22.03.2014;2014;03;14;Lauantai;50;47;97;50;53;103
89;22.03.2014;2014;03;15;Lauantai;82;45;127;54;43;97
89;22.03.2014;2014;03;16;Lauantai;84;59;143;41;36;77
89;22.03.2014;2014;03;17;Lauantai;36;32;68;53;41;94
89;22.03.2014;2014;03;18;Lauantai;39;37;76;30;26;56
89;22.03.2014;2014;03;19;Lauantai;21;39;60;21;20;41
89;22.03.2014;2014;03;20;Lauantai;22;24;46;14;13;27
89;22.03.2014;2014;03;21;Lauantai;23;16;39;8;10;18
89;22.03.2014;2014;03;22;Lauantai;11;8;19;7;9;16
89;22.03.2014;2014;03;23;Lauantai;10;10;20;6;8;14
89;23.03.2014;2014;03;00;Sunnuntai;22;19;41;5;11;16
89;23.03.2014;2014;03;01;Sunnuntai;15;1;16;4;2;6
89;23.03.2014;2014;03;02;Sunnuntai;10;4;14;5;0;5
89;23.03.2014;2014;03;03;Sunnuntai;15;3;18;17;0;17
89;23.03.2014;2014;03;04;Sunnuntai;8;2;10;8;3;11
89;23.03.2014;2014;03;05;Sunnuntai;2;4;6;4;0;4
89;23.03.2014;2014;03;06;Sunnuntai;3;4;7;0;2;2
89;23.03.2014;2014;03;07;Sunnuntai;6;4;10;2;8;10
89;23.03.2014;2014;03;08;Sunnuntai;1;8;9;12;16;28
89;23.03.2014;2014;03;09;Sunnuntai;10;21;31;19;30;49
89;23.03.2014;2014;03;10;Sunnuntai;9;32;41;30;54;84
89;23.03.2014;2014;03;11;Sunnuntai;26;25;51;50;59;109
89;23.03.2014;2014;03;12;Sunnuntai;29;59;88;39;62;101
89;23.03.2014;2014;03;13;Sunnuntai;62;62;124;56;61;117
89;23.03.2014;2014;03;14;Sunnuntai;42;57;99;55;33;88
89;23.03.2014;2014;03;15;Sunnuntai;53;41;94;42;31;73
89;23.03.2014;2014;03;16;Sunnuntai;46;30;76;33;39;72
89;23.03.2014;2014;03;17;Sunnuntai;51;34;85;41;35;76
89;23.03.2014;2014;03;18;Sunnuntai;36;24;60;27;25;52
89;23.03.2014;2014;03;19;Sunnuntai;17;11;28;13;22;35
89;23.03.2014;2014;03;20;Sunnuntai;16;19;35;14;16;30
89;23.03.2014;2014;03;21;Sunnuntai;18;19;37;13;8;21
89;23.03.2014;2014;03;22;Sunnuntai;5;3;8;2;1;3
89;23.03.2014;2014;03;23;Sunnuntai;8;3;11;5;0;5
89;31.03.2014;2014;03;00;Maanantai;4;3;7;1;5;6
89;31.03.2014;2014;03;01;Maanantai;1;0;1;0;0;0
89;31.03.2014;2014;03;02;Maanantai;1;0;1;1;1;2
89;31.03.2014;2014;03;03;Maanantai;1;1;2;0;0;0
89;31.03.2014;2014;03;04;Maanantai;0;2;2;2;0;2
89;31.03.2014;2014;03;05;Maanantai;3;10;13;0;1;1
89;31.03.2014;2014;03;06;Maanantai;17;35;52;3;4;7
89;31.03.2014;2014;03;07;Maanantai;26;111;137;8;29;37
89;31.03.2014;2014;03;08;Maanantai;56;201;257;11;40;51
89;31.03.2014;2014;03;09;Maanantai;52;123;175;13;51;64
89;31.03.2014;2014;03;10;Maanantai;61;93;154;27;35;62
89;31.03.2014;2014;03;11;Maanantai;67;77;144;39;33;72
89;31.03.2014;2014;03;12;Maanantai;57;96;153;23;29;52
89;31.03.2014;2014;03;13;Maanantai;75;70;145;33;24;57
89;31.03.2014;2014;03;14;Maanantai;129;61;190;32;23;55
89;31.03.2014;2014;03;15;Maanantai;138;80;218;51;36;87
89;31.03.2014;2014;03;16;Maanantai;177;101;278;55;29;84
89;31.03.2014;2014;03;17;Maanantai;104;79;183;38;32;70
89;31.03.2014;2014;03;18;Maanantai;97;70;167;54;41;95
89;31.03.2014;2014;03;19;Maanantai;82;43;125;70;37;107
89;31.03.2014;2014;03;20;Maanantai;65;35;100;46;23;69
89;31.03.2014;2014;03;21;Maanantai;36;24;60;17;16;33
89;31.03.2014;2014;03;22;Maanantai;17;8;25;6;7;13
89;31.03.2014;2014;03;23;Maanantai;9;7;16;2;3;5
89;01.04.2014;2014;04;00;Tiistai;6;4;10;2;4;6
89;01.04.2014;2014;04;01;Tiistai;5;3;8;0;1;1
89;01.04.2014;2014;04;02;Tiistai;1;0;1;0;1;1
89;01.04.2014;2014;04;03;Tiistai;5;3;8;1;0;1
89;01.04.2014;2014;04;04;Tiistai;3;2;5;0;0;0
89;01.04.2014;2014;04;05;Tiistai;1;11;12;1;1;2
89;01.04.2014;2014;04;06;Tiistai;11;46;57;4;9;13
89;01.04.2014;2014;04;07;Tiistai;35;138;173;8;33;41
89;01.04.2014;2014;04;08;Tiistai;67;193;260;13;39;52
89;01.04.2014;2014;04;09;Tiistai;31;108;139;16;32;48
89;01.04.2014;2014;04;10;Tiistai;43;84;127;20;38;58
89;01.04.2014;2014;04;11;Tiistai;63;73;136;28;29;57
89;01.04.2014;2014;04;12;Tiistai;66;87;153;32;30;62
89;01.04.2014;2014;04;13;Tiistai;87;80;167;23;29;52
89;01.04.2014;2014;04;14;Tiistai;130;82;212;37;27;64
89;01.04.2014;2014;04;15;Tiistai;160;74;234;42;18;60
89;01.04.2014;2014;04;16;Tiistai;183;94;277;47;25;72
89;01.04.2014;2014;04;17;Tiistai;141;69;210;40;35;75
89;01.04.2014;2014;04;18;Tiistai;88;63;151;48;38;86
89;01.04.2014;2014;04;19;Tiistai;69;38;107;49;35;84
89;01.04.2014;2014;04;20;Tiistai;55;32;87;42;27;69
89;01.04.2014;2014;04;21;Tiistai;37;17;54;25;11;36
89;01.04.2014;2014;04;22;Tiistai;26;11;37;7;3;10
89;01.04.2014;2014;04;23;Tiistai;8;1;9;3;3;6
89;02.04.2014;2014;04;00;Keskiviikko;4;3;7;4;1;5
89;02.04.2014;2014;04;01;Keskiviikko;3;1;4;0;0;0
89;02.04.2014;2014;04;02;Keskiviikko;1;0;1;1;2;3
89;02.04.2014;2014;04;03;Keskiviikko;1;2;3;0;0;0
89;02.04.2014;2014;04;04;Keskiviikko;1;2;3;1;0;1
89;02.04.2014;2014;04;05;Keskiviikko;2;9;11;1;1;2
89;02.04.2014;2014;04;06;Keskiviikko;10;42;52;5;7;12
89;02.04.2014;2014;04;07;Keskiviikko;38;124;162;6;20;26
89;02.04.2014;2014;04;08;Keskiviikko;56;211;267;13;47;60
89;02.04.2014;2014;04;09;Keskiviikko;42;122;164;9;26;35
89;02.04.2014;2014;04;10;Keskiviikko;35;75;110;27;37;64
89;02.04.2014;2014;04;11;Keskiviikko;52;85;137;22;30;52
89;02.04.2014;2014;04;12;Keskiviikko;85;79;164;30;32;62
89;02.04.2014;2014;04;13;Keskiviikko;84;74;158;35;39;74
89;02.04.2014;2014;04;14;Keskiviikko;121;64;185;44;35;79
89;02.04.2014;2014;04;15;Keskiviikko;145;80;225;37;20;57
89;02.04.2014;2014;04;16;Keskiviikko;178;99;277;42;32;74
89;02.04.2014;2014;04;17;Keskiviikko;123;91;214;34;40;74
89;02.04.2014;2014;04;18;Keskiviikko;87;59;146;33;27;60
89;02.04.2014;2014;04;19;Keskiviikko;83;45;128;25;33;58
89;02.04.2014;2014;04;20;Keskiviikko;79;35;114;33;32;65
89;02.04.2014;2014;04;21;Keskiviikko;66;26;92;25;15;40
89;02.04.2014;2014;04;22;Keskiviikko;21;15;36;4;4;8
89;02.04.2014;2014;04;23;Keskiviikko;8;8;16;6;2;8
89;03.04.2014;2014;04;00;Torstai;6;1;7;0;1;1
89;03.04.2014;2014;04;01;Torstai;3;5;8;0;0;0
89;03.04.2014;2014;04;02;Torstai;6;1;7;0;0;0
89;03.04.2014;2014;04;03;Torstai;6;1;7;0;0;0
89;03.04.2014;2014;04;04;Torstai;4;0;4;0;0;0
89;03.04.2014;2014;04;05;Torstai;4;7;11;0;1;1
89;03.04.2014;2014;04;06;Torstai;12;44;56;8;9;17
89;03.04.2014;2014;04;07;Torstai;38;129;167;8;33;41
89;03.04.2014;2014;04;08;Torstai;61;194;255;13;51;64
89;03.04.2014;2014;04;09;Torstai;40;94;134;15;25;40
89;03.04.2014;2014;04;10;Torstai;41;85;126;25;35;60
89;03.04.2014;2014;04;11;Torstai;68;78;146;31;48;79
89;03.04.2014;2014;04;12;Torstai;80;79;159;47;34;81
89;03.04.2014;2014;04;13;Torstai;69;80;149;30;52;82
89;03.04.2014;2014;04;14;Torstai;125;83;208;29;29;58
89;03.04.2014;2014;04;15;Torstai;159;81;240;41;25;66
89;03.04.2014;2014;04;16;Torstai;180;107;287;52;28;80
89;03.04.2014;2014;04;17;Torstai;124;82;206;49;27;76
89;03.04.2014;2014;04;18;Torstai;88;70;158;35;44;79
89;03.04.2014;2014;04;19;Torstai;75;56;131;30;30;60
89;03.04.2014;2014;04;20;Torstai;67;33;100;31;17;48
89;03.04.2014;2014;04;21;Torstai;58;24;82;17;16;33
89;03.04.2014;2014;04;22;Torstai;33;16;49;15;9;24
89;03.04.2014;2014;04;23;Torstai;13;5;18;3;3;6
89;04.04.2014;2014;04;00;Perjantai;7;3;10;2;3;5
89;04.04.2014;2014;04;01;Perjantai;4;3;7;4;0;4
89;04.04.2014;2014;04;02;Perjantai;8;0;8;3;1;4
89;04.04.2014;2014;04;03;Perjantai;7;3;10;0;0;0
89;04.04.2014;2014;04;04;Perjantai;0;1;1;0;0;0
89;04.04.2014;2014;04;05;Perjantai;3;6;9;2;0;2
89;04.04.2014;2014;04;06;Perjantai;7;31;38;5;4;9
89;04.04.2014;2014;04;07;Perjantai;35;131;166;6;24;30
89;04.04.2014;2014;04;08;Perjantai;39;182;221;12;57;69
89;04.04.2014;2014;04;09;Perjantai;34;88;122;16;32;48
89;04.04.2014;2014;04;10;Perjantai;31;54;85;17;27;44
89;04.04.2014;2014;04;11;Perjantai;55;71;126;26;37;63
89;04.04.2014;2014;04;12;Perjantai;45;93;138;39;29;68
89;04.04.2014;2014;04;13;Perjantai;86;75;161;44;53;97
89;04.04.2014;2014;04;14;Perjantai;129;62;191;41;47;88
89;04.04.2014;2014;04;15;Perjantai;136;75;211;40;23;63
89;04.04.2014;2014;04;16;Perjantai;131;75;206;27;29;56
89;04.04.2014;2014;04;17;Perjantai;86;75;161;31;27;58
89;04.04.2014;2014;04;18;Perjantai;84;48;132;36;23;59
89;04.04.2014;2014;04;19;Perjantai;68;41;109;16;26;42
89;04.04.2014;2014;04;20;Perjantai;37;23;60;23;13;36
89;04.04.2014;2014;04;21;Perjantai;34;41;75;10;8;18
89;04.04.2014;2014;04;22;Perjantai;18;21;39;7;11;18
89;04.04.2014;2014;04;23;Perjantai;17;18;35;5;4;9
89;05.04.2014;2014;04;00;Lauantai;23;12;35;3;4;7
89;05.04.2014;2014;04;01;Lauantai;16;6;22;9;4;13
89;05.04.2014;2014;04;02;Lauantai;17;2;19;2;1;3
89;05.04.2014;2014;04;03;Lauantai;12;5;17;4;0;4
89;05.04.2014;2014;04;04;Lauantai;12;2;14;13;0;13
89;05.04.2014;2014;04;05;Lauantai;1;5;6;2;0;2
89;05.04.2014;2014;04;06;Lauantai;7;10;17;3;4;7
89;05.04.2014;2014;04;07;Lauantai;9;9;18;4;5;9
89;05.04.2014;2014;04;08;Lauantai;13;37;50;12;9;21
89;05.04.2014;2014;04;09;Lauantai;16;52;68;26;30;56
89;05.04.2014;2014;04;10;Lauantai;20;63;83;24;31;55
89;05.04.2014;2014;04;11;Lauantai;59;59;118;21;37;58
89;05.04.2014;2014;04;12;Lauantai;54;82;136;26;46;72
89;05.04.2014;2014;04;13;Lauantai;58;72;130;31;44;75
89;05.04.2014;2014;04;14;Lauantai;67;56;123;37;36;73
89;05.04.2014;2014;04;15;Lauantai;71;40;111;33;21;54
89;05.04.2014;2014;04;16;Lauantai;66;66;132;31;23;54
89;05.04.2014;2014;04;17;Lauantai;63;58;121;27;23;50
89;05.04.2014;2014;04;18;Lauantai;48;47;95;33;34;67
89;05.04.2014;2014;04;19;Lauantai;46;41;87;20;43;63
89;05.04.2014;2014;04;20;Lauantai;52;33;85;15;20;35
89;05.04.2014;2014;04;21;Lauantai;29;26;55;8;7;15
89;05.04.2014;2014;04;22;Lauantai;30;26;56;3;11;14
89;05.04.2014;2014;04;23;Lauantai;17;30;47;2;8;10
89;06.04.2014;2014;04;00;Sunnuntai;15;34;49;4;9;13
89;06.04.2014;2014;04;01;Sunnuntai;21;6;27;3;3;6
89;06.04.2014;2014;04;02;Sunnuntai;17;8;25;4;3;7
89;06.04.2014;2014;04;03;Sunnuntai;15;1;16;10;2;12
89;06.04.2014;2014;04;04;Sunnuntai;19;2;21;8;0;8
89;06.04.2014;2014;04;05;Sunnuntai;2;2;4;1;0;1
89;06.04.2014;2014;04;06;Sunnuntai;8;12;20;2;2;4
89;06.04.2014;2014;04;07;Sunnuntai;4;4;8;7;6;13
89;06.04.2014;2014;04;08;Sunnuntai;5;5;10;7;16;23
89;06.04.2014;2014;04;09;Sunnuntai;15;33;48;22;25;47
89;06.04.2014;2014;04;10;Sunnuntai;22;38;60;40;57;97
89;06.04.2014;2014;04;11;Sunnuntai;38;62;100;69;75;144
89;06.04.2014;2014;04;12;Sunnuntai;66;83;149;49;90;139
89;06.04.2014;2014;04;13;Sunnuntai;86;84;170;86;73;159
89;06.04.2014;2014;04;14;Sunnuntai;83;79;162;78;66;144
89;06.04.2014;2014;04;15;Sunnuntai;92;55;147;68;69;137
89;06.04.2014;2014;04;16;Sunnuntai;93;43;136;72;63;135
89;06.04.2014;2014;04;17;Sunnuntai;62;49;111;55;52;107
89;06.04.2014;2014;04;18;Sunnuntai;67;41;108;58;34;92
89;06.04.2014;2014;04;19;Sunnuntai;42;34;76;38;32;70
89;06.04.2014;2014;04;20;Sunnuntai;29;25;54;25;32;57
89;06.04.2014;2014;04;21;Sunnuntai;29;23;52;16;11;27
89;06.04.2014;2014;04;22;Sunnuntai;13;4;17;4;1;5
89;06.04.2014;2014;04;23;Sunnuntai;11;7;18;3;6;9
89;07.04.2014;2014;04;00;Maanantai;1;0;1;11;5;16
89;07.04.2014;2014;04;01;Maanantai;2;3;5;3;0;3
89;07.04.2014;2014;04;02;Maanantai;2;0;2;1;0;1
89;07.04.2014;2014;04;03;Maanantai;1;2;3;0;0;0
89;07.04.2014;2014;04;04;Maanantai;2;3;5;2;0;2
89;07.04.2014;2014;04;05;Maanantai;3;7;10;0;1;1
89;07.04.2014;2014;04;06;Maanantai;13;43;56;3;5;8
89;07.04.2014;2014;04;07;Maanantai;42;131;173;4;33;37
89;07.04.2014;2014;04;08;Maanantai;64;228;292;8;40;48
89;07.04.2014;2014;04;09;Maanantai;31;110;141;17;36;53
89;07.04.2014;2014;04;10;Maanantai;48;72;120;17;36;53
89;07.04.2014;2014;04;11;Maanantai;71;80;151;24;36;60
89;07.04.2014;2014;04;12;Maanantai;65;82;147;34;42;76
89;07.04.2014;2014;04;13;Maanantai;76;89;165;29;39;68
89;07.04.2014;2014;04;14;Maanantai;140;71;211;50;48;98
89;07.04.2014;2014;04;15;Maanantai;168;83;251;59;35;94
89;07.04.2014;2014;04;16;Maanantai;213;103;316;48;39;87
89;07.04.2014;2014;04;17;Maanantai;108;87;195;60;32;92
89;07.04.2014;2014;04;18;Maanantai;101;81;182;55;38;93
89;07.04.2014;2014;04;19;Maanantai;88;27;115;42;35;77
89;07.04.2014;2014;04;20;Maanantai;62;31;93;40;29;69
89;07.04.2014;2014;04;21;Maanantai;45;22;67;19;16;35
89;07.04.2014;2014;04;22;Maanantai;25;13;38;5;8;13
89;07.04.2014;2014;04;23;Maanantai;5;9;14;2;1;3
89;08.04.2014;2014;04;00;Tiistai;2;1;3;0;1;1
89;08.04.2014;2014;04;01;Tiistai;4;2;6;0;0;0
89;08.04.2014;2014;04;02;Tiistai;0;0;0;1;0;1
89;08.04.2014;2014;04;03;Tiistai;3;1;4;1;0;1
89;08.04.2014;2014;04;04;Tiistai;2;7;9;1;1;2
89;08.04.2014;2014;04;05;Tiistai;3;7;10;2;2;4
89;08.04.2014;2014;04;06;Tiistai;16;36;52;3;10;13
89;08.04.2014;2014;04;07;Tiistai;39;153;192;8;28;36
89;08.04.2014;2014;04;08;Tiistai;74;234;308;13;40;53
89;08.04.2014;2014;04;09;Tiistai;46;129;175;15;44;59
89;08.04.2014;2014;04;10;Tiistai;41;95;136;32;42;74
89;08.04.2014;2014;04;11;Tiistai;58;72;130;39;38;77
89;08.04.2014;2014;04;12;Tiistai;81;79;160;23;36;59
89;08.04.2014;2014;04;13;Tiistai;64;78;142;46;33;79
89;08.04.2014;2014;04;14;Tiistai;115;77;192;39;26;65
89;08.04.2014;2014;04;15;Tiistai;149;82;231;36;26;62
89;08.04.2014;2014;04;16;Tiistai;192;96;288;54;37;91
89;08.04.2014;2014;04;17;Tiistai;139;92;231;58;41;99
89;08.04.2014;2014;04;18;Tiistai;97;81;178;40;36;76
89;08.04.2014;2014;04;19;Tiistai;101;65;166;67;54;121
89;08.04.2014;2014;04;20;Tiistai;75;39;114;40;30;70
89;08.04.2014;2014;04;21;Tiistai;45;23;68;24;18;42
89;08.04.2014;2014;04;22;Tiistai;22;15;37;1;6;7
89;08.04.2014;2014;04;23;Tiistai;12;0;12;3;1;4
89;09.04.2014;2014;04;00;Keskiviikko;6;2;8;1;1;2
89;09.04.2014;2014;04;01;Keskiviikko;3;0;3;1;0;1
89;09.04.2014;2014;04;02;Keskiviikko;5;0;5;1;1;2
89;09.04.2014;2014;04;03;Keskiviikko;1;3;4;1;2;3
89;09.04.2014;2014;04;04;Keskiviikko;1;6;7;2;0;2
89;09.04.2014;2014;04;05;Keskiviikko;1;6;7;1;1;2
89;09.04.2014;2014;04;06;Keskiviikko;20;39;59;5;4;9
89;09.04.2014;2014;04;07;Keskiviikko;29;148;177;11;31;42
89;09.04.2014;2014;04;08;Keskiviikko;60;264;324;12;47;59
89;09.04.2014;2014;04;09;Keskiviikko;37;139;176;12;43;55
89;09.04.2014;2014;04;10;Keskiviikko;58;110;168;19;44;63
89;09.04.2014;2014;04;11;Keskiviikko;61;80;141;27;28;55
89;09.04.2014;2014;04;12;Keskiviikko;82;99;181;30;31;61
89;09.04.2014;2014;04;13;Keskiviikko;95;90;185;34;26;60
89;09.04.2014;2014;04;14;Keskiviikko;129;98;227;30;26;56
89;09.04.2014;2014;04;15;Keskiviikko;179;102;281;46;31;77
89;09.04.2014;2014;04;16;Keskiviikko;218;123;341;51;25;76
89;09.04.2014;2014;04;17;Keskiviikko;125;100;225;42;44;86
89;09.04.2014;2014;04;18;Keskiviikko;111;85;196;43;48;91
89;09.04.2014;2014;04;19;Keskiviikko;89;47;136;39;43;82
89;09.04.2014;2014;04;20;Keskiviikko;84;51;135;40;19;59
89;09.04.2014;2014;04;21;Keskiviikko;84;27;111;30;15;45
89;09.04.2014;2014;04;22;Keskiviikko;29;10;39;6;6;12
89;09.04.2014;2014;04;23;Keskiviikko;10;4;14;5;1;6
89;10.04.2014;2014;04;00;Torstai;12;3;15;2;0;2
89;10.04.2014;2014;04;01;Torstai;5;1;6;0;0;0
89;10.04.2014;2014;04;02;Torstai;6;2;8;2;1;3
89;10.04.2014;2014;04;03;Torstai;2;3;5;0;0;0
89;10.04.2014;2014;04;04;Torstai;8;7;15;4;0;4
89;10.04.2014;2014;04;05;Torstai;3;12;15;1;1;2
89;10.04.2014;2014;04;06;Torstai;14;33;47;4;4;8
89;10.04.2014;2014;04;07;Torstai;31;177;208;7;31;38
89;10.04.2014;2014;04;08;Torstai;72;243;315;18;41;59
89;10.04.2014;2014;04;09;Torstai;55;111;166;9;34;43
89;10.04.2014;2014;04;10;Torstai;57;91;148;21;42;63
89;10.04.2014;2014;04;11;Torstai;67;86;153;29;35;64
89;10.04.2014;2014;04;12;Torstai;70;105;175;23;32;55
89;10.04.2014;2014;04;13;Torstai;89;86;175;33;30;63
89;10.04.2014;2014;04;14;Torstai;123;93;216;38;26;64
89;10.04.2014;2014;04;15;Torstai;162;92;254;43;32;75
89;10.04.2014;2014;04;16;Torstai;209;113;322;38;28;66
89;10.04.2014;2014;04;17;Torstai;146;85;231;38;17;55
89;10.04.2014;2014;04;18;Torstai;111;71;182;43;37;80
89;10.04.2014;2014;04;19;Torstai;101;51;152;43;32;75
89;10.04.2014;2014;04;20;Torstai;86;48;134;28;26;54
89;10.04.2014;2014;04;21;Torstai;52;30;82;23;14;37
89;10.04.2014;2014;04;22;Torstai;25;16;41;14;5;19
89;10.04.2014;2014;04;23;Torstai;13;4;17;3;0;3
89;11.04.2014;2014;04;00;Perjantai;6;4;10;3;0;3
89;11.04.2014;2014;04;01;Perjantai;6;1;7;2;3;5
89;11.04.2014;2014;04;02;Perjantai;4;2;6;0;0;0
89;11.04.2014;2014;04;03;Perjantai;8;4;12;0;0;0
89;11.04.2014;2014;04;04;Perjantai;4;7;11;1;1;2
89;11.04.2014;2014;04;05;Perjantai;4;9;13;0;0;0
89;11.04.2014;2014;04;06;Perjantai;11;35;46;2;6;8
89;11.04.2014;2014;04;07;Perjantai;28;121;149;8;32;40
89;11.04.2014;2014;04;08;Perjantai;42;206;248;9;41;50
89;11.04.2014;2014;04;09;Perjantai;43;123;166;10;32;42
89;11.04.2014;2014;04;10;Perjantai;33;50;83;19;20;39
89;11.04.2014;2014;04;11;Perjantai;46;75;121;17;22;39
89;11.04.2014;2014;04;12;Perjantai;61;69;130;22;26;48
89;11.04.2014;2014;04;13;Perjantai;105;88;193;26;28;54
89;11.04.2014;2014;04;14;Perjantai;130;85;215;27;35;62
89;11.04.2014;2014;04;15;Perjantai;141;76;217;43;25;68
89;11.04.2014;2014;04;16;Perjantai;157;82;239;29;30;59
89;11.04.2014;2014;04;17;Perjantai;96;61;157;33;26;59
89;11.04.2014;2014;04;18;Perjantai;84;68;152;36;32;68
89;11.04.2014;2014;04;19;Perjantai;66;50;116;29;19;48
89;11.04.2014;2014;04;20;Perjantai;55;39;94;21;26;47
89;11.04.2014;2014;04;21;Perjantai;48;29;77;14;11;25
89;11.04.2014;2014;04;22;Perjantai;27;21;48;13;9;22
89;11.04.2014;2014;04;23;Perjantai;19;10;29;7;5;12
89;12.04.2014;2014;04;00;Lauantai;12;15;27;4;6;10
89;12.04.2014;2014;04;01;Lauantai;15;4;19;4;3;7
89;12.04.2014;2014;04;02;Lauantai;5;6;11;6;3;9
89;12.04.2014;2014;04;03;Lauantai;15;0;15;8;1;9
89;12.04.2014;2014;04;04;Lauantai;8;3;11;3;0;3
89;12.04.2014;2014;04;05;Lauantai;3;3;6;2;1;3
89;12.04.2014;2014;04;06;Lauantai;4;7;11;4;1;5
89;12.04.2014;2014;04;07;Lauantai;6;22;28;6;8;14
89;12.04.2014;2014;04;08;Lauantai;9;40;49;12;14;26
89;12.04.2014;2014;04;09;Lauantai;16;55;71;17;29;46
89;12.04.2014;2014;04;10;Lauantai;37;88;125;33;37;70
89;12.04.2014;2014;04;11;Lauantai;55;97;152;32;50;82
89;12.04.2014;2014;04;12;Lauantai;78;125;203;43;58;101
89;12.04.2014;2014;04;13;Lauantai;94;98;192;49;51;100
89;12.04.2014;2014;04;14;Lauantai;114;82;196;52;40;92
89;12.04.2014;2014;04;15;Lauantai;127;81;208;63;52;115
89;12.04.2014;2014;04;16;Lauantai;89;52;141;59;29;88
89;12.04.2014;2014;04;17;Lauantai;75;84;159;34;44;78
89;12.04.2014;2014;04;18;Lauantai;76;54;130;43;29;72
89;12.04.2014;2014;04;19;Lauantai;49;46;95;27;25;52
89;12.04.2014;2014;04;20;Lauantai;35;46;81;18;24;42
89;12.04.2014;2014;04;21;Lauantai;35;35;70;15;16;31
89;12.04.2014;2014;04;22;Lauantai;14;15;29;3;9;12
89;12.04.2014;2014;04;23;Lauantai;21;24;45;7;9;16
89;13.04.2014;2014;04;00;Sunnuntai;12;18;30;3;8;11
89;13.04.2014;2014;04;01;Sunnuntai;15;7;22;5;1;6
89;13.04.2014;2014;04;02;Sunnuntai;19;4;23;6;0;6
89;13.04.2014;2014;04;03;Sunnuntai;13;1;14;7;0;7
89;13.04.2014;2014;04;04;Sunnuntai;24;5;29;3;0;3
89;13.04.2014;2014;04;05;Sunnuntai;10;4;14;2;0;2
89;13.04.2014;2014;04;06;Sunnuntai;5;6;11;0;2;2
89;13.04.2014;2014;04;07;Sunnuntai;1;7;8;1;2;3
89;13.04.2014;2014;04;08;Sunnuntai;2;11;13;7;7;14
89;13.04.2014;2014;04;09;Sunnuntai;5;9;14;13;6;19
89;13.04.2014;2014;04;10;Sunnuntai;11;22;33;16;21;37
89;13.04.2014;2014;04;11;Sunnuntai;19;35;54;24;32;56
89;13.04.2014;2014;04;12;Sunnuntai;42;72;114;22;35;57
89;13.04.2014;2014;04;13;Sunnuntai;45;55;100;41;37;78
89;13.04.2014;2014;04;14;Sunnuntai;39;53;92;30;27;57
89;13.04.2014;2014;04;15;Sunnuntai;55;48;103;34;28;62
89;13.04.2014;2014;04;16;Sunnuntai;58;38;96;29;34;63
89;13.04.2014;2014;04;17;Sunnuntai;34;27;61;20;14;34
89;13.04.2014;2014;04;18;Sunnuntai;35;19;54;19;25;44
89;13.04.2014;2014;04;19;Sunnuntai;31;11;42;22;34;56
89;13.04.2014;2014;04;20;Sunnuntai;23;22;45;24;16;40
89;13.04.2014;2014;04;21;Sunnuntai;27;18;45;21;12;33
89;13.04.2014;2014;04;22;Sunnuntai;11;12;23;6;6;12
89;13.04.2014;2014;04;23;Sunnuntai;3;4;7;0;5;5
89;14.04.2014;2014;04;00;Maanantai;1;8;9;0;1;1
89;14.04.2014;2014;04;01;Maanantai;1;0;1;2;0;2
89;14.04.2014;2014;04;02;Maanantai;3;1;4;0;1;1
89;14.04.2014;2014;04;03;Maanantai;1;2;3;0;1;1
89;14.04.2014;2014;04;04;Maanantai;0;3;3;0;1;1
89;14.04.2014;2014;04;05;Maanantai;4;9;13;0;0;0
89;14.04.2014;2014;04;06;Maanantai;11;39;50;2;4;6
89;14.04.2014;2014;04;07;Maanantai;40;132;172;10;24;34
89;14.04.2014;2014;04;08;Maanantai;47;211;258;10;42;52
89;14.04.2014;2014;04;09;Maanantai;33;92;125;9;37;46
89;14.04.2014;2014;04;10;Maanantai;42;83;125;16;32;48
89;14.04.2014;2014;04;11;Maanantai;56;76;132;28;34;62
89;14.04.2014;2014;04;12;Maanantai;70;59;129;20;19;39
89;14.04.2014;2014;04;13;Maanantai;73;80;153;22;18;40
89;14.04.2014;2014;04;14;Maanantai;103;80;183;30;13;43
89;14.04.2014;2014;04;15;Maanantai;120;83;203;34;24;58
89;14.04.2014;2014;04;16;Maanantai;179;98;277;26;22;48
89;14.04.2014;2014;04;17;Maanantai;109;71;180;32;21;53
89;14.04.2014;2014;04;18;Maanantai;82;69;151;37;31;68
89;14.04.2014;2014;04;19;Maanantai;105;50;155;35;32;67
89;14.04.2014;2014;04;20;Maanantai;71;43;114;29;27;56
89;14.04.2014;2014;04;21;Maanantai;48;35;83;24;12;36
89;14.04.2014;2014;04;22;Maanantai;24;16;40;5;4;9
89;14.04.2014;2014;04;23;Maanantai;7;0;7;2;2;4
89;15.04.2014;2014;04;00;Tiistai;3;2;5;1;2;3
89;15.04.2014;2014;04;01;Tiistai;1;3;4;1;3;4
89;15.04.2014;2014;04;02;Tiistai;1;1;2;0;0;0
89;15.04.2014;2014;04;03;Tiistai;0;1;1;1;0;1
89;15.04.2014;2014;04;04;Tiistai;0;3;3;0;1;1
89;15.04.2014;2014;04;05;Tiistai;2;9;11;2;0;2
89;15.04.2014;2014;04;06;Tiistai;21;46;67;7;9;16
89;15.04.2014;2014;04;07;Tiistai;52;178;230;7;29;36
89;15.04.2014;2014;04;08;Tiistai;77;255;332;22;48;70
89;15.04.2014;2014;04;09;Tiistai;54;138;192;13;37;50
89;15.04.2014;2014;04;10;Tiistai;56;119;175;31;60;91
89;15.04.2014;2014;04;11;Tiistai;76;81;157;20;30;50
89;15.04.2014;2014;04;12;Tiistai;86;81;167;23;24;47
89;15.04.2014;2014;04;13;Tiistai;84;90;174;20;21;41
89;15.04.2014;2014;04;14;Tiistai;121;76;197;37;29;66
89;15.04.2014;2014;04;15;Tiistai;150;112;262;36;24;60
89;15.04.2014;2014;04;16;Tiistai;218;133;351;47;33;80
89;15.04.2014;2014;04;17;Tiistai;133;98;231;37;43;80
89;15.04.2014;2014;04;18;Tiistai;94;95;189;52;36;88
89;15.04.2014;2014;04;19;Tiistai;90;49;139;39;36;75
89;15.04.2014;2014;04;20;Tiistai;67;26;93;30;19;49
89;15.04.2014;2014;04;21;Tiistai;74;35;109;23;14;37
89;15.04.2014;2014;04;22;Tiistai;26;13;39;6;6;12
89;15.04.2014;2014;04;23;Tiistai;17;6;23;5;3;8
89;16.04.2014;2014;04;00;Keskiviikko;4;1;5;1;1;2
89;16.04.2014;2014;04;01;Keskiviikko;5;5;10;4;1;5
89;16.04.2014;2014;04;02;Keskiviikko;6;5;11;1;0;1
89;16.04.2014;2014;04;03;Keskiviikko;1;2;3;0;0;0
89;16.04.2014;2014;04;04;Keskiviikko;4;3;7;0;1;1
89;16.04.2014;2014;04;05;Keskiviikko;1;7;8;0;1;1
89;16.04.2014;2014;04;06;Keskiviikko;17;46;63;2;6;8
89;16.04.2014;2014;04;07;Keskiviikko;47;159;206;11;27;38
89;16.04.2014;2014;04;08;Keskiviikko;70;254;324;14;45;59
89;16.04.2014;2014;04;09;Keskiviikko;44;128;172;19;35;54
89;16.04.2014;2014;04;10;Keskiviikko;38;112;150;29;28;57
89;16.04.2014;2014;04;11;Keskiviikko;51;89;140;41;35;76
89;16.04.2014;2014;04;12;Keskiviikko;86;85;171;25;36;61
89;16.04.2014;2014;04;13;Keskiviikko;95;102;197;26;27;53
89;16.04.2014;2014;04;14;Keskiviikko;149;102;251;36;34;70
89;16.04.2014;2014;04;15;Keskiviikko;145;90;235;44;41;85
89;16.04.2014;2014;04;16;Keskiviikko;201;118;319;35;19;54
89;16.04.2014;2014;04;17;Keskiviikko;109;91;200;51;35;86
89;16.04.2014;2014;04;18;Keskiviikko;107;62;169;36;29;65
89;16.04.2014;2014;04;19;Keskiviikko;79;38;117;35;32;67
89;16.04.2014;2014;04;20;Keskiviikko;68;40;108;27;13;40
89;16.04.2014;2014;04;21;Keskiviikko;42;23;65;17;19;36
89;16.04.2014;2014;04;22;Keskiviikko;26;13;39;14;5;19
89;16.04.2014;2014;04;23;Keskiviikko;12;16;28;2;6;8
89;17.04.2014;2014;04;00;Torstai;9;11;20;0;2;2
89;17.04.2014;2014;04;01;Torstai;5;1;6;2;1;3
89;17.04.2014;2014;04;02;Torstai;3;0;3;0;0;0
89;17.04.2014;2014;04;03;Torstai;2;3;5;3;1;4
89;17.04.2014;2014;04;04;Torstai;7;3;10;1;0;1
89;17.04.2014;2014;04;05;Torstai;5;11;16;0;0;0
89;17.04.2014;2014;04;06;Torstai;17;40;57;4;5;9
89;17.04.2014;2014;04;07;Torstai;31;145;176;6;26;32
89;17.04.2014;2014;04;08;Torstai;52;188;240;11;54;65
89;17.04.2014;2014;04;09;Torstai;48;127;175;16;42;58
89;17.04.2014;2014;04;10;Torstai;44;87;131;24;24;48
89;17.04.2014;2014;04;11;Torstai;76;99;175;21;32;53
89;17.04.2014;2014;04;12;Torstai;89;110;199;25;26;51
89;17.04.2014;2014;04;13;Torstai;94;100;194;29;37;66
89;17.04.2014;2014;04;14;Torstai;142;98;240;24;23;47
89;17.04.2014;2014;04;15;Torstai;141;59;200;40;16;56
89;17.04.2014;2014;04;16;Torstai;129;55;184;24;8;32
89;17.04.2014;2014;04;17;Torstai;81;80;161;19;17;36
89;17.04.2014;2014;04;18;Torstai;60;58;118;16;13;29
89;17.04.2014;2014;04;19;Torstai;47;36;83;11;17;28
89;17.04.2014;2014;04;20;Torstai;43;29;72;11;13;24
89;17.04.2014;2014;04;21;Torstai;43;30;73;15;10;25
89;17.04.2014;2014;04;22;Torstai;20;22;42;8;11;19
89;17.04.2014;2014;04;23;Torstai;19;28;47;4;2;6
89;18.04.2014;2014;04;00;Perjantai;14;7;21;1;2;3
89;18.04.2014;2014;04;01;Perjantai;13;3;16;3;1;4
89;18.04.2014;2014;04;02;Perjantai;10;7;17;4;2;6
89;18.04.2014;2014;04;03;Perjantai;11;1;12;6;1;7
89;18.04.2014;2014;04;04;Perjantai;14;3;17;2;0;2
89;18.04.2014;2014;04;05;Perjantai;2;3;5;1;1;2
89;18.04.2014;2014;04;06;Perjantai;2;11;13;0;3;3
89;18.04.2014;2014;04;07;Perjantai;3;1;4;3;6;9
89;18.04.2014;2014;04;08;Perjantai;5;6;11;5;6;11
89;18.04.2014;2014;04;09;Perjantai;4;6;10;5;19;24
89;18.04.2014;2014;04;10;Perjantai;9;14;23;13;11;24
89;18.04.2014;2014;04;11;Perjantai;21;33;54;19;21;40
89;18.04.2014;2014;04;12;Perjantai;20;17;37;17;21;38
89;18.04.2014;2014;04;13;Perjantai;29;41;70;18;27;45
89;18.04.2014;2014;04;14;Perjantai;38;48;86;26;35;61
89;18.04.2014;2014;04;15;Perjantai;53;38;91;27;25;52
89;18.04.2014;2014;04;16;Perjantai;33;33;66;37;24;61
89;18.04.2014;2014;04;17;Perjantai;46;49;95;25;30;55
89;18.04.2014;2014;04;18;Perjantai;48;35;83;33;22;55
89;18.04.2014;2014;04;19;Perjantai;45;34;79;28;43;71
89;18.04.2014;2014;04;20;Perjantai;28;41;69;21;23;44
89;18.04.2014;2014;04;21;Perjantai;22;25;47;11;17;28
89;18.04.2014;2014;04;22;Perjantai;18;14;32;5;10;15
89;18.04.2014;2014;04;23;Perjantai;11;13;24;1;5;6
89;19.04.2014;2014;04;00;Lauantai;11;14;25;0;6;6
89;19.04.2014;2014;04;01;Lauantai;8;7;15;1;5;6
89;19.04.2014;2014;04;02;Lauantai;10;7;17;4;6;10
89;19.04.2014;2014;04;03;Lauantai;13;3;16;5;2;7
89;19.04.2014;2014;04;04;Lauantai;13;5;18;7;0;7
89;19.04.2014;2014;04;05;Lauantai;8;2;10;2;0;2
89;19.04.2014;2014;04;06;Lauantai;6;11;17;1;1;2
89;19.04.2014;2014;04;07;Lauantai;4;16;20;3;2;5
89;19.04.2014;2014;04;08;Lauantai;7;20;27;7;9;16
89;19.04.2014;2014;04;09;Lauantai;14;36;50;7;18;25
89;19.04.2014;2014;04;10;Lauantai;25;71;96;16;23;39
89;19.04.2014;2014;04;11;Lauantai;33;88;121;20;30;50
89;19.04.2014;2014;04;12;Lauantai;63;86;149;41;47;88
89;19.04.2014;2014;04;13;Lauantai;85;92;177;31;34;65
89;19.04.2014;2014;04;14;Lauantai;78;57;135;22;24;46
89;19.04.2014;2014;04;15;Lauantai;65;68;133;37;62;99
89;19.04.2014;2014;04;16;Lauantai;50;82;132;25;27;52
89;19.04.2014;2014;04;17;Lauantai;58;48;106;27;41;68
89;19.04.2014;2014;04;18;Lauantai;53;77;130;27;35;62
89;19.04.2014;2014;04;19;Lauantai;79;30;109;21;22;43
89;19.04.2014;2014;04;20;Lauantai;56;34;90;19;19;38
89;19.04.2014;2014;04;21;Lauantai;21;40;61;11;9;20
89;19.04.2014;2014;04;22;Lauantai;17;26;43;3;13;16
89;19.04.2014;2014;04;23;Lauantai;10;19;29;2;10;12
89;20.04.2014;2014;04;00;Sunnuntai;14;8;22;1;3;4
89;20.04.2014;2014;04;01;Sunnuntai;11;7;18;5;1;6
89;20.04.2014;2014;04;02;Sunnuntai;18;9;27;6;0;6
89;20.04.2014;2014;04;03;Sunnuntai;18;2;20;9;0;9
89;20.04.2014;2014;04;04;Sunnuntai;21;0;21;10;0;10
89;20.04.2014;2014;04;05;Sunnuntai;5;3;8;2;2;4
89;20.04.2014;2014;04;06;Sunnuntai;3;9;12;2;1;3
89;20.04.2014;2014;04;07;Sunnuntai;3;4;7;5;2;7
89;20.04.2014;2014;04;08;Sunnuntai;5;12;17;6;5;11
89;20.04.2014;2014;04;09;Sunnuntai;14;21;35;12;22;34
89;20.04.2014;2014;04;10;Sunnuntai;17;36;53;20;47;67
89;20.04.2014;2014;04;11;Sunnuntai;36;58;94;38;41;79
89;20.04.2014;2014;04;12;Sunnuntai;56;93;149;54;66;120
89;20.04.2014;2014;04;13;Sunnuntai;104;89;193;48;67;115
89;20.04.2014;2014;04;14;Sunnuntai;87;116;203;48;86;134
89;20.04.2014;2014;04;15;Sunnuntai;95;109;204;59;49;108
89;20.04.2014;2014;04;16;Sunnuntai;71;65;136;40;43;83
89;20.04.2014;2014;04;17;Sunnuntai;78;81;159;40;31;71
89;20.04.2014;2014;04;18;Sunnuntai;61;75;136;38;43;81
89;20.04.2014;2014;04;19;Sunnuntai;52;46;98;31;38;69
89;20.04.2014;2014;04;20;Sunnuntai;39;39;78;24;19;43
89;20.04.2014;2014;04;21;Sunnuntai;29;34;63;7;12;19
89;20.04.2014;2014;04;22;Sunnuntai;24;23;47;6;9;15
89;20.04.2014;2014;04;23;Sunnuntai;12;5;17;4;0;4
89;21.04.2014;2014;04;00;Maanantai;15;4;19;0;3;3
89;21.04.2014;2014;04;01;Maanantai;6;2;8;4;2;6
89;21.04.2014;2014;04;02;Maanantai;8;0;8;1;4;5
89;21.04.2014;2014;04;03;Maanantai;8;0;8;5;0;5
89;21.04.2014;2014;04;04;Maanantai;12;2;14;1;0;1
89;21.04.2014;2014;04;05;Maanantai;5;0;5;0;1;1
89;21.04.2014;2014;04;06;Maanantai;3;14;17;1;2;3
89;21.04.2014;2014;04;07;Maanantai;7;7;14;1;2;3
89;21.04.2014;2014;04;08;Maanantai;5;14;19;11;11;22
89;21.04.2014;2014;04;09;Maanantai;7;17;24;15;32;47
89;21.04.2014;2014;04;10;Maanantai;18;25;43;27;32;59
89;21.04.2014;2014;04;11;Maanantai;34;30;64;38;32;70
89;21.04.2014;2014;04;12;Maanantai;42;52;94;28;39;67
89;21.04.2014;2014;04;13;Maanantai;49;73;122;24;49;73
89;21.04.2014;2014;04;14;Maanantai;68;68;136;35;45;80
89;21.04.2014;2014;04;15;Maanantai;58;77;135;42;50;92
89;21.04.2014;2014;04;16;Maanantai;94;133;227;56;69;125
89;21.04.2014;2014;04;17;Maanantai;114;75;189;60;51;111
89;21.04.2014;2014;04;18;Maanantai;75;64;139;43;43;86
89;21.04.2014;2014;04;19;Maanantai;60;61;121;41;35;76
89;21.04.2014;2014;04;20;Maanantai;43;34;77;26;29;55
89;21.04.2014;2014;04;21;Maanantai;37;22;59;17;9;26
89;21.04.2014;2014;04;22;Maanantai;29;5;34;14;6;20
89;21.04.2014;2014;04;23;Maanantai;7;11;18;3;2;5
89;22.04.2014;2014;04;00;Tiistai;7;3;10;1;1;2
89;22.04.2014;2014;04;01;Tiistai;4;2;6;0;0;0
89;22.04.2014;2014;04;02;Tiistai;2;0;2;0;0;0
89;22.04.2014;2014;04;03;Tiistai;1;2;3;0;0;0
89;22.04.2014;2014;04;04;Tiistai;1;1;2;0;0;0
89;22.04.2014;2014;04;05;Tiistai;3;13;16;1;0;1
89;22.04.2014;2014;04;06;Tiistai;15;46;61;2;3;5
89;22.04.2014;2014;04;07;Tiistai;44;187;231;1;23;24
89;22.04.2014;2014;04;08;Tiistai;84;241;325;8;59;67
89;22.04.2014;2014;04;09;Tiistai;44;141;185;27;42;69
89;22.04.2014;2014;04;10;Tiistai;60;120;180;27;32;59
89;22.04.2014;2014;04;11;Tiistai;97;96;193;27;40;67
89;22.04.2014;2014;04;12;Tiistai;87;110;197;35;36;71
89;22.04.2014;2014;04;13;Tiistai;71;99;170;24;28;52
89;22.04.2014;2014;04;14;Tiistai;133;108;241;30;24;54
89;22.04.2014;2014;04;15;Tiistai;185;107;292;33;17;50
89;22.04.2014;2014;04;16;Tiistai;272;139;411;33;22;55
89;22.04.2014;2014;04;17;Tiistai;153;87;240;22;21;43
89;22.04.2014;2014;04;18;Tiistai;123;96;219;34;30;64
89;22.04.2014;2014;04;19;Tiistai;85;41;126;50;32;82
89;22.04.2014;2014;04;20;Tiistai;80;44;124;37;34;71
89;22.04.2014;2014;04;21;Tiistai;45;29;74;22;18;40
89;22.04.2014;2014;04;22;Tiistai;19;14;33;10;12;22
89;22.04.2014;2014;04;23;Tiistai;13;11;24;3;2;5
89;23.04.2014;2014;04;00;Keskiviikko;9;4;13;0;0;0
89;23.04.2014;2014;04;01;Keskiviikko;1;2;3;0;0;0
89;23.04.2014;2014;04;02;Keskiviikko;0;1;1;1;0;1
89;23.04.2014;2014;04;03;Keskiviikko;0;3;3;1;0;1
89;23.04.2014;2014;04;04;Keskiviikko;3;6;9;1;0;1
89;23.04.2014;2014;04;05;Keskiviikko;0;13;13;3;1;4
89;23.04.2014;2014;04;06;Keskiviikko;16;46;62;4;6;10
89;23.04.2014;2014;04;07;Keskiviikko;45;167;212;6;24;30
89;23.04.2014;2014;04;08;Keskiviikko;58;258;316;7;45;52
89;23.04.2014;2014;04;09;Keskiviikko;47;140;187;11;34;45
89;23.04.2014;2014;04;10;Keskiviikko;46;124;170;24;41;65
89;23.04.2014;2014;04;11;Keskiviikko;79;84;163;26;38;64
89;23.04.2014;2014;04;12;Keskiviikko;91;83;174;17;29;46
89;23.04.2014;2014;04;13;Keskiviikko;108;108;216;33;43;76
89;23.04.2014;2014;04;14;Keskiviikko;146;100;246;30;29;59
89;23.04.2014;2014;04;15;Keskiviikko;154;100;254;40;17;57
89;23.04.2014;2014;04;16;Keskiviikko;245;123;368;42;25;67
89;23.04.2014;2014;04;17;Keskiviikko;131;119;250;26;30;56
89;23.04.2014;2014;04;18;Keskiviikko;113;75;188;37;34;71
89;23.04.2014;2014;04;19;Keskiviikko;85;40;125;21;28;49
89;23.04.2014;2014;04;20;Keskiviikko;68;31;99;25;16;41
89;23.04.2014;2014;04;21;Keskiviikko;81;30;111;15;20;35
89;23.04.2014;2014;04;22;Keskiviikko;22;22;44;7;3;10
89;23.04.2014;2014;04;23;Keskiviikko;20;12;32;5;4;9
89;24.04.2014;2014;04;00;Torstai;9;10;19;1;1;2
89;24.04.2014;2014;04;01;Torstai;8;2;10;0;0;0
89;24.04.2014;2014;04;02;Torstai;3;0;3;2;1;3
89;24.04.2014;2014;04;03;Torstai;4;2;6;3;1;4
89;24.04.2014;2014;04;04;Torstai;0;2;2;3;0;3
89;24.04.2014;2014;04;05;Torstai;1;11;12;0;0;0
89;24.04.2014;2014;04;06;Torstai;20;57;77;4;8;12
89;24.04.2014;2014;04;07;Torstai;39;154;193;7;16;23
89;24.04.2014;2014;04;08;Torstai;80;254;334;10;36;46
89;24.04.2014;2014;04;09;Torstai;61;116;177;19;35;54
89;24.04.2014;2014;04;10;Torstai;50;78;128;20;37;57
89;24.04.2014;2014;04;11;Torstai;75;104;179;27;30;57
89;24.04.2014;2014;04;12;Torstai;72;109;181;70;69;139
89;24.04.2014;2014;04;13;Torstai;111;102;213;34;39;73
89;24.04.2014;2014;04;14;Torstai;138;109;247;39;44;83
89;24.04.2014;2014;04;15;Torstai;183;105;288;33;24;57
89;24.04.2014;2014;04;16;Torstai;248;116;364;38;30;68
89;24.04.2014;2014;04;17;Torstai;125;110;235;29;39;68
89;24.04.2014;2014;04;18;Torstai;116;72;188;44;38;82
89;24.04.2014;2014;04;19;Torstai;97;64;161;34;38;72
89;24.04.2014;2014;04;20;Torstai;68;46;114;28;24;52
89;24.04.2014;2014;04;21;Torstai;47;32;79;22;12;34
89;24.04.2014;2014;04;22;Torstai;33;10;43;9;10;19
89;24.04.2014;2014;04;23;Torstai;15;17;32;5;3;8
89;25.04.2014;2014;04;00;Perjantai;5;8;13;1;0;1
89;25.04.2014;2014;04;01;Perjantai;5;6;11;0;2;2
89;25.04.2014;2014;04;02;Perjantai;4;1;5;0;1;1
89;25.04.2014;2014;04;03;Perjantai;3;7;10;0;0;0
89;25.04.2014;2014;04;04;Perjantai;5;3;8;1;0;1
89;25.04.2014;2014;04;05;Perjantai;3;10;13;1;2;3
89;25.04.2014;2014;04;06;Perjantai;18;52;70;2;7;9
89;25.04.2014;2014;04;07;Perjantai;34;134;168;5;19;24
89;25.04.2014;2014;04;08;Perjantai;74;211;285;16;44;60
89;25.04.2014;2014;04;09;Perjantai;42;157;199;11;43;54
89;25.04.2014;2014;04;10;Perjantai;50;79;129;15;31;46
89;25.04.2014;2014;04;11;Perjantai;91;124;215;35;35;70
89;25.04.2014;2014;04;12;Perjantai;174;122;296;39;45;84
89;25.04.2014;2014;04;13;Perjantai;171;136;307;46;59;105
89;25.04.2014;2014;04;14;Perjantai;194;150;344;40;36;76
89;25.04.2014;2014;04;15;Perjantai;222;168;390;44;32;76
89;25.04.2014;2014;04;16;Perjantai;204;202;406;44;55;99
89;25.04.2014;2014;04;17;Perjantai;136;170;306;34;56;90
89;25.04.2014;2014;04;18;Perjantai;117;112;229;35;52;87
89;25.04.2014;2014;04;19;Perjantai;66;61;127;34;25;59
89;25.04.2014;2014;04;20;Perjantai;65;42;107;20;15;35
89;25.04.2014;2014;04;21;Perjantai;74;37;111;15;13;28
89;25.04.2014;2014;04;22;Perjantai;36;60;96;6;15;21
89;25.04.2014;2014;04;23;Perjantai;35;22;57;4;2;6
89;26.04.2014;2014;04;00;Lauantai;20;18;38;4;5;9
89;26.04.2014;2014;04;01;Lauantai;23;8;31;2;3;5
89;26.04.2014;2014;04;02;Lauantai;16;8;24;10;2;12
89;26.04.2014;2014;04;03;Lauantai;21;7;28;5;1;6
89;26.04.2014;2014;04;04;Lauantai;16;7;23;4;0;4
89;26.04.2014;2014;04;05;Lauantai;9;7;16;1;1;2
89;26.04.2014;2014;04;06;Lauantai;5;18;23;1;3;4
89;26.04.2014;2014;04;07;Lauantai;3;16;19;6;8;14
89;26.04.2014;2014;04;08;Lauantai;12;49;61;9;19;28
89;26.04.2014;2014;04;09;Lauantai;31;88;119;25;40;65
89;26.04.2014;2014;04;10;Lauantai;44;111;155;24;36;60
89;26.04.2014;2014;04;11;Lauantai;88;132;220;30;46;76
89;26.04.2014;2014;04;12;Lauantai;96;139;235;39;41;80
89;26.04.2014;2014;04;13;Lauantai;114;96;210;22;30;52
89;26.04.2014;2014;04;14;Lauantai;118;119;237;37;39;76
89;26.04.2014;2014;04;15;Lauantai;149;118;267;41;45;86
89;26.04.2014;2014;04;16;Lauantai;139;145;284;51;63;114
89;26.04.2014;2014;04;17;Lauantai;116;90;206;36;30;66
89;26.04.2014;2014;04;18;Lauantai;60;62;122;30;26;56
89;26.04.2014;2014;04;19;Lauantai;40;46;86;17;27;44
89;26.04.2014;2014;04;20;Lauantai;72;74;146;16;41;57
89;26.04.2014;2014;04;21;Lauantai;78;104;182;21;32;53
89;26.04.2014;2014;04;22;Lauantai;53;76;129;10;14;24
89;26.04.2014;2014;04;23;Lauantai;45;37;82;8;19;27
89;27.04.2014;2014;04;00;Sunnuntai;37;29;66;16;11;27
89;27.04.2014;2014;04;01;Sunnuntai;37;8;45;5;1;6
89;27.04.2014;2014;04;02;Sunnuntai;49;9;58;12;4;16
89;27.04.2014;2014;04;03;Sunnuntai;40;4;44;5;4;9
89;27.04.2014;2014;04;04;Sunnuntai;23;2;25;11;1;12
89;27.04.2014;2014;04;05;Sunnuntai;13;5;18;2;0;2
89;27.04.2014;2014;04;06;Sunnuntai;9;12;21;2;4;6
89;27.04.2014;2014;04;07;Sunnuntai;6;10;16;6;7;13
89;27.04.2014;2014;04;08;Sunnuntai;11;23;34;14;12;26
89;27.04.2014;2014;04;09;Sunnuntai;17;42;59;18;25;43
89;27.04.2014;2014;04;10;Sunnuntai;45;62;107;38;42;80
89;27.04.2014;2014;04;11;Sunnuntai;56;78;134;39;54;93
89;27.04.2014;2014;04;12;Sunnuntai;75;117;192;42;67;109
89;27.04.2014;2014;04;13;Sunnuntai;94;113;207;45;73;118
89;27.04.2014;2014;04;14;Sunnuntai;117;125;242;31;32;63
89;27.04.2014;2014;04;15;Sunnuntai;99;100;199;20;20;40
89;27.04.2014;2014;04;16;Sunnuntai;89;84;173;20;20;40
89;27.04.2014;2014;04;17;Sunnuntai;63;60;123;15;15;30
89;27.04.2014;2014;04;18;Sunnuntai;81;77;158;15;15;30
89;27.04.2014;2014;04;19;Sunnuntai;49;48;97;10;10;20
89;27.04.2014;2014;04;20;Sunnuntai;42;40;82;5;5;10
89;27.04.2014;2014;04;21;Sunnuntai;25;23;48;2;2;4
89;27.04.2014;2014;04;22;Sunnuntai;14;12;26;1;1;2
89;27.04.2014;2014;04;23;Sunnuntai;10;8;18;1;1;2
89;28.04.2014;2014;04;00;Maanantai;5;3;8;0;3;3
89;28.04.2014;2014;04;01;Maanantai;3;3;6;4;2;6
89;28.04.2014;2014;04;02;Maanantai;2;1;3;1;4;5
89;28.04.2014;2014;04;03;Maanantai;4;2;6;5;0;5
89;28.04.2014;2014;04;04;Maanantai;2;2;4;1;0;1
89;28.04.2014;2014;04;05;Maanantai;9;7;16;0;1;1
89;28.04.2014;2014;04;06;Maanantai;27;24;51;1;2;3
89;28.04.2014;2014;04;07;Maanantai;104;103;207;1;2;3
89;28.04.2014;2014;04;08;Maanantai;162;160;322;11;11;22
89;28.04.2014;2014;04;09;Maanantai;97;95;192;15;32;47
89;28.04.2014;2014;04;10;Maanantai;73;73;146;27;32;59
89;28.04.2014;2014;04;11;Maanantai;95;92;187;38;32;70
89;28.04.2014;2014;04;12;Maanantai;103;102;205;28;39;67
89;28.04.2014;2014;04;13;Maanantai;98;95;193;24;49;73
89;28.04.2014;2014;04;14;Maanantai;124;120;244;35;45;80
89;28.04.2014;2014;04;15;Maanantai;162;158;320;42;50;92
89;28.04.2014;2014;04;16;Maanantai;205;203;408;56;69;125
89;28.04.2014;2014;04;17;Maanantai;136;133;269;60;51;111
89;28.04.2014;2014;04;18;Maanantai;88;93;181;43;43;86
89;28.04.2014;2014;04;19;Maanantai;90;88;178;41;35;76
89;28.04.2014;2014;04;20;Maanantai;64;62;126;26;29;55
89;28.04.2014;2014;04;21;Maanantai;50;48;98;17;9;26
89;28.04.2014;2014;04;22;Maanantai;28;26;54;14;6;20
89;28.04.2014;2014;04;23;Maanantai;19;16;35;3;2;5
89;29.04.2014;2014;04;00;Tiistai;17;14;31;1;1;2
89;29.04.2014;2014;04;01;Tiistai;5;2;7;0;0;0
89;29.04.2014;2014;04;02;Tiistai;7;5;12;0;0;0
89;29.04.2014;2014;04;03;Tiistai;9;6;15;0;0;0
89;29.04.2014;2014;04;04;Tiistai;7;4;11;0;0;0
89;29.04.2014;2014;04;05;Tiistai;8;5;13;1;0;1
89;29.04.2014;2014;04;06;Tiistai;34;33;67;2;3;5
89;29.04.2014;2014;04;07;Tiistai;106;103;209;1;23;24
89;29.04.2014;2014;04;08;Tiistai;152;150;302;8;59;67
89;29.04.2014;2014;04;09;Tiistai;84;82;166;27;42;69
89;29.04.2014;2014;04;10;Tiistai;73;70;143;27;32;59
89;29.04.2014;2014;04;11;Tiistai;80;78;158;27;40;67
89;29.04.2014;2014;04;12;Tiistai;99;98;197;35;36;71
89;29.04.2014;2014;04;13;Tiistai;103;91;194;24;28;52
89;29.04.2014;2014;04;14;Tiistai;121;120;241;30;24;54
89;29.04.2014;2014;04;15;Tiistai;127;127;254;33;17;50
89;29.04.2014;2014;04;16;Tiistai;181;179;360;33;22;55
89;29.04.2014;2014;04;17;Tiistai;105;101;206;22;21;43
89;29.04.2014;2014;04;18;Tiistai;109;102;211;34;30;64
89;29.04.2014;2014;04;19;Tiistai;84;86;170;50;32;82
89;29.04.2014;2014;04;20;Tiistai;75;72;147;37;34;71
89;29.04.2014;2014;04;21;Tiistai;62;59;121;22;18;40
89;29.04.2014;2014;04;22;Tiistai;21;20;41;10;12;22
89;29.04.2014;2014;04;23;Tiistai;9;8;17;3;2;5
89;30.04.2014;2014;04;00;Keskiviikko;12;10;22;0;0;0
89;30.04.2014;2014;04;01;Keskiviikko;10;8;18;0;0;0
89;30.04.2014;2014;04;02;Keskiviikko;9;7;16;1;0;1
89;30.04.2014;2014;04;03;Keskiviikko;5;3;8;1;0;1
89;30.04.2014;2014;04;04;Keskiviikko;9;8;17;1;0;1
89;30.04.2014;2014;04;05;Keskiviikko;10;8;18;3;1;4
89;30.04.2014;2014;04;06;Keskiviikko;31;30;61;4;6;10
89;30.04.2014;2014;04;07;Keskiviikko;103;101;204;6;24;30
89;30.04.2014;2014;04;08;Keskiviikko;138;135;273;7;45;52
89;30.04.2014;2014;04;09;Keskiviikko;87;84;171;11;34;45
89;30.04.2014;2014;04;10;Keskiviikko;71;70;141;24;41;65
89;30.04.2014;2014;04;11;Keskiviikko;104;104;208;26;38;64
89;30.04.2014;2014;04;12;Keskiviikko;130;129;259;17;29;46
89;30.04.2014;2014;04;13;Keskiviikko;148;142;290;33;43;76
89;30.04.2014;2014;04;14;Keskiviikko;204;209;413;30;29;59
89;30.04.2014;2014;04;15;Keskiviikko;214;169;383;40;17;57
89;30.04.2014;2014;04;16;Keskiviikko;235;167;402;42;25;67
89;30.04.2014;2014;04;17;Keskiviikko;162;120;282;26;30;56
89;30.04.2014;2014;04;18;Keskiviikko;119;128;247;37;34;71
89;30.04.2014;2014;04;19;Keskiviikko;102;110;212;21;28;49
89;30.04.2014;2014;04;20;Keskiviikko;64;124;188;25;16;41
89;30.04.2014;2014;04;21;Keskiviikko;72;123;195;15;20;35
89;30.04.2014;2014;04;22;Keskiviikko;55;87;142;7;3;10
89;30.04.2014;2014;04;23;Keskiviikko;50;55;105;5;4;9
89;01.05.2014;2014;05;00;Torstai;76;37;113;20;15;35
89;01.05.2014;2014;05;01;Torstai;77;25;102;17;6;23
89;01.05.2014;2014;05;02;Torstai;56;16;72;16;4;20
89;01.05.2014;2014;05;03;Torstai;45;15;60;17;2;19
89;01.05.2014;2014;05;04;Torstai;58;6;64;14;1;15
89;01.05.2014;2014;05;05;Torstai;67;23;90;8;2;10
89;01.05.2014;2014;05;06;Torstai;20;10;30;6;2;8
89;01.05.2014;2014;05;07;Torstai;13;8;21;3;4;7
89;01.05.2014;2014;05;08;Torstai;12;20;32;10;17;27
89;01.05.2014;2014;05;09;Torstai;16;50;66;12;28;40
89;01.05.2014;2014;05;10;Torstai;38;70;108;23;47;70
89;01.05.2014;2014;05;11;Torstai;34;175;209;30;56;86
89;01.05.2014;2014;05;12;Torstai;76;145;221;29;68;97
89;01.05.2014;2014;05;13;Torstai;125;199;324;43;69;112
89;01.05.2014;2014;05;14;Torstai;180;174;354;63;66;129
89;01.05.2014;2014;05;15;Torstai;153;124;277;60;44;104
89;01.05.2014;2014;05;16;Torstai;151;76;227;59;55;114
89;01.05.2014;2014;05;17;Torstai;121;72;193;52;34;86
89;01.05.2014;2014;05;18;Torstai;118;71;189;30;42;72
89;01.05.2014;2014;05;19;Torstai;93;43;136;33;21;54
89;01.05.2014;2014;05;20;Torstai;59;38;97;27;16;43
89;01.05.2014;2014;05;21;Torstai;34;19;53;12;11;23
89;01.05.2014;2014;05;22;Torstai;25;24;49;8;9;17
89;01.05.2014;2014;05;23;Torstai;15;13;28;5;1;6
89;02.05.2014;2014;05;00;Perjantai;10;7;17;3;3;6
89;02.05.2014;2014;05;01;Perjantai;12;1;13;1;0;1
89;02.05.2014;2014;05;02;Perjantai;0;7;7;3;0;3
89;02.05.2014;2014;05;03;Perjantai;5;4;9;2;1;3
89;02.05.2014;2014;05;04;Perjantai;4;5;9;2;0;2
89;02.05.2014;2014;05;05;Perjantai;4;11;15;1;2;3
89;02.05.2014;2014;05;06;Perjantai;11;30;41;2;3;5
89;02.05.2014;2014;05;07;Perjantai;28;91;119;6;21;27
89;02.05.2014;2014;05;08;Perjantai;28;96;124;7;18;25
89;02.05.2014;2014;05;09;Perjantai;38;85;123;7;28;35
89;02.05.2014;2014;05;10;Perjantai;57;80;137;22;22;44
89;02.05.2014;2014;05;11;Perjantai;70;105;175;19;45;64
89;02.05.2014;2014;05;12;Perjantai;85;133;218;23;31;54
89;02.05.2014;2014;05;13;Perjantai;112;107;219;39;48;87
89;02.05.2014;2014;05;14;Perjantai;116;110;226;21;42;63
89;02.05.2014;2014;05;15;Perjantai;135;90;225;34;24;58
89;02.05.2014;2014;05;16;Perjantai;158;77;235;59;19;78
89;02.05.2014;2014;05;17;Perjantai;96;81;177;35;23;58
89;02.05.2014;2014;05;18;Perjantai;93;72;165;28;27;55
89;02.05.2014;2014;05;19;Perjantai;67;35;102;22;28;50
89;02.05.2014;2014;05;20;Perjantai;64;53;117;16;25;41
89;02.05.2014;2014;05;21;Perjantai;39;20;59;13;8;21
89;02.05.2014;2014;05;22;Perjantai;32;23;55;12;5;17
89;02.05.2014;2014;05;23;Perjantai;25;22;47;2;10;12
89;03.05.2014;2014;05;00;Lauantai;14;14;28;4;8;12
89;03.05.2014;2014;05;01;Lauantai;13;4;17;6;2;8
89;03.05.2014;2014;05;02;Lauantai;9;2;11;1;0;1
89;03.05.2014;2014;05;03;Lauantai;14;4;18;1;1;2
89;03.05.2014;2014;05;04;Lauantai;13;4;17;1;0;1
89;03.05.2014;2014;05;05;Lauantai;0;6;6;1;0;1
89;03.05.2014;2014;05;06;Lauantai;3;12;15;1;1;2
89;03.05.2014;2014;05;07;Lauantai;11;12;23;3;6;9
89;03.05.2014;2014;05;08;Lauantai;16;32;48;8;11;19
89;03.05.2014;2014;05;09;Lauantai;18;52;70;9;34;43
89;03.05.2014;2014;05;10;Lauantai;24;103;127;13;35;48
89;03.05.2014;2014;05;11;Lauantai;59;129;188;16;45;61
89;03.05.2014;2014;05;12;Lauantai;70;129;199;23;55;78
89;03.05.2014;2014;05;13;Lauantai;105;118;223;42;46;88
89;03.05.2014;2014;05;14;Lauantai;110;108;218;38;39;77
89;03.05.2014;2014;05;15;Lauantai;116;85;201;47;27;74
89;03.05.2014;2014;05;16;Lauantai;133;73;206;36;34;70
89;03.05.2014;2014;05;17;Lauantai;101;59;160;34;33;67
89;03.05.2014;2014;05;18;Lauantai;96;67;163;57;45;102
89;03.05.2014;2014;05;19;Lauantai;47;65;112;14;28;42
89;03.05.2014;2014;05;20;Lauantai;54;43;97;16;22;38
89;03.05.2014;2014;05;21;Lauantai;35;29;64;13;16;29
89;03.05.2014;2014;05;22;Lauantai;38;26;64;7;9;16
89;03.05.2014;2014;05;23;Lauantai;22;25;47;5;5;10
89;04.05.2014;2014;05;00;Sunnuntai;16;11;27;3;7;10
89;04.05.2014;2014;05;01;Sunnuntai;12;9;21;3;0;3
89;04.05.2014;2014;05;02;Sunnuntai;19;8;27;5;2;7
89;04.05.2014;2014;05;03;Sunnuntai;14;3;17;4;0;4
89;04.05.2014;2014;05;04;Sunnuntai;13;5;18;4;0;4
89;04.05.2014;2014;05;05;Sunnuntai;3;3;6;2;0;2
89;04.05.2014;2014;05;06;Sunnuntai;3;9;12;1;1;2
89;04.05.2014;2014;05;07;Sunnuntai;6;9;15;4;6;10
89;04.05.2014;2014;05;08;Sunnuntai;11;17;28;6;11;17
89;04.05.2014;2014;05;09;Sunnuntai;11;39;50;12;22;34
89;04.05.2014;2014;05;10;Sunnuntai;19;57;76;26;42;68
89;04.05.2014;2014;05;11;Sunnuntai;46;64;110;23;41;64
89;04.05.2014;2014;05;12;Sunnuntai;41;66;107;28;32;60
89;04.05.2014;2014;05;13;Sunnuntai;55;100;155;27;38;65
89;04.05.2014;2014;05;14;Sunnuntai;69;68;137;29;31;60
89;04.05.2014;2014;05;15;Sunnuntai;90;54;144;32;34;66
89;04.05.2014;2014;05;16;Sunnuntai;73;54;127;28;26;54
89;04.05.2014;2014;05;17;Sunnuntai;68;48;116;26;39;65
89;04.05.2014;2014;05;18;Sunnuntai;77;55;132;43;34;77
89;04.05.2014;2014;05;19;Sunnuntai;50;54;104;31;31;62
89;04.05.2014;2014;05;20;Sunnuntai;48;37;85;21;22;43
89;04.05.2014;2014;05;21;Sunnuntai;30;25;55;17;18;35
89;04.05.2014;2014;05;22;Sunnuntai;27;11;38;13;5;18
89;04.05.2014;2014;05;23;Sunnuntai;11;7;18;1;5;6
89;05.05.2014;2014;05;00;Maanantai;4;2;6;2;0;2
89;05.05.2014;2014;05;01;Maanantai;1;3;4;1;0;1
89;05.05.2014;2014;05;02;Maanantai;0;0;0;1;2;3
89;05.05.2014;2014;05;03;Maanantai;3;2;5;0;0;0
89;05.05.2014;2014;05;04;Maanantai;6;6;12;1;0;1
89;05.05.2014;2014;05;05;Maanantai;8;12;20;2;1;3
89;05.05.2014;2014;05;06;Maanantai;21;50;71;3;3;6
89;05.05.2014;2014;05;07;Maanantai;59;186;245;4;25;29
89;05.05.2014;2014;05;08;Maanantai;79;271;350;5;53;58
89;05.05.2014;2014;05;09;Maanantai;48;143;191;15;47;62
89;05.05.2014;2014;05;10;Maanantai;41;108;149;18;25;43
89;05.05.2014;2014;05;11;Maanantai;87;104;191;24;27;51
89;05.05.2014;2014;05;12;Maanantai;82;123;205;28;28;56
89;05.05.2014;2014;05;13;Maanantai;102;103;205;21;37;58
89;05.05.2014;2014;05;14;Maanantai;142;101;243;28;35;63
89;05.05.2014;2014;05;15;Maanantai;220;108;328;40;14;54
89;05.05.2014;2014;05;16;Maanantai;271;131;402;36;19;55
89;05.05.2014;2014;05;17;Maanantai;138;98;236;27;16;43
89;05.05.2014;2014;05;18;Maanantai;110;56;166;27;29;56
89;05.05.2014;2014;05;19;Maanantai;80;71;151;33;44;77
89;05.05.2014;2014;05;20;Maanantai;77;44;121;29;30;59
89;05.05.2014;2014;05;21;Maanantai;48;32;80;17;24;41
89;05.05.2014;2014;05;22;Maanantai;33;22;55;15;15;30
89;05.05.2014;2014;05;23;Maanantai;19;9;28;7;2;9
89;06.05.2014;2014;05;00;Tiistai;3;5;8;1;1;2
89;06.05.2014;2014;05;01;Tiistai;5;2;7;0;1;1
89;06.05.2014;2014;05;02;Tiistai;2;1;3;0;1;1
89;06.05.2014;2014;05;03;Tiistai;0;2;2;3;0;3
89;06.05.2014;2014;05;04;Tiistai;1;4;5;0;0;0
89;06.05.2014;2014;05;05;Tiistai;5;8;13;2;2;4
89;06.05.2014;2014;05;06;Tiistai;16;51;67;4;7;11
89;06.05.2014;2014;05;07;Tiistai;51;207;258;3;27;30
89;06.05.2014;2014;05;08;Tiistai;68;283;351;16;45;61
89;06.05.2014;2014;05;09;Tiistai;40;139;179;9;26;35
89;06.05.2014;2014;05;10;Tiistai;55;76;131;29;42;71
89;06.05.2014;2014;05;11;Tiistai;59;95;154;24;22;46
89;06.05.2014;2014;05;12;Tiistai;80;131;211;16;25;41
89;06.05.2014;2014;05;13;Tiistai;92;91;183;17;45;62
89;06.05.2014;2014;05;14;Tiistai;150;90;240;14;19;33
89;06.05.2014;2014;05;15;Tiistai;176;105;281;32;12;44
89;06.05.2014;2014;05;16;Tiistai;267;119;386;39;22;61
89;06.05.2014;2014;05;17;Tiistai;163;84;247;31;28;59
89;06.05.2014;2014;05;18;Tiistai;96;78;174;29;21;50
89;06.05.2014;2014;05;19;Tiistai;86;60;146;42;29;71
89;06.05.2014;2014;05;20;Tiistai;86;62;148;33;31;64
89;06.05.2014;2014;05;21;Tiistai;56;26;82;19;18;37
89;06.05.2014;2014;05;22;Tiistai;34;16;50;10;6;16
89;06.05.2014;2014;05;23;Tiistai;26;13;39;5;1;6
89;07.05.2014;2014;05;00;Keskiviikko;9;2;11;0;0;0
89;07.05.2014;2014;05;01;Keskiviikko;2;2;4;1;0;1
89;07.05.2014;2014;05;02;Keskiviikko;0;4;4;0;0;0
89;07.05.2014;2014;05;03;Keskiviikko;2;1;3;1;0;1
89;07.05.2014;2014;05;04;Keskiviikko;2;3;5;0;0;0
89;07.05.2014;2014;05;05;Keskiviikko;2;7;9;0;0;0
89;07.05.2014;2014;05;06;Keskiviikko;23;52;75;2;4;6
89;07.05.2014;2014;05;07;Keskiviikko;41;210;251;7;15;22
89;07.05.2014;2014;05;08;Keskiviikko;72;251;323;15;56;71
89;07.05.2014;2014;05;09;Keskiviikko;48;150;198;18;32;50
89;07.05.2014;2014;05;10;Keskiviikko;59;104;163;22;40;62
89;07.05.2014;2014;05;11;Keskiviikko;63;102;165;24;34;58
89;07.05.2014;2014;05;12;Keskiviikko;75;106;181;23;35;58
89;07.05.2014;2014;05;13;Keskiviikko;89;110;199;23;23;46
89;07.05.2014;2014;05;14;Keskiviikko;155;96;251;44;24;68
89;07.05.2014;2014;05;15;Keskiviikko;206;112;318;31;18;49
89;07.05.2014;2014;05;16;Keskiviikko;264;141;405;37;37;74
89;07.05.2014;2014;05;17;Keskiviikko;156;90;246;45;21;66
89;07.05.2014;2014;05;18;Keskiviikko;117;94;211;30;29;59
89;07.05.2014;2014;05;19;Keskiviikko;109;50;159;35;23;58
89;07.05.2014;2014;05;20;Keskiviikko;92;33;125;32;25;57
89;07.05.2014;2014;05;21;Keskiviikko;40;34;74;12;17;29
89;07.05.2014;2014;05;22;Keskiviikko;31;18;49;8;5;13
89;07.05.2014;2014;05;23;Keskiviikko;19;15;34;4;3;7
89;08.05.2014;2014;05;00;Torstai;5;9;14;4;1;5
89;08.05.2014;2014;05;01;Torstai;9;6;15;1;0;1
89;08.05.2014;2014;05;02;Torstai;1;2;3;0;0;0
89;08.05.2014;2014;05;03;Torstai;2;0;2;0;1;1
89;08.05.2014;2014;05;04;Torstai;3;6;9;4;0;4
89;08.05.2014;2014;05;05;Torstai;5;13;18;0;1;1
89;08.05.2014;2014;05;06;Torstai;18;52;70;4;3;7
89;08.05.2014;2014;05;07;Torstai;47;205;252;6;17;23
89;08.05.2014;2014;05;08;Torstai;83;259;342;7;39;46
89;08.05.2014;2014;05;09;Torstai;44;134;178;10;49;59
89;08.05.2014;2014;05;10;Torstai;48;91;139;28;16;44
89;08.05.2014;2014;05;11;Torstai;67;121;188;20;38;58
89;08.05.2014;2014;05;12;Torstai;73;132;205;20;37;57
89;08.05.2014;2014;05;13;Torstai;103;107;210;37;31;68
89;08.05.2014;2014;05;14;Torstai;135;89;224;52;26;78
89;08.05.2014;2014;05;15;Torstai;217;101;318;50;21;71
89;08.05.2014;2014;05;16;Torstai;265;150;415;94;30;124
89;08.05.2014;2014;05;17;Torstai;157;101;258;112;29;141
89;08.05.2014;2014;05;18;Torstai;99;75;174;69;40;109
89;08.05.2014;2014;05;19;Torstai;132;71;203;51;37;88
89;08.05.2014;2014;05;20;Torstai;84;60;144;30;25;55
89;08.05.2014;2014;05;21;Torstai;59;47;106;14;23;37
89;08.05.2014;2014;05;22;Torstai;42;21;63;7;8;15
89;08.05.2014;2014;05;23;Torstai;17;11;28;2;4;6
89;09.05.2014;2014;05;00;Perjantai;8;5;13;3;1;4
89;09.05.2014;2014;05;01;Perjantai;5;1;6;1;0;1
89;09.05.2014;2014;05;02;Perjantai;4;3;7;0;0;0
89;09.05.2014;2014;05;03;Perjantai;1;2;3;0;0;0
89;09.05.2014;2014;05;04;Perjantai;3;2;5;2;1;3
89;09.05.2014;2014;05;05;Perjantai;2;14;16;1;0;1
89;09.05.2014;2014;05;06;Perjantai;15;51;66;9;4;13
89;09.05.2014;2014;05;07;Perjantai;40;182;222;5;23;28
89;09.05.2014;2014;05;08;Perjantai;57;245;302;11;44;55
89;09.05.2014;2014;05;09;Perjantai;41;128;169;15;37;52
89;09.05.2014;2014;05;10;Perjantai;43;81;124;17;21;38
89;09.05.2014;2014;05;11;Perjantai;69;70;139;10;33;43
89;09.05.2014;2014;05;12;Perjantai;71;101;172;20;21;41
89;09.05.2014;2014;05;13;Perjantai;96;83;179;13;8;21
89;09.05.2014;2014;05;14;Perjantai;126;65;191;23;12;35
89;09.05.2014;2014;05;15;Perjantai;158;74;232;17;14;31
89;09.05.2014;2014;05;16;Perjantai;177;68;245;14;15;29
89;09.05.2014;2014;05;17;Perjantai;98;78;176;12;18;30
89;09.05.2014;2014;05;18;Perjantai;57;42;99;17;11;28
89;09.05.2014;2014;05;19;Perjantai;63;40;103;11;11;22
89;09.05.2014;2014;05;20;Perjantai;54;21;75;13;14;27
89;09.05.2014;2014;05;21;Perjantai;37;21;58;5;5;10
89;09.05.2014;2014;05;22;Perjantai;33;23;56;11;8;19
89;09.05.2014;2014;05;23;Perjantai;19;21;40;2;6;8
89;10.05.2014;2014;05;00;Lauantai;15;14;29;6;5;11
89;10.05.2014;2014;05;01;Lauantai;11;3;14;3;4;7
89;10.05.2014;2014;05;02;Lauantai;13;3;16;2;1;3
89;10.05.2014;2014;05;03;Lauantai;11;3;14;5;1;6
89;10.05.2014;2014;05;04;Lauantai;23;1;24;6;0;6
89;10.05.2014;2014;05;05;Lauantai;4;3;7;1;0;1
89;10.05.2014;2014;05;06;Lauantai;9;7;16;0;3;3
89;10.05.2014;2014;05;07;Lauantai;3;5;8;1;1;2
89;10.05.2014;2014;05;08;Lauantai;2;26;28;9;10;19
89;10.05.2014;2014;05;09;Lauantai;9;48;57;3;23;26
89;10.05.2014;2014;05;10;Lauantai;32;49;81;8;15;23
89;10.05.2014;2014;05;11;Lauantai;35;75;110;17;48;65
89;10.05.2014;2014;05;12;Lauantai;42;68;110;15;18;33
89;10.05.2014;2014;05;13;Lauantai;50;50;100;15;11;26
89;10.05.2014;2014;05;14;Lauantai;63;58;121;8;16;24
89;10.05.2014;2014;05;15;Lauantai;58;34;92;11;16;27
89;10.05.2014;2014;05;16;Lauantai;63;29;92;21;13;34
89;10.05.2014;2014;05;17;Lauantai;33;31;64;15;11;26
89;10.05.2014;2014;05;18;Lauantai;29;32;61;20;18;38
89;10.05.2014;2014;05;19;Lauantai;38;39;77;16;18;34
89;10.05.2014;2014;05;20;Lauantai;42;32;74;15;14;29
89;10.05.2014;2014;05;21;Lauantai;37;23;60;6;5;11
89;10.05.2014;2014;05;22;Lauantai;23;28;51;7;4;11
89;10.05.2014;2014;05;23;Lauantai;15;12;27;2;1;3
89;11.05.2014;2014;05;00;Sunnuntai;20;15;35;5;7;12
89;11.05.2014;2014;05;01;Sunnuntai;10;9;19;2;5;7
89;11.05.2014;2014;05;02;Sunnuntai;17;20;37;4;2;6
89;11.05.2014;2014;05;03;Sunnuntai;18;4;22;7;1;8
89;11.05.2014;2014;05;04;Sunnuntai;13;2;15;4;0;4
89;11.05.2014;2014;05;05;Sunnuntai;5;3;8;2;0;2
89;11.05.2014;2014;05;06;Sunnuntai;4;7;11;1;3;4
89;11.05.2014;2014;05;07;Sunnuntai;3;8;11;5;3;8
89;11.05.2014;2014;05;08;Sunnuntai;7;10;17;8;9;17
89;11.05.2014;2014;05;09;Sunnuntai;7;20;27;7;16;23
89;11.05.2014;2014;05;10;Sunnuntai;20;28;48;14;27;41
89;11.05.2014;2014;05;11;Sunnuntai;32;38;70;20;36;56
89;11.05.2014;2014;05;12;Sunnuntai;42;55;97;36;17;53
89;11.05.2014;2014;05;13;Sunnuntai;48;72;120;24;39;63
89;11.05.2014;2014;05;14;Sunnuntai;54;53;107;26;15;41
89;11.05.2014;2014;05;15;Sunnuntai;40;31;71;16;32;48
89;11.05.2014;2014;05;16;Sunnuntai;50;23;73;17;18;35
89;11.05.2014;2014;05;17;Sunnuntai;36;52;88;20;12;32
89;11.05.2014;2014;05;18;Sunnuntai;52;26;78;24;22;46
89;11.05.2014;2014;05;19;Sunnuntai;39;34;73;20;28;48
89;11.05.2014;2014;05;20;Sunnuntai;48;31;79;27;27;54
89;11.05.2014;2014;05;21;Sunnuntai;25;15;40;16;16;32
89;11.05.2014;2014;05;22;Sunnuntai;13;6;19;6;6;12
89;11.05.2014;2014;05;23;Sunnuntai;11;7;18;3;0;3
89;12.05.2014;2014;05;00;Maanantai;10;5;15;2;2;4
89;12.05.2014;2014;05;01;Maanantai;3;1;4;1;0;1
89;12.05.2014;2014;05;02;Maanantai;1;3;4;0;0;0
89;12.05.2014;2014;05;03;Maanantai;1;5;6;0;0;0
89;12.05.2014;2014;05;04;Maanantai;3;6;9;1;0;1
89;12.05.2014;2014;05;05;Maanantai;2;7;9;1;0;1
89;12.05.2014;2014;05;06;Maanantai;20;68;88;4;5;9
89;12.05.2014;2014;05;07;Maanantai;43;167;210;3;17;20
89;12.05.2014;2014;05;08;Maanantai;71;260;331;7;34;41
89;12.05.2014;2014;05;09;Maanantai;49;138;187;12;24;36
89;12.05.2014;2014;05;10;Maanantai;50;80;130;13;27;40
89;12.05.2014;2014;05;11;Maanantai;51;104;155;22;23;45
89;12.05.2014;2014;05;12;Maanantai;86;86;172;19;26;45
89;12.05.2014;2014;05;13;Maanantai;107;97;204;19;18;37
89;12.05.2014;2014;05;14;Maanantai;129;100;229;17;17;34
89;12.05.2014;2014;05;15;Maanantai;222;85;307;31;25;56
89;12.05.2014;2014;05;16;Maanantai;240;92;332;20;19;39
89;12.05.2014;2014;05;17;Maanantai;117;80;197;15;17;32
89;12.05.2014;2014;05;18;Maanantai;97;65;162;29;25;54
89;12.05.2014;2014;05;19;Maanantai;75;37;112;30;30;60
89;12.05.2014;2014;05;20;Maanantai;78;49;127;23;21;44
89;12.05.2014;2014;05;21;Maanantai;26;24;50;13;12;25
89;12.05.2014;2014;05;22;Maanantai;26;11;37;9;4;13
89;12.05.2014;2014;05;23;Maanantai;13;5;18;4;1;5
89;13.05.2014;2014;05;00;Tiistai;2;3;5;0;1;1
89;13.05.2014;2014;05;01;Tiistai;1;1;2;3;2;5
89;13.05.2014;2014;05;02;Tiistai;4;1;5;0;0;0
89;13.05.2014;2014;05;03;Tiistai;1;5;6;0;0;0
89;13.05.2014;2014;05;04;Tiistai;0;4;4;0;0;0
89;13.05.2014;2014;05;05;Tiistai;3;11;14;2;1;3
89;13.05.2014;2014;05;06;Tiistai;17;62;79;2;10;12
89;13.05.2014;2014;05;07;Tiistai;52;182;234;7;19;26
89;13.05.2014;2014;05;08;Tiistai;77;251;328;10;36;46
89;13.05.2014;2014;05;09;Tiistai;44;124;168;16;32;48
89;13.05.2014;2014;05;10;Tiistai;56;101;157;27;37;64
89;13.05.2014;2014;05;11;Tiistai;55;102;157;36;23;59
89;13.05.2014;2014;05;12;Tiistai;77;91;168;22;35;57
89;13.05.2014;2014;05;13;Tiistai;111;143;254;31;65;96
89;13.05.2014;2014;05;14;Tiistai;150;95;245;41;27;68
89;13.05.2014;2014;05;15;Tiistai;211;119;330;34;22;56
89;13.05.2014;2014;05;16;Tiistai;267;119;386;37;23;60
89;13.05.2014;2014;05;17;Tiistai;146;92;238;28;21;49
89;13.05.2014;2014;05;18;Tiistai;97;77;174;21;32;53
89;13.05.2014;2014;05;19;Tiistai;108;72;180;35;23;58
89;13.05.2014;2014;05;20;Tiistai;91;32;123;30;35;65
89;13.05.2014;2014;05;21;Tiistai;50;25;75;8;18;26
89;13.05.2014;2014;05;22;Tiistai;30;16;46;2;3;5
89;13.05.2014;2014;05;23;Tiistai;23;14;37;0;3;3
89;14.05.2014;2014;05;00;Keskiviikko;3;3;6;1;1;2
89;14.05.2014;2014;05;01;Keskiviikko;4;3;7;0;1;1
89;14.05.2014;2014;05;02;Keskiviikko;0;2;2;0;1;1
89;14.05.2014;2014;05;03;Keskiviikko;1;5;6;0;1;1
89;14.05.2014;2014;05;04;Keskiviikko;3;3;6;4;0;4
89;14.05.2014;2014;05;05;Keskiviikko;3;12;15;2;0;2
89;14.05.2014;2014;05;06;Keskiviikko;19;62;81;3;4;7
89;14.05.2014;2014;05;07;Keskiviikko;48;197;245;5;21;26
89;14.05.2014;2014;05;08;Keskiviikko;76;278;354;11;36;47
89;14.05.2014;2014;05;09;Keskiviikko;44;140;184;16;46;62
89;14.05.2014;2014;05;10;Keskiviikko;46;85;131;12;32;44
89;14.05.2014;2014;05;11;Keskiviikko;76;99;175;18;33;51
89;14.05.2014;2014;05;12;Keskiviikko;80;103;183;25;34;59
89;14.05.2014;2014;05;13;Keskiviikko;93;94;187;27;25;52
89;14.05.2014;2014;05;14;Keskiviikko;162;92;254;32;38;70
89;14.05.2014;2014;05;15;Keskiviikko;183;124;307;34;34;68
89;14.05.2014;2014;05;16;Keskiviikko;245;141;386;36;25;61
89;14.05.2014;2014;05;17;Keskiviikko;141;111;252;38;29;67
89;14.05.2014;2014;05;18;Keskiviikko;118;89;207;41;44;85
89;14.05.2014;2014;05;19;Keskiviikko;135;63;198;37;33;70
89;14.05.2014;2014;05;20;Keskiviikko;96;31;127;26;32;58
89;14.05.2014;2014;05;21;Keskiviikko;53;35;88;20;24;44
89;14.05.2014;2014;05;22;Keskiviikko;21;17;38;8;10;18
89;14.05.2014;2014;05;23;Keskiviikko;20;12;32;3;2;5
89;15.05.2014;2014;05;00;Torstai;7;6;13;2;2;4
89;15.05.2014;2014;05;01;Torstai;8;4;12;1;4;5
89;15.05.2014;2014;05;02;Torstai;7;0;7;1;2;3
89;15.05.2014;2014;05;03;Torstai;4;3;7;0;0;0
89;15.05.2014;2014;05;04;Torstai;5;3;8;1;0;1
89;15.05.2014;2014;05;05;Torstai;3;7;10;2;2;4
89;15.05.2014;2014;05;06;Torstai;27;52;79;5;2;7
89;15.05.2014;2014;05;07;Torstai;47;181;228;6;20;26
89;15.05.2014;2014;05;08;Torstai;86;309;395;13;37;50
89;15.05.2014;2014;05;09;Torstai;63;163;226;14;29;43
89;15.05.2014;2014;05;10;Torstai;63;122;185;24;23;47
89;15.05.2014;2014;05;11;Torstai;70;103;173;8;24;32
89;15.05.2014;2014;05;12;Torstai;89;95;184;22;30;52
89;15.05.2014;2014;05;13;Torstai;105;128;233;31;40;71
89;15.05.2014;2014;05;14;Torstai;171;97;268;62;34;96
89;15.05.2014;2014;05;15;Torstai;200;118;318;36;25;61
89;15.05.2014;2014;05;16;Torstai;292;136;428;42;19;61
89;15.05.2014;2014;05;17;Torstai;181;108;289;38;33;71
89;15.05.2014;2014;05;18;Torstai;143;71;214;37;31;68
89;15.05.2014;2014;05;19;Torstai;126;86;212;38;40;78
89;15.05.2014;2014;05;20;Torstai;107;60;167;26;23;49
89;15.05.2014;2014;05;21;Torstai;50;32;82;11;14;25
89;15.05.2014;2014;05;22;Torstai;38;14;52;8;10;18
89;15.05.2014;2014;05;23;Torstai;11;11;22;4;2;6
89;16.05.2014;2014;05;00;Perjantai;13;9;22;4;3;7
89;16.05.2014;2014;05;01;Perjantai;4;1;5;1;0;1
89;16.05.2014;2014;05;02;Perjantai;3;1;4;3;0;3
89;16.05.2014;2014;05;03;Perjantai;4;1;5;0;0;0
89;16.05.2014;2014;05;04;Perjantai;3;5;8;2;1;3
89;16.05.2014;2014;05;05;Perjantai;2;10;12;1;0;1
89;16.05.2014;2014;05;06;Perjantai;17;42;59;2;0;2
89;16.05.2014;2014;05;07;Perjantai;45;122;167;2;18;20
89;16.05.2014;2014;05;08;Perjantai;48;173;221;9;35;44
89;16.05.2014;2014;05;09;Perjantai;25;80;105;6;46;52
89;16.05.2014;2014;05;10;Perjantai;29;65;94;10;16;26
89;16.05.2014;2014;05;11;Perjantai;39;78;117;25;27;52
89;16.05.2014;2014;05;12;Perjantai;72;93;165;23;25;48
89;16.05.2014;2014;05;13;Perjantai;115;93;208;29;24;53
89;16.05.2014;2014;05;14;Perjantai;145;76;221;24;24;48
89;16.05.2014;2014;05;15;Perjantai;150;106;256;26;18;44
89;16.05.2014;2014;05;16;Perjantai;155;86;241;24;24;48
89;16.05.2014;2014;05;17;Perjantai;147;102;249;38;32;70
89;16.05.2014;2014;05;18;Perjantai;100;96;196;24;28;52
89;16.05.2014;2014;05;19;Perjantai;74;70;144;14;25;39
89;16.05.2014;2014;05;20;Perjantai;70;55;125;17;16;33
89;16.05.2014;2014;05;21;Perjantai;41;44;85;7;5;12
89;16.05.2014;2014;05;22;Perjantai;36;20;56;12;12;24
89;16.05.2014;2014;05;23;Perjantai;52;34;86;5;9;14
89;17.05.2014;2014;05;00;Lauantai;28;32;60;4;5;9
89;17.05.2014;2014;05;01;Lauantai;26;16;42;7;1;8
89;17.05.2014;2014;05;02;Lauantai;31;5;36;8;1;9
89;17.05.2014;2014;05;03;Lauantai;18;7;25;2;0;2
89;17.05.2014;2014;05;04;Lauantai;18;2;20;7;0;7
89;17.05.2014;2014;05;05;Lauantai;10;2;12;2;0;2
89;17.05.2014;2014;05;06;Lauantai;6;13;19;2;1;3
89;17.05.2014;2014;05;07;Lauantai;9;16;25;1;6;7
89;17.05.2014;2014;05;08;Lauantai;13;42;55;5;10;15
89;17.05.2014;2014;05;09;Lauantai;14;90;104;10;32;42
89;17.05.2014;2014;05;10;Lauantai;26;108;134;20;27;47
89;17.05.2014;2014;05;11;Lauantai;82;178;260;38;75;113
89;17.05.2014;2014;05;12;Lauantai;109;214;323;33;83;116
89;17.05.2014;2014;05;13;Lauantai;177;215;392;53;91;144
89;17.05.2014;2014;05;14;Lauantai;175;168;343;52;65;117
89;17.05.2014;2014;05;15;Lauantai;170;138;308;50;43;93
89;17.05.2014;2014;05;16;Lauantai;163;105;268;44;36;80
89;17.05.2014;2014;05;17;Lauantai;95;95;190;39;23;62
89;17.05.2014;2014;05;18;Lauantai;104;111;215;45;37;82
89;17.05.2014;2014;05;19;Lauantai;122;112;234;27;38;65
89;17.05.2014;2014;05;20;Lauantai;66;58;124;25;30;55
89;17.05.2014;2014;05;21;Lauantai;49;53;102;16;14;30
89;17.05.2014;2014;05;22;Lauantai;36;39;75;12;10;22
89;17.05.2014;2014;05;23;Lauantai;41;37;78;3;4;7
89;18.05.2014;2014;05;00;Sunnuntai;26;29;55;6;5;11
89;18.05.2014;2014;05;01;Sunnuntai;24;4;28;4;5;9
89;18.05.2014;2014;05;02;Sunnuntai;44;11;55;7;4;11
89;18.05.2014;2014;05;03;Sunnuntai;22;5;27;8;0;8
89;18.05.2014;2014;05;04;Sunnuntai;28;3;31;6;1;7
89;18.05.2014;2014;05;05;Sunnuntai;11;5;16;3;0;3
89;18.05.2014;2014;05;06;Sunnuntai;6;8;14;2;3;5
89;18.05.2014;2014;05;07;Sunnuntai;6;11;17;5;6;11
89;18.05.2014;2014;05;08;Sunnuntai;8;9;17;5;9;14
89;18.05.2014;2014;05;09;Sunnuntai;13;41;54;18;15;33
89;18.05.2014;2014;05;10;Sunnuntai;39;65;104;30;45;75
89;18.05.2014;2014;05;11;Sunnuntai;70;103;173;29;37;66
89;18.05.2014;2014;05;12;Sunnuntai;108;167;275;56;66;122
89;18.05.2014;2014;05;13;Sunnuntai;158;190;348;43;53;96
89;18.05.2014;2014;05;14;Sunnuntai;163;174;337;36;68;104
89;18.05.2014;2014;05;15;Sunnuntai;168;147;315;47;72;119
89;18.05.2014;2014;05;16;Sunnuntai;157;125;282;45;70;115
89;18.05.2014;2014;05;17;Sunnuntai;144;105;249;46;40;86
89;18.05.2014;2014;05;18;Sunnuntai;108;82;190;36;54;90
89;18.05.2014;2014;05;19;Sunnuntai;118;116;234;47;60;107
89;18.05.2014;2014;05;20;Sunnuntai;87;62;149;40;34;74
89;18.05.2014;2014;05;21;Sunnuntai;61;43;104;17;25;42
89;18.05.2014;2014;05;22;Sunnuntai;25;33;58;5;5;10
89;18.05.2014;2014;05;23;Sunnuntai;25;16;41;8;7;15
89;19.05.2014;2014;05;00;Maanantai;8;15;23;7;2;9
89;19.05.2014;2014;05;01;Maanantai;1;2;3;0;1;1
89;19.05.2014;2014;05;02;Maanantai;3;3;6;0;1;1
89;19.05.2014;2014;05;03;Maanantai;3;6;9;0;1;1
89;19.05.2014;2014;05;04;Maanantai;3;7;10;1;0;1
89;19.05.2014;2014;05;05;Maanantai;4;12;16;0;1;1
89;19.05.2014;2014;05;06;Maanantai;31;83;114;3;5;8
89;19.05.2014;2014;05;07;Maanantai;63;233;296;5;22;27
89;19.05.2014;2014;05;08;Maanantai;87;346;433;7;34;41
89;19.05.2014;2014;05;09;Maanantai;56;151;207;7;38;45
89;19.05.2014;2014;05;10;Maanantai;76;141;217;17;51;68
89;19.05.2014;2014;05;11;Maanantai;128;134;262;56;42;98
89;19.05.2014;2014;05;12;Maanantai;130;171;301;44;68;112
89;19.05.2014;2014;05;13;Maanantai;161;169;330;80;59;139
89;19.05.2014;2014;05;14;Maanantai;251;157;408;52;50;102
89;19.05.2014;2014;05;15;Maanantai;352;207;559;93;54;147
89;19.05.2014;2014;05;16;Maanantai;434;229;663;70;55;125
89;19.05.2014;2014;05;17;Maanantai;252;205;457;55;71;126
89;19.05.2014;2014;05;18;Maanantai;207;163;370;64;54;118
89;19.05.2014;2014;05;19;Maanantai;228;206;434;50;49;99
89;19.05.2014;2014;05;20;Maanantai;218;122;340;41;41;82
89;19.05.2014;2014;05;21;Maanantai;158;111;269;98;79;177
89;19.05.2014;2014;05;22;Maanantai;31;27;58;11;6;17
89;19.05.2014;2014;05;23;Maanantai;19;12;31;5;2;7
89;20.05.2014;2014;05;00;Tiistai;10;6;16;1;1;2
89;20.05.2014;2014;05;01;Tiistai;4;4;8;4;2;6
89;20.05.2014;2014;05;02;Tiistai;5;4;9;0;1;1
89;20.05.2014;2014;05;03;Tiistai;7;6;13;0;0;0
89;20.05.2014;2014;05;04;Tiistai;4;2;6;1;1;2
89;20.05.2014;2014;05;05;Tiistai;3;14;17;0;4;4
89;20.05.2014;2014;05;06;Tiistai;30;73;103;2;5;7
89;20.05.2014;2014;05;07;Tiistai;55;200;255;5;15;20
89;20.05.2014;2014;05;08;Tiistai;72;283;355;10;34;44
89;20.05.2014;2014;05;09;Tiistai;56;189;245;8;30;38
89;20.05.2014;2014;05;10;Tiistai;54;90;144;22;64;86
89;20.05.2014;2014;05;11;Tiistai;79;88;167;23;19;42
89;20.05.2014;2014;05;12;Tiistai;100;131;231;26;24;50
89;20.05.2014;2014;05;13;Tiistai;133;123;256;28;51;79
89;20.05.2014;2014;05;14;Tiistai;160;134;294;31;34;65
89;20.05.2014;2014;05;15;Tiistai;235;151;386;36;29;65
89;20.05.2014;2014;05;16;Tiistai;336;158;494;53;26;79
89;20.05.2014;2014;05;17;Tiistai;201;152;353;45;39;84
89;20.05.2014;2014;05;18;Tiistai;125;135;260;39;54;93
89;20.05.2014;2014;05;19;Tiistai;166;100;266;47;46;93
89;20.05.2014;2014;05;20;Tiistai;137;87;224;34;33;67
89;20.05.2014;2014;05;21;Tiistai;82;48;130;29;26;55
89;20.05.2014;2014;05;22;Tiistai;32;20;52;9;7;16
89;20.05.2014;2014;05;23;Tiistai;24;12;36;1;9;10
89;21.05.2014;2014;05;00;Keskiviikko;8;5;13;3;2;5
89;21.05.2014;2014;05;01;Keskiviikko;5;8;13;0;2;2
89;21.05.2014;2014;05;02;Keskiviikko;10;3;13;0;4;4
89;21.05.2014;2014;05;03;Keskiviikko;11;6;17;3;0;3
89;21.05.2014;2014;05;04;Keskiviikko;5;5;10;3;2;5
89;21.05.2014;2014;05;05;Keskiviikko;6;17;23;1;1;2
89;21.05.2014;2014;05;06;Keskiviikko;31;80;111;4;9;13
89;21.05.2014;2014;05;07;Keskiviikko;49;205;254;4;19;23
89;21.05.2014;2014;05;08;Keskiviikko;70;313;383;18;54;72
89;21.05.2014;2014;05;09;Keskiviikko;48;137;185;20;44;64
89;21.05.2014;2014;05;10;Keskiviikko;52;111;163;17;31;48
89;21.05.2014;2014;05;11;Keskiviikko;62;129;191;23;30;53
89;21.05.2014;2014;05;12;Keskiviikko;119;141;260;20;29;49
89;21.05.2014;2014;05;13;Keskiviikko;144;138;282;32;47;79
89;21.05.2014;2014;05;14;Keskiviikko;183;125;308;25;41;66
89;21.05.2014;2014;05;15;Keskiviikko;248;147;395;32;21;53
89;21.05.2014;2014;05;16;Keskiviikko;304;182;486;29;28;57
89;21.05.2014;2014;05;17;Keskiviikko;223;159;382;38;41;79
89;21.05.2014;2014;05;18;Keskiviikko;177;153;330;46;44;90
89;21.05.2014;2014;05;19;Keskiviikko;177;135;312;37;49;86
89;21.05.2014;2014;05;20;Keskiviikko;151;76;227;39;42;81
89;21.05.2014;2014;05;21;Keskiviikko;96;72;168;23;26;49
89;21.05.2014;2014;05;22;Keskiviikko;61;40;101;11;14;25
89;21.05.2014;2014;05;23;Keskiviikko;38;25;63;5;11;16
89;22.05.2014;2014;05;00;Torstai;17;10;27;1;1;2
89;22.05.2014;2014;05;01;Torstai;10;6;16;2;3;5
89;22.05.2014;2014;05;02;Torstai;4;3;7;3;0;3
89;22.05.2014;2014;05;03;Torstai;8;3;11;1;4;5
89;22.05.2014;2014;05;04;Torstai;9;6;15;1;1;2
89;22.05.2014;2014;05;05;Torstai;9;12;21;0;0;0
89;22.05.2014;2014;05;06;Torstai;28;65;93;4;2;6
89;22.05.2014;2014;05;07;Torstai;58;213;271;7;23;30
89;22.05.2014;2014;05;08;Torstai;80;334;414;7;49;56
89;22.05.2014;2014;05;09;Torstai;55;233;288;15;60;75
89;22.05.2014;2014;05;10;Torstai;89;152;241;29;37;66
89;22.05.2014;2014;05;11;Torstai;174;145;319;26;29;55
89;22.05.2014;2014;05;12;Torstai;132;156;288;45;60;105
89;22.05.2014;2014;05;13;Torstai;144;144;288;41;36;77
89;22.05.2014;2014;05;14;Torstai;269;133;402;68;36;104
89;22.05.2014;2014;05;15;Torstai;248;156;404;32;32;64
89;22.05.2014;2014;05;16;Torstai;324;187;511;40;34;74
89;22.05.2014;2014;05;17;Torstai;213;189;402;38;40;78
89;22.05.2014;2014;05;18;Torstai;172;122;294;44;37;81
89;22.05.2014;2014;05;19;Torstai;153;75;228;36;36;72
89;22.05.2014;2014;05;20;Torstai;89;67;156;23;21;44
89;22.05.2014;2014;05;21;Torstai;67;35;102;11;11;22
89;22.05.2014;2014;05;22;Torstai;36;27;63;12;13;25
89;22.05.2014;2014;05;23;Torstai;25;10;35;5;4;9
89;23.05.2014;2014;05;00;Perjantai;16;14;30;4;5;9
89;23.05.2014;2014;05;01;Perjantai;9;4;13;1;2;3
89;23.05.2014;2014;05;02;Perjantai;9;1;10;0;1;1
89;23.05.2014;2014;05;03;Perjantai;3;6;9;0;0;0
89;23.05.2014;2014;05;04;Perjantai;9;6;15;3;2;5
89;23.05.2014;2014;05;05;Perjantai;6;18;24;1;0;1
89;23.05.2014;2014;05;06;Perjantai;26;63;89;6;11;17
89;23.05.2014;2014;05;07;Perjantai;52;195;247;6;23;29
89;23.05.2014;2014;05;08;Perjantai;81;328;409;14;112;126
89;23.05.2014;2014;05;09;Perjantai;63;170;233;35;59;94
89;23.05.2014;2014;05;10;Perjantai;65;146;211;26;60;86
89;23.05.2014;2014;05;11;Perjantai;148;207;355;63;44;107
89;23.05.2014;2014;05;12;Perjantai;193;173;366;26;44;70
89;23.05.2014;2014;05;13;Perjantai;220;183;403;42;50;92
89;23.05.2014;2014;05;14;Perjantai;256;159;415;28;27;55
89;23.05.2014;2014;05;15;Perjantai;292;178;470;65;35;100
89;23.05.2014;2014;05;16;Perjantai;299;178;477;47;42;89
89;23.05.2014;2014;05;17;Perjantai;219;186;405;50;57;107
89;23.05.2014;2014;05;18;Perjantai;260;223;483;55;70;125
89;23.05.2014;2014;05;19;Perjantai;207;195;402;70;64;134
89;23.05.2014;2014;05;20;Perjantai;179;166;345;62;59;121
89;23.05.2014;2014;05;21;Perjantai;152;184;336;69;97;166
89;23.05.2014;2014;05;22;Perjantai;122;152;274;44;81;125
89;23.05.2014;2014;05;23;Perjantai;98;119;217;60;82;142
89;24.05.2014;2014;05;00;Lauantai;57;94;151;45;93;138
89;24.05.2014;2014;05;01;Lauantai;59;54;113;23;57;80
89;24.05.2014;2014;05;02;Lauantai;52;77;129;24;48;72
89;24.05.2014;2014;05;03;Lauantai;50;32;82;27;24;51
89;24.05.2014;2014;05;04;Lauantai;29;11;40;7;12;19
89;24.05.2014;2014;05;05;Lauantai;10;12;22;4;3;7
89;24.05.2014;2014;05;06;Lauantai;11;18;29;3;6;9
89;24.05.2014;2014;05;07;Lauantai;9;20;29;3;12;15
89;24.05.2014;2014;05;08;Lauantai;19;70;89;16;14;30
89;24.05.2014;2014;05;09;Lauantai;42;138;180;15;55;70
89;24.05.2014;2014;05;10;Lauantai;70;261;331;20;53;73
89;24.05.2014;2014;05;11;Lauantai;124;274;398;44;100;144
89;24.05.2014;2014;05;12;Lauantai;177;270;447;87;537;624
89;24.05.2014;2014;05;13;Lauantai;185;293;478;137;744;881
89;24.05.2014;2014;05;14;Lauantai;176;262;438;132;856;988
89;24.05.2014;2014;05;15;Lauantai;286;221;507;79;193;272
89;24.05.2014;2014;05;16;Lauantai;223;135;358;66;172;238
89;24.05.2014;2014;05;17;Lauantai;170;134;304;39;54;93
89;24.05.2014;2014;05;18;Lauantai;118;150;268;41;33;74
89;24.05.2014;2014;05;19;Lauantai;128;93;221;53;50;103
89;24.05.2014;2014;05;20;Lauantai;89;63;152;34;47;81
89;24.05.2014;2014;05;21;Lauantai;74;99;173;16;39;55
89;24.05.2014;2014;05;22;Lauantai;58;83;141;14;36;50
89;24.05.2014;2014;05;23;Lauantai;46;78;124;8;25;33
89;25.05.2014;2014;05;00;Sunnuntai;41;45;86;12;14;26
89;25.05.2014;2014;05;01;Sunnuntai;44;39;83;4;9;13
89;25.05.2014;2014;05;02;Sunnuntai;31;16;47;17;4;21
89;25.05.2014;2014;05;03;Sunnuntai;48;4;52;8;0;8
89;25.05.2014;2014;05;04;Sunnuntai;27;3;30;9;0;9
89;25.05.2014;2014;05;05;Sunnuntai;12;6;18;5;0;5
89;25.05.2014;2014;05;06;Sunnuntai;7;12;19;2;1;3
89;25.05.2014;2014;05;07;Sunnuntai;5;6;11;6;7;13
89;25.05.2014;2014;05;08;Sunnuntai;4;11;15;0;2;2
89;25.05.2014;2014;05;09;Sunnuntai;10;11;21;4;5;9
89;25.05.2014;2014;05;10;Sunnuntai;9;13;22;7;4;11
89;25.05.2014;2014;05;11;Sunnuntai;7;21;28;9;18;27
89;25.05.2014;2014;05;12;Sunnuntai;14;33;47;18;15;33
89;25.05.2014;2014;05;13;Sunnuntai;33;43;76;20;26;46
89;25.05.2014;2014;05;14;Sunnuntai;38;67;105;20;24;44
89;25.05.2014;2014;05;15;Sunnuntai;39;67;106;17;15;32
89;25.05.2014;2014;05;16;Sunnuntai;67;46;113;16;23;39
89;25.05.2014;2014;05;17;Sunnuntai;54;42;96;21;24;45
89;25.05.2014;2014;05;18;Sunnuntai;43;64;107;17;32;49
89;25.05.2014;2014;05;19;Sunnuntai;54;37;91;22;24;46
89;25.05.2014;2014;05;20;Sunnuntai;74;68;142;20;9;29
89;25.05.2014;2014;05;21;Sunnuntai;33;19;52;5;5;10
89;25.05.2014;2014;05;22;Sunnuntai;14;9;23;4;1;5
89;25.05.2014;2014;05;23;Sunnuntai;23;19;42;3;4;7
89;26.05.2014;2014;05;00;Maanantai;13;15;28;3;2;5
89;26.05.2014;2014;05;01;Maanantai;2;2;4;2;1;3
89;26.05.2014;2014;05;02;Maanantai;5;0;5;0;2;2
89;26.05.2014;2014;05;03;Maanantai;2;2;4;1;0;1
89;26.05.2014;2014;05;04;Maanantai;6;6;12;0;2;2
89;26.05.2014;2014;05;05;Maanantai;10;11;21;0;0;0
89;26.05.2014;2014;05;06;Maanantai;20;48;68;2;3;5
89;26.05.2014;2014;05;07;Maanantai;37;189;226;2;19;21
89;26.05.2014;2014;05;08;Maanantai;67;263;330;6;28;34
89;26.05.2014;2014;05;09;Maanantai;55;164;219;5;34;39
89;26.05.2014;2014;05;10;Maanantai;57;104;161;12;16;28
89;26.05.2014;2014;05;11;Maanantai;73;98;171;18;21;39
89;26.05.2014;2014;05;12;Maanantai;120;106;226;17;33;50
89;26.05.2014;2014;05;13;Maanantai;134;99;233;34;28;62
89;26.05.2014;2014;05;14;Maanantai;155;85;240;19;16;35
89;26.05.2014;2014;05;15;Maanantai;174;73;247;16;18;34
89;26.05.2014;2014;05;16;Maanantai;238;111;349;22;13;35
89;26.05.2014;2014;05;17;Maanantai;142;78;220;26;18;44
89;26.05.2014;2014;05;18;Maanantai;116;59;175;30;23;53
89;26.05.2014;2014;05;19;Maanantai;61;60;121;27;27;54
89;26.05.2014;2014;05;20;Maanantai;61;37;98;16;17;33
89;26.05.2014;2014;05;21;Maanantai;50;23;73;14;14;28
89;26.05.2014;2014;05;22;Maanantai;18;17;35;11;12;23
89;26.05.2014;2014;05;23;Maanantai;11;9;20;7;4;11
89;27.05.2014;2014;05;00;Tiistai;8;11;19;3;0;3
89;27.05.2014;2014;05;01;Tiistai;3;0;3;1;0;1
89;27.05.2014;2014;05;02;Tiistai;2;1;3;2;0;2
89;27.05.2014;2014;05;03;Tiistai;1;2;3;1;0;1
89;27.05.2014;2014;05;04;Tiistai;1;4;5;0;0;0
89;27.05.2014;2014;05;05;Tiistai;3;6;9;1;0;1
89;27.05.2014;2014;05;06;Tiistai;24;68;92;0;9;9
89;27.05.2014;2014;05;07;Tiistai;47;178;225;3;26;29
89;27.05.2014;2014;05;08;Tiistai;59;267;326;12;33;45
89;27.05.2014;2014;05;09;Tiistai;51;164;215;11;61;72
89;27.05.2014;2014;05;10;Tiistai;52;104;156;15;29;44
89;27.05.2014;2014;05;11;Tiistai;73;92;165;34;20;54
89;27.05.2014;2014;05;12;Tiistai;83;87;170;21;25;46
89;27.05.2014;2014;05;13;Tiistai;104;109;213;12;20;32
89;27.05.2014;2014;05;14;Tiistai;164;82;246;24;16;40
89;27.05.2014;2014;05;15;Tiistai;187;106;293;37;16;53
89;27.05.2014;2014;05;16;Tiistai;242;126;368;33;14;47
89;27.05.2014;2014;05;17;Tiistai;159;102;261;28;37;65
89;27.05.2014;2014;05;18;Tiistai;106;60;166;26;22;48
89;27.05.2014;2014;05;19;Tiistai;107;57;164;19;21;40
89;27.05.2014;2014;05;20;Tiistai;69;48;117;19;19;38
89;27.05.2014;2014;05;21;Tiistai;57;22;79;15;12;27
89;27.05.2014;2014;05;22;Tiistai;35;16;51;10;8;18
89;27.05.2014;2014;05;23;Tiistai;20;19;39;4;9;13
89;28.05.2014;2014;05;00;Keskiviikko;7;11;18;3;4;7
89;28.05.2014;2014;05;01;Keskiviikko;7;1;8;0;0;0
89;28.05.2014;2014;05;02;Keskiviikko;5;0;5;1;0;1
89;28.05.2014;2014;05;03;Keskiviikko;2;2;4;0;1;1
89;28.05.2014;2014;05;04;Keskiviikko;0;1;1;3;0;3
89;28.05.2014;2014;05;05;Keskiviikko;5;12;17;0;0;0
89;28.05.2014;2014;05;06;Keskiviikko;28;56;84;4;7;11
89;28.05.2014;2014;05;07;Keskiviikko;42;164;206;4;11;15
89;28.05.2014;2014;05;08;Keskiviikko;52;231;283;6;29;35
89;28.05.2014;2014;05;09;Keskiviikko;47;165;212;5;38;43
89;28.05.2014;2014;05;10;Keskiviikko;64;147;211;16;35;51
89;28.05.2014;2014;05;11;Keskiviikko;93;127;220;27;25;52
89;28.05.2014;2014;05;12;Keskiviikko;145;89;234;33;25;58
89;28.05.2014;2014;05;13;Keskiviikko;117;113;230;25;23;48
89;28.05.2014;2014;05;14;Keskiviikko;159;104;263;24;26;50
89;28.05.2014;2014;05;15;Keskiviikko;186;130;316;25;22;47
89;28.05.2014;2014;05;16;Keskiviikko;223;131;354;41;30;71
89;28.05.2014;2014;05;17;Keskiviikko;166;142;308;31;21;52
89;28.05.2014;2014;05;18;Keskiviikko;96;123;219;34;36;70
89;28.05.2014;2014;05;19;Keskiviikko;90;91;181;25;36;61
89;28.05.2014;2014;05;20;Keskiviikko;90;79;169;21;23;44
89;28.05.2014;2014;05;21;Keskiviikko;84;55;139;17;28;45
89;28.05.2014;2014;05;22;Keskiviikko;44;40;84;13;15;28
89;28.05.2014;2014;05;23;Keskiviikko;36;32;68;10;7;17
89;29.05.2014;2014;05;00;Torstai;32;36;68;5;12;17
89;29.05.2014;2014;05;01;Torstai;28;11;39;4;2;6
89;29.05.2014;2014;05;02;Torstai;20;2;22;3;1;4
89;29.05.2014;2014;05;03;Torstai;25;1;26;6;0;6
89;29.05.2014;2014;05;04;Torstai;24;2;26;3;1;4
89;29.05.2014;2014;05;05;Torstai;9;5;14;0;1;1
89;29.05.2014;2014;05;06;Torstai;7;13;20;1;2;3
89;29.05.2014;2014;05;07;Torstai;10;11;21;3;5;8
89;29.05.2014;2014;05;08;Torstai;15;15;30;14;10;24
89;29.05.2014;2014;05;09;Torstai;27;28;55;13;26;39
89;29.05.2014;2014;05;10;Torstai;32;73;105;34;32;66
89;29.05.2014;2014;05;11;Torstai;72;100;172;30;47;77
89;29.05.2014;2014;05;12;Torstai;111;117;228;39;50;89
89;29.05.2014;2014;05;13;Torstai;91;143;234;33;62;95
89;29.05.2014;2014;05;14;Torstai;101;142;243;45;56;101
89;29.05.2014;2014;05;15;Torstai;126;128;254;41;42;83
89;29.05.2014;2014;05;16;Torstai;111;96;207;17;33;50
89;29.05.2014;2014;05;17;Torstai;118;82;200;29;34;63
89;29.05.2014;2014;05;18;Torstai;67;75;142;26;33;59
89;29.05.2014;2014;05;19;Torstai;77;81;158;24;43;67
89;29.05.2014;2014;05;20;Torstai;68;58;126;23;24;47
89;29.05.2014;2014;05;21;Torstai;72;34;106;11;16;27
89;29.05.2014;2014;05;22;Torstai;31;20;51;6;15;21
89;29.05.2014;2014;05;23;Torstai;17;16;33;3;2;5
89;30.05.2014;2014;05;00;Perjantai;10;1;11;5;4;9
89;30.05.2014;2014;05;01;Perjantai;9;3;12;2;0;2
89;30.05.2014;2014;05;02;Perjantai;7;5;12;3;2;5
89;30.05.2014;2014;05;03;Perjantai;8;4;12;1;0;1
89;30.05.2014;2014;05;04;Perjantai;2;5;7;0;0;0
89;30.05.2014;2014;05;05;Perjantai;4;11;15;0;2;2
89;30.05.2014;2014;05;06;Perjantai;19;54;73;0;8;8
89;30.05.2014;2014;05;07;Perjantai;31;107;138;0;13;13
89;30.05.2014;2014;05;08;Perjantai;36;149;185;6;20;26
89;30.05.2014;2014;05;09;Perjantai;47;74;121;5;12;17
89;30.05.2014;2014;05;10;Perjantai;48;67;115;12;24;36
89;30.05.2014;2014;05;11;Perjantai;56;56;112;10;14;24
89;30.05.2014;2014;05;12;Perjantai;51;43;94;13;13;26
89;30.05.2014;2014;05;13;Perjantai;58;42;100;16;14;30
89;30.05.2014;2014;05;14;Perjantai;86;49;135;10;10;20
89;30.05.2014;2014;05;15;Perjantai;85;50;135;9;11;20
89;30.05.2014;2014;05;16;Perjantai;96;50;146;14;12;26
89;30.05.2014;2014;05;17;Perjantai;61;45;106;10;16;26
89;30.05.2014;2014;05;18;Perjantai;56;26;82;12;23;35
89;30.05.2014;2014;05;19;Perjantai;42;32;74;9;6;15
89;30.05.2014;2014;05;20;Perjantai;37;34;71;11;9;20
89;30.05.2014;2014;05;21;Perjantai;26;30;56;6;4;10
89;30.05.2014;2014;05;22;Perjantai;20;11;31;11;8;19
89;30.05.2014;2014;05;23;Perjantai;12;17;29;3;7;10
89;31.05.2014;2014;05;00;Lauantai;15;14;29;2;2;4
89;31.05.2014;2014;05;01;Lauantai;12;10;22;5;4;9
89;31.05.2014;2014;05;02;Lauantai;19;5;24;7;1;8
89;31.05.2014;2014;05;03;Lauantai;16;1;17;6;0;6
89;31.05.2014;2014;05;04;Lauantai;11;3;14;4;0;4
89;31.05.2014;2014;05;05;Lauantai;2;6;8;1;4;5
89;31.05.2014;2014;05;06;Lauantai;5;13;18;1;1;2
89;31.05.2014;2014;05;07;Lauantai;6;13;19;7;3;10
89;31.05.2014;2014;05;08;Lauantai;15;48;63;6;10;16
89;31.05.2014;2014;05;09;Lauantai;33;68;101;13;15;28
89;31.05.2014;2014;05;10;Lauantai;52;62;114;11;34;45
89;31.05.2014;2014;05;11;Lauantai;45;101;146;21;25;46
89;31.05.2014;2014;05;12;Lauantai;83;92;175;27;40;67
89;31.05.2014;2014;05;13;Lauantai;80;92;172;28;45;73
89;31.05.2014;2014;05;14;Lauantai;94;137;231;26;49;75
89;31.05.2014;2014;05;15;Lauantai;104;191;295;26;49;75
89;31.05.2014;2014;05;16;Lauantai;156;92;248;39;19;58
89;31.05.2014;2014;05;17;Lauantai;94;60;154;16;21;37
89;31.05.2014;2014;05;18;Lauantai;58;65;123;20;23;43
89;31.05.2014;2014;05;19;Lauantai;63;46;109;21;14;35
89;31.05.2014;2014;05;20;Lauantai;52;65;117;15;18;33
89;31.05.2014;2014;05;21;Lauantai;37;33;70;10;10;20
89;31.05.2014;2014;05;22;Lauantai;61;38;99;20;12;32
89;31.05.2014;2014;05;23;Lauantai;31;37;68;5;6;11
89;01.06.2014;2014;06;00;Sunnuntai;36;21;57;4;9;13
89;01.06.2014;2014;06;01;Sunnuntai;40;10;50;10;6;16
89;01.06.2014;2014;06;02;Sunnuntai;41;8;49;13;2;15
89;01.06.2014;2014;06;03;Sunnuntai;40;6;46;20;1;21
89;01.06.2014;2014;06;04;Sunnuntai;17;4;21;9;1;10
89;01.06.2014;2014;06;05;Sunnuntai;3;6;9;1;2;3
89;01.06.2014;2014;06;06;Sunnuntai;4;13;17;1;0;1
89;01.06.2014;2014;06;07;Sunnuntai;5;11;16;2;2;4
89;01.06.2014;2014;06;08;Sunnuntai;8;7;15;2;9;11
89;01.06.2014;2014;06;09;Sunnuntai;9;34;43;8;19;27
89;01.06.2014;2014;06;10;Sunnuntai;21;44;65;16;29;45
89;01.06.2014;2014;06;11;Sunnuntai;41;62;103;28;38;66
89;01.06.2014;2014;06;12;Sunnuntai;45;52;97;37;32;69
89;01.06.2014;2014;06;13;Sunnuntai;77;63;140;38;43;81
89;01.06.2014;2014;06;14;Sunnuntai;79;65;144;23;32;55
89;01.06.2014;2014;06;15;Sunnuntai;68;84;152;34;36;70
89;01.06.2014;2014;06;16;Sunnuntai;89;68;157;28;37;65
89;01.06.2014;2014;06;17;Sunnuntai;78;65;143;31;24;55
89;01.06.2014;2014;06;18;Sunnuntai;57;63;120;23;17;40
89;01.06.2014;2014;06;19;Sunnuntai;59;51;110;14;44;58
89;01.06.2014;2014;06;20;Sunnuntai;53;40;93;20;26;46
89;01.06.2014;2014;06;21;Sunnuntai;31;18;49;14;9;23
89;01.06.2014;2014;06;22;Sunnuntai;20;13;33;6;2;8
89;01.06.2014;2014;06;23;Sunnuntai;14;16;30;4;2;6
89;02.06.2014;2014;06;00;Maanantai;9;8;17;7;4;11
89;02.06.2014;2014;06;01;Maanantai;5;6;11;1;1;2
89;02.06.2014;2014;06;02;Maanantai;5;2;7;2;0;2
89;02.06.2014;2014;06;03;Maanantai;3;2;5;1;0;1
89;02.06.2014;2014;06;04;Maanantai;3;7;10;1;0;1
89;02.06.2014;2014;06;05;Maanantai;10;26;36;0;1;1
89;02.06.2014;2014;06;06;Maanantai;33;95;128;5;14;19
89;02.06.2014;2014;06;07;Maanantai;61;253;314;8;16;24
89;02.06.2014;2014;06;08;Maanantai;46;220;266;5;26;31
89;02.06.2014;2014;06;09;Maanantai;52;127;179;9;18;27
89;02.06.2014;2014;06;10;Maanantai;65;106;171;16;34;50
89;02.06.2014;2014;06;11;Maanantai;90;127;217;18;46;64
89;02.06.2014;2014;06;12;Maanantai;109;127;236;20;26;46
89;02.06.2014;2014;06;13;Maanantai;144;135;279;41;35;76
89;02.06.2014;2014;06;14;Maanantai;159;148;307;44;31;75
89;02.06.2014;2014;06;15;Maanantai;268;133;401;60;33;93
89;02.06.2014;2014;06;16;Maanantai;284;152;436;44;29;73
89;02.06.2014;2014;06;17;Maanantai;192;134;326;50;56;106
89;02.06.2014;2014;06;18;Maanantai;147;121;268;38;45;83
89;02.06.2014;2014;06;19;Maanantai;129;102;231;42;46;88
89;02.06.2014;2014;06;20;Maanantai;123;58;181;45;38;83
89;02.06.2014;2014;06;21;Maanantai;83;48;131;35;28;63
89;02.06.2014;2014;06;22;Maanantai;30;61;91;53;38;91
89;02.06.2014;2014;06;23;Maanantai;21;15;36;8;19;27
89;03.06.2014;2014;06;00;Tiistai;14;8;22;1;3;4
89;03.06.2014;2014;06;01;Tiistai;6;3;9;4;1;5
89;03.06.2014;2014;06;02;Tiistai;5;3;8;0;0;0
89;03.06.2014;2014;06;03;Tiistai;6;2;8;1;0;1
89;03.06.2014;2014;06;04;Tiistai;1;5;6;3;0;3
89;03.06.2014;2014;06;05;Tiistai;9;31;40;4;1;5
89;03.06.2014;2014;06;06;Tiistai;34;92;126;3;5;8
89;03.06.2014;2014;06;07;Tiistai;63;315;378;9;29;38
89;03.06.2014;2014;06;08;Tiistai;55;230;285;17;41;58
89;03.06.2014;2014;06;09;Tiistai;52;122;174;12;38;50
89;03.06.2014;2014;06;10;Tiistai;78;146;224;37;54;91
89;03.06.2014;2014;06;11;Tiistai;116;150;266;31;36;67
89;03.06.2014;2014;06;12;Tiistai;149;147;296;29;30;59
89;03.06.2014;2014;06;13;Tiistai;164;158;322;37;45;82
89;03.06.2014;2014;06;14;Tiistai;210;160;370;58;48;106
89;03.06.2014;2014;06;15;Tiistai;305;190;495;56;33;89
89;03.06.2014;2014;06;16;Tiistai;307;217;524;73;52;125
89;03.06.2014;2014;06;17;Tiistai;240;277;517;46;73;119
89;03.06.2014;2014;06;18;Tiistai;193;192;385;39;62;101
89;03.06.2014;2014;06;19;Tiistai;269;141;410;60;68;128
89;03.06.2014;2014;06;20;Tiistai;192;149;341;41;38;79
89;03.06.2014;2014;06;21;Tiistai;105;63;168;20;41;61
89;03.06.2014;2014;06;22;Tiistai;66;46;112;18;15;33
89;03.06.2014;2014;06;23;Tiistai;28;39;67;4;10;14
89;04.06.2014;2014;06;00;Keskiviikko;19;8;27;8;3;11
89;04.06.2014;2014;06;01;Keskiviikko;5;8;13;0;4;4
89;04.06.2014;2014;06;02;Keskiviikko;8;1;9;1;2;3
89;04.06.2014;2014;06;03;Keskiviikko;2;3;5;3;0;3
89;04.06.2014;2014;06;04;Keskiviikko;8;3;11;3;0;3
89;04.06.2014;2014;06;05;Keskiviikko;6;13;19;1;1;2
89;04.06.2014;2014;06;06;Keskiviikko;25;84;109;2;7;9
89;04.06.2014;2014;06;07;Keskiviikko;62;203;265;4;21;25
89;04.06.2014;2014;06;08;Keskiviikko;60;260;320;13;29;42
89;04.06.2014;2014;06;09;Keskiviikko;53;135;188;17;21;38
89;04.06.2014;2014;06;10;Keskiviikko;59;106;165;24;29;53
89;04.06.2014;2014;06;11;Keskiviikko;57;125;182;20;24;44
89;04.06.2014;2014;06;12;Keskiviikko;98;137;235;13;36;49
89;04.06.2014;2014;06;13;Keskiviikko;116;120;236;18;31;49
89;04.06.2014;2014;06;14;Keskiviikko;139;105;244;24;34;58
89;04.06.2014;2014;06;15;Keskiviikko;218;135;353;19;18;37
89;04.06.2014;2014;06;16;Keskiviikko;279;131;410;27;29;56
89;04.06.2014;2014;06;17;Keskiviikko;191;151;342;45;45;90
89;04.06.2014;2014;06;18;Keskiviikko;185;165;350;56;46;102
89;04.06.2014;2014;06;19;Keskiviikko;187;152;339;46;64;110
89;04.06.2014;2014;06;20;Keskiviikko;152;133;285;25;34;59
89;04.06.2014;2014;06;21;Keskiviikko;107;77;184;51;59;110
89;04.06.2014;2014;06;22;Keskiviikko;51;44;95;7;9;16
89;04.06.2014;2014;06;23;Keskiviikko;41;26;67;7;8;15
89;05.06.2014;2014;06;00;Torstai;17;11;28;9;4;13
89;05.06.2014;2014;06;01;Torstai;18;10;28;4;2;6
89;05.06.2014;2014;06;02;Torstai;8;6;14;1;1;2
89;05.06.2014;2014;06;03;Torstai;9;7;16;4;0;4
89;05.06.2014;2014;06;04;Torstai;10;4;14;3;0;3
89;05.06.2014;2014;06;05;Torstai;10;23;33;0;2;2
89;05.06.2014;2014;06;06;Torstai;36;101;137;2;8;10
89;05.06.2014;2014;06;07;Torstai;72;273;345;10;23;33
89;05.06.2014;2014;06;08;Torstai;74;234;308;9;33;42
89;05.06.2014;2014;06;09;Torstai;84;156;240;14;44;58
89;05.06.2014;2014;06;10;Torstai;86;123;209;13;26;39
89;05.06.2014;2014;06;11;Torstai;100;174;274;15;58;73
89;05.06.2014;2014;06;12;Torstai;182;145;327;26;26;52
89;05.06.2014;2014;06;13;Torstai;135;111;246;19;32;51
89;05.06.2014;2014;06;14;Torstai;145;119;264;17;26;43
89;05.06.2014;2014;06;15;Torstai;257;177;434;46;48;94
89;05.06.2014;2014;06;16;Torstai;333;170;503;46;49;95
89;05.06.2014;2014;06;17;Torstai;198;206;404;40;64;104
89;05.06.2014;2014;06;18;Torstai;172;172;344;40;44;84
89;05.06.2014;2014;06;19;Torstai;194;128;322;30;36;66
89;05.06.2014;2014;06;20;Torstai;147;116;263;35;27;62
89;05.06.2014;2014;06;21;Torstai;92;79;171;33;41;74
89;05.06.2014;2014;06;22;Torstai;63;48;111;18;16;34
89;05.06.2014;2014;06;23;Torstai;49;31;80;9;11;20
89;06.06.2014;2014;06;00;Perjantai;52;18;70;10;3;13
89;06.06.2014;2014;06;01;Perjantai;11;11;22;2;4;6
89;06.06.2014;2014;06;02;Perjantai;11;11;22;1;2;3
89;06.06.2014;2014;06;03;Perjantai;7;9;16;1;2;3
89;06.06.2014;2014;06;04;Perjantai;5;6;11;2;1;3
89;06.06.2014;2014;06;05;Perjantai;12;27;39;0;6;6
89;06.06.2014;2014;06;06;Perjantai;30;98;128;2;3;5
89;06.06.2014;2014;06;07;Perjantai;58;205;263;7;20;27
89;06.06.2014;2014;06;08;Perjantai;61;208;269;8;26;34
89;06.06.2014;2014;06;09;Perjantai;59;145;204;18;25;43
89;06.06.2014;2014;06;10;Perjantai;76;114;190;19;30;49
89;06.06.2014;2014;06;11;Perjantai;80;122;202;13;35;48
89;06.06.2014;2014;06;12;Perjantai;129;134;263;39;39;78
89;06.06.2014;2014;06;13;Perjantai;161;162;323;18;40;58
89;06.06.2014;2014;06;14;Perjantai;218;149;367;51;22;73
89;06.06.2014;2014;06;15;Perjantai;257;169;426;42;34;76
89;06.06.2014;2014;06;16;Perjantai;210;126;336;30;18;48
89;06.06.2014;2014;06;17;Perjantai;158;153;311;19;33;52
89;06.06.2014;2014;06;18;Perjantai;83;73;156;13;21;34
89;06.06.2014;2014;06;19;Perjantai;91;63;154;21;20;41
89;06.06.2014;2014;06;20;Perjantai;81;79;160;19;22;41
89;06.06.2014;2014;06;21;Perjantai;67;69;136;17;33;50
89;06.06.2014;2014;06;22;Perjantai;54;48;102;10;18;28
89;06.06.2014;2014;06;23;Perjantai;33;45;78;9;13;22
89;07.06.2014;2014;06;00;Lauantai;44;21;65;4;11;15
89;07.06.2014;2014;06;01;Lauantai;46;18;64;5;6;11
89;07.06.2014;2014;06;02;Lauantai;38;8;46;7;2;9
89;07.06.2014;2014;06;03;Lauantai;37;9;46;16;6;22
89;07.06.2014;2014;06;04;Lauantai;23;3;26;4;0;4
89;07.06.2014;2014;06;05;Lauantai;6;12;18;3;3;6
89;07.06.2014;2014;06;06;Lauantai;15;13;28;1;3;4
89;07.06.2014;2014;06;07;Lauantai;9;29;38;14;7;21
89;07.06.2014;2014;06;08;Lauantai;17;50;67;9;17;26
89;07.06.2014;2014;06;09;Lauantai;46;120;166;19;20;39
89;07.06.2014;2014;06;10;Lauantai;66;119;185;13;31;44
89;07.06.2014;2014;06;11;Lauantai;85;132;217;25;66;91
89;07.06.2014;2014;06;12;Lauantai;109;154;263;35;47;82
89;07.06.2014;2014;06;13;Lauantai;164;174;338;65;55;120
89;07.06.2014;2014;06;14;Lauantai;171;182;353;53;50;103
89;07.06.2014;2014;06;15;Lauantai;193;150;343;67;65;132
89;07.06.2014;2014;06;16;Lauantai;142;147;289;31;33;64
89;07.06.2014;2014;06;17;Lauantai;149;157;306;31;32;63
89;07.06.2014;2014;06;18;Lauantai;128;141;269;24;38;62
89;07.06.2014;2014;06;19;Lauantai;109;121;230;27;41;68
89;07.06.2014;2014;06;20;Lauantai;100;81;181;27;18;45
89;07.06.2014;2014;06;21;Lauantai;69;106;175;18;28;46
89;07.06.2014;2014;06;22;Lauantai;58;90;148;16;36;52
89;07.06.2014;2014;06;23;Lauantai;41;71;112;5;24;29
89;08.06.2014;2014;06;00;Sunnuntai;44;49;93;6;11;17
89;08.06.2014;2014;06;01;Sunnuntai;41;23;64;6;3;9
89;08.06.2014;2014;06;02;Sunnuntai;50;8;58;18;1;19
89;08.06.2014;2014;06;03;Sunnuntai;41;5;46;7;1;8
89;08.06.2014;2014;06;04;Sunnuntai;31;3;34;5;1;6
89;08.06.2014;2014;06;05;Sunnuntai;10;3;13;2;1;3
89;08.06.2014;2014;06;06;Sunnuntai;12;12;24;1;1;2
89;08.06.2014;2014;06;07;Sunnuntai;3;4;7;2;2;4
89;08.06.2014;2014;06;08;Sunnuntai;2;9;11;1;3;4
89;08.06.2014;2014;06;09;Sunnuntai;11;27;38;8;4;12
89;08.06.2014;2014;06;10;Sunnuntai;15;30;45;11;15;26
89;08.06.2014;2014;06;11;Sunnuntai;19;32;51;16;16;32
89;08.06.2014;2014;06;12;Sunnuntai;58;56;114;37;34;71
89;08.06.2014;2014;06;13;Sunnuntai;53;75;128;20;38;58
89;08.06.2014;2014;06;14;Sunnuntai;72;73;145;29;37;66
89;08.06.2014;2014;06;15;Sunnuntai;69;72;141;28;48;76
89;08.06.2014;2014;06;16;Sunnuntai;79;77;156;24;35;59
89;08.06.2014;2014;06;17;Sunnuntai;88;68;156;26;32;58
89;08.06.2014;2014;06;18;Sunnuntai;57;48;105;25;26;51
89;08.06.2014;2014;06;19;Sunnuntai;34;31;65;20;19;39
89;08.06.2014;2014;06;20;Sunnuntai;36;36;72;19;24;43
89;08.06.2014;2014;06;21;Sunnuntai;41;17;58;11;7;18
89;08.06.2014;2014;06;22;Sunnuntai;12;12;24;1;3;4
89;08.06.2014;2014;06;23;Sunnuntai;8;9;17;3;3;6
89;09.06.2014;2014;06;00;Maanantai;4;5;9;1;3;4
89;09.06.2014;2014;06;01;Maanantai;5;2;7;2;1;3
89;09.06.2014;2014;06;02;Maanantai;0;2;2;0;0;0
89;09.06.2014;2014;06;03;Maanantai;3;3;6;1;0;1
89;09.06.2014;2014;06;04;Maanantai;1;6;7;0;2;2
89;09.06.2014;2014;06;05;Maanantai;6;21;27;0;4;4
89;09.06.2014;2014;06;06;Maanantai;34;76;110;0;5;5
89;09.06.2014;2014;06;07;Maanantai;49;191;240;8;28;36
89;09.06.2014;2014;06;08;Maanantai;36;161;197;7;19;26
89;09.06.2014;2014;06;09;Maanantai;33;91;124;8;27;35
89;09.06.2014;2014;06;10;Maanantai;63;83;146;9;21;30
89;09.06.2014;2014;06;11;Maanantai;76;113;189;24;34;58
89;09.06.2014;2014;06;12;Maanantai;69;126;195;23;25;48
89;09.06.2014;2014;06;13;Maanantai;88;87;175;18;33;51
89;09.06.2014;2014;06;14;Maanantai;132;91;223;28;26;54
89;09.06.2014;2014;06;15;Maanantai;185;117;302;19;35;54
89;09.06.2014;2014;06;16;Maanantai;235;116;351;27;14;41
89;09.06.2014;2014;06;17;Maanantai;143;90;233;26;29;55
89;09.06.2014;2014;06;18;Maanantai;128;71;199;38;36;74
89;09.06.2014;2014;06;19;Maanantai;99;71;170;33;28;61
89;09.06.2014;2014;06;20;Maanantai;95;46;141;22;21;43
89;09.06.2014;2014;06;21;Maanantai;54;47;101;18;20;38
89;09.06.2014;2014;06;22;Maanantai;33;24;57;13;10;23
89;09.06.2014;2014;06;23;Maanantai;19;21;40;9;13;22
89;10.06.2014;2014;06;00;Tiistai;6;6;12;4;3;7
89;10.06.2014;2014;06;01;Tiistai;6;5;11;4;0;4
89;10.06.2014;2014;06;02;Tiistai;2;5;7;3;3;6
89;10.06.2014;2014;06;03;Tiistai;0;4;4;2;0;2
89;10.06.2014;2014;06;04;Tiistai;3;7;10;0;2;2
89;10.06.2014;2014;06;05;Tiistai;5;24;29;2;3;5
89;10.06.2014;2014;06;06;Tiistai;28;111;139;1;14;15
89;10.06.2014;2014;06;07;Tiistai;57;226;283;6;19;25
89;10.06.2014;2014;06;08;Tiistai;65;211;276;11;15;26
89;10.06.2014;2014;06;09;Tiistai;45;99;144;13;25;38
89;10.06.2014;2014;06;10;Tiistai;44;91;135;15;35;50
89;10.06.2014;2014;06;11;Tiistai;71;106;177;15;20;35
89;10.06.2014;2014;06;12;Tiistai;79;113;192;15;32;47
89;10.06.2014;2014;06;13;Tiistai;99;89;188;36;24;60
89;10.06.2014;2014;06;14;Tiistai;143;132;275;18;25;43
89;10.06.2014;2014;06;15;Tiistai;267;123;390;25;22;47
89;10.06.2014;2014;06;16;Tiistai;302;137;439;27;33;60
89;10.06.2014;2014;06;17;Tiistai;136;122;258;22;21;43
89;10.06.2014;2014;06;18;Tiistai;131;102;233;40;36;76
89;10.06.2014;2014;06;19;Tiistai;144;52;196;34;38;72
89;10.06.2014;2014;06;20;Tiistai;127;59;186;30;33;63
89;10.06.2014;2014;06;21;Tiistai;52;45;97;14;17;31
89;10.06.2014;2014;06;22;Tiistai;29;19;48;9;10;19
89;10.06.2014;2014;06;23;Tiistai;13;11;24;6;7;13
89;11.06.2014;2014;06;00;Keskiviikko;8;14;22;3;2;5
89;11.06.2014;2014;06;01;Keskiviikko;5;3;8;1;0;1
89;11.06.2014;2014;06;02;Keskiviikko;6;3;9;0;3;3
89;11.06.2014;2014;06;03;Keskiviikko;6;5;11;1;0;1
89;11.06.2014;2014;06;04;Keskiviikko;5;8;13;5;1;6
89;11.06.2014;2014;06;05;Keskiviikko;8;23;31;1;3;4
89;11.06.2014;2014;06;06;Keskiviikko;30;106;136;4;10;14
89;11.06.2014;2014;06;07;Keskiviikko;69;257;326;6;22;28
89;11.06.2014;2014;06;08;Keskiviikko;60;205;265;5;23;28
89;11.06.2014;2014;06;09;Keskiviikko;58;152;210;8;30;38
89;11.06.2014;2014;06;10;Keskiviikko;71;135;206;26;56;82
89;11.06.2014;2014;06;11;Keskiviikko;89;144;233;34;61;95
89;11.06.2014;2014;06;12;Keskiviikko;120;177;297;41;51;92
89;11.06.2014;2014;06;13;Keskiviikko;151;182;333;45;49;94
89;11.06.2014;2014;06;14;Keskiviikko;185;123;308;77;33;110
89;11.06.2014;2014;06;15;Keskiviikko;267;146;413;50;30;80
89;11.06.2014;2014;06;16;Keskiviikko;328;177;505;60;39;99
89;11.06.2014;2014;06;17;Keskiviikko;240;184;424;49;53;102
89;11.06.2014;2014;06;18;Keskiviikko;155;156;311;37;52;89
89;11.06.2014;2014;06;19;Keskiviikko;198;127;325;48;51;99
89;11.06.2014;2014;06;20;Keskiviikko;122;109;231;39;39;78
89;11.06.2014;2014;06;21;Keskiviikko;89;70;159;21;23;44
89;11.06.2014;2014;06;22;Keskiviikko;58;53;111;37;28;65
89;11.06.2014;2014;06;23;Keskiviikko;33;21;54;12;6;18
89;12.06.2014;2014;06;00;Torstai;19;25;44;3;6;9
89;12.06.2014;2014;06;01;Torstai;10;4;14;2;2;4
89;12.06.2014;2014;06;02;Torstai;3;1;4;2;6;8
89;12.06.2014;2014;06;03;Torstai;12;6;18;1;3;4
89;12.06.2014;2014;06;04;Torstai;13;4;17;1;2;3
89;12.06.2014;2014;06;05;Torstai;10;21;31;1;2;3
89;12.06.2014;2014;06;06;Torstai;36;99;135;2;6;8
89;12.06.2014;2014;06;07;Torstai;64;203;267;3;25;28
89;12.06.2014;2014;06;08;Torstai;42;161;203;4;12;16
89;12.06.2014;2014;06;09;Torstai;38;102;140;13;48;61
89;12.06.2014;2014;06;10;Torstai;40;106;146;12;30;42
89;12.06.2014;2014;06;11;Torstai;65;75;140;34;23;57
89;12.06.2014;2014;06;12;Torstai;50;98;148;11;22;33
89;12.06.2014;2014;06;13;Torstai;75;82;157;13;28;41
89;12.06.2014;2014;06;14;Torstai;122;93;215;21;16;37
89;12.06.2014;2014;06;15;Torstai;186;111;297;16;15;31
89;12.06.2014;2014;06;16;Torstai;229;115;344;20;12;32
89;12.06.2014;2014;06;17;Torstai;112;80;192;25;23;48
89;12.06.2014;2014;06;18;Torstai;111;86;197;28;23;51
89;12.06.2014;2014;06;19;Torstai;72;43;115;17;16;33
89;12.06.2014;2014;06;20;Torstai;57;18;75;18;11;29
89;12.06.2014;2014;06;21;Torstai;58;32;90;11;19;30
89;12.06.2014;2014;06;22;Torstai;23;15;38;4;4;8
89;12.06.2014;2014;06;23;Torstai;12;16;28;6;11;17
89;13.06.2014;2014;06;00;Perjantai;14;13;27;1;3;4
89;13.06.2014;2014;06;01;Perjantai;14;4;18;1;2;3
89;13.06.2014;2014;06;02;Perjantai;3;2;5;3;0;3
89;13.06.2014;2014;06;03;Perjantai;6;5;11;0;0;0
89;13.06.2014;2014;06;04;Perjantai;4;3;7;1;2;3
89;13.06.2014;2014;06;05;Perjantai;8;14;22;2;2;4
89;13.06.2014;2014;06;06;Perjantai;32;84;116;3;8;11
89;13.06.2014;2014;06;07;Perjantai;46;168;214;8;14;22
89;13.06.2014;2014;06;08;Perjantai;46;170;216;9;20;29
89;13.06.2014;2014;06;09;Perjantai;37;111;148;3;22;25
89;13.06.2014;2014;06;10;Perjantai;55;93;148;14;18;32
89;13.06.2014;2014;06;11;Perjantai;62;100;162;19;29;48
89;13.06.2014;2014;06;12;Perjantai;89;90;179;24;39;63
89;13.06.2014;2014;06;13;Perjantai;98;93;191;16;25;41
89;13.06.2014;2014;06;14;Perjantai;136;123;259;15;22;37
89;13.06.2014;2014;06;15;Perjantai;160;103;263;16;17;33
89;13.06.2014;2014;06;16;Perjantai;171;101;272;19;22;41
89;13.06.2014;2014;06;17;Perjantai;125;67;192;16;14;30
89;13.06.2014;2014;06;18;Perjantai;86;54;140;18;12;30
89;13.06.2014;2014;06;19;Perjantai;64;39;103;16;7;23
89;13.06.2014;2014;06;20;Perjantai;47;46;93;7;13;20
89;13.06.2014;2014;06;21;Perjantai;50;46;96;14;15;29
89;13.06.2014;2014;06;22;Perjantai;25;46;71;7;11;18
89;13.06.2014;2014;06;23;Perjantai;38;28;66;10;14;24
89;14.06.2014;2014;06;00;Lauantai;33;27;60;12;10;22
89;14.06.2014;2014;06;01;Lauantai;31;7;38;2;2;4
89;14.06.2014;2014;06;02;Lauantai;32;10;42;6;2;8
89;14.06.2014;2014;06;03;Lauantai;44;7;51;6;1;7
89;14.06.2014;2014;06;04;Lauantai;21;14;35;2;2;4
89;14.06.2014;2014;06;05;Lauantai;1;6;7;2;0;2
89;14.06.2014;2014;06;06;Lauantai;9;20;29;0;1;1
89;14.06.2014;2014;06;07;Lauantai;9;18;27;6;16;22
89;14.06.2014;2014;06;08;Lauantai;18;40;58;13;8;21
89;14.06.2014;2014;06;09;Lauantai;30;73;103;6;30;36
89;14.06.2014;2014;06;10;Lauantai;32;92;124;26;36;62
89;14.06.2014;2014;06;11;Lauantai;62;110;172;19;38;57
89;14.06.2014;2014;06;12;Lauantai;74;126;200;24;41;65
89;14.06.2014;2014;06;13;Lauantai;87;135;222;45;35;80
89;14.06.2014;2014;06;14;Lauantai;107;101;208;52;45;97
89;14.06.2014;2014;06;15;Lauantai;148;86;234;80;28;108
89;14.06.2014;2014;06;16;Lauantai;128;99;227;48;20;68
89;14.06.2014;2014;06;17;Lauantai;113;79;192;35;33;68
89;14.06.2014;2014;06;18;Lauantai;98;99;197;44;34;78
89;14.06.2014;2014;06;19;Lauantai;89;75;164;25;36;61
89;14.06.2014;2014;06;20;Lauantai;62;68;130;21;33;54
89;14.06.2014;2014;06;21;Lauantai;51;59;110;15;23;38
89;14.06.2014;2014;06;22;Lauantai;40;74;114;6;13;19
89;14.06.2014;2014;06;23;Lauantai;32;47;79;5;7;12
89;15.06.2014;2014;06;00;Sunnuntai;30;33;63;4;12;16
89;15.06.2014;2014;06;01;Sunnuntai;23;20;43;10;3;13
89;15.06.2014;2014;06;02;Sunnuntai;43;6;49;3;0;3
89;15.06.2014;2014;06;03;Sunnuntai;37;2;39;12;2;14
89;15.06.2014;2014;06;04;Sunnuntai;21;4;25;4;0;4
89;15.06.2014;2014;06;05;Sunnuntai;8;5;13;2;2;4
89;15.06.2014;2014;06;06;Sunnuntai;9;22;31;0;2;2
89;15.06.2014;2014;06;07;Sunnuntai;4;10;14;3;4;7
89;15.06.2014;2014;06;08;Sunnuntai;5;7;12;10;11;21
89;15.06.2014;2014;06;09;Sunnuntai;22;34;56;17;20;37
89;15.06.2014;2014;06;10;Sunnuntai;33;62;95;15;32;47
89;15.06.2014;2014;06;11;Sunnuntai;68;97;165;27;40;67
89;15.06.2014;2014;06;12;Sunnuntai;58;100;158;25;40;65
89;15.06.2014;2014;06;13;Sunnuntai;76;107;183;54;66;120
89;15.06.2014;2014;06;14;Sunnuntai;88;117;205;43;73;116
89;15.06.2014;2014;06;15;Sunnuntai;123;110;233;22;45;67
89;15.06.2014;2014;06;16;Sunnuntai;106;101;207;42;24;66
89;15.06.2014;2014;06;17;Sunnuntai;113;92;205;40;24;64
89;15.06.2014;2014;06;18;Sunnuntai;89;92;181;36;35;71
89;15.06.2014;2014;06;19;Sunnuntai;100;61;161;36;22;58
89;15.06.2014;2014;06;20;Sunnuntai;56;45;101;30;20;50
89;15.06.2014;2014;06;21;Sunnuntai;42;23;65;21;14;35
89;15.06.2014;2014;06;22;Sunnuntai;29;16;45;6;4;10
89;15.06.2014;2014;06;23;Sunnuntai;14;5;19;5;2;7
89;16.06.2014;2014;06;00;Maanantai;4;7;11;2;3;5
89;16.06.2014;2014;06;01;Maanantai;3;3;6;1;2;3
89;16.06.2014;2014;06;02;Maanantai;0;3;3;1;0;1
89;16.06.2014;2014;06;03;Maanantai;5;4;9;0;0;0
89;16.06.2014;2014;06;04;Maanantai;4;0;4;1;1;2
89;16.06.2014;2014;06;05;Maanantai;8;18;26;0;5;5
89;16.06.2014;2014;06;06;Maanantai;25;63;88;0;4;4
89;16.06.2014;2014;06;07;Maanantai;26;133;159;0;17;17
89;16.06.2014;2014;06;08;Maanantai;31;123;154;1;22;23
89;16.06.2014;2014;06;09;Maanantai;22;73;95;8;13;21
89;16.06.2014;2014;06;10;Maanantai;41;98;139;11;14;25
89;16.06.2014;2014;06;11;Maanantai;73;93;166;13;25;38
89;16.06.2014;2014;06;12;Maanantai;60;100;160;20;22;42
89;16.06.2014;2014;06;13;Maanantai;91;95;186;22;18;40
89;16.06.2014;2014;06;14;Maanantai;143;125;268;37;23;60
89;16.06.2014;2014;06;15;Maanantai;169;85;254;51;14;65
89;16.06.2014;2014;06;16;Maanantai;197;99;296;47;21;68
89;16.06.2014;2014;06;17;Maanantai;115;105;220;19;20;39
89;16.06.2014;2014;06;18;Maanantai;108;85;193;36;38;74
89;16.06.2014;2014;06;19;Maanantai;98;47;145;20;24;44
89;16.06.2014;2014;06;20;Maanantai;85;30;115;19;13;32
89;16.06.2014;2014;06;21;Maanantai;52;20;72;15;17;32
89;16.06.2014;2014;06;22;Maanantai;27;10;37;13;1;14
89;16.06.2014;2014;06;23;Maanantai;9;7;16;2;2;4
89;17.06.2014;2014;06;00;Tiistai;8;10;18;4;2;6
89;17.06.2014;2014;06;01;Tiistai;6;4;10;1;1;2
89;17.06.2014;2014;06;02;Tiistai;2;3;5;0;0;0
89;17.06.2014;2014;06;03;Tiistai;1;6;7;0;0;0
89;17.06.2014;2014;06;04;Tiistai;0;3;3;2;0;2
89;17.06.2014;2014;06;05;Tiistai;6;15;21;3;2;5
89;17.06.2014;2014;06;06;Tiistai;38;81;119;1;7;8
89;17.06.2014;2014;06;07;Tiistai;54;204;258;2;16;18
89;17.06.2014;2014;06;08;Tiistai;36;141;177;5;18;23
89;17.06.2014;2014;06;09;Tiistai;10;62;72;4;3;7
89;17.06.2014;2014;06;10;Tiistai;29;62;91;6;13;19
89;17.06.2014;2014;06;11;Tiistai;40;76;116;16;31;47
89;17.06.2014;2014;06;12;Tiistai;76;81;157;23;33;56
89;17.06.2014;2014;06;13;Tiistai;72;87;159;26;18;44
89;17.06.2014;2014;06;14;Tiistai;130;99;229;30;27;57
89;17.06.2014;2014;06;15;Tiistai;192;147;339;43;21;64
89;17.06.2014;2014;06;16;Tiistai;209;101;310;30;29;59
89;17.06.2014;2014;06;17;Tiistai;132;66;198;37;32;69
89;17.06.2014;2014;06;18;Tiistai;90;68;158;28;30;58
89;17.06.2014;2014;06;19;Tiistai;78;40;118;38;29;67
89;17.06.2014;2014;06;20;Tiistai;89;36;125;15;18;33
89;17.06.2014;2014;06;21;Tiistai;44;41;85;11;14;25
89;17.06.2014;2014;06;22;Tiistai;30;17;47;4;10;14
89;17.06.2014;2014;06;23;Tiistai;10;11;21;2;0;2
89;18.06.2014;2014;06;00;Keskiviikko;12;8;20;2;3;5
89;18.06.2014;2014;06;01;Keskiviikko;6;6;12;1;1;2
89;18.06.2014;2014;06;02;Keskiviikko;3;1;4;0;0;0
89;18.06.2014;2014;06;03;Keskiviikko;4;2;6;0;0;0
89;18.06.2014;2014;06;04;Keskiviikko;2;5;7;0;0;0
89;18.06.2014;2014;06;05;Keskiviikko;10;23;33;0;3;3
89;18.06.2014;2014;06;06;Keskiviikko;40;84;124;4;6;10
89;18.06.2014;2014;06;07;Keskiviikko;47;199;246;3;26;29
89;18.06.2014;2014;06;08;Keskiviikko;46;151;197;3;19;22
89;18.06.2014;2014;06;09;Keskiviikko;36;81;117;14;21;35
89;18.06.2014;2014;06;10;Keskiviikko;50;91;141;10;18;28
89;18.06.2014;2014;06;11;Keskiviikko;57;81;138;23;21;44
89;18.06.2014;2014;06;12;Keskiviikko;76;99;175;25;34;59
89;18.06.2014;2014;06;13;Keskiviikko;103;112;215;19;25;44
89;18.06.2014;2014;06;14;Keskiviikko;126;102;228;27;28;55
89;18.06.2014;2014;06;15;Keskiviikko;189;125;314;41;18;59
89;18.06.2014;2014;06;16;Keskiviikko;232;113;345;35;27;62
89;18.06.2014;2014;06;17;Keskiviikko;118;104;222;26;22;48
89;18.06.2014;2014;06;18;Keskiviikko;119;80;199;22;25;47
89;18.06.2014;2014;06;19;Keskiviikko;112;41;153;22;13;35
89;18.06.2014;2014;06;20;Keskiviikko;74;44;118;12;16;28
89;18.06.2014;2014;06;21;Keskiviikko;44;39;83;15;10;25
89;18.06.2014;2014;06;22;Keskiviikko;29;26;55;2;5;7
89;18.06.2014;2014;06;23;Keskiviikko;28;7;35;5;4;9
89;19.06.2014;2014;06;00;Torstai;17;10;27;3;0;3
89;19.06.2014;2014;06;01;Torstai;3;9;12;0;2;2
89;19.06.2014;2014;06;02;Torstai;13;1;14;1;1;2
89;19.06.2014;2014;06;03;Torstai;4;3;7;1;1;2
89;19.06.2014;2014;06;04;Torstai;7;3;10;1;0;1
89;19.06.2014;2014;06;05;Torstai;9;17;26;1;3;4
89;19.06.2014;2014;06;06;Torstai;29;91;120;2;6;8
89;19.06.2014;2014;06;07;Torstai;45;188;233;7;22;29
89;19.06.2014;2014;06;08;Torstai;46;146;192;7;24;31
89;19.06.2014;2014;06;09;Torstai;25;96;121;12;31;43
89;19.06.2014;2014;06;10;Torstai;45;102;147;13;31;44
89;19.06.2014;2014;06;11;Torstai;76;105;181;19;43;62
89;19.06.2014;2014;06;12;Torstai;95;109;204;36;28;64
89;19.06.2014;2014;06;13;Torstai;122;97;219;16;27;43
89;19.06.2014;2014;06;14;Torstai;160;86;246;22;12;34
89;19.06.2014;2014;06;15;Torstai;159;85;244;27;15;42
89;19.06.2014;2014;06;16;Torstai;125;65;190;18;15;33
89;19.06.2014;2014;06;17;Torstai;76;61;137;12;13;25
89;19.06.2014;2014;06;18;Torstai;63;38;101;15;24;39
89;19.06.2014;2014;06;19;Torstai;59;37;96;18;19;37
89;19.06.2014;2014;06;20;Torstai;58;36;94;5;12;17
89;19.06.2014;2014;06;21;Torstai;47;37;84;8;13;21
89;19.06.2014;2014;06;22;Torstai;19;27;46;7;7;14
89;19.06.2014;2014;06;23;Torstai;16;11;27;5;3;8
89;20.06.2014;2014;06;00;Perjantai;15;20;35;4;0;4
89;20.06.2014;2014;06;01;Perjantai;10;14;24;2;1;3
89;20.06.2014;2014;06;02;Perjantai;7;6;13;1;4;5
89;20.06.2014;2014;06;03;Perjantai;9;4;13;0;0;0
89;20.06.2014;2014;06;04;Perjantai;6;1;7;4;2;6
89;20.06.2014;2014;06;05;Perjantai;4;8;12;3;1;4
89;20.06.2014;2014;06;06;Perjantai;7;17;24;1;1;2
89;20.06.2014;2014;06;07;Perjantai;14;27;41;3;10;13
89;20.06.2014;2014;06;08;Perjantai;27;53;80;3;14;17
89;20.06.2014;2014;06;09;Perjantai;21;65;86;4;20;24
89;20.06.2014;2014;06;10;Perjantai;54;82;136;14;19;33
89;20.06.2014;2014;06;11;Perjantai;73;74;147;23;29;52
89;20.06.2014;2014;06;12;Perjantai;71;58;129;21;27;48
89;20.06.2014;2014;06;13;Perjantai;68;81;149;38;27;65
89;20.06.2014;2014;06;14;Perjantai;74;63;137;62;13;75
89;20.06.2014;2014;06;15;Perjantai;59;47;106;72;16;88
89;20.06.2014;2014;06;16;Perjantai;59;42;101;26;14;40
89;20.06.2014;2014;06;17;Perjantai;49;43;92;25;22;47
89;20.06.2014;2014;06;18;Perjantai;40;75;115;20;33;53
89;20.06.2014;2014;06;19;Perjantai;27;33;60;9;13;22
89;20.06.2014;2014;06;20;Perjantai;25;16;41;8;4;12
89;20.06.2014;2014;06;21;Perjantai;49;36;85;18;10;28
89;20.06.2014;2014;06;22;Perjantai;11;17;28;2;10;12
89;20.06.2014;2014;06;23;Perjantai;19;18;37;2;6;8
89;21.06.2014;2014;06;00;Lauantai;3;25;28;1;0;1
89;21.06.2014;2014;06;01;Lauantai;15;10;25;2;3;5
89;21.06.2014;2014;06;02;Lauantai;17;2;19;1;1;2
89;21.06.2014;2014;06;03;Lauantai;22;6;28;4;0;4
89;21.06.2014;2014;06;04;Lauantai;19;2;21;6;0;6
89;21.06.2014;2014;06;05;Lauantai;2;2;4;1;0;1
89;21.06.2014;2014;06;06;Lauantai;3;11;14;2;3;5
89;21.06.2014;2014;06;07;Lauantai;5;7;12;2;1;3
89;21.06.2014;2014;06;08;Lauantai;3;8;11;4;2;6
89;21.06.2014;2014;06;09;Lauantai;12;8;20;6;7;13
89;21.06.2014;2014;06;10;Lauantai;4;16;20;12;16;28
89;21.06.2014;2014;06;11;Lauantai;18;25;43;11;7;18
89;21.06.2014;2014;06;12;Lauantai;27;29;56;17;22;39
89;21.06.2014;2014;06;13;Lauantai;26;31;57;23;19;42
89;21.06.2014;2014;06;14;Lauantai;33;31;64;24;21;45
89;21.06.2014;2014;06;15;Lauantai;44;53;97;31;22;53
89;21.06.2014;2014;06;16;Lauantai;44;64;108;16;27;43
89;21.06.2014;2014;06;17;Lauantai;66;60;126;28;20;48
89;21.06.2014;2014;06;18;Lauantai;62;50;112;16;29;45
89;21.06.2014;2014;06;19;Lauantai;41;49;90;25;33;58
89;21.06.2014;2014;06;20;Lauantai;42;37;79;23;21;44
89;21.06.2014;2014;06;21;Lauantai;24;29;53;10;20;30
89;21.06.2014;2014;06;22;Lauantai;12;31;43;4;5;9
89;21.06.2014;2014;06;23;Lauantai;17;13;30;2;6;8
89;22.06.2014;2014;06;00;Sunnuntai;12;26;38;3;11;14
89;22.06.2014;2014;06;01;Sunnuntai;14;12;26;3;3;6
89;22.06.2014;2014;06;02;Sunnuntai;7;3;10;7;1;8
89;22.06.2014;2014;06;03;Sunnuntai;16;3;19;4;0;4
89;22.06.2014;2014;06;04;Sunnuntai;9;3;12;3;3;6
89;22.06.2014;2014;06;05;Sunnuntai;4;3;7;2;0;2
89;22.06.2014;2014;06;06;Sunnuntai;4;10;14;2;2;4
89;22.06.2014;2014;06;07;Sunnuntai;6;6;12;3;2;5
89;22.06.2014;2014;06;08;Sunnuntai;5;20;25;4;11;15
89;22.06.2014;2014;06;09;Sunnuntai;10;50;60;15;23;38
89;22.06.2014;2014;06;10;Sunnuntai;36;42;78;26;32;58
89;22.06.2014;2014;06;11;Sunnuntai;57;85;142;27;50;77
89;22.06.2014;2014;06;12;Sunnuntai;69;91;160;26;64;90
89;22.06.2014;2014;06;13;Sunnuntai;65;72;137;15;26;41
89;22.06.2014;2014;06;14;Sunnuntai;43;39;82;16;17;33
89;22.06.2014;2014;06;15;Sunnuntai;49;29;78;19;22;41
89;22.06.2014;2014;06;16;Sunnuntai;45;34;79;22;23;45
89;22.06.2014;2014;06;17;Sunnuntai;31;16;47;19;5;24
89;22.06.2014;2014;06;18;Sunnuntai;26;22;48;8;17;25
89;22.06.2014;2014;06;19;Sunnuntai;25;22;47;5;28;33
89;22.06.2014;2014;06;20;Sunnuntai;41;22;63;16;14;30
89;22.06.2014;2014;06;21;Sunnuntai;30;19;49;12;11;23
89;22.06.2014;2014;06;22;Sunnuntai;18;10;28;4;11;15
89;22.06.2014;2014;06;23;Sunnuntai;12;2;14;3;3;6
89;23.06.2014;2014;06;00;Maanantai;3;7;10;3;1;4
89;23.06.2014;2014;06;01;Maanantai;1;3;4;4;0;4
89;23.06.2014;2014;06;02;Maanantai;1;0;1;1;1;2
89;23.06.2014;2014;06;03;Maanantai;1;3;4;1;0;1
89;23.06.2014;2014;06;04;Maanantai;2;7;9;1;0;1
89;23.06.2014;2014;06;05;Maanantai;7;17;24;1;3;4
89;23.06.2014;2014;06;06;Maanantai;30;83;113;4;7;11
89;23.06.2014;2014;06;07;Maanantai;40;186;226;5;16;21
89;23.06.2014;2014;06;08;Maanantai;43;152;195;3;22;25
89;23.06.2014;2014;06;09;Maanantai;32;123;155;11;22;33
89;23.06.2014;2014;06;10;Maanantai;60;117;177;17;30;47
89;23.06.2014;2014;06;11;Maanantai;71;131;202;24;35;59
89;23.06.2014;2014;06;12;Maanantai;91;118;209;18;44;62
89;23.06.2014;2014;06;13;Maanantai;96;113;209;22;21;43
89;23.06.2014;2014;06;14;Maanantai;109;102;211;32;33;65
89;23.06.2014;2014;06;15;Maanantai;178;88;266;19;22;41
89;23.06.2014;2014;06;16;Maanantai;226;95;321;27;14;41
89;23.06.2014;2014;06;17;Maanantai;120;70;190;19;17;36
89;23.06.2014;2014;06;18;Maanantai;112;64;176;26;35;61
89;23.06.2014;2014;06;19;Maanantai;95;35;130;20;23;43
89;23.06.2014;2014;06;20;Maanantai;65;34;99;15;32;47
89;23.06.2014;2014;06;21;Maanantai;39;26;65;23;11;34
89;23.06.2014;2014;06;22;Maanantai;30;11;41;7;9;16
89;23.06.2014;2014;06;23;Maanantai;15;14;29;3;1;4
89;24.06.2014;2014;06;00;Tiistai;18;12;30;3;3;6
89;24.06.2014;2014;06;01;Tiistai;5;3;8;2;0;2
89;24.06.2014;2014;06;02;Tiistai;2;1;3;1;0;1
89;24.06.2014;2014;06;03;Tiistai;5;1;6;3;1;4
89;24.06.2014;2014;06;04;Tiistai;2;7;9;2;3;5
89;24.06.2014;2014;06;05;Tiistai;5;22;27;2;2;4
89;24.06.2014;2014;06;06;Tiistai;28;65;93;6;4;10
89;24.06.2014;2014;06;07;Tiistai;45;150;195;1;14;15
89;24.06.2014;2014;06;08;Tiistai;42;142;184;3;21;24
89;24.06.2014;2014;06;09;Tiistai;39;99;138;12;31;43
89;24.06.2014;2014;06;10;Tiistai;46;75;121;12;32;44
89;24.06.2014;2014;06;11;Tiistai;54;92;146;19;28;47
89;24.06.2014;2014;06;12;Tiistai;71;89;160;24;23;47
89;24.06.2014;2014;06;13;Tiistai;67;88;155;18;23;41
89;24.06.2014;2014;06;14;Tiistai;121;94;215;31;24;55
89;24.06.2014;2014;06;15;Tiistai;169;93;262;19;33;52
89;24.06.2014;2014;06;16;Tiistai;187;107;294;24;19;43
89;24.06.2014;2014;06;17;Tiistai;143;77;220;34;30;64
89;24.06.2014;2014;06;18;Tiistai;109;78;187;21;30;51
89;24.06.2014;2014;06;19;Tiistai;103;31;134;31;24;55
89;24.06.2014;2014;06;20;Tiistai;76;37;113;25;21;46
89;24.06.2014;2014;06;21;Tiistai;58;26;84;14;11;25
89;24.06.2014;2014;06;22;Tiistai;40;43;83;49;42;91
89;24.06.2014;2014;06;23;Tiistai;15;21;36;8;5;13
89;25.06.2014;2014;06;00;Keskiviikko;10;3;13;1;4;5
89;25.06.2014;2014;06;01;Keskiviikko;6;7;13;2;0;2
89;25.06.2014;2014;06;02;Keskiviikko;4;6;10;1;1;2
89;25.06.2014;2014;06;03;Keskiviikko;8;5;13;3;0;3
89;25.06.2014;2014;06;04;Keskiviikko;7;8;15;1;0;1
89;25.06.2014;2014;06;05;Keskiviikko;6;17;23;1;4;5
89;25.06.2014;2014;06;06;Keskiviikko;21;69;90;2;3;5
89;25.06.2014;2014;06;07;Keskiviikko;44;146;190;0;13;13
89;25.06.2014;2014;06;08;Keskiviikko;34;139;173;4;21;25
89;25.06.2014;2014;06;09;Keskiviikko;37;93;130;14;24;38
89;25.06.2014;2014;06;10;Keskiviikko;46;111;157;19;35;54
89;25.06.2014;2014;06;11;Keskiviikko;58;97;155;16;25;41
89;25.06.2014;2014;06;12;Keskiviikko;79;106;185;16;35;51
89;25.06.2014;2014;06;13;Keskiviikko;119;116;235;26;27;53
89;25.06.2014;2014;06;14;Keskiviikko;118;95;213;66;26;92
89;25.06.2014;2014;06;15;Keskiviikko;173;81;254;43;18;61
89;25.06.2014;2014;06;16;Keskiviikko;188;107;295;25;26;51
89;25.06.2014;2014;06;17;Keskiviikko;121;122;243;35;27;62
89;25.06.2014;2014;06;18;Keskiviikko;128;102;230;33;40;73
89;25.06.2014;2014;06;19;Keskiviikko;113;55;168;25;24;49
89;25.06.2014;2014;06;20;Keskiviikko;72;50;122;25;26;51
89;25.06.2014;2014;06;21;Keskiviikko;76;49;125;16;20;36
89;25.06.2014;2014;06;22;Keskiviikko;37;27;64;7;9;16
89;25.06.2014;2014;06;23;Keskiviikko;29;6;35;5;6;11
89;26.06.2014;2014;06;00;Torstai;13;9;22;3;1;4
89;26.06.2014;2014;06;01;Torstai;14;4;18;1;1;2
89;26.06.2014;2014;06;02;Torstai;9;5;14;1;2;3
89;26.06.2014;2014;06;03;Torstai;8;2;10;2;1;3
89;26.06.2014;2014;06;04;Torstai;9;7;16;0;0;0
89;26.06.2014;2014;06;05;Torstai;6;17;23;0;7;7
89;26.06.2014;2014;06;06;Torstai;21;75;96;2;2;4
89;26.06.2014;2014;06;07;Torstai;36;122;158;7;19;26
89;26.06.2014;2014;06;08;Torstai;35;129;164;7;17;24
89;26.06.2014;2014;06;09;Torstai;36;91;127;7;23;30
89;26.06.2014;2014;06;10;Torstai;38;84;122;19;27;46
89;26.06.2014;2014;06;11;Torstai;65;80;145;19;13;32
89;26.06.2014;2014;06;12;Torstai;61;80;141;15;28;43
89;26.06.2014;2014;06;13;Torstai;75;76;151;18;22;40
89;26.06.2014;2014;06;14;Torstai;111;86;197;21;18;39
89;26.06.2014;2014;06;15;Torstai;159;78;237;15;27;42
89;26.06.2014;2014;06;16;Torstai;168;100;268;32;14;46
89;26.06.2014;2014;06;17;Torstai;116;66;182;17;15;32
89;26.06.2014;2014;06;18;Torstai;94;69;163;17;22;39
89;26.06.2014;2014;06;19;Torstai;85;47;132;25;26;51
89;26.06.2014;2014;06;20;Torstai;64;33;97;16;9;25
89;26.06.2014;2014;06;21;Torstai;38;32;70;12;16;28
89;26.06.2014;2014;06;22;Torstai;25;13;38;6;7;13
89;26.06.2014;2014;06;23;Torstai;12;3;15;4;5;9
89;27.06.2014;2014;06;00;Perjantai;13;2;15;0;0;0
89;27.06.2014;2014;06;01;Perjantai;10;5;15;0;1;1
89;27.06.2014;2014;06;02;Perjantai;9;0;9;3;0;3
89;27.06.2014;2014;06;03;Perjantai;9;6;15;1;0;1
89;27.06.2014;2014;06;04;Perjantai;1;6;7;1;1;2
89;27.06.2014;2014;06;05;Perjantai;9;13;22;1;1;2
89;27.06.2014;2014;06;06;Perjantai;19;55;74;2;3;5
89;27.06.2014;2014;06;07;Perjantai;30;105;135;10;20;30
89;27.06.2014;2014;06;08;Perjantai;27;104;131;1;16;17
89;27.06.2014;2014;06;09;Perjantai;33;90;123;8;18;26
89;27.06.2014;2014;06;10;Perjantai;35;87;122;9;39;48
89;27.06.2014;2014;06;11;Perjantai;53;79;132;22;25;47
89;27.06.2014;2014;06;12;Perjantai;84;81;165;16;31;47
89;27.06.2014;2014;06;13;Perjantai;80;84;164;21;30;51
89;27.06.2014;2014;06;14;Perjantai;101;90;191;21;24;45
89;27.06.2014;2014;06;15;Perjantai;142;95;237;20;20;40
89;27.06.2014;2014;06;16;Perjantai;125;85;210;23;19;42
89;27.06.2014;2014;06;17;Perjantai;98;74;172;9;20;29
89;27.06.2014;2014;06;18;Perjantai;94;53;147;19;15;34
89;27.06.2014;2014;06;19;Perjantai;61;48;109;14;8;22
89;27.06.2014;2014;06;20;Perjantai;56;38;94;15;18;33
89;27.06.2014;2014;06;21;Perjantai;51;33;84;10;11;21
89;27.06.2014;2014;06;22;Perjantai;44;39;83;9;8;17
89;27.06.2014;2014;06;23;Perjantai;20;39;59;3;7;10
89;28.06.2014;2014;06;00;Lauantai;32;12;44;6;5;11
89;28.06.2014;2014;06;01;Lauantai;13;13;26;4;3;7
89;28.06.2014;2014;06;02;Lauantai;19;9;28;2;1;3
89;28.06.2014;2014;06;03;Lauantai;24;2;26;6;0;6
89;28.06.2014;2014;06;04;Lauantai;15;6;21;7;3;10
89;28.06.2014;2014;06;05;Lauantai;6;5;11;2;1;3
89;28.06.2014;2014;06;06;Lauantai;10;13;23;2;4;6
89;28.06.2014;2014;06;07;Lauantai;8;21;29;4;6;10
89;28.06.2014;2014;06;08;Lauantai;9;39;48;6;8;14
89;28.06.2014;2014;06;09;Lauantai;26;75;101;11;21;32
89;28.06.2014;2014;06;10;Lauantai;55;100;155;17;42;59
89;28.06.2014;2014;06;11;Lauantai;60;106;166;16;48;64
89;28.06.2014;2014;06;12;Lauantai;81;143;224;43;74;117
89;28.06.2014;2014;06;13;Lauantai;92;144;236;36;47;83
89;28.06.2014;2014;06;14;Lauantai;105;100;205;31;27;58
89;28.06.2014;2014;06;15;Lauantai;141;85;226;28;34;62
89;28.06.2014;2014;06;16;Lauantai;107;103;210;23;33;56
89;28.06.2014;2014;06;17;Lauantai;113;88;201;22;27;49
89;28.06.2014;2014;06;18;Lauantai;93;73;166;24;34;58
89;28.06.2014;2014;06;19;Lauantai;75;60;135;27;31;58
89;28.06.2014;2014;06;20;Lauantai;51;63;114;13;25;38
89;28.06.2014;2014;06;21;Lauantai;53;73;126;13;20;33
89;28.06.2014;2014;06;22;Lauantai;52;87;139;10;25;35
89;28.06.2014;2014;06;23;Lauantai;29;55;84;7;12;19
89;29.06.2014;2014;06;00;Sunnuntai;35;37;72;8;6;14
89;29.06.2014;2014;06;01;Sunnuntai;37;16;53;2;4;6
89;29.06.2014;2014;06;02;Sunnuntai;37;18;55;7;5;12
89;29.06.2014;2014;06;03;Sunnuntai;45;1;46;8;0;8
89;29.06.2014;2014;06;04;Sunnuntai;19;2;21;15;1;16
89;29.06.2014;2014;06;05;Sunnuntai;10;4;14;4;2;6
89;29.06.2014;2014;06;06;Sunnuntai;6;10;16;4;2;6
89;29.06.2014;2014;06;07;Sunnuntai;9;8;17;4;7;11
89;29.06.2014;2014;06;08;Sunnuntai;11;13;24;6;14;20
89;29.06.2014;2014;06;09;Sunnuntai;20;38;58;14;23;37
89;29.06.2014;2014;06;10;Sunnuntai;41;62;103;27;25;52
89;29.06.2014;2014;06;11;Sunnuntai;81;120;201;33;37;70
89;29.06.2014;2014;06;12;Sunnuntai;80;163;243;19;48;67
89;29.06.2014;2014;06;13;Sunnuntai;120;176;296;31;67;98
89;29.06.2014;2014;06;14;Sunnuntai;118;139;257;51;43;94
89;29.06.2014;2014;06;15;Sunnuntai;136;123;259;65;70;135
89;29.06.2014;2014;06;16;Sunnuntai;157;115;272;47;41;88
89;29.06.2014;2014;06;17;Sunnuntai;126;104;230;38;37;75
89;29.06.2014;2014;06;18;Sunnuntai;128;109;237;34;38;72
89;29.06.2014;2014;06;19;Sunnuntai;92;59;151;22;26;48
89;29.06.2014;2014;06;20;Sunnuntai;55;43;98;18;14;32
89;29.06.2014;2014;06;21;Sunnuntai;49;47;96;16;17;33
89;29.06.2014;2014;06;22;Sunnuntai;36;26;62;3;11;14
89;29.06.2014;2014;06;23;Sunnuntai;15;14;29;1;3;4
89;30.06.2014;2014;06;00;Maanantai;17;10;27;2;9;11
89;30.06.2014;2014;06;01;Maanantai;15;7;22;1;2;3
89;30.06.2014;2014;06;02;Maanantai;1;1;2;1;1;2
89;30.06.2014;2014;06;03;Maanantai;4;3;7;2;0;2
89;30.06.2014;2014;06;04;Maanantai;2;5;7;3;0;3
89;30.06.2014;2014;06;05;Maanantai;10;16;26;3;5;8
89;30.06.2014;2014;06;06;Maanantai;21;57;78;1;8;9
89;30.06.2014;2014;06;07;Maanantai;28;125;153;4;16;20
89;30.06.2014;2014;06;08;Maanantai;33;125;158;11;18;29
89;30.06.2014;2014;06;09;Maanantai;40;109;149;9;27;36
89;30.06.2014;2014;06;10;Maanantai;68;122;190;21;26;47
89;30.06.2014;2014;06;11;Maanantai;108;139;247;21;46;67
89;30.06.2014;2014;06;12;Maanantai;88;97;185;23;24;47
89;30.06.2014;2014;06;13;Maanantai;102;87;189;18;29;47
89;30.06.2014;2014;06;14;Maanantai;118;71;189;13;20;33
89;30.06.2014;2014;06;15;Maanantai;154;91;245;22;23;45
89;30.06.2014;2014;06;16;Maanantai;175;78;253;19;17;36
89;30.06.2014;2014;06;17;Maanantai;137;89;226;21;25;46
89;30.06.2014;2014;06;18;Maanantai;103;116;219;31;56;87
89;30.06.2014;2014;06;19;Maanantai;116;62;178;42;29;71
89;30.06.2014;2014;06;20;Maanantai;83;45;128;13;13;26
89;30.06.2014;2014;06;21;Maanantai;61;27;88;10;19;29
89;30.06.2014;2014;06;22;Maanantai;37;15;52;12;13;25
89;30.06.2014;2014;06;23;Maanantai;16;10;26;7;9;16
89;01.07.2014;2014;07;00;Tiistai;8;5;13;3;5;8
89;01.07.2014;2014;07;01;Tiistai;7;7;14;1;2;3
89;01.07.2014;2014;07;02;Tiistai;7;5;12;2;1;3
89;01.07.2014;2014;07;03;Tiistai;3;1;4;1;0;1
89;01.07.2014;2014;07;04;Tiistai;4;5;9;0;2;2
89;01.07.2014;2014;07;05;Tiistai;9;21;30;3;2;5
89;01.07.2014;2014;07;06;Tiistai;23;75;98;5;9;14
89;01.07.2014;2014;07;07;Tiistai;35;132;167;8;16;24
89;01.07.2014;2014;07;08;Tiistai;30;135;165;5;21;26
89;01.07.2014;2014;07;09;Tiistai;38;114;152;14;37;51
89;01.07.2014;2014;07;10;Tiistai;56;122;178;25;57;82
89;01.07.2014;2014;07;11;Tiistai;90;134;224;31;44;75
89;01.07.2014;2014;07;12;Tiistai;129;164;293;28;44;72
89;01.07.2014;2014;07;13;Tiistai;139;126;265;45;45;90
89;01.07.2014;2014;07;14;Tiistai;158;177;335;36;50;86
89;01.07.2014;2014;07;15;Tiistai;233;130;363;52;45;97
89;01.07.2014;2014;07;16;Tiistai;233;157;390;44;55;99
89;01.07.2014;2014;07;17;Tiistai;184;128;312;26;40;66
89;01.07.2014;2014;07;18;Tiistai;150;121;271;45;67;112
89;01.07.2014;2014;07;19;Tiistai;140;106;246;80;46;126
89;01.07.2014;2014;07;20;Tiistai;139;63;202;29;33;62
89;01.07.2014;2014;07;21;Tiistai;79;61;140;16;23;39
89;01.07.2014;2014;07;22;Tiistai;52;43;95;10;25;35
89;01.07.2014;2014;07;23;Tiistai;25;32;57;2;7;9
89;02.07.2014;2014;07;00;Keskiviikko;22;6;28;5;5;10
89;02.07.2014;2014;07;01;Keskiviikko;9;5;14;4;2;6
89;02.07.2014;2014;07;02;Keskiviikko;9;2;11;1;1;2
89;02.07.2014;2014;07;03;Keskiviikko;5;4;9;0;1;1
89;02.07.2014;2014;07;04;Keskiviikko;6;8;14;1;0;1
89;02.07.2014;2014;07;05;Keskiviikko;6;22;28;4;0;4
89;02.07.2014;2014;07;06;Keskiviikko;14;51;65;4;10;14
89;02.07.2014;2014;07;07;Keskiviikko;26;107;133;2;16;18
89;02.07.2014;2014;07;08;Keskiviikko;21;89;110;5;12;17
89;02.07.2014;2014;07;09;Keskiviikko;21;49;70;8;10;18
89;02.07.2014;2014;07;10;Keskiviikko;20;35;55;6;7;13
89;02.07.2014;2014;07;11;Keskiviikko;26;28;54;7;7;14
89;02.07.2014;2014;07;12;Keskiviikko;23;28;51;8;4;12
89;02.07.2014;2014;07;13;Keskiviikko;34;24;58;3;10;13
89;02.07.2014;2014;07;14;Keskiviikko;53;33;86;12;8;20
89;02.07.2014;2014;07;15;Keskiviikko;76;29;105;5;1;6
89;02.07.2014;2014;07;16;Keskiviikko;73;31;104;11;4;15
89;02.07.2014;2014;07;17;Keskiviikko;43;22;65;10;8;18
89;02.07.2014;2014;07;18;Keskiviikko;34;22;56;10;15;25
89;02.07.2014;2014;07;19;Keskiviikko;28;28;56;14;20;34
89;02.07.2014;2014;07;20;Keskiviikko;38;24;62;16;13;29
89;02.07.2014;2014;07;21;Keskiviikko;30;25;55;12;18;30
89;02.07.2014;2014;07;22;Keskiviikko;21;11;32;10;5;15
89;02.07.2014;2014;07;23;Keskiviikko;15;11;26;5;7;12
89;03.07.2014;2014;07;00;Torstai;5;13;18;0;0;0
89;03.07.2014;2014;07;01;Torstai;4;3;7;0;2;2
89;03.07.2014;2014;07;02;Torstai;7;1;8;0;1;1
89;03.07.2014;2014;07;03;Torstai;2;2;4;1;2;3
89;03.07.2014;2014;07;04;Torstai;8;0;8;3;0;3
89;03.07.2014;2014;07;05;Torstai;9;21;30;1;0;1
89;03.07.2014;2014;07;06;Torstai;14;57;71;1;5;6
89;03.07.2014;2014;07;07;Torstai;27;94;121;6;16;22
89;03.07.2014;2014;07;08;Torstai;14;100;114;8;21;29
89;03.07.2014;2014;07;09;Torstai;20;71;91;8;17;25
89;03.07.2014;2014;07;10;Torstai;39;65;104;16;26;42
89;03.07.2014;2014;07;11;Torstai;37;57;94;14;24;38
89;03.07.2014;2014;07;12;Torstai;56;70;126;17;36;53
89;03.07.2014;2014;07;13;Torstai;71;67;138;13;24;37
89;03.07.2014;2014;07;14;Torstai;81;70;151;21;30;51
89;03.07.2014;2014;07;15;Torstai;126;60;186;12;10;22
89;03.07.2014;2014;07;16;Torstai;129;56;185;22;11;33
89;03.07.2014;2014;07;17;Torstai;100;59;159;24;13;37
89;03.07.2014;2014;07;18;Torstai;69;40;109;17;20;37
89;03.07.2014;2014;07;19;Torstai;71;37;108;21;23;44
89;03.07.2014;2014;07;20;Torstai;62;34;96;22;12;34
89;03.07.2014;2014;07;21;Torstai;39;33;72;14;14;28
89;03.07.2014;2014;07;22;Torstai;24;18;42;10;9;19
89;03.07.2014;2014;07;23;Torstai;14;10;24;2;4;6
89;04.07.2014;2014;07;00;Perjantai;12;5;17;1;0;1
89;04.07.2014;2014;07;01;Perjantai;12;7;19;1;7;8
89;04.07.2014;2014;07;02;Perjantai;8;2;10;3;1;4
89;04.07.2014;2014;07;03;Perjantai;6;2;8;0;1;1
89;04.07.2014;2014;07;04;Perjantai;6;4;10;3;0;3
89;04.07.2014;2014;07;05;Perjantai;12;14;26;2;2;4
89;04.07.2014;2014;07;06;Perjantai;16;55;71;1;2;3
89;04.07.2014;2014;07;07;Perjantai;30;114;144;7;15;22
89;04.07.2014;2014;07;08;Perjantai;16;101;117;5;17;22
89;04.07.2014;2014;07;09;Perjantai;31;76;107;10;20;30
89;04.07.2014;2014;07;10;Perjantai;37;85;122;14;33;47
89;04.07.2014;2014;07;11;Perjantai;56;88;144;22;39;61
89;04.07.2014;2014;07;12;Perjantai;74;103;177;24;28;52
89;04.07.2014;2014;07;13;Perjantai;119;122;241;40;39;79
89;04.07.2014;2014;07;14;Perjantai;121;113;234;25;25;50
89;04.07.2014;2014;07;15;Perjantai;129;106;235;24;21;45
89;04.07.2014;2014;07;16;Perjantai;138;57;195;17;10;27
89;04.07.2014;2014;07;17;Perjantai;66;38;104;8;16;24
89;04.07.2014;2014;07;18;Perjantai;74;42;116;15;9;24
89;04.07.2014;2014;07;19;Perjantai;31;29;60;6;15;21
89;04.07.2014;2014;07;20;Perjantai;24;19;43;8;6;14
89;04.07.2014;2014;07;21;Perjantai;29;26;55;8;14;22
89;04.07.2014;2014;07;22;Perjantai;23;34;57;7;5;12
89;04.07.2014;2014;07;23;Perjantai;25;30;55;6;10;16
89;05.07.2014;2014;07;00;Lauantai;12;10;22;1;5;6
89;05.07.2014;2014;07;01;Lauantai;29;13;42;2;12;14
89;05.07.2014;2014;07;02;Lauantai;21;4;25;6;2;8
89;05.07.2014;2014;07;03;Lauantai;23;0;23;3;1;4
89;05.07.2014;2014;07;04;Lauantai;20;3;23;6;2;8
89;05.07.2014;2014;07;05;Lauantai;5;7;12;2;1;3
89;05.07.2014;2014;07;06;Lauantai;15;11;26;2;2;4
89;05.07.2014;2014;07;07;Lauantai;7;19;26;5;4;9
89;05.07.2014;2014;07;08;Lauantai;17;38;55;10;13;23
89;05.07.2014;2014;07;09;Lauantai;24;73;97;11;31;42
89;05.07.2014;2014;07;10;Lauantai;31;103;134;20;45;65
89;05.07.2014;2014;07;11;Lauantai;69;124;193;33;49;82
89;05.07.2014;2014;07;12;Lauantai;101;169;270;28;57;85
89;05.07.2014;2014;07;13;Lauantai;132;158;290;51;47;98
89;05.07.2014;2014;07;14;Lauantai;125;141;266;46;49;95
89;05.07.2014;2014;07;15;Lauantai;184;112;296;47;77;124
89;05.07.2014;2014;07;16;Lauantai;136;123;259;45;51;96
89;05.07.2014;2014;07;17;Lauantai;132;136;268;45;40;85
89;05.07.2014;2014;07;18;Lauantai;126;141;267;31;44;75
89;05.07.2014;2014;07;19;Lauantai;117;100;217;40;46;86
89;05.07.2014;2014;07;20;Lauantai;74;111;185;20;30;50
89;05.07.2014;2014;07;21;Lauantai;79;84;163;25;37;62
89;05.07.2014;2014;07;22;Lauantai;58;83;141;12;24;36
89;05.07.2014;2014;07;23;Lauantai;74;57;131;16;17;33
89;06.07.2014;2014;07;00;Sunnuntai;44;40;84;5;10;15
89;06.07.2014;2014;07;01;Sunnuntai;66;23;89;6;6;12
89;06.07.2014;2014;07;02;Sunnuntai;65;19;84;9;2;11
89;06.07.2014;2014;07;03;Sunnuntai;49;5;54;5;3;8
89;06.07.2014;2014;07;04;Sunnuntai;43;0;43;9;5;14
89;06.07.2014;2014;07;05;Sunnuntai;12;10;22;6;4;10
89;06.07.2014;2014;07;06;Sunnuntai;13;11;24;2;2;4
89;06.07.2014;2014;07;07;Sunnuntai;7;16;23;5;4;9
89;06.07.2014;2014;07;08;Sunnuntai;8;23;31;11;10;21
89;06.07.2014;2014;07;09;Sunnuntai;22;47;69;10;21;31
89;06.07.2014;2014;07;10;Sunnuntai;43;72;115;32;52;84
89;06.07.2014;2014;07;11;Sunnuntai;82;134;216;26;46;72
89;06.07.2014;2014;07;12;Sunnuntai;108;175;283;43;66;109
89;06.07.2014;2014;07;13;Sunnuntai;177;179;356;34;88;122
89;06.07.2014;2014;07;14;Sunnuntai;163;150;313;44;64;108
89;06.07.2014;2014;07;15;Sunnuntai;224;180;404;54;36;90
89;06.07.2014;2014;07;16;Sunnuntai;176;147;323;62;50;112
89;06.07.2014;2014;07;17;Sunnuntai;148;157;305;38;70;108
89;06.07.2014;2014;07;18;Sunnuntai;167;156;323;39;56;95
89;06.07.2014;2014;07;19;Sunnuntai;172;109;281;37;64;101
89;06.07.2014;2014;07;20;Sunnuntai;106;99;205;31;37;68
89;06.07.2014;2014;07;21;Sunnuntai;64;57;121;28;25;53
89;06.07.2014;2014;07;22;Sunnuntai;67;28;95;13;10;23
89;06.07.2014;2014;07;23;Sunnuntai;26;17;43;5;16;21
89;07.07.2014;2014;07;00;Maanantai;9;23;32;6;10;16
89;07.07.2014;2014;07;01;Maanantai;8;4;12;4;6;10
89;07.07.2014;2014;07;02;Maanantai;10;2;12;6;6;12
89;07.07.2014;2014;07;03;Maanantai;8;2;10;0;2;2
89;07.07.2014;2014;07;04;Maanantai;12;6;18;1;2;3
89;07.07.2014;2014;07;05;Maanantai;9;21;30;2;2;4
89;07.07.2014;2014;07;06;Maanantai;17;67;84;5;6;11
89;07.07.2014;2014;07;07;Maanantai;32;117;149;8;12;20
89;07.07.2014;2014;07;08;Maanantai;33;116;149;9;16;25
89;07.07.2014;2014;07;09;Maanantai;39;100;139;10;31;41
89;07.07.2014;2014;07;10;Maanantai;64;99;163;19;25;44
89;07.07.2014;2014;07;11;Maanantai;92;139;231;21;35;56
89;07.07.2014;2014;07;12;Maanantai;112;154;266;27;37;64
89;07.07.2014;2014;07;13;Maanantai;154;144;298;32;41;73
89;07.07.2014;2014;07;14;Maanantai;173;172;345;39;33;72
89;07.07.2014;2014;07;15;Maanantai;217;149;366;47;38;85
89;07.07.2014;2014;07;16;Maanantai;232;164;396;45;23;68
89;07.07.2014;2014;07;17;Maanantai;206;176;382;30;40;70
89;07.07.2014;2014;07;18;Maanantai;167;190;357;36;61;97
89;07.07.2014;2014;07;19;Maanantai;226;160;386;58;45;103
89;07.07.2014;2014;07;20;Maanantai;160;122;282;40;44;84
89;07.07.2014;2014;07;21;Maanantai;123;78;201;21;31;52
89;07.07.2014;2014;07;22;Maanantai;59;47;106;20;31;51
89;07.07.2014;2014;07;23;Maanantai;40;33;73;4;3;7
89;08.07.2014;2014;07;00;Tiistai;15;25;40;6;5;11
89;08.07.2014;2014;07;01;Tiistai;12;9;21;2;4;6
89;08.07.2014;2014;07;02;Tiistai;16;9;25;0;2;2
89;08.07.2014;2014;07;03;Tiistai;7;3;10;0;0;0
89;08.07.2014;2014;07;04;Tiistai;6;3;9;0;1;1
89;08.07.2014;2014;07;05;Tiistai;8;21;29;3;3;6
89;08.07.2014;2014;07;06;Tiistai;20;59;79;2;13;15
89;08.07.2014;2014;07;07;Tiistai;23;129;152;4;13;17
89;08.07.2014;2014;07;08;Tiistai;18;113;131;7;18;25
89;08.07.2014;2014;07;09;Tiistai;34;111;145;15;35;50
89;08.07.2014;2014;07;10;Tiistai;77;111;188;15;22;37
89;08.07.2014;2014;07;11;Tiistai;100;121;221;21;36;57
89;08.07.2014;2014;07;12;Tiistai;140;161;301;19;32;51
89;08.07.2014;2014;07;13;Tiistai;180;157;337;33;32;65
89;08.07.2014;2014;07;14;Tiistai;180;124;304;35;26;61
89;08.07.2014;2014;07;15;Tiistai;241;160;401;54;40;94
89;08.07.2014;2014;07;16;Tiistai;233;134;367;30;43;73
89;08.07.2014;2014;07;17;Tiistai;209;171;380;31;42;73
89;08.07.2014;2014;07;18;Tiistai;166;135;301;18;38;56
89;08.07.2014;2014;07;19;Tiistai;166;143;309;43;46;89
89;08.07.2014;2014;07;20;Tiistai;122;113;235;12;31;43
89;08.07.2014;2014;07;21;Tiistai;94;76;170;20;38;58
89;08.07.2014;2014;07;22;Tiistai;80;63;143;23;35;58
89;08.07.2014;2014;07;23;Tiistai;34;14;48;4;15;19
89;09.07.2014;2014;07;00;Keskiviikko;23;24;47;6;1;7
89;09.07.2014;2014;07;01;Keskiviikko;16;10;26;5;3;8
89;09.07.2014;2014;07;02;Keskiviikko;9;9;18;2;2;4
89;09.07.2014;2014;07;03;Keskiviikko;6;5;11;2;0;2
89;09.07.2014;2014;07;04;Keskiviikko;5;7;12;3;0;3
89;09.07.2014;2014;07;05;Keskiviikko;8;23;31;2;2;4
89;09.07.2014;2014;07;06;Keskiviikko;18;67;85;3;8;11
89;09.07.2014;2014;07;07;Keskiviikko;26;142;168;4;10;14
89;09.07.2014;2014;07;08;Keskiviikko;15;106;121;8;17;25
89;09.07.2014;2014;07;09;Keskiviikko;38;93;131;7;29;36
89;09.07.2014;2014;07;10;Keskiviikko;67;114;181;14;38;52
89;09.07.2014;2014;07;11;Keskiviikko;82;116;198;19;28;47
89;09.07.2014;2014;07;12;Keskiviikko;105;152;257;22;28;50
89;09.07.2014;2014;07;13;Keskiviikko;152;131;283;28;32;60
89;09.07.2014;2014;07;14;Keskiviikko;169;132;301;23;38;61
89;09.07.2014;2014;07;15;Keskiviikko;220;185;405;42;33;75
89;09.07.2014;2014;07;16;Keskiviikko;216;158;374;38;43;81
89;09.07.2014;2014;07;17;Keskiviikko;162;161;323;29;35;64
89;09.07.2014;2014;07;18;Keskiviikko;135;182;317;35;62;97
89;09.07.2014;2014;07;19;Keskiviikko;148;173;321;27;48;75
89;09.07.2014;2014;07;20;Keskiviikko;109;106;215;34;40;74
89;09.07.2014;2014;07;21;Keskiviikko;141;82;223;30;15;45
89;09.07.2014;2014;07;22;Keskiviikko;91;44;135;16;21;37
89;09.07.2014;2014;07;23;Keskiviikko;54;16;70;10;4;14
89;10.07.2014;2014;07;00;Torstai;55;8;63;3;2;5
89;10.07.2014;2014;07;01;Torstai;31;7;38;3;4;7
89;10.07.2014;2014;07;02;Torstai;15;9;24;2;1;3
89;10.07.2014;2014;07;03;Torstai;9;4;13;4;0;4
89;10.07.2014;2014;07;04;Torstai;9;3;12;1;0;1
89;10.07.2014;2014;07;05;Torstai;6;15;21;4;4;8
89;10.07.2014;2014;07;06;Torstai;13;64;77;1;11;12
89;10.07.2014;2014;07;07;Torstai;22;124;146;6;11;17
89;10.07.2014;2014;07;08;Torstai;20;100;120;7;18;25
89;10.07.2014;2014;07;09;Torstai;28;79;107;13;15;28
89;10.07.2014;2014;07;10;Torstai;43;93;136;21;42;63
89;10.07.2014;2014;07;11;Torstai;64;88;152;22;39;61
89;10.07.2014;2014;07;12;Torstai;79;123;202;23;37;60
89;10.07.2014;2014;07;13;Torstai;113;120;233;26;40;66
89;10.07.2014;2014;07;14;Torstai;134;112;246;35;36;71
89;10.07.2014;2014;07;15;Torstai;200;121;321;49;19;68
89;10.07.2014;2014;07;16;Torstai;188;159;347;39;46;85
89;10.07.2014;2014;07;17;Torstai;147;144;291;28;40;68
89;10.07.2014;2014;07;18;Torstai;140;175;315;48;49;97
89;10.07.2014;2014;07;19;Torstai;107;129;236;32;39;71
89;10.07.2014;2014;07;20;Torstai;127;84;211;23;43;66
89;10.07.2014;2014;07;21;Torstai;135;70;205;28;23;51
89;10.07.2014;2014;07;22;Torstai;61;49;110;9;17;26
89;10.07.2014;2014;07;23;Torstai;48;28;76;7;9;16
89;11.07.2014;2014;07;00;Perjantai;52;11;63;10;7;17
89;11.07.2014;2014;07;01;Perjantai;21;4;25;4;2;6
89;11.07.2014;2014;07;02;Perjantai;11;1;12;5;1;6
89;11.07.2014;2014;07;03;Perjantai;9;3;12;9;1;10
89;11.07.2014;2014;07;04;Perjantai;7;6;13;0;1;1
89;11.07.2014;2014;07;05;Perjantai;6;14;20;6;2;8
89;11.07.2014;2014;07;06;Perjantai;16;56;72;5;7;12
89;11.07.2014;2014;07;07;Perjantai;20;90;110;3;7;10
89;11.07.2014;2014;07;08;Perjantai;22;98;120;5;15;20
89;11.07.2014;2014;07;09;Perjantai;44;79;123;12;24;36
89;11.07.2014;2014;07;10;Perjantai;52;95;147;17;25;42
89;11.07.2014;2014;07;11;Perjantai;89;98;187;22;42;64
89;11.07.2014;2014;07;12;Perjantai;86;132;218;33;43;76
89;11.07.2014;2014;07;13;Perjantai;153;149;302;35;34;69
89;11.07.2014;2014;07;14;Perjantai;154;135;289;30;32;62
89;11.07.2014;2014;07;15;Perjantai;180;138;318;35;32;67
89;11.07.2014;2014;07;16;Perjantai;166;131;297;31;31;62
89;11.07.2014;2014;07;17;Perjantai;170;126;296;39;31;70
89;11.07.2014;2014;07;18;Perjantai;114;123;237;26;40;66
89;11.07.2014;2014;07;19;Perjantai;90;163;253;22;45;67
89;11.07.2014;2014;07;20;Perjantai;99;138;237;21;33;54
89;11.07.2014;2014;07;21;Perjantai;84;133;217;24;38;62
89;11.07.2014;2014;07;22;Perjantai;70;102;172;22;44;66
89;11.07.2014;2014;07;23;Perjantai;74;63;137;30;34;64
89;12.07.2014;2014;07;00;Lauantai;66;36;102;9;12;21
89;12.07.2014;2014;07;01;Lauantai;49;22;71;5;6;11
89;12.07.2014;2014;07;02;Lauantai;43;12;55;4;3;7
89;12.07.2014;2014;07;03;Lauantai;38;0;38;7;2;9
89;12.07.2014;2014;07;04;Lauantai;29;1;30;11;3;14
89;12.07.2014;2014;07;05;Lauantai;14;13;27;4;1;5
89;12.07.2014;2014;07;06;Lauantai;5;11;16;1;5;6
89;12.07.2014;2014;07;07;Lauantai;8;18;26;7;8;15
89;12.07.2014;2014;07;08;Lauantai;16;30;46;7;12;19
89;12.07.2014;2014;07;09;Lauantai;24;64;88;13;18;31
89;12.07.2014;2014;07;10;Lauantai;38;102;140;19;38;57
89;12.07.2014;2014;07;11;Lauantai;107;110;217;19;30;49
89;12.07.2014;2014;07;12;Lauantai;98;120;218;29;44;73
89;12.07.2014;2014;07;13;Lauantai;119;153;272;34;42;76
89;12.07.2014;2014;07;14;Lauantai;161;143;304;38;57;95
89;12.07.2014;2014;07;15;Lauantai;152;132;284;37;38;75
89;12.07.2014;2014;07;16;Lauantai;145;142;287;37;37;74
89;12.07.2014;2014;07;17;Lauantai;124;123;247;29;54;83
89;12.07.2014;2014;07;18;Lauantai;115;117;232;23;61;84
89;12.07.2014;2014;07;19;Lauantai;112;146;258;23;48;71
89;12.07.2014;2014;07;20;Lauantai;82;119;201;18;43;61
89;12.07.2014;2014;07;21;Lauantai;74;116;190;14;26;40
89;12.07.2014;2014;07;22;Lauantai;60;103;163;14;36;50
89;12.07.2014;2014;07;23;Lauantai;44;69;113;7;15;22
89;13.07.2014;2014;07;00;Sunnuntai;47;34;81;6;2;8
89;13.07.2014;2014;07;01;Sunnuntai;46;35;81;5;4;9
89;13.07.2014;2014;07;02;Sunnuntai;41;11;52;7;2;9
89;13.07.2014;2014;07;03;Sunnuntai;53;3;56;11;4;15
89;13.07.2014;2014;07;04;Sunnuntai;36;3;39;4;1;5
89;13.07.2014;2014;07;05;Sunnuntai;8;9;17;3;3;6
89;13.07.2014;2014;07;06;Sunnuntai;5;16;21;2;3;5
89;13.07.2014;2014;07;07;Sunnuntai;5;12;17;3;7;10
89;13.07.2014;2014;07;08;Sunnuntai;7;14;21;11;12;23
89;13.07.2014;2014;07;09;Sunnuntai;20;27;47;12;17;29
89;13.07.2014;2014;07;10;Sunnuntai;40;51;91;14;34;48
89;13.07.2014;2014;07;11;Sunnuntai;54;85;139;20;44;64
89;13.07.2014;2014;07;12;Sunnuntai;79;129;208;41;43;84
89;13.07.2014;2014;07;13;Sunnuntai;118;113;231;31;62;93
89;13.07.2014;2014;07;14;Sunnuntai;122;126;248;28;49;77
89;13.07.2014;2014;07;15;Sunnuntai;113;130;243;40;35;75
89;13.07.2014;2014;07;16;Sunnuntai;131;123;254;39;58;97
89;13.07.2014;2014;07;17;Sunnuntai;131;120;251;31;35;66
89;13.07.2014;2014;07;18;Sunnuntai;116;120;236;28;37;65
89;13.07.2014;2014;07;19;Sunnuntai;115;84;199;33;29;62
89;13.07.2014;2014;07;20;Sunnuntai;99;74;173;28;32;60
89;13.07.2014;2014;07;21;Sunnuntai;72;74;146;14;31;45
89;13.07.2014;2014;07;22;Sunnuntai;29;23;52;9;13;22
89;13.07.2014;2014;07;23;Sunnuntai;20;12;32;4;6;10
89;14.07.2014;2014;07;00;Maanantai;17;9;26;0;2;2
89;14.07.2014;2014;07;01;Maanantai;21;11;32;1;1;2
89;14.07.2014;2014;07;02;Maanantai;9;2;11;0;2;2
89;14.07.2014;2014;07;03;Maanantai;8;6;14;0;0;0
89;14.07.2014;2014;07;04;Maanantai;5;7;12;2;1;3
89;14.07.2014;2014;07;05;Maanantai;7;15;22;4;5;9
89;14.07.2014;2014;07;06;Maanantai;16;62;78;2;8;10
89;14.07.2014;2014;07;07;Maanantai;20;122;142;3;9;12
89;14.07.2014;2014;07;08;Maanantai;16;89;105;7;16;23
89;14.07.2014;2014;07;09;Maanantai;36;89;125;8;19;27
89;14.07.2014;2014;07;10;Maanantai;46;80;126;16;23;39
89;14.07.2014;2014;07;11;Maanantai;60;39;99;16;15;31
89;14.07.2014;2014;07;12;Maanantai;71;88;159;19;23;42
89;14.07.2014;2014;07;13;Maanantai;104;98;202;18;43;61
89;14.07.2014;2014;07;14;Maanantai;163;118;281;29;45;74
89;14.07.2014;2014;07;15;Maanantai;208;123;331;29;19;48
89;14.07.2014;2014;07;16;Maanantai;200;109;309;14;33;47
89;14.07.2014;2014;07;17;Maanantai;128;176;304;37;30;67
89;14.07.2014;2014;07;18;Maanantai;130;124;254;22;37;59
89;14.07.2014;2014;07;19;Maanantai;86;26;112;21;7;28
89;14.07.2014;2014;07;20;Maanantai;50;34;84;6;18;24
89;14.07.2014;2014;07;21;Maanantai;40;39;79;22;22;44
89;14.07.2014;2014;07;22;Maanantai;29;17;46;15;7;22
89;14.07.2014;2014;07;23;Maanantai;20;19;39;3;5;8
89;15.07.2014;2014;07;00;Tiistai;12;8;20;1;4;5
89;15.07.2014;2014;07;01;Tiistai;13;7;20;4;2;6
89;15.07.2014;2014;07;02;Tiistai;2;2;4;1;0;1
89;15.07.2014;2014;07;03;Tiistai;4;2;6;3;0;3
89;15.07.2014;2014;07;04;Tiistai;1;5;6;0;2;2
89;15.07.2014;2014;07;05;Tiistai;8;18;26;1;3;4
89;15.07.2014;2014;07;06;Tiistai;16;57;73;2;6;8
89;15.07.2014;2014;07;07;Tiistai;25;92;117;4;12;16
89;15.07.2014;2014;07;08;Tiistai;11;94;105;11;11;22
89;15.07.2014;2014;07;09;Tiistai;29;87;116;5;30;35
89;15.07.2014;2014;07;10;Tiistai;41;78;119;18;30;48
89;15.07.2014;2014;07;11;Tiistai;53;93;146;16;23;39
89;15.07.2014;2014;07;12;Tiistai;84;88;172;36;28;64
89;15.07.2014;2014;07;13;Tiistai;81;49;130;16;10;26
89;15.07.2014;2014;07;14;Tiistai;143;85;228;28;17;45
89;15.07.2014;2014;07;15;Tiistai;158;114;272;24;30;54
89;15.07.2014;2014;07;16;Tiistai;206;130;336;28;29;57
89;15.07.2014;2014;07;17;Tiistai;167;149;316;31;39;70
89;15.07.2014;2014;07;18;Tiistai;130;139;269;42;38;80
89;15.07.2014;2014;07;19;Tiistai;166;110;276;26;44;70
89;15.07.2014;2014;07;20;Tiistai;77;36;113;19;13;32
89;15.07.2014;2014;07;21;Tiistai;49;32;81;4;17;21
89;15.07.2014;2014;07;22;Tiistai;26;38;64;9;16;25
89;15.07.2014;2014;07;23;Tiistai;23;12;35;3;2;5
89;16.07.2014;2014;07;00;Keskiviikko;6;14;20;0;3;3
89;16.07.2014;2014;07;01;Keskiviikko;11;4;15;4;5;9
89;16.07.2014;2014;07;02;Keskiviikko;8;1;9;2;1;3
89;16.07.2014;2014;07;03;Keskiviikko;3;3;6;2;4;6
89;16.07.2014;2014;07;04;Keskiviikko;2;5;7;1;0;1
89;16.07.2014;2014;07;05;Keskiviikko;10;21;31;2;3;5
89;16.07.2014;2014;07;06;Keskiviikko;22;59;81;2;8;10
89;16.07.2014;2014;07;07;Keskiviikko;24;88;112;9;15;24
89;16.07.2014;2014;07;08;Keskiviikko;24;104;128;12;23;35
89;16.07.2014;2014;07;09;Keskiviikko;29;93;122;19;22;41
89;16.07.2014;2014;07;10;Keskiviikko;51;93;144;14;45;59
89;16.07.2014;2014;07;11;Keskiviikko;80;131;211;16;28;44
89;16.07.2014;2014;07;12;Keskiviikko;84;120;204;23;48;71
89;16.07.2014;2014;07;13;Keskiviikko;121;115;236;19;40;59
89;16.07.2014;2014;07;14;Keskiviikko;111;97;208;20;26;46
89;16.07.2014;2014;07;15;Keskiviikko;139;73;212;22;5;27
89;16.07.2014;2014;07;16;Keskiviikko;143;74;217;22;19;41
89;16.07.2014;2014;07;17;Keskiviikko;96;63;159;18;28;46
89;16.07.2014;2014;07;18;Keskiviikko;99;99;198;25;35;60
89;16.07.2014;2014;07;19;Keskiviikko;85;56;141;29;37;66
89;16.07.2014;2014;07;20;Keskiviikko;69;63;132;20;25;45
89;16.07.2014;2014;07;21;Keskiviikko;82;57;139;26;27;53
89;16.07.2014;2014;07;22;Keskiviikko;56;37;93;11;15;26
89;16.07.2014;2014;07;23;Keskiviikko;21;22;43;8;9;17
89;17.07.2014;2014;07;00;Torstai;19;14;33;3;4;7
89;17.07.2014;2014;07;01;Torstai;24;15;39;2;0;2
89;17.07.2014;2014;07;02;Torstai;11;5;16;3;2;5
89;17.07.2014;2014;07;03;Torstai;12;7;19;9;2;11
89;17.07.2014;2014;07;04;Torstai;6;2;8;4;0;4
89;17.07.2014;2014;07;05;Torstai;7;13;20;3;3;6
89;17.07.2014;2014;07;06;Torstai;16;59;75;7;6;13
89;17.07.2014;2014;07;07;Torstai;22;93;115;5;10;15
89;17.07.2014;2014;07;08;Torstai;16;95;111;4;24;28
89;17.07.2014;2014;07;09;Torstai;28;78;106;10;35;45
89;17.07.2014;2014;07;10;Torstai;36;78;114;19;24;43
89;17.07.2014;2014;07;11;Torstai;58;112;170;17;50;67
89;17.07.2014;2014;07;12;Torstai;71;92;163;24;54;78
89;17.07.2014;2014;07;13;Torstai;102;100;202;33;40;73
89;17.07.2014;2014;07;14;Torstai;97;74;171;20;31;51
89;17.07.2014;2014;07;15;Torstai;132;94;226;28;30;58
89;17.07.2014;2014;07;16;Torstai;156;94;250;24;19;43
89;17.07.2014;2014;07;17;Torstai;121;83;204;25;24;49
89;17.07.2014;2014;07;18;Torstai;105;88;193;27;34;61
89;17.07.2014;2014;07;19;Torstai;87;75;162;21;34;55
89;17.07.2014;2014;07;20;Torstai;91;50;141;25;19;44
89;17.07.2014;2014;07;21;Torstai;66;35;101;11;12;23
89;17.07.2014;2014;07;22;Torstai;47;22;69;7;4;11
89;17.07.2014;2014;07;23;Torstai;23;34;57;10;10;20
89;18.07.2014;2014;07;00;Perjantai;18;9;27;0;4;4
89;18.07.2014;2014;07;01;Perjantai;18;5;23;4;1;5
89;18.07.2014;2014;07;02;Perjantai;6;3;9;1;0;1
89;18.07.2014;2014;07;03;Perjantai;10;4;14;6;0;6
89;18.07.2014;2014;07;04;Perjantai;9;4;13;1;0;1
89;18.07.2014;2014;07;05;Perjantai;11;18;29;2;3;5
89;18.07.2014;2014;07;06;Perjantai;17;54;71;1;9;10
89;18.07.2014;2014;07;07;Perjantai;16;89;105;7;16;23
89;18.07.2014;2014;07;08;Perjantai;15;85;100;4;17;21
89;18.07.2014;2014;07;09;Perjantai;27;88;115;13;18;31
89;18.07.2014;2014;07;10;Perjantai;50;77;127;19;34;53
89;18.07.2014;2014;07;11;Perjantai;70;86;156;13;33;46
89;18.07.2014;2014;07;12;Perjantai;79;64;143;19;19;38
89;18.07.2014;2014;07;13;Perjantai;62;52;114;10;16;26
89;18.07.2014;2014;07;14;Perjantai;83;28;111;9;9;18
89;18.07.2014;2014;07;15;Perjantai;101;75;176;14;8;22
89;18.07.2014;2014;07;16;Perjantai;105;73;178;32;25;57
89;18.07.2014;2014;07;17;Perjantai;96;88;184;23;42;65
89;18.07.2014;2014;07;18;Perjantai;119;100;219;28;28;56
89;18.07.2014;2014;07;19;Perjantai;93;106;199;20;21;41
89;18.07.2014;2014;07;20;Perjantai;87;88;175;26;40;66
89;18.07.2014;2014;07;21;Perjantai;90;77;167;26;43;69
89;18.07.2014;2014;07;22;Perjantai;64;105;169;26;33;59
89;18.07.2014;2014;07;23;Perjantai;68;59;127;10;18;28
89;19.07.2014;2014;07;00;Lauantai;31;48;79;9;9;18
89;19.07.2014;2014;07;01;Lauantai;32;18;50;3;5;8
89;19.07.2014;2014;07;02;Lauantai;40;4;44;8;4;12
89;19.07.2014;2014;07;03;Lauantai;38;5;43;10;0;10
89;19.07.2014;2014;07;04;Lauantai;48;7;55;10;5;15
89;19.07.2014;2014;07;05;Lauantai;8;14;22;2;5;7
89;19.07.2014;2014;07;06;Lauantai;5;11;16;5;5;10
89;19.07.2014;2014;07;07;Lauantai;7;17;24;8;7;15
89;19.07.2014;2014;07;08;Lauantai;9;32;41;10;13;23
89;19.07.2014;2014;07;09;Lauantai;29;81;110;8;20;28
89;19.07.2014;2014;07;10;Lauantai;44;86;130;13;48;61
89;19.07.2014;2014;07;11;Lauantai;95;120;215;24;32;56
89;19.07.2014;2014;07;12;Lauantai;102;102;204;28;46;74
89;19.07.2014;2014;07;13;Lauantai;92;130;222;18;38;56
89;19.07.2014;2014;07;14;Lauantai;99;97;196;21;23;44
89;19.07.2014;2014;07;15;Lauantai;97;51;148;16;12;28
89;19.07.2014;2014;07;16;Lauantai;61;47;108;19;27;46
89;19.07.2014;2014;07;17;Lauantai;52;64;116;10;17;27
89;19.07.2014;2014;07;18;Lauantai;76;52;128;24;10;34
89;19.07.2014;2014;07;19;Lauantai;70;62;132;23;26;49
89;19.07.2014;2014;07;20;Lauantai;71;53;124;23;20;43
89;19.07.2014;2014;07;21;Lauantai;48;74;122;8;14;22
89;19.07.2014;2014;07;22;Lauantai;62;86;148;11;11;22
89;19.07.2014;2014;07;23;Lauantai;42;70;112;28;40;68
89;20.07.2014;2014;07;00;Sunnuntai;41;38;79;6;8;14
89;20.07.2014;2014;07;01;Sunnuntai;53;19;72;8;7;15
89;20.07.2014;2014;07;02;Sunnuntai;41;6;47;3;5;8
89;20.07.2014;2014;07;03;Sunnuntai;49;7;56;12;0;12
89;20.07.2014;2014;07;04;Sunnuntai;26;1;27;7;3;10
89;20.07.2014;2014;07;05;Sunnuntai;7;10;17;2;4;6
89;20.07.2014;2014;07;06;Sunnuntai;4;5;9;2;4;6
89;20.07.2014;2014;07;07;Sunnuntai;7;11;18;7;7;14
89;20.07.2014;2014;07;08;Sunnuntai;8;20;28;6;13;19
89;20.07.2014;2014;07;09;Sunnuntai;28;42;70;14;23;37
89;20.07.2014;2014;07;10;Sunnuntai;47;60;107;24;29;53
89;20.07.2014;2014;07;11;Sunnuntai;66;86;152;20;55;75
89;20.07.2014;2014;07;12;Sunnuntai;107;131;238;28;37;65
89;20.07.2014;2014;07;13;Sunnuntai;113;153;266;19;41;60
89;20.07.2014;2014;07;14;Sunnuntai;124;142;266;41;27;68
89;20.07.2014;2014;07;15;Sunnuntai;116;93;209;26;47;73
89;20.07.2014;2014;07;16;Sunnuntai;122;103;225;20;30;50
89;20.07.2014;2014;07;17;Sunnuntai;118;140;258;28;28;56
89;20.07.2014;2014;07;18;Sunnuntai;108;82;190;32;38;70
89;20.07.2014;2014;07;19;Sunnuntai;103;66;169;30;37;67
89;20.07.2014;2014;07;20;Sunnuntai;75;62;137;25;24;49
89;20.07.2014;2014;07;21;Sunnuntai;48;31;79;16;16;32
89;20.07.2014;2014;07;22;Sunnuntai;35;17;52;7;10;17
89;20.07.2014;2014;07;23;Sunnuntai;36;13;49;5;11;16
89;21.07.2014;2014;07;00;Maanantai;20;15;35;0;3;3
89;21.07.2014;2014;07;01;Maanantai;14;6;20;3;2;5
89;21.07.2014;2014;07;02;Maanantai;8;2;10;1;2;3
89;21.07.2014;2014;07;03;Maanantai;2;1;3;1;0;1
89;21.07.2014;2014;07;04;Maanantai;8;0;8;4;1;5
89;21.07.2014;2014;07;05;Maanantai;9;11;20;4;6;10
89;21.07.2014;2014;07;06;Maanantai;22;81;103;3;14;17
89;21.07.2014;2014;07;07;Maanantai;25;132;157;3;18;21
89;21.07.2014;2014;07;08;Maanantai;25;104;129;5;19;24
89;21.07.2014;2014;07;09;Maanantai;48;118;166;8;26;34
89;21.07.2014;2014;07;10;Maanantai;65;127;192;28;45;73
89;21.07.2014;2014;07;11;Maanantai;92;129;221;20;31;51
89;21.07.2014;2014;07;12;Maanantai;120;132;252;26;23;49
89;21.07.2014;2014;07;13;Maanantai;143;136;279;44;32;76
89;21.07.2014;2014;07;14;Maanantai;155;148;303;39;27;66
89;21.07.2014;2014;07;15;Maanantai;224;143;367;35;39;74
89;21.07.2014;2014;07;16;Maanantai;197;131;328;50;26;76
89;21.07.2014;2014;07;17;Maanantai;142;150;292;28;25;53
89;21.07.2014;2014;07;18;Maanantai;180;140;320;30;53;83
89;21.07.2014;2014;07;19;Maanantai;120;126;246;25;40;65
89;21.07.2014;2014;07;20;Maanantai;129;75;204;17;31;48
89;21.07.2014;2014;07;21;Maanantai;87;82;169;20;23;43
89;21.07.2014;2014;07;22;Maanantai;61;38;99;11;12;23
89;21.07.2014;2014;07;23;Maanantai;38;40;78;7;9;16
89;22.07.2014;2014;07;00;Tiistai;18;18;36;6;2;8
89;22.07.2014;2014;07;01;Tiistai;14;1;15;4;4;8
89;22.07.2014;2014;07;02;Tiistai;7;13;20;4;0;4
89;22.07.2014;2014;07;03;Tiistai;2;3;5;3;2;5
89;22.07.2014;2014;07;04;Tiistai;6;1;7;4;0;4
89;22.07.2014;2014;07;05;Tiistai;13;3;16;1;3;4
89;22.07.2014;2014;07;06;Tiistai;24;76;100;2;10;12
89;22.07.2014;2014;07;07;Tiistai;26;140;166;7;14;21
89;22.07.2014;2014;07;08;Tiistai;26;115;141;12;22;34
89;22.07.2014;2014;07;09;Tiistai;39;110;149;11;20;31
89;22.07.2014;2014;07;10;Tiistai;71;106;177;21;44;65
89;22.07.2014;2014;07;11;Tiistai;106;144;250;21;23;44
89;22.07.2014;2014;07;12;Tiistai;140;117;257;31;28;59
89;22.07.2014;2014;07;13;Tiistai;155;161;316;39;36;75
89;22.07.2014;2014;07;14;Tiistai;173;136;309;29;30;59
89;22.07.2014;2014;07;15;Tiistai;210;126;336;43;18;61
89;22.07.2014;2014;07;16;Tiistai;242;122;364;40;35;75
89;22.07.2014;2014;07;17;Tiistai;153;153;306;28;39;67
89;22.07.2014;2014;07;18;Tiistai;126;124;250;29;34;63
89;22.07.2014;2014;07;19;Tiistai;156;130;286;38;41;79
89;22.07.2014;2014;07;20;Tiistai;115;95;210;26;34;60
89;22.07.2014;2014;07;21;Tiistai;113;65;178;23;13;36
89;22.07.2014;2014;07;22;Tiistai;38;57;95;15;11;26
89;22.07.2014;2014;07;23;Tiistai;26;27;53;3;14;17
89;23.07.2014;2014;07;00;Keskiviikko;19;26;45;3;6;9
89;23.07.2014;2014;07;01;Keskiviikko;14;2;16;5;2;7
89;23.07.2014;2014;07;02;Keskiviikko;18;6;24;2;0;2
89;23.07.2014;2014;07;03;Keskiviikko;10;10;20;1;2;3
89;23.07.2014;2014;07;04;Keskiviikko;5;1;6;1;0;1
89;23.07.2014;2014;07;05;Keskiviikko;9;0;9;3;2;5
89;23.07.2014;2014;07;06;Keskiviikko;19;85;104;1;7;8
89;23.07.2014;2014;07;07;Keskiviikko;26;113;139;10;18;28
89;23.07.2014;2014;07;08;Keskiviikko;23;124;147;9;18;27
89;23.07.2014;2014;07;09;Keskiviikko;36;104;140;11;23;34
89;23.07.2014;2014;07;10;Keskiviikko;65;124;189;12;27;39
89;23.07.2014;2014;07;11;Keskiviikko;88;127;215;15;18;33
89;23.07.2014;2014;07;12;Keskiviikko;98;131;229;29;34;63
89;23.07.2014;2014;07;13;Keskiviikko;149;147;296;19;32;51
89;23.07.2014;2014;07;14;Keskiviikko;166;141;307;27;24;51
89;23.07.2014;2014;07;15;Keskiviikko;204;164;368;31;24;55
89;23.07.2014;2014;07;16;Keskiviikko;206;170;376;22;25;47
89;23.07.2014;2014;07;17;Keskiviikko;163;151;314;31;36;67
89;23.07.2014;2014;07;18;Keskiviikko;178;186;364;30;67;97
89;23.07.2014;2014;07;19;Keskiviikko;165;135;300;23;42;65
89;23.07.2014;2014;07;20;Keskiviikko;118;105;223;23;25;48
89;23.07.2014;2014;07;21;Keskiviikko;115;91;206;21;29;50
89;23.07.2014;2014;07;22;Keskiviikko;88;59;147;21;9;30
89;23.07.2014;2014;07;23;Keskiviikko;45;42;87;8;7;15
89;24.07.2014;2014;07;00;Torstai;27;29;56;4;3;7
89;24.07.2014;2014;07;01;Torstai;22;15;37;7;5;12
89;24.07.2014;2014;07;02;Torstai;16;6;22;6;2;8
89;24.07.2014;2014;07;03;Torstai;12;6;18;7;1;8
89;24.07.2014;2014;07;04;Torstai;8;1;9;4;0;4
89;24.07.2014;2014;07;05;Torstai;9;2;11;6;1;7
89;24.07.2014;2014;07;06;Torstai;20;53;73;3;6;9
89;24.07.2014;2014;07;07;Torstai;20;118;138;8;20;28
89;24.07.2014;2014;07;08;Torstai;32;110;142;13;15;28
89;24.07.2014;2014;07;09;Torstai;31;83;114;6;17;23
89;24.07.2014;2014;07;10;Torstai;55;101;156;10;24;34
89;24.07.2014;2014;07;11;Torstai;100;135;235;14;36;50
89;24.07.2014;2014;07;12;Torstai;128;146;274;18;31;49
89;24.07.2014;2014;07;13;Torstai;126;143;269;28;34;62
89;24.07.2014;2014;07;14;Torstai;144;125;269;32;36;68
89;24.07.2014;2014;07;15;Torstai;169;162;331;52;31;83
89;24.07.2014;2014;07;16;Torstai;221;164;385;41;34;75
89;24.07.2014;2014;07;17;Torstai;171;167;338;37;47;84
89;24.07.2014;2014;07;18;Torstai;148;196;344;38;71;109
89;24.07.2014;2014;07;19;Torstai;183;136;319;41;26;67
89;24.07.2014;2014;07;20;Torstai;145;114;259;21;43;64
89;24.07.2014;2014;07;21;Torstai;147;76;223;37;28;65
89;24.07.2014;2014;07;22;Torstai;78;53;131;20;21;41
89;24.07.2014;2014;07;23;Torstai;43;41;84;22;14;36
89;25.07.2014;2014;07;00;Perjantai;49;27;76;4;6;10
89;25.07.2014;2014;07;01;Perjantai;20;5;25;0;2;2
89;25.07.2014;2014;07;02;Perjantai;19;2;21;4;0;4
89;25.07.2014;2014;07;03;Perjantai;12;1;13;1;0;1
89;25.07.2014;2014;07;04;Perjantai;6;1;7;3;0;3
89;25.07.2014;2014;07;05;Perjantai;4;8;12;2;5;7
89;25.07.2014;2014;07;06;Perjantai;24;68;92;1;8;9
89;25.07.2014;2014;07;07;Perjantai;28;90;118;5;28;33
89;25.07.2014;2014;07;08;Perjantai;32;121;153;11;26;37
89;25.07.2014;2014;07;09;Perjantai;46;99;145;16;19;35
89;25.07.2014;2014;07;10;Perjantai;62;105;167;10;33;43
89;25.07.2014;2014;07;11;Perjantai;93;134;227;22;33;55
89;25.07.2014;2014;07;12;Perjantai;144;154;298;24;27;51
89;25.07.2014;2014;07;13;Perjantai;145;171;316;29;34;63
89;25.07.2014;2014;07;14;Perjantai;180;155;335;31;31;62
89;25.07.2014;2014;07;15;Perjantai;186;189;375;42;31;73
89;25.07.2014;2014;07;16;Perjantai;155;183;338;37;47;84
89;25.07.2014;2014;07;17;Perjantai;141;156;297;19;34;53
89;25.07.2014;2014;07;18;Perjantai;124;196;320;27;56;83
89;25.07.2014;2014;07;19;Perjantai;109;170;279;19;51;70
89;25.07.2014;2014;07;20;Perjantai;121;163;284;17;26;43
89;25.07.2014;2014;07;21;Perjantai;82;121;203;13;38;51
89;25.07.2014;2014;07;22;Perjantai;112;86;198;26;40;66
89;25.07.2014;2014;07;23;Perjantai;90;49;139;12;17;29
89;26.07.2014;2014;07;00;Lauantai;104;29;133;27;10;37
89;26.07.2014;2014;07;01;Lauantai;126;28;154;16;17;33
89;26.07.2014;2014;07;02;Lauantai;142;23;165;46;6;52
89;26.07.2014;2014;07;03;Lauantai;85;3;88;43;9;52
89;26.07.2014;2014;07;04;Lauantai;37;15;52;20;4;24
89;26.07.2014;2014;07;05;Lauantai;14;5;19;3;7;10
89;26.07.2014;2014;07;06;Lauantai;8;18;26;1;3;4
89;26.07.2014;2014;07;07;Lauantai;12;24;36;12;18;30
89;26.07.2014;2014;07;08;Lauantai;19;46;65;13;11;24
89;26.07.2014;2014;07;09;Lauantai;31;92;123;14;11;25
89;26.07.2014;2014;07;10;Lauantai;29;99;128;9;23;32
89;26.07.2014;2014;07;11;Lauantai;89;132;221;14;26;40
89;26.07.2014;2014;07;12;Lauantai;123;147;270;12;47;59
89;26.07.2014;2014;07;13;Lauantai;162;141;303;25;45;70
89;26.07.2014;2014;07;14;Lauantai;149;180;329;56;32;88
89;26.07.2014;2014;07;15;Lauantai;162;136;298;70;24;94
89;26.07.2014;2014;07;16;Lauantai;153;146;299;39;44;83
89;26.07.2014;2014;07;17;Lauantai;111;164;275;13;46;59
89;26.07.2014;2014;07;18;Lauantai;137;145;282;24;39;63
89;26.07.2014;2014;07;19;Lauantai;112;154;266;21;30;51
89;26.07.2014;2014;07;20;Lauantai;110;158;268;23;44;67
89;26.07.2014;2014;07;21;Lauantai;81;119;200;14;33;47
89;26.07.2014;2014;07;22;Lauantai;82;135;217;18;46;64
89;26.07.2014;2014;07;23;Lauantai;87;68;155;12;14;26
89;27.07.2014;2014;07;00;Sunnuntai;137;32;169;15;7;22
89;27.07.2014;2014;07;01;Sunnuntai;105;25;130;26;7;33
89;27.07.2014;2014;07;02;Sunnuntai;105;11;116;32;5;37
89;27.07.2014;2014;07;03;Sunnuntai;90;3;93;42;4;46
89;27.07.2014;2014;07;04;Sunnuntai;50;4;54;21;5;26
89;27.07.2014;2014;07;05;Sunnuntai;17;10;27;10;0;10
89;27.07.2014;2014;07;06;Sunnuntai;9;18;27;3;3;6
89;27.07.2014;2014;07;07;Sunnuntai;10;23;33;6;3;9
89;27.07.2014;2014;07;08;Sunnuntai;10;22;32;10;11;21
89;27.07.2014;2014;07;09;Sunnuntai;27;44;71;11;18;29
89;27.07.2014;2014;07;10;Sunnuntai;38;70;108;12;20;32
89;27.07.2014;2014;07;11;Sunnuntai;89;82;171;22;31;53
89;27.07.2014;2014;07;12;Sunnuntai;94;85;179;22;26;48
89;27.07.2014;2014;07;13;Sunnuntai;94;121;215;25;48;73
89;27.07.2014;2014;07;14;Sunnuntai;118;117;235;17;35;52
89;27.07.2014;2014;07;15;Sunnuntai;111;113;224;35;33;68
89;27.07.2014;2014;07;16;Sunnuntai;107;111;218;40;46;86
89;27.07.2014;2014;07;17;Sunnuntai;120;155;275;33;38;71
89;27.07.2014;2014;07;18;Sunnuntai;121;127;248;25;29;54
89;27.07.2014;2014;07;19;Sunnuntai;100;96;196;24;32;56
89;27.07.2014;2014;07;20;Sunnuntai;118;74;192;23;15;38
89;27.07.2014;2014;07;21;Sunnuntai;63;63;126;15;12;27
89;27.07.2014;2014;07;22;Sunnuntai;26;28;54;9;7;16
89;27.07.2014;2014;07;23;Sunnuntai;36;28;64;5;6;11
89;28.07.2014;2014;07;00;Maanantai;15;10;25;1;1;2
89;28.07.2014;2014;07;01;Maanantai;13;7;20;2;2;4
89;28.07.2014;2014;07;02;Maanantai;8;6;14;4;1;5
89;28.07.2014;2014;07;03;Maanantai;11;6;17;3;2;5
89;28.07.2014;2014;07;04;Maanantai;7;3;10;1;0;1
89;28.07.2014;2014;07;05;Maanantai;7;14;21;2;3;5
89;28.07.2014;2014;07;06;Maanantai;22;55;77;1;10;11
89;28.07.2014;2014;07;07;Maanantai;35;128;163;8;23;31
89;28.07.2014;2014;07;08;Maanantai;27;115;142;10;16;26
89;28.07.2014;2014;07;09;Maanantai;22;48;70;8;13;21
89;28.07.2014;2014;07;10;Maanantai;22;34;56;3;8;11
89;28.07.2014;2014;07;11;Maanantai;22;58;80;6;13;19
89;28.07.2014;2014;07;12;Maanantai;43;64;107;12;16;28
89;28.07.2014;2014;07;13;Maanantai;55;77;132;18;19;37
89;28.07.2014;2014;07;14;Maanantai;81;77;158;24;20;44
89;28.07.2014;2014;07;15;Maanantai;112;52;164;15;13;28
89;28.07.2014;2014;07;16;Maanantai;131;64;195;26;17;43
89;28.07.2014;2014;07;17;Maanantai;102;72;174;21;26;47
89;28.07.2014;2014;07;18;Maanantai;76;61;137;30;27;57
89;28.07.2014;2014;07;19;Maanantai;92;65;157;29;42;71
89;28.07.2014;2014;07;20;Maanantai;63;37;100;22;19;41
89;28.07.2014;2014;07;21;Maanantai;45;28;73;12;21;33
89;28.07.2014;2014;07;22;Maanantai;26;26;52;4;8;12
89;28.07.2014;2014;07;23;Maanantai;15;10;25;4;3;7
89;29.07.2014;2014;07;00;Tiistai;10;11;21;2;1;3
89;29.07.2014;2014;07;01;Tiistai;11;6;17;1;0;1
89;29.07.2014;2014;07;02;Tiistai;6;1;7;2;1;3
89;29.07.2014;2014;07;03;Tiistai;1;2;3;0;0;0
89;29.07.2014;2014;07;04;Tiistai;4;1;5;0;0;0
89;29.07.2014;2014;07;05;Tiistai;5;0;5;3;1;4
89;29.07.2014;2014;07;06;Tiistai;16;8;24;3;3;6
89;29.07.2014;2014;07;07;Tiistai;36;140;176;9;8;17
89;29.07.2014;2014;07;08;Tiistai;28;134;162;7;27;34
89;29.07.2014;2014;07;09;Tiistai;34;111;145;14;28;42
89;29.07.2014;2014;07;10;Tiistai;58;86;144;10;22;32
89;29.07.2014;2014;07;11;Tiistai;67;95;162;22;41;63
89;29.07.2014;2014;07;12;Tiistai;70;131;201;27;43;70
89;29.07.2014;2014;07;13;Tiistai;110;116;226;26;35;61
89;29.07.2014;2014;07;14;Tiistai;158;116;274;32;34;66
89;29.07.2014;2014;07;15;Tiistai;200;102;302;36;30;66
89;29.07.2014;2014;07;16;Tiistai;185;125;310;23;28;51
89;29.07.2014;2014;07;17;Tiistai;145;141;286;22;30;52
89;29.07.2014;2014;07;18;Tiistai;130;111;241;31;49;80
89;29.07.2014;2014;07;19;Tiistai;131;91;222;43;54;97
89;29.07.2014;2014;07;20;Tiistai;141;78;219;27;33;60
89;29.07.2014;2014;07;21;Tiistai;78;38;116;22;25;47
89;29.07.2014;2014;07;22;Tiistai;51;19;70;8;16;24
89;29.07.2014;2014;07;23;Tiistai;27;21;48;5;7;12
89;30.07.2014;2014;07;00;Keskiviikko;17;11;28;3;0;3
89;30.07.2014;2014;07;01;Keskiviikko;4;12;16;1;3;4
89;30.07.2014;2014;07;02;Keskiviikko;6;4;10;2;0;2
89;30.07.2014;2014;07;03;Keskiviikko;4;3;7;0;0;0
89;30.07.2014;2014;07;04;Keskiviikko;6;3;9;3;0;3
89;30.07.2014;2014;07;05;Keskiviikko;8;9;17;2;1;3
89;30.07.2014;2014;07;06;Keskiviikko;16;60;76;3;6;9
89;30.07.2014;2014;07;07;Keskiviikko;30;140;170;6;11;17
89;30.07.2014;2014;07;08;Keskiviikko;29;126;155;2;26;28
89;30.07.2014;2014;07;09;Keskiviikko;22;104;126;19;29;48
89;30.07.2014;2014;07;10;Keskiviikko;47;96;143;15;37;52
89;30.07.2014;2014;07;11;Keskiviikko;61;83;144;20;34;54
89;30.07.2014;2014;07;12;Keskiviikko;101;120;221;17;20;37
89;30.07.2014;2014;07;13;Keskiviikko;117;115;232;24;28;52
89;30.07.2014;2014;07;14;Keskiviikko;132;115;247;27;39;66
89;30.07.2014;2014;07;15;Keskiviikko;195;109;304;36;19;55
89;30.07.2014;2014;07;16;Keskiviikko;218;136;354;33;28;61
89;30.07.2014;2014;07;17;Keskiviikko;147;119;266;17;19;36
89;30.07.2014;2014;07;18;Keskiviikko;132;93;225;34;42;76
89;30.07.2014;2014;07;19;Keskiviikko;134;131;265;28;32;60
89;30.07.2014;2014;07;20;Keskiviikko;118;86;204;25;34;59
89;30.07.2014;2014;07;21;Keskiviikko;65;72;137;17;20;37
89;30.07.2014;2014;07;22;Keskiviikko;57;45;102;12;25;37
89;30.07.2014;2014;07;23;Keskiviikko;44;33;77;3;6;9
89;31.07.2014;2014;07;00;Torstai;28;18;46;6;4;10
89;31.07.2014;2014;07;01;Torstai;16;2;18;3;1;4
89;31.07.2014;2014;07;02;Torstai;8;7;15;3;0;3
89;31.07.2014;2014;07;03;Torstai;8;4;12;1;0;1
89;31.07.2014;2014;07;04;Torstai;6;4;10;4;2;6
89;31.07.2014;2014;07;05;Torstai;6;11;17;1;1;2
89;31.07.2014;2014;07;06;Torstai;13;58;71;0;7;7
89;31.07.2014;2014;07;07;Torstai;23;114;137;2;14;16
89;31.07.2014;2014;07;08;Torstai;14;100;114;8;17;25
89;31.07.2014;2014;07;09;Torstai;27;58;85;7;13;20
89;31.07.2014;2014;07;10;Torstai;34;57;91;13;18;31
89;31.07.2014;2014;07;11;Torstai;27;50;77;13;31;44
89;31.07.2014;2014;07;12;Torstai;59;47;106;5;4;9
89;31.07.2014;2014;07;13;Torstai;49;30;79;11;5;16
89;31.07.2014;2014;07;14;Torstai;52;26;78;3;7;10
89;31.07.2014;2014;07;15;Torstai;94;27;121;11;5;16
89;31.07.2014;2014;07;16;Torstai;75;17;92;7;5;12
89;31.07.2014;2014;07;17;Torstai;33;21;54;4;7;11
89;31.07.2014;2014;07;18;Torstai;29;9;38;3;3;6
89;31.07.2014;2014;07;19;Torstai;35;16;51;10;10;20
89;31.07.2014;2014;07;20;Torstai;29;27;56;19;18;37
89;31.07.2014;2014;07;21;Torstai;35;31;66;14;16;30
89;31.07.2014;2014;07;22;Torstai;26;18;44;10;13;23
89;31.07.2014;2014;07;23;Torstai;4;9;13;11;2;13
89;01.08.2014;2014;08;00;Perjantai;8;6;14;5;5;10
89;01.08.2014;2014;08;01;Perjantai;8;12;20;2;4;6
89;01.08.2014;2014;08;02;Perjantai;14;2;16;3;3;6
89;01.08.2014;2014;08;03;Perjantai;4;5;9;0;0;0
89;01.08.2014;2014;08;04;Perjantai;9;3;12;3;0;3
89;01.08.2014;2014;08;05;Perjantai;11;13;24;0;0;0
89;01.08.2014;2014;08;06;Perjantai;12;43;55;3;9;12
89;01.08.2014;2014;08;07;Perjantai;20;133;153;7;15;22
89;01.08.2014;2014;08;08;Perjantai;21;107;128;3;20;23
89;01.08.2014;2014;08;09;Perjantai;44;105;149;13;35;48
89;01.08.2014;2014;08;10;Perjantai;60;109;169;22;33;55
89;01.08.2014;2014;08;11;Perjantai;82;109;191;27;54;81
89;01.08.2014;2014;08;12;Perjantai;105;161;266;15;46;61
89;01.08.2014;2014;08;13;Perjantai;122;191;313;28;42;70
89;01.08.2014;2014;08;14;Perjantai;166;171;337;40;35;75
89;01.08.2014;2014;08;15;Perjantai;204;151;355;31;29;60
89;01.08.2014;2014;08;16;Perjantai;160;139;299;32;46;78
89;01.08.2014;2014;08;17;Perjantai;155;122;277;17;35;52
89;01.08.2014;2014;08;18;Perjantai;128;134;262;25;26;51
89;01.08.2014;2014;08;19;Perjantai;81;79;160;20;24;44
89;01.08.2014;2014;08;20;Perjantai;93;81;174;18;24;42
89;01.08.2014;2014;08;21;Perjantai;78;72;150;16;21;37
89;01.08.2014;2014;08;22;Perjantai;72;59;131;11;22;33
89;01.08.2014;2014;08;23;Perjantai;71;28;99;10;8;18
89;02.08.2014;2014;08;00;Lauantai;38;9;47;4;4;8
89;02.08.2014;2014;08;01;Lauantai;46;7;53;12;4;16
89;02.08.2014;2014;08;02;Lauantai;28;7;35;4;3;7
89;02.08.2014;2014;08;03;Lauantai;24;2;26;10;1;11
89;02.08.2014;2014;08;04;Lauantai;10;4;14;6;1;7
89;02.08.2014;2014;08;05;Lauantai;4;6;10;4;2;6
89;02.08.2014;2014;08;06;Lauantai;10;16;26;3;3;6
89;02.08.2014;2014;08;07;Lauantai;8;29;37;4;9;13
89;02.08.2014;2014;08;08;Lauantai;14;19;33;8;11;19
89;02.08.2014;2014;08;09;Lauantai;19;71;90;9;16;25
89;02.08.2014;2014;08;10;Lauantai;42;88;130;15;38;53
89;02.08.2014;2014;08;11;Lauantai;54;102;156;14;22;36
89;02.08.2014;2014;08;12;Lauantai;92;169;261;16;43;59
89;02.08.2014;2014;08;13;Lauantai;101;149;250;31;51;82
89;02.08.2014;2014;08;14;Lauantai;125;147;272;59;60;119
89;02.08.2014;2014;08;15;Lauantai;142;101;243;40;30;70
89;02.08.2014;2014;08;16;Lauantai;138;93;231;31;52;83
89;02.08.2014;2014;08;17;Lauantai;158;88;246;30;25;55
89;02.08.2014;2014;08;18;Lauantai;102;121;223;25;37;62
89;02.08.2014;2014;08;19;Lauantai;95;127;222;24;35;59
89;02.08.2014;2014;08;20;Lauantai;75;109;184;12;28;40
89;02.08.2014;2014;08;21;Lauantai;71;100;171;14;20;34
89;02.08.2014;2014;08;22;Lauantai;59;81;140;12;35;47
89;02.08.2014;2014;08;23;Lauantai;74;41;115;12;17;29
89;03.08.2014;2014;08;00;Sunnuntai;36;36;72;9;10;19
89;03.08.2014;2014;08;01;Sunnuntai;47;16;63;6;4;10
89;03.08.2014;2014;08;02;Sunnuntai;46;9;55;15;2;17
89;03.08.2014;2014;08;03;Sunnuntai;52;2;54;11;0;11
89;03.08.2014;2014;08;04;Sunnuntai;29;3;32;8;0;8
89;03.08.2014;2014;08;05;Sunnuntai;11;3;14;1;1;2
89;03.08.2014;2014;08;06;Sunnuntai;15;13;28;5;2;7
89;03.08.2014;2014;08;07;Sunnuntai;2;10;12;3;3;6
89;03.08.2014;2014;08;08;Sunnuntai;15;12;27;7;10;17
89;03.08.2014;2014;08;09;Sunnuntai;14;44;58;11;17;28
89;03.08.2014;2014;08;10;Sunnuntai;38;57;95;11;23;34
89;03.08.2014;2014;08;11;Sunnuntai;51;84;135;22;40;62
89;03.08.2014;2014;08;12;Sunnuntai;91;118;209;16;33;49
89;03.08.2014;2014;08;13;Sunnuntai;110;137;247;37;34;71
89;03.08.2014;2014;08;14;Sunnuntai;150;135;285;35;55;90
89;03.08.2014;2014;08;15;Sunnuntai;159;132;291;32;44;76
89;03.08.2014;2014;08;16;Sunnuntai;156;132;288;27;52;79
89;03.08.2014;2014;08;17;Sunnuntai;173;118;291;51;49;100
89;03.08.2014;2014;08;18;Sunnuntai;137;99;236;24;35;59
89;03.08.2014;2014;08;19;Sunnuntai;89;107;196;22;44;66
89;03.08.2014;2014;08;20;Sunnuntai;98;100;198;27;20;47
89;03.08.2014;2014;08;21;Sunnuntai;52;54;106;14;23;37
89;03.08.2014;2014;08;22;Sunnuntai;50;39;89;9;9;18
89;03.08.2014;2014;08;23;Sunnuntai;21;23;44;1;7;8
89;04.08.2014;2014;08;00;Maanantai;16;12;28;4;5;9
89;04.08.2014;2014;08;01;Maanantai;12;3;15;3;0;3
89;04.08.2014;2014;08;02;Maanantai;1;2;3;1;2;3
89;04.08.2014;2014;08;03;Maanantai;6;6;12;2;0;2
89;04.08.2014;2014;08;04;Maanantai;10;4;14;2;0;2
89;04.08.2014;2014;08;05;Maanantai;6;16;22;2;0;2
89;04.08.2014;2014;08;06;Maanantai;21;72;93;3;2;5
89;04.08.2014;2014;08;07;Maanantai;40;193;233;3;29;32
89;04.08.2014;2014;08;08;Maanantai;43;177;220;12;17;29
89;04.08.2014;2014;08;09;Maanantai;43;107;150;12;27;39
89;04.08.2014;2014;08;10;Maanantai;46;82;128;17;36;53
89;04.08.2014;2014;08;11;Maanantai;81;130;211;11;28;39
89;04.08.2014;2014;08;12;Maanantai;101;111;212;26;41;67
89;04.08.2014;2014;08;13;Maanantai;116;120;236;31;39;70
89;04.08.2014;2014;08;14;Maanantai;196;122;318;33;22;55
89;04.08.2014;2014;08;15;Maanantai;262;162;424;26;30;56
89;04.08.2014;2014;08;16;Maanantai;258;143;401;30;23;53
89;04.08.2014;2014;08;17;Maanantai;200;156;356;30;30;60
89;04.08.2014;2014;08;18;Maanantai;190;141;331;33;36;69
89;04.08.2014;2014;08;19;Maanantai;136;121;257;18;28;46
89;04.08.2014;2014;08;20;Maanantai;119;111;230;27;32;59
89;04.08.2014;2014;08;21;Maanantai;106;86;192;32;19;51
89;04.08.2014;2014;08;22;Maanantai;50;56;106;8;18;26
89;04.08.2014;2014;08;23;Maanantai;20;16;36;3;5;8
89;05.08.2014;2014;08;00;Tiistai;22;17;39;3;11;14
89;05.08.2014;2014;08;01;Tiistai;8;10;18;2;2;4
89;05.08.2014;2014;08;02;Tiistai;6;3;9;4;0;4
89;05.08.2014;2014;08;03;Tiistai;3;0;3;1;2;3
89;05.08.2014;2014;08;04;Tiistai;3;0;3;1;0;1
89;05.08.2014;2014;08;05;Tiistai;5;2;7;5;0;5
89;05.08.2014;2014;08;06;Tiistai;17;8;25;5;2;7
89;05.08.2014;2014;08;07;Tiistai;56;165;221;14;25;39
89;05.08.2014;2014;08;08;Tiistai;38;198;236;7;35;42
89;05.08.2014;2014;08;09;Tiistai;50;119;169;7;29;36
89;05.08.2014;2014;08;10;Tiistai;56;105;161;13;42;55
89;05.08.2014;2014;08;11;Tiistai;101;109;210;27;26;53
89;05.08.2014;2014;08;12;Tiistai;117;133;250;13;29;42
89;05.08.2014;2014;08;13;Tiistai;161;162;323;22;24;46
89;05.08.2014;2014;08;14;Tiistai;200;133;333;30;18;48
89;05.08.2014;2014;08;15;Tiistai;269;146;415;34;16;50
89;05.08.2014;2014;08;16;Tiistai;294;152;446;37;32;69
89;05.08.2014;2014;08;17;Tiistai;200;223;423;27;45;72
89;05.08.2014;2014;08;18;Tiistai;173;160;333;36;48;84
89;05.08.2014;2014;08;19;Tiistai;166;149;315;22;28;50
89;05.08.2014;2014;08;20;Tiistai;151;139;290;13;36;49
89;05.08.2014;2014;08;21;Tiistai;108;80;188;30;23;53
89;05.08.2014;2014;08;22;Tiistai;64;44;108;8;17;25
89;05.08.2014;2014;08;23;Tiistai;34;22;56;6;12;18
89;06.08.2014;2014;08;00;Keskiviikko;19;21;40;4;8;12
89;06.08.2014;2014;08;01;Keskiviikko;14;5;19;0;0;0
89;06.08.2014;2014;08;02;Keskiviikko;6;0;6;1;2;3
89;06.08.2014;2014;08;03;Keskiviikko;8;3;11;3;0;3
89;06.08.2014;2014;08;04;Keskiviikko;9;1;10;1;0;1
89;06.08.2014;2014;08;05;Keskiviikko;6;9;15;1;0;1
89;06.08.2014;2014;08;06;Keskiviikko;15;75;90;6;8;14
89;06.08.2014;2014;08;07;Keskiviikko;48;210;258;6;22;28
89;06.08.2014;2014;08;08;Keskiviikko;50;201;251;11;33;44
89;06.08.2014;2014;08;09;Keskiviikko;51;155;206;13;29;42
89;06.08.2014;2014;08;10;Keskiviikko;64;131;195;19;50;69
89;06.08.2014;2014;08;11;Keskiviikko;126;128;254;26;33;59
89;06.08.2014;2014;08;12;Keskiviikko;144;171;315;18;36;54
89;06.08.2014;2014;08;13;Keskiviikko;167;137;304;25;27;52
89;06.08.2014;2014;08;14;Keskiviikko;223;128;351;33;31;64
89;06.08.2014;2014;08;15;Keskiviikko;251;166;417;41;27;68
89;06.08.2014;2014;08;16;Keskiviikko;284;169;453;30;21;51
89;06.08.2014;2014;08;17;Keskiviikko;198;200;398;34;59;93
89;06.08.2014;2014;08;18;Keskiviikko;197;153;350;33;53;86
89;06.08.2014;2014;08;19;Keskiviikko;204;201;405;20;49;69
89;06.08.2014;2014;08;20;Keskiviikko;166;127;293;29;40;69
89;06.08.2014;2014;08;21;Keskiviikko;115;96;211;26;22;48
89;06.08.2014;2014;08;22;Keskiviikko;71;44;115;10;13;23
89;06.08.2014;2014;08;23;Keskiviikko;26;36;62;4;11;15
89;07.08.2014;2014;08;00;Torstai;27;14;41;8;5;13
89;07.08.2014;2014;08;01;Torstai;15;9;24;2;1;3
89;07.08.2014;2014;08;02;Torstai;10;5;15;5;0;5
89;07.08.2014;2014;08;03;Torstai;11;5;16;3;0;3
89;07.08.2014;2014;08;04;Torstai;17;10;27;2;1;3
89;07.08.2014;2014;08;05;Torstai;6;2;8;0;2;2
89;07.08.2014;2014;08;06;Torstai;16;61;77;3;3;6
89;07.08.2014;2014;08;07;Torstai;39;204;243;6;24;30
89;07.08.2014;2014;08;08;Torstai;46;243;289;8;31;39
89;07.08.2014;2014;08;09;Torstai;44;205;249;9;26;35
89;07.08.2014;2014;08;10;Torstai;71;141;212;11;31;42
89;07.08.2014;2014;08;11;Torstai;112;113;225;13;29;42
89;07.08.2014;2014;08;12;Torstai;144;132;276;26;20;46
89;07.08.2014;2014;08;13;Torstai;163;108;271;26;13;39
89;07.08.2014;2014;08;14;Torstai;199;144;343;38;33;71
89;07.08.2014;2014;08;15;Torstai;281;138;419;26;32;58
89;07.08.2014;2014;08;16;Torstai;296;166;462;40;39;79
89;07.08.2014;2014;08;17;Torstai;146;198;344;30;51;81
89;07.08.2014;2014;08;18;Torstai;205;144;349;35;37;72
89;07.08.2014;2014;08;19;Torstai;125;126;251;22;37;59
89;07.08.2014;2014;08;20;Torstai;161;137;298;25;33;58
89;07.08.2014;2014;08;21;Torstai;97;70;167;15;15;30
89;07.08.2014;2014;08;22;Torstai;40;32;72;6;8;14
89;07.08.2014;2014;08;23;Torstai;19;23;42;7;5;12
89;08.08.2014;2014;08;00;Perjantai;16;7;23;5;11;16
89;08.08.2014;2014;08;01;Perjantai;8;4;12;3;1;4
89;08.08.2014;2014;08;02;Perjantai;6;5;11;3;1;4
89;08.08.2014;2014;08;03;Perjantai;2;1;3;1;0;1
89;08.08.2014;2014;08;04;Perjantai;3;1;4;2;0;2
89;08.08.2014;2014;08;05;Perjantai;3;17;20;6;0;6
89;08.08.2014;2014;08;06;Perjantai;20;66;86;7;10;17
89;08.08.2014;2014;08;07;Perjantai;42;196;238;4;23;27
89;08.08.2014;2014;08;08;Perjantai;53;206;259;10;28;38
89;08.08.2014;2014;08;09;Perjantai;45;159;204;12;18;30
89;08.08.2014;2014;08;10;Perjantai;55;142;197;16;33;49
89;08.08.2014;2014;08;11;Perjantai;92;104;196;15;34;49
89;08.08.2014;2014;08;12;Perjantai;110;106;216;20;20;40
89;08.08.2014;2014;08;13;Perjantai;127;112;239;20;30;50
89;08.08.2014;2014;08;14;Perjantai;190;118;308;26;18;44
89;08.08.2014;2014;08;15;Perjantai;190;100;290;12;24;36
89;08.08.2014;2014;08;16;Perjantai;188;140;328;12;19;31
89;08.08.2014;2014;08;17;Perjantai;128;120;248;17;27;44
89;08.08.2014;2014;08;18;Perjantai;98;101;199;21;25;46
89;08.08.2014;2014;08;19;Perjantai;124;131;255;24;37;61
89;08.08.2014;2014;08;20;Perjantai;100;103;203;28;32;60
89;08.08.2014;2014;08;21;Perjantai;55;113;168;17;32;49
89;08.08.2014;2014;08;22;Perjantai;50;86;136;12;19;31
89;08.08.2014;2014;08;23;Perjantai;62;44;106;13;10;23
89;09.08.2014;2014;08;00;Lauantai;45;33;78;8;14;22
89;09.08.2014;2014;08;01;Lauantai;63;20;83;7;6;13
89;09.08.2014;2014;08;02;Lauantai;50;11;61;8;0;8
89;09.08.2014;2014;08;03;Lauantai;39;8;47;8;1;9
89;09.08.2014;2014;08;04;Lauantai;28;6;34;10;4;14
89;09.08.2014;2014;08;05;Lauantai;3;3;6;4;3;7
89;09.08.2014;2014;08;06;Lauantai;10;13;23;4;0;4
89;09.08.2014;2014;08;07;Lauantai;12;19;31;7;9;16
89;09.08.2014;2014;08;08;Lauantai;16;27;43;12;23;35
89;09.08.2014;2014;08;09;Lauantai;20;84;104;7;28;35
89;09.08.2014;2014;08;10;Lauantai;52;88;140;24;34;58
89;09.08.2014;2014;08;11;Lauantai;62;113;175;12;33;45
89;09.08.2014;2014;08;12;Lauantai;78;107;185;26;29;55
89;09.08.2014;2014;08;13;Lauantai;113;121;234;20;43;63
89;09.08.2014;2014;08;14;Lauantai;120;115;235;34;30;64
89;09.08.2014;2014;08;15;Lauantai;138;94;232;22;24;46
89;09.08.2014;2014;08;16;Lauantai;54;50;104;8;10;18
89;09.08.2014;2014;08;17;Lauantai;67;37;104;16;8;24
89;09.08.2014;2014;08;18;Lauantai;58;34;92;9;8;17
89;09.08.2014;2014;08;19;Lauantai;37;19;56;10;12;22
89;09.08.2014;2014;08;20;Lauantai;34;23;57;6;7;13
89;09.08.2014;2014;08;21;Lauantai;10;18;28;4;3;7
89;09.08.2014;2014;08;22;Lauantai;17;16;33;3;7;10
89;09.08.2014;2014;08;23;Lauantai;12;8;20;0;1;1
89;10.08.2014;2014;08;00;Sunnuntai;14;25;39;2;4;6
89;10.08.2014;2014;08;01;Sunnuntai;13;9;22;5;0;5
89;10.08.2014;2014;08;02;Sunnuntai;10;3;13;1;0;1
89;10.08.2014;2014;08;03;Sunnuntai;18;5;23;7;0;7
89;10.08.2014;2014;08;04;Sunnuntai;14;3;17;12;0;12
89;10.08.2014;2014;08;05;Sunnuntai;6;2;8;2;1;3
89;10.08.2014;2014;08;06;Sunnuntai;4;9;13;3;3;6
89;10.08.2014;2014;08;07;Sunnuntai;5;10;15;5;3;8
89;10.08.2014;2014;08;08;Sunnuntai;4;6;10;5;3;8
89;10.08.2014;2014;08;09;Sunnuntai;13;17;30;9;12;21
89;10.08.2014;2014;08;10;Sunnuntai;13;23;36;15;22;37
89;10.08.2014;2014;08;11;Sunnuntai;22;64;86;22;41;63
89;10.08.2014;2014;08;12;Sunnuntai;47;118;165;24;41;65
89;10.08.2014;2014;08;13;Sunnuntai;62;85;147;21;38;59
89;10.08.2014;2014;08;14;Sunnuntai;94;87;181;27;37;64
89;10.08.2014;2014;08;15;Sunnuntai;94;93;187;29;30;59
89;10.08.2014;2014;08;16;Sunnuntai;108;80;188;32;41;73
89;10.08.2014;2014;08;17;Sunnuntai;115;89;204;35;36;71
89;10.08.2014;2014;08;18;Sunnuntai;96;109;205;38;50;88
89;10.08.2014;2014;08;19;Sunnuntai;106;72;178;44;49;93
89;10.08.2014;2014;08;20;Sunnuntai;80;92;172;24;43;67
89;10.08.2014;2014;08;21;Sunnuntai;52;48;100;11;17;28
89;10.08.2014;2014;08;22;Sunnuntai;30;31;61;6;6;12
89;10.08.2014;2014;08;23;Sunnuntai;22;18;40;5;7;12
89;11.08.2014;2014;08;00;Maanantai;13;6;19;6;2;8
89;11.08.2014;2014;08;01;Maanantai;3;8;11;1;2;3
89;11.08.2014;2014;08;02;Maanantai;5;0;5;1;1;2
89;11.08.2014;2014;08;03;Maanantai;10;6;16;2;0;2
89;11.08.2014;2014;08;04;Maanantai;9;3;12;2;1;3
89;11.08.2014;2014;08;05;Maanantai;4;15;19;0;4;4
89;11.08.2014;2014;08;06;Maanantai;21;86;107;5;10;15
89;11.08.2014;2014;08;07;Maanantai;56;318;374;3;33;36
89;11.08.2014;2014;08;08;Maanantai;57;264;321;9;26;35
89;11.08.2014;2014;08;09;Maanantai;57;199;256;16;44;60
89;11.08.2014;2014;08;10;Maanantai;57;118;175;19;35;54
89;11.08.2014;2014;08;11;Maanantai;107;100;207;34;33;67
89;11.08.2014;2014;08;12;Maanantai;118;149;267;19;35;54
89;11.08.2014;2014;08;13;Maanantai;151;132;283;31;28;59
89;11.08.2014;2014;08;14;Maanantai;207;150;357;25;29;54
89;11.08.2014;2014;08;15;Maanantai;285;149;434;40;42;82
89;11.08.2014;2014;08;16;Maanantai;359;166;525;37;24;61
89;11.08.2014;2014;08;17;Maanantai;205;147;352;33;33;66
89;11.08.2014;2014;08;18;Maanantai;172;150;322;26;37;63
89;11.08.2014;2014;08;19;Maanantai;149;93;242;38;37;75
89;11.08.2014;2014;08;20;Maanantai;124;77;201;35;31;66
89;11.08.2014;2014;08;21;Maanantai;67;47;114;16;22;38
89;11.08.2014;2014;08;22;Maanantai;32;18;50;11;10;21
89;11.08.2014;2014;08;23;Maanantai;24;11;35;4;4;8
89;12.08.2014;2014;08;00;Tiistai;8;9;17;1;2;3
89;12.08.2014;2014;08;01;Tiistai;5;7;12;1;2;3
89;12.08.2014;2014;08;02;Tiistai;7;4;11;0;1;1
89;12.08.2014;2014;08;03;Tiistai;2;6;8;1;1;2
89;12.08.2014;2014;08;04;Tiistai;1;7;8;2;0;2
89;12.08.2014;2014;08;05;Tiistai;6;9;15;3;1;4
89;12.08.2014;2014;08;06;Tiistai;20;90;110;7;8;15
89;12.08.2014;2014;08;07;Tiistai;51;270;321;8;29;37
89;12.08.2014;2014;08;08;Tiistai;67;248;315;12;30;42
89;12.08.2014;2014;08;09;Tiistai;45;143;188;6;13;19
89;12.08.2014;2014;08;10;Tiistai;34;30;64;4;16;20
89;12.08.2014;2014;08;11;Tiistai;37;25;62;14;10;24
89;12.08.2014;2014;08;12;Tiistai;41;37;78;8;7;15
89;12.08.2014;2014;08;13;Tiistai;52;49;101;12;11;23
89;12.08.2014;2014;08;14;Tiistai;113;68;181;16;22;38
89;12.08.2014;2014;08;15;Tiistai;201;99;300;34;22;56
89;12.08.2014;2014;08;16;Tiistai;252;107;359;23;17;40
89;12.08.2014;2014;08;17;Tiistai;137;112;249;25;29;54
89;12.08.2014;2014;08;18;Tiistai;105;87;192;34;36;70
89;12.08.2014;2014;08;19;Tiistai;109;63;172;38;50;88
89;12.08.2014;2014;08;20;Tiistai;88;48;136;25;41;66
89;12.08.2014;2014;08;21;Tiistai;58;42;100;16;19;35
89;12.08.2014;2014;08;22;Tiistai;32;19;51;7;5;12
89;12.08.2014;2014;08;23;Tiistai;12;10;22;2;10;12
89;13.08.2014;2014;08;00;Keskiviikko;8;11;19;1;2;3
89;13.08.2014;2014;08;01;Keskiviikko;10;2;12;2;1;3
89;13.08.2014;2014;08;02;Keskiviikko;5;1;6;1;1;2
89;13.08.2014;2014;08;03;Keskiviikko;3;3;6;1;1;2
89;13.08.2014;2014;08;04;Keskiviikko;3;7;10;1;1;2
89;13.08.2014;2014;08;05;Keskiviikko;3;16;19;1;1;2
89;13.08.2014;2014;08;06;Keskiviikko;29;75;104;2;4;6
89;13.08.2014;2014;08;07;Keskiviikko;71;318;389;5;33;38
89;13.08.2014;2014;08;08;Keskiviikko;58;278;336;13;37;50
89;13.08.2014;2014;08;09;Keskiviikko;54;163;217;13;30;43
89;13.08.2014;2014;08;10;Keskiviikko;56;114;170;24;36;60
89;13.08.2014;2014;08;11;Keskiviikko;103;111;214;18;20;38
89;13.08.2014;2014;08;12;Keskiviikko;124;115;239;32;21;53
89;13.08.2014;2014;08;13;Keskiviikko;153;93;246;27;24;51
89;13.08.2014;2014;08;14;Keskiviikko;185;96;281;31;21;52
89;13.08.2014;2014;08;15;Keskiviikko;250;123;373;27;25;52
89;13.08.2014;2014;08;16;Keskiviikko;270;116;386;38;14;52
89;13.08.2014;2014;08;17;Keskiviikko;149;149;298;18;59;77
89;13.08.2014;2014;08;18;Keskiviikko;145;85;230;29;44;73
89;13.08.2014;2014;08;19;Keskiviikko;142;62;204;45;26;71
89;13.08.2014;2014;08;20;Keskiviikko;142;71;213;33;30;63
89;13.08.2014;2014;08;21;Keskiviikko;62;50;112;15;19;34
89;13.08.2014;2014;08;22;Keskiviikko;38;25;63;13;7;20
89;13.08.2014;2014;08;23;Keskiviikko;20;17;37;4;3;7
89;14.08.2014;2014;08;00;Torstai;14;4;18;3;0;3
89;14.08.2014;2014;08;01;Torstai;11;6;17;0;1;1
89;14.08.2014;2014;08;02;Torstai;2;0;2;2;3;5
89;14.08.2014;2014;08;03;Torstai;4;4;8;1;1;2
89;14.08.2014;2014;08;04;Torstai;11;4;15;1;0;1
89;14.08.2014;2014;08;05;Torstai;6;14;20;0;0;0
89;14.08.2014;2014;08;06;Torstai;25;87;112;3;11;14
89;14.08.2014;2014;08;07;Torstai;52;289;341;3;27;30
89;14.08.2014;2014;08;08;Torstai;59;284;343;16;29;45
89;14.08.2014;2014;08;09;Torstai;46;140;186;19;33;52
89;14.08.2014;2014;08;10;Torstai;56;111;167;16;49;65
89;14.08.2014;2014;08;11;Torstai;85;115;200;21;27;48
89;14.08.2014;2014;08;12;Torstai;95;107;202;14;24;38
89;14.08.2014;2014;08;13;Torstai;133;100;233;29;14;43
89;14.08.2014;2014;08;14;Torstai;182;130;312;24;26;50
89;14.08.2014;2014;08;15;Torstai;260;128;388;26;18;44
89;14.08.2014;2014;08;16;Torstai;272;104;376;17;16;33
89;14.08.2014;2014;08;17;Torstai;122;111;233;13;28;41
89;14.08.2014;2014;08;18;Torstai;85;106;191;19;25;44
89;14.08.2014;2014;08;19;Torstai;109;87;196;24;21;45
89;14.08.2014;2014;08;20;Torstai;101;62;163;19;17;36
89;14.08.2014;2014;08;21;Torstai;81;58;139;19;18;37
89;14.08.2014;2014;08;22;Torstai;85;28;113;13;13;26
89;14.08.2014;2014;08;23;Torstai;22;8;30;6;5;11
89;15.08.2014;2014;08;00;Perjantai;24;4;28;1;2;3
89;15.08.2014;2014;08;01;Perjantai;13;4;17;2;4;6
89;15.08.2014;2014;08;02;Perjantai;4;1;5;5;0;5
89;15.08.2014;2014;08;03;Perjantai;10;1;11;3;0;3
89;15.08.2014;2014;08;04;Perjantai;12;6;18;1;0;1
89;15.08.2014;2014;08;05;Perjantai;10;13;23;1;1;2
89;15.08.2014;2014;08;06;Perjantai;26;71;97;4;9;13
89;15.08.2014;2014;08;07;Perjantai;56;229;285;9;27;36
89;15.08.2014;2014;08;08;Perjantai;54;243;297;8;27;35
89;15.08.2014;2014;08;09;Perjantai;43;160;203;28;33;61
89;15.08.2014;2014;08;10;Perjantai;52;115;167;16;30;46
89;15.08.2014;2014;08;11;Perjantai;80;110;190;10;22;32
89;15.08.2014;2014;08;12;Perjantai;97;103;200;26;20;46
89;15.08.2014;2014;08;13;Perjantai;148;98;246;32;35;67
89;15.08.2014;2014;08;14;Perjantai;203;115;318;13;13;26
89;15.08.2014;2014;08;15;Perjantai;240;128;368;32;23;55
89;15.08.2014;2014;08;16;Perjantai;202;105;307;31;20;51
89;15.08.2014;2014;08;17;Perjantai;123;106;229;21;19;40
89;15.08.2014;2014;08;18;Perjantai;109;96;205;13;28;41
89;15.08.2014;2014;08;19;Perjantai;82;109;191;19;30;49
89;15.08.2014;2014;08;20;Perjantai;86;78;164;20;20;40
89;15.08.2014;2014;08;21;Perjantai;71;76;147;27;18;45
89;15.08.2014;2014;08;22;Perjantai;44;80;124;9;15;24
89;15.08.2014;2014;08;23;Perjantai;43;39;82;13;9;22
89;16.08.2014;2014;08;00;Lauantai;45;34;79;4;5;9
89;16.08.2014;2014;08;01;Lauantai;45;15;60;8;1;9
89;16.08.2014;2014;08;02;Lauantai;42;3;45;11;0;11
89;16.08.2014;2014;08;03;Lauantai;40;7;47;3;1;4
89;16.08.2014;2014;08;04;Lauantai;28;5;33;1;2;3
89;16.08.2014;2014;08;05;Lauantai;7;6;13;1;1;2
89;16.08.2014;2014;08;06;Lauantai;9;15;24;0;1;1
89;16.08.2014;2014;08;07;Lauantai;5;26;31;3;5;8
89;16.08.2014;2014;08;08;Lauantai;12;28;40;11;22;33
89;16.08.2014;2014;08;09;Lauantai;26;70;96;14;25;39
89;16.08.2014;2014;08;10;Lauantai;28;93;121;11;32;43
89;16.08.2014;2014;08;11;Lauantai;84;101;185;26;33;59
89;16.08.2014;2014;08;12;Lauantai;80;145;225;23;48;71
89;16.08.2014;2014;08;13;Lauantai;102;131;233;32;44;76
89;16.08.2014;2014;08;14;Lauantai;123;105;228;29;44;73
89;16.08.2014;2014;08;15;Lauantai;147;91;238;33;29;62
89;16.08.2014;2014;08;16;Lauantai;129;63;192;20;40;60
89;16.08.2014;2014;08;17;Lauantai;82;99;181;27;28;55
89;16.08.2014;2014;08;18;Lauantai;92;96;188;17;25;42
89;16.08.2014;2014;08;19;Lauantai;84;68;152;21;20;41
89;16.08.2014;2014;08;20;Lauantai;46;75;121;26;29;55
89;16.08.2014;2014;08;21;Lauantai;54;47;101;11;11;22
89;16.08.2014;2014;08;22;Lauantai;23;40;63;8;14;22
89;16.08.2014;2014;08;23;Lauantai;25;27;52;2;7;9
89;17.08.2014;2014;08;00;Sunnuntai;26;31;57;8;3;11
89;17.08.2014;2014;08;01;Sunnuntai;33;16;49;2;0;2
89;17.08.2014;2014;08;02;Sunnuntai;27;2;29;8;0;8
89;17.08.2014;2014;08;03;Sunnuntai;25;6;31;14;0;14
89;17.08.2014;2014;08;04;Sunnuntai;27;4;31;8;0;8
89;17.08.2014;2014;08;05;Sunnuntai;10;5;15;4;1;5
89;17.08.2014;2014;08;06;Sunnuntai;3;7;10;2;0;2
89;17.08.2014;2014;08;07;Sunnuntai;6;10;16;0;0;0
89;17.08.2014;2014;08;08;Sunnuntai;6;10;16;3;3;6
89;17.08.2014;2014;08;09;Sunnuntai;13;33;46;20;18;38
89;17.08.2014;2014;08;10;Sunnuntai;21;61;82;19;34;53
89;17.08.2014;2014;08;11;Sunnuntai;62;86;148;27;57;84
89;17.08.2014;2014;08;12;Sunnuntai;66;146;212;40;45;85
89;17.08.2014;2014;08;13;Sunnuntai;109;137;246;38;67;105
89;17.08.2014;2014;08;14;Sunnuntai;115;138;253;33;60;93
89;17.08.2014;2014;08;15;Sunnuntai;156;93;249;46;39;85
89;17.08.2014;2014;08;16;Sunnuntai;108;78;186;30;33;63
89;17.08.2014;2014;08;17;Sunnuntai;93;67;160;29;30;59
89;17.08.2014;2014;08;18;Sunnuntai;75;76;151;19;27;46
89;17.08.2014;2014;08;19;Sunnuntai;59;57;116;26;23;49
89;17.08.2014;2014;08;20;Sunnuntai;55;41;96;28;28;56
89;17.08.2014;2014;08;21;Sunnuntai;36;31;67;11;9;20
89;17.08.2014;2014;08;22;Sunnuntai;15;26;41;2;4;6
89;17.08.2014;2014;08;23;Sunnuntai;14;12;26;3;1;4
89;18.08.2014;2014;08;00;Maanantai;5;3;8;1;2;3
89;18.08.2014;2014;08;01;Maanantai;6;4;10;2;1;3
89;18.08.2014;2014;08;02;Maanantai;2;1;3;0;1;1
89;18.08.2014;2014;08;03;Maanantai;5;2;7;0;0;0
89;18.08.2014;2014;08;04;Maanantai;2;4;6;0;0;0
89;18.08.2014;2014;08;05;Maanantai;5;14;19;2;2;4
89;18.08.2014;2014;08;06;Maanantai;24;71;95;4;9;13
89;18.08.2014;2014;08;07;Maanantai;67;279;346;7;19;26
89;18.08.2014;2014;08;08;Maanantai;53;304;357;8;35;43
89;18.08.2014;2014;08;09;Maanantai;51;159;210;15;26;41
89;18.08.2014;2014;08;10;Maanantai;59;124;183;25;20;45
89;18.08.2014;2014;08;11;Maanantai;90;100;190;17;30;47
89;18.08.2014;2014;08;12;Maanantai;102;128;230;19;38;57
89;18.08.2014;2014;08;13;Maanantai;111;99;210;23;28;51
89;18.08.2014;2014;08;14;Maanantai;178;111;289;27;28;55
89;18.08.2014;2014;08;15;Maanantai;259;114;373;24;19;43
89;18.08.2014;2014;08;16;Maanantai;283;87;370;23;7;30
89;18.08.2014;2014;08;17;Maanantai;121;34;155;14;10;24
89;18.08.2014;2014;08;18;Maanantai;78;20;98;13;11;24
89;18.08.2014;2014;08;19;Maanantai;52;31;83;17;14;31
89;18.08.2014;2014;08;20;Maanantai;47;24;71;18;18;36
89;18.08.2014;2014;08;21;Maanantai;19;18;37;10;10;20
89;18.08.2014;2014;08;22;Maanantai;12;12;24;11;7;18
89;18.08.2014;2014;08;23;Maanantai;12;5;17;4;2;6
89;19.08.2014;2014;08;00;Tiistai;7;3;10;2;1;3
89;19.08.2014;2014;08;01;Tiistai;4;2;6;2;0;2
89;19.08.2014;2014;08;02;Tiistai;4;2;6;0;0;0
89;19.08.2014;2014;08;03;Tiistai;0;2;2;0;0;0
89;19.08.2014;2014;08;04;Tiistai;0;5;5;0;0;0
89;19.08.2014;2014;08;05;Tiistai;3;10;13;2;0;2
89;19.08.2014;2014;08;06;Tiistai;24;72;96;5;7;12
89;19.08.2014;2014;08;07;Tiistai;44;260;304;7;25;32
89;19.08.2014;2014;08;08;Tiistai;42;266;308;6;29;35
89;19.08.2014;2014;08;09;Tiistai;53;184;237;12;30;42
89;19.08.2014;2014;08;10;Tiistai;50;69;119;14;27;41
89;19.08.2014;2014;08;11;Tiistai;71;76;147;15;9;24
89;19.08.2014;2014;08;12;Tiistai;59;78;137;11;15;26
89;19.08.2014;2014;08;13;Tiistai;116;101;217;25;21;46
89;19.08.2014;2014;08;14;Tiistai;150;105;255;30;30;60
89;19.08.2014;2014;08;15;Tiistai;259;103;362;20;23;43
89;19.08.2014;2014;08;16;Tiistai;279;130;409;41;18;59
89;19.08.2014;2014;08;17;Tiistai;155;87;242;19;26;45
89;19.08.2014;2014;08;18;Tiistai;96;77;173;28;26;54
89;19.08.2014;2014;08;19;Tiistai;103;59;162;30;27;57
89;19.08.2014;2014;08;20;Tiistai;95;55;150;28;33;61
89;19.08.2014;2014;08;21;Tiistai;52;21;73;20;7;27
89;19.08.2014;2014;08;22;Tiistai;23;9;32;3;2;5
89;19.08.2014;2014;08;23;Tiistai;7;3;10;1;2;3
89;20.08.2014;2014;08;00;Keskiviikko;4;7;11;1;4;5
89;20.08.2014;2014;08;01;Keskiviikko;2;2;4;0;0;0
89;20.08.2014;2014;08;02;Keskiviikko;2;2;4;0;0;0
89;20.08.2014;2014;08;03;Keskiviikko;5;3;8;1;0;1
89;20.08.2014;2014;08;04;Keskiviikko;5;6;11;1;0;1
89;20.08.2014;2014;08;05;Keskiviikko;4;15;19;3;1;4
89;20.08.2014;2014;08;06;Keskiviikko;24;86;110;6;7;13
89;20.08.2014;2014;08;07;Keskiviikko;55;287;342;6;30;36
89;20.08.2014;2014;08;08;Keskiviikko;49;269;318;5;39;44
89;20.08.2014;2014;08;09;Keskiviikko;32;183;215;20;21;41
89;20.08.2014;2014;08;10;Keskiviikko;66;90;156;12;21;33
89;20.08.2014;2014;08;11;Keskiviikko;80;100;180;18;26;44
89;20.08.2014;2014;08;12;Keskiviikko;105;89;194;25;25;50
89;20.08.2014;2014;08;13;Keskiviikko;131;105;236;23;35;58
89;20.08.2014;2014;08;14;Keskiviikko;172;103;275;24;24;48
89;20.08.2014;2014;08;15;Keskiviikko;214;135;349;22;21;43
89;20.08.2014;2014;08;16;Keskiviikko;265;125;390;23;36;59
89;20.08.2014;2014;08;17;Keskiviikko;140;84;224;25;20;45
89;20.08.2014;2014;08;18;Keskiviikko;96;77;173;34;35;69
89;20.08.2014;2014;08;19;Keskiviikko;97;49;146;26;30;56
89;20.08.2014;2014;08;20;Keskiviikko;92;45;137;18;17;35
89;20.08.2014;2014;08;21;Keskiviikko;48;26;74;13;12;25
89;20.08.2014;2014;08;22;Keskiviikko;19;10;29;7;6;13
89;20.08.2014;2014;08;23;Keskiviikko;14;5;19;2;3;5
89;21.08.2014;2014;08;00;Torstai;2;4;6;3;5;8
89;21.08.2014;2014;08;01;Torstai;3;3;6;0;1;1
89;21.08.2014;2014;08;02;Torstai;6;0;6;0;0;0
89;21.08.2014;2014;08;03;Torstai;3;2;5;1;0;1
89;21.08.2014;2014;08;04;Torstai;1;2;3;0;0;0
89;21.08.2014;2014;08;05;Torstai;3;8;11;2;0;2
89;21.08.2014;2014;08;06;Torstai;29;70;99;2;11;13
89;21.08.2014;2014;08;07;Torstai;41;255;296;5;20;25
89;21.08.2014;2014;08;08;Torstai;57;241;298;8;22;30
89;21.08.2014;2014;08;09;Torstai;36;145;181;9;21;30
89;21.08.2014;2014;08;10;Torstai;49;87;136;14;23;37
89;21.08.2014;2014;08;11;Torstai;73;121;194;14;33;47
89;21.08.2014;2014;08;12;Torstai;79;68;147;16;18;34
89;21.08.2014;2014;08;13;Torstai;78;64;142;18;24;42
89;21.08.2014;2014;08;14;Torstai;147;106;253;18;35;53
89;21.08.2014;2014;08;15;Torstai;222;118;340;30;27;57
89;21.08.2014;2014;08;16;Torstai;236;140;376;20;15;35
89;21.08.2014;2014;08;17;Torstai;136;123;259;25;24;49
89;21.08.2014;2014;08;18;Torstai;105;134;239;46;29;75
89;21.08.2014;2014;08;19;Torstai;123;107;230;39;75;114
89;21.08.2014;2014;08;20;Torstai;109;106;215;20;42;62
89;21.08.2014;2014;08;21;Torstai;86;45;131;33;18;51
89;21.08.2014;2014;08;22;Torstai;78;24;102;14;7;21
89;21.08.2014;2014;08;23;Torstai;49;19;68;12;9;21
89;22.08.2014;2014;08;00;Perjantai;34;14;48;7;7;14
89;22.08.2014;2014;08;01;Perjantai;39;13;52;8;0;8
89;22.08.2014;2014;08;02;Perjantai;14;10;24;2;5;7
89;22.08.2014;2014;08;03;Perjantai;11;4;15;1;1;2
89;22.08.2014;2014;08;04;Perjantai;10;7;17;2;1;3
89;22.08.2014;2014;08;05;Perjantai;6;9;15;5;1;6
89;22.08.2014;2014;08;06;Perjantai;21;72;93;4;10;14
89;22.08.2014;2014;08;07;Perjantai;46;215;261;6;25;31
89;22.08.2014;2014;08;08;Perjantai;60;216;276;12;34;46
89;22.08.2014;2014;08;09;Perjantai;38;141;179;13;23;36
89;22.08.2014;2014;08;10;Perjantai;60;89;149;9;21;30
89;22.08.2014;2014;08;11;Perjantai;53;126;179;26;26;52
89;22.08.2014;2014;08;12;Perjantai;92;99;191;19;30;49
89;22.08.2014;2014;08;13;Perjantai;131;91;222;24;12;36
89;22.08.2014;2014;08;14;Perjantai;193;88;281;21;28;49
89;22.08.2014;2014;08;15;Perjantai;220;93;313;20;12;32
89;22.08.2014;2014;08;16;Perjantai;171;107;278;12;12;24
89;22.08.2014;2014;08;17;Perjantai;143;113;256;26;23;49
89;22.08.2014;2014;08;18;Perjantai;105;93;198;20;32;52
89;22.08.2014;2014;08;19;Perjantai;101;70;171;32;19;51
89;22.08.2014;2014;08;20;Perjantai;67;67;134;23;19;42
89;22.08.2014;2014;08;21;Perjantai;54;59;113;13;21;34
89;22.08.2014;2014;08;22;Perjantai;48;46;94;9;16;25
89;22.08.2014;2014;08;23;Perjantai;29;36;65;9;9;18
89;23.08.2014;2014;08;00;Lauantai;17;31;48;1;6;7
89;23.08.2014;2014;08;01;Lauantai;27;11;38;1;1;2
89;23.08.2014;2014;08;02;Lauantai;27;16;43;7;6;13
89;23.08.2014;2014;08;03;Lauantai;28;5;33;2;0;2
89;23.08.2014;2014;08;04;Lauantai;20;1;21;8;0;8
89;23.08.2014;2014;08;05;Lauantai;9;7;16;2;3;5
89;23.08.2014;2014;08;06;Lauantai;7;13;20;1;5;6
89;23.08.2014;2014;08;07;Lauantai;6;18;24;6;2;8
89;23.08.2014;2014;08;08;Lauantai;18;36;54;9;15;24
89;23.08.2014;2014;08;09;Lauantai;19;66;85;6;23;29
89;23.08.2014;2014;08;10;Lauantai;33;90;123;14;32;46
89;23.08.2014;2014;08;11;Lauantai;54;123;177;37;145;182
89;23.08.2014;2014;08;12;Lauantai;80;140;220;22;40;62
89;23.08.2014;2014;08;13;Lauantai;87;145;232;21;53;74
89;23.08.2014;2014;08;14;Lauantai;110;129;239;27;40;67
89;23.08.2014;2014;08;15;Lauantai;129;72;201;31;24;55
89;23.08.2014;2014;08;16;Lauantai;134;72;206;26;26;52
89;23.08.2014;2014;08;17;Lauantai;75;62;137;19;20;39
89;23.08.2014;2014;08;18;Lauantai;61;56;117;9;14;23
89;23.08.2014;2014;08;19;Lauantai;58;49;107;18;26;44
89;23.08.2014;2014;08;20;Lauantai;60;60;120;18;16;34
89;23.08.2014;2014;08;21;Lauantai;31;39;70;10;17;27
89;23.08.2014;2014;08;22;Lauantai;27;51;78;5;14;19
89;23.08.2014;2014;08;23;Lauantai;26;27;53;4;7;11
89;24.08.2014;2014;08;00;Sunnuntai;27;26;53;2;4;6
89;24.08.2014;2014;08;01;Sunnuntai;29;28;57;4;3;7
89;24.08.2014;2014;08;02;Sunnuntai;29;10;39;4;1;5
89;24.08.2014;2014;08;03;Sunnuntai;25;4;29;8;1;9
89;24.08.2014;2014;08;04;Sunnuntai;27;6;33;7;1;8
89;24.08.2014;2014;08;05;Sunnuntai;7;6;13;6;0;6
89;24.08.2014;2014;08;06;Sunnuntai;7;11;18;2;1;3
89;24.08.2014;2014;08;07;Sunnuntai;2;8;10;1;3;4
89;24.08.2014;2014;08;08;Sunnuntai;7;5;12;11;7;18
89;24.08.2014;2014;08;09;Sunnuntai;16;29;45;14;29;43
89;24.08.2014;2014;08;10;Sunnuntai;22;42;64;19;40;59
89;24.08.2014;2014;08;11;Sunnuntai;53;85;138;37;38;75
89;24.08.2014;2014;08;12;Sunnuntai;58;64;122;28;40;68
89;24.08.2014;2014;08;13;Sunnuntai;72;96;168;35;43;78
89;24.08.2014;2014;08;14;Sunnuntai;94;59;153;35;34;69
89;24.08.2014;2014;08;15;Sunnuntai;71;46;117;19;9;28
89;24.08.2014;2014;08;16;Sunnuntai;56;48;104;20;25;45
89;24.08.2014;2014;08;17;Sunnuntai;64;50;114;17;15;32
89;24.08.2014;2014;08;18;Sunnuntai;57;54;111;24;37;61
89;24.08.2014;2014;08;19;Sunnuntai;54;43;97;26;18;44
89;24.08.2014;2014;08;20;Sunnuntai;51;30;81;17;20;37
89;24.08.2014;2014;08;21;Sunnuntai;22;16;38;7;10;17
89;24.08.2014;2014;08;22;Sunnuntai;16;16;32;4;6;10
89;24.08.2014;2014;08;23;Sunnuntai;4;5;9;6;3;9
89;25.08.2014;2014;08;00;Maanantai;3;12;15;3;1;4
89;25.08.2014;2014;08;01;Maanantai;3;2;5;3;1;4
89;25.08.2014;2014;08;02;Maanantai;4;3;7;0;2;2
89;25.08.2014;2014;08;03;Maanantai;1;3;4;1;0;1
89;25.08.2014;2014;08;04;Maanantai;2;3;5;2;0;2
89;25.08.2014;2014;08;05;Maanantai;6;13;19;3;4;7
89;25.08.2014;2014;08;06;Maanantai;26;81;107;4;6;10
89;25.08.2014;2014;08;07;Maanantai;64;259;323;5;17;22
89;25.08.2014;2014;08;08;Maanantai;61;264;325;7;35;42
89;25.08.2014;2014;08;09;Maanantai;66;183;249;13;32;45
89;25.08.2014;2014;08;10;Maanantai;58;105;163;16;26;42
89;25.08.2014;2014;08;11;Maanantai;96;132;228;28;31;59
89;25.08.2014;2014;08;12;Maanantai;115;140;255;15;37;52
89;25.08.2014;2014;08;13;Maanantai;136;87;223;24;19;43
89;25.08.2014;2014;08;14;Maanantai;181;119;300;18;25;43
89;25.08.2014;2014;08;15;Maanantai;272;139;411;28;18;46
89;25.08.2014;2014;08;16;Maanantai;281;123;404;30;27;57
89;25.08.2014;2014;08;17;Maanantai;151;113;264;27;30;57
89;25.08.2014;2014;08;18;Maanantai;130;74;204;32;32;64
89;25.08.2014;2014;08;19;Maanantai;119;62;181;32;32;64
89;25.08.2014;2014;08;20;Maanantai;82;62;144;31;13;44
89;25.08.2014;2014;08;21;Maanantai;44;30;74;10;12;22
89;25.08.2014;2014;08;22;Maanantai;25;14;39;10;11;21
89;25.08.2014;2014;08;23;Maanantai;11;4;15;3;1;4
89;26.08.2014;2014;08;00;Tiistai;9;1;10;3;1;4
89;26.08.2014;2014;08;01;Tiistai;9;2;11;0;0;0
89;26.08.2014;2014;08;02;Tiistai;4;1;5;1;0;1
89;26.08.2014;2014;08;03;Tiistai;5;0;5;1;0;1
89;26.08.2014;2014;08;04;Tiistai;2;5;7;2;0;2
89;26.08.2014;2014;08;05;Tiistai;3;10;13;2;1;3
89;26.08.2014;2014;08;06;Tiistai;18;77;95;4;11;15
89;26.08.2014;2014;08;07;Tiistai;58;240;298;6;22;28
89;26.08.2014;2014;08;08;Tiistai;50;259;309;3;36;39
89;26.08.2014;2014;08;09;Tiistai;77;161;238;1;24;25
89;26.08.2014;2014;08;10;Tiistai;52;74;126;20;23;43
89;26.08.2014;2014;08;11;Tiistai;66;77;143;23;22;45
89;26.08.2014;2014;08;12;Tiistai;60;90;150;14;17;31
89;26.08.2014;2014;08;13;Tiistai;92;104;196;24;21;45
89;26.08.2014;2014;08;14;Tiistai;162;109;271;20;15;35
89;26.08.2014;2014;08;15;Tiistai;215;121;336;30;13;43
89;26.08.2014;2014;08;16;Tiistai;273;95;368;16;11;27
89;26.08.2014;2014;08;17;Tiistai;130;84;214;23;10;33
89;26.08.2014;2014;08;18;Tiistai;109;62;171;21;24;45
89;26.08.2014;2014;08;19;Tiistai;76;47;123;25;22;47
89;26.08.2014;2014;08;20;Tiistai;62;33;95;14;11;25
89;26.08.2014;2014;08;21;Tiistai;43;27;70;12;8;20
89;26.08.2014;2014;08;22;Tiistai;20;17;37;9;4;13
89;26.08.2014;2014;08;23;Tiistai;6;3;9;2;1;3
89;27.08.2014;2014;08;00;Keskiviikko;4;4;8;1;0;1
89;27.08.2014;2014;08;01;Keskiviikko;6;2;8;0;0;0
89;27.08.2014;2014;08;02;Keskiviikko;4;1;5;0;0;0
89;27.08.2014;2014;08;03;Keskiviikko;0;2;2;1;0;1
89;27.08.2014;2014;08;04;Keskiviikko;1;0;1;1;0;1
89;27.08.2014;2014;08;05;Keskiviikko;5;12;17;3;0;3
89;27.08.2014;2014;08;06;Keskiviikko;17;66;83;0;6;6
89;27.08.2014;2014;08;07;Keskiviikko;51;232;283;3;29;32
89;27.08.2014;2014;08;08;Keskiviikko;50;223;273;7;31;38
89;27.08.2014;2014;08;09;Keskiviikko;51;96;147;5;21;26
89;27.08.2014;2014;08;10;Keskiviikko;33;53;86;14;20;34
89;27.08.2014;2014;08;11;Keskiviikko;46;55;101;9;12;21
89;27.08.2014;2014;08;12;Keskiviikko;61;67;128;11;10;21
89;27.08.2014;2014;08;13;Keskiviikko;120;70;190;14;16;30
89;27.08.2014;2014;08;14;Keskiviikko;132;88;220;19;29;48
89;27.08.2014;2014;08;15;Keskiviikko;184;95;279;23;19;42
89;27.08.2014;2014;08;16;Keskiviikko;217;81;298;24;14;38
89;27.08.2014;2014;08;17;Keskiviikko;132;79;211;19;17;36
89;27.08.2014;2014;08;18;Keskiviikko;92;69;161;24;23;47
89;27.08.2014;2014;08;19;Keskiviikko;78;39;117;23;23;46
89;27.08.2014;2014;08;20;Keskiviikko;55;42;97;11;17;28
89;27.08.2014;2014;08;21;Keskiviikko;34;27;61;9;20;29
89;27.08.2014;2014;08;22;Keskiviikko;27;27;54;8;7;15
89;27.08.2014;2014;08;23;Keskiviikko;12;11;23;4;1;5
89;28.08.2014;2014;08;00;Torstai;11;3;14;1;1;2
89;28.08.2014;2014;08;01;Torstai;6;10;16;1;0;1
89;28.08.2014;2014;08;02;Torstai;10;5;15;3;0;3
89;28.08.2014;2014;08;03;Torstai;10;4;14;2;0;2
89;28.08.2014;2014;08;04;Torstai;4;2;6;0;0;0
89;28.08.2014;2014;08;05;Torstai;9;9;18;0;2;2
89;28.08.2014;2014;08;06;Torstai;21;72;93;1;6;7
89;28.08.2014;2014;08;07;Torstai;47;228;275;7;17;24
89;28.08.2014;2014;08;08;Torstai;42;256;298;10;31;41
89;28.08.2014;2014;08;09;Torstai;52;147;199;18;33;51
89;28.08.2014;2014;08;10;Torstai;53;111;164;11;25;36
89;28.08.2014;2014;08;11;Torstai;74;98;172;10;24;34
89;28.08.2014;2014;08;12;Torstai;67;96;163;21;25;46
89;28.08.2014;2014;08;13;Torstai;101;100;201;29;19;48
89;28.08.2014;2014;08;14;Torstai;151;78;229;15;16;31
89;28.08.2014;2014;08;15;Torstai;214;112;326;24;12;36
89;28.08.2014;2014;08;16;Torstai;233;91;324;19;14;33
89;28.08.2014;2014;08;17;Torstai;124;75;199;18;18;36
89;28.08.2014;2014;08;18;Torstai;120;68;188;24;31;55
89;28.08.2014;2014;08;19;Torstai;99;60;159;31;26;57
89;28.08.2014;2014;08;20;Torstai;81;44;125;15;24;39
89;28.08.2014;2014;08;21;Torstai;45;39;84;15;12;27
89;28.08.2014;2014;08;22;Torstai;25;14;39;6;9;15
89;28.08.2014;2014;08;23;Torstai;17;8;25;2;5;7
89;29.08.2014;2014;08;00;Perjantai;14;4;18;1;0;1
89;29.08.2014;2014;08;01;Perjantai;8;1;9;0;3;3
89;29.08.2014;2014;08;02;Perjantai;0;1;1;2;1;3
89;29.08.2014;2014;08;03;Perjantai;3;5;8;0;0;0
89;29.08.2014;2014;08;04;Perjantai;2;1;3;2;0;2
89;29.08.2014;2014;08;05;Perjantai;4;8;12;2;1;3
89;29.08.2014;2014;08;06;Perjantai;22;74;96;2;7;9
89;29.08.2014;2014;08;07;Perjantai;56;232;288;3;31;34
89;29.08.2014;2014;08;08;Perjantai;51;246;297;12;37;49
89;29.08.2014;2014;08;09;Perjantai;58;139;197;14;68;82
89;29.08.2014;2014;08;10;Perjantai;60;113;173;34;37;71
89;29.08.2014;2014;08;11;Perjantai;87;126;213;25;26;51
89;29.08.2014;2014;08;12;Perjantai;90;97;187;19;27;46
89;29.08.2014;2014;08;13;Perjantai;146;109;255;18;15;33
89;29.08.2014;2014;08;14;Perjantai;190;107;297;23;26;49
89;29.08.2014;2014;08;15;Perjantai;200;111;311;19;32;51
89;29.08.2014;2014;08;16;Perjantai;179;99;278;18;17;35
89;29.08.2014;2014;08;17;Perjantai;116;86;202;26;18;44
89;29.08.2014;2014;08;18;Perjantai;80;69;149;14;16;30
89;29.08.2014;2014;08;19;Perjantai;68;97;165;17;30;47
89;29.08.2014;2014;08;20;Perjantai;51;82;133;20;26;46
89;29.08.2014;2014;08;21;Perjantai;66;40;106;15;14;29
89;29.08.2014;2014;08;22;Perjantai;63;29;92;7;6;13
89;29.08.2014;2014;08;23;Perjantai;50;19;69;3;14;17
89;30.08.2014;2014;08;00;Lauantai;22;26;48;3;3;6
89;30.08.2014;2014;08;01;Lauantai;28;8;36;3;1;4
89;30.08.2014;2014;08;02;Lauantai;26;8;34;5;2;7
89;30.08.2014;2014;08;03;Lauantai;29;6;35;9;0;9
89;30.08.2014;2014;08;04;Lauantai;19;2;21;6;0;6
89;30.08.2014;2014;08;05;Lauantai;8;8;16;4;2;6
89;30.08.2014;2014;08;06;Lauantai;12;15;27;1;1;2
89;30.08.2014;2014;08;07;Lauantai;3;15;18;1;5;6
89;30.08.2014;2014;08;08;Lauantai;8;44;52;4;11;15
89;30.08.2014;2014;08;09;Lauantai;12;86;98;11;18;29
89;30.08.2014;2014;08;10;Lauantai;35;136;171;15;42;57
89;30.08.2014;2014;08;11;Lauantai;63;145;208;23;51;74
89;30.08.2014;2014;08;12;Lauantai;78;128;206;35;118;153
89;30.08.2014;2014;08;13;Lauantai;99;121;220;32;50;82
89;30.08.2014;2014;08;14;Lauantai;144;108;252;27;26;53
89;30.08.2014;2014;08;15;Lauantai;122;87;209;27;24;51
89;30.08.2014;2014;08;16;Lauantai;92;62;154;16;19;35
89;30.08.2014;2014;08;17;Lauantai;95;73;168;42;39;81
89;30.08.2014;2014;08;18;Lauantai;74;73;147;15;28;43
89;30.08.2014;2014;08;19;Lauantai;69;50;119;17;25;42
89;30.08.2014;2014;08;20;Lauantai;63;54;117;16;10;26
89;30.08.2014;2014;08;21;Lauantai;48;28;76;5;11;16
89;30.08.2014;2014;08;22;Lauantai;36;30;66;4;9;13
89;30.08.2014;2014;08;23;Lauantai;30;27;57;3;7;10
89;31.08.2014;2014;08;00;Sunnuntai;15;31;46;4;7;11
89;31.08.2014;2014;08;01;Sunnuntai;19;12;31;2;4;6
89;31.08.2014;2014;08;02;Sunnuntai;18;2;20;5;0;5
89;31.08.2014;2014;08;03;Sunnuntai;34;5;39;5;2;7
89;31.08.2014;2014;08;04;Sunnuntai;26;4;30;7;0;7
89;31.08.2014;2014;08;05;Sunnuntai;6;2;8;1;0;1
89;31.08.2014;2014;08;06;Sunnuntai;13;8;21;2;6;8
89;31.08.2014;2014;08;07;Sunnuntai;1;4;5;0;1;1
89;31.08.2014;2014;08;08;Sunnuntai;1;11;12;4;14;18
89;31.08.2014;2014;08;09;Sunnuntai;18;30;48;15;21;36
89;31.08.2014;2014;08;10;Sunnuntai;20;45;65;33;36;69
89;31.08.2014;2014;08;11;Sunnuntai;43;80;123;28;48;76
89;31.08.2014;2014;08;12;Sunnuntai;69;86;155;35;40;75
89;31.08.2014;2014;08;13;Sunnuntai;69;116;185;31;41;72
89;31.08.2014;2014;08;14;Sunnuntai;79;114;193;41;47;88
89;31.08.2014;2014;08;15;Sunnuntai;97;104;201;23;34;57
89;31.08.2014;2014;08;16;Sunnuntai;84;74;158;18;22;40
89;31.08.2014;2014;08;17;Sunnuntai;106;66;172;34;27;61
89;31.08.2014;2014;08;18;Sunnuntai;82;58;140;35;37;72
89;31.08.2014;2014;08;19;Sunnuntai;74;58;132;27;41;68
89;31.08.2014;2014;08;20;Sunnuntai;49;28;77;20;20;40
89;31.08.2014;2014;08;21;Sunnuntai;22;24;46;3;5;8
89;31.08.2014;2014;08;22;Sunnuntai;12;11;23;1;2;3
89;31.08.2014;2014;08;23;Sunnuntai;8;8;16;1;1;2
89;01.09.2014;2014;09;00;Maanantai;4;2;6;2;1;3
89;01.09.2014;2014;09;01;Maanantai;4;4;8;1;1;2
89;01.09.2014;2014;09;02;Maanantai;3;0;3;0;1;1
89;01.09.2014;2014;09;03;Maanantai;3;2;5;0;0;0
89;01.09.2014;2014;09;04;Maanantai;4;6;10;3;0;3
89;01.09.2014;2014;09;05;Maanantai;3;18;21;2;1;3
89;01.09.2014;2014;09;06;Maanantai;30;70;100;1;5;6
89;01.09.2014;2014;09;07;Maanantai;77;249;326;2;26;28
89;01.09.2014;2014;09;08;Maanantai;56;241;297;6;34;40
89;01.09.2014;2014;09;09;Maanantai;72;190;262;10;33;43
89;01.09.2014;2014;09;10;Maanantai;73;74;147;17;22;39
89;01.09.2014;2014;09;11;Maanantai;84;113;197;29;31;60
89;01.09.2014;2014;09;12;Maanantai;85;112;197;38;19;57
89;01.09.2014;2014;09;13;Maanantai;108;81;189;19;13;32
89;01.09.2014;2014;09;14;Maanantai;192;104;296;25;17;42
89;01.09.2014;2014;09;15;Maanantai;251;104;355;18;23;41
89;01.09.2014;2014;09;16;Maanantai;266;159;425;24;15;39
89;01.09.2014;2014;09;17;Maanantai;141;86;227;29;16;45
89;01.09.2014;2014;09;18;Maanantai;122;85;207;38;28;66
89;01.09.2014;2014;09;19;Maanantai;85;53;138;25;27;52
89;01.09.2014;2014;09;20;Maanantai;102;42;144;25;26;51
89;01.09.2014;2014;09;21;Maanantai;32;30;62;11;14;25
89;01.09.2014;2014;09;22;Maanantai;17;6;23;3;4;7
89;01.09.2014;2014;09;23;Maanantai;9;3;12;0;2;2
89;02.09.2014;2014;09;00;Tiistai;2;4;6;0;0;0
89;02.09.2014;2014;09;01;Tiistai;0;0;0;0;0;0
89;02.09.2014;2014;09;02;Tiistai;4;1;5;0;0;0
89;02.09.2014;2014;09;03;Tiistai;3;2;5;1;0;1
89;02.09.2014;2014;09;04;Tiistai;2;11;13;1;0;1
89;02.09.2014;2014;09;05;Tiistai;4;15;19;4;0;4
89;02.09.2014;2014;09;06;Tiistai;27;74;101;5;7;12
89;02.09.2014;2014;09;07;Tiistai;74;243;317;3;21;24
89;02.09.2014;2014;09;08;Tiistai;61;264;325;5;27;32
89;02.09.2014;2014;09;09;Tiistai;43;146;189;51;28;79
89;02.09.2014;2014;09;10;Tiistai;54;96;150;24;33;57
89;02.09.2014;2014;09;11;Tiistai;86;92;178;15;79;94
89;02.09.2014;2014;09;12;Tiistai;106;90;196;16;18;34
89;02.09.2014;2014;09;13;Tiistai;97;84;181;42;27;69
89;02.09.2014;2014;09;14;Tiistai;162;118;280;20;27;47
89;02.09.2014;2014;09;15;Tiistai;252;105;357;30;16;46
89;02.09.2014;2014;09;16;Tiistai;277;139;416;36;27;63
89;02.09.2014;2014;09;17;Tiistai;149;112;261;28;33;61
89;02.09.2014;2014;09;18;Tiistai;107;75;182;27;45;72
89;02.09.2014;2014;09;19;Tiistai;110;65;175;33;31;64
89;02.09.2014;2014;09;20;Tiistai;101;51;152;32;30;62
89;02.09.2014;2014;09;21;Tiistai;44;29;73;15;19;34
89;02.09.2014;2014;09;22;Tiistai;20;11;31;5;5;10
89;02.09.2014;2014;09;23;Tiistai;17;4;21;1;3;4
89;03.09.2014;2014;09;00;Keskiviikko;7;1;8;1;0;1
89;03.09.2014;2014;09;01;Keskiviikko;11;1;12;1;0;1
89;03.09.2014;2014;09;02;Keskiviikko;1;2;3;1;0;1
89;03.09.2014;2014;09;03;Keskiviikko;2;2;4;0;1;1
89;03.09.2014;2014;09;04;Keskiviikko;2;4;6;1;0;1
89;03.09.2014;2014;09;05;Keskiviikko;8;14;22;1;0;1
89;03.09.2014;2014;09;06;Keskiviikko;23;65;88;4;7;11
89;03.09.2014;2014;09;07;Keskiviikko;103;269;372;9;20;29
89;03.09.2014;2014;09;08;Keskiviikko;38;248;286;5;36;41
89;03.09.2014;2014;09;09;Keskiviikko;45;153;198;14;35;49
89;03.09.2014;2014;09;10;Keskiviikko;58;83;141;24;17;41
89;03.09.2014;2014;09;11;Keskiviikko;110;107;217;21;26;47
89;03.09.2014;2014;09;12;Keskiviikko;86;94;180;36;22;58
89;03.09.2014;2014;09;13;Keskiviikko;125;91;216;36;22;58
89;03.09.2014;2014;09;14;Keskiviikko;187;98;285;26;16;42
89;03.09.2014;2014;09;15;Keskiviikko;234;118;352;28;18;46
89;03.09.2014;2014;09;16;Keskiviikko;250;146;396;28;15;43
89;03.09.2014;2014;09;17;Keskiviikko;145;107;252;17;22;39
89;03.09.2014;2014;09;18;Keskiviikko;111;81;192;31;34;65
89;03.09.2014;2014;09;19;Keskiviikko;101;64;165;34;35;69
89;03.09.2014;2014;09;20;Keskiviikko;89;43;132;14;20;34
89;03.09.2014;2014;09;21;Keskiviikko;36;29;65;9;13;22
89;03.09.2014;2014;09;22;Keskiviikko;18;13;31;5;9;14
89;03.09.2014;2014;09;23;Keskiviikko;7;9;16;4;1;5
89;04.09.2014;2014;09;00;Torstai;5;6;11;0;2;2
89;04.09.2014;2014;09;01;Torstai;1;5;6;1;4;5
89;04.09.2014;2014;09;02;Torstai;7;1;8;0;0;0
89;04.09.2014;2014;09;03;Torstai;6;2;8;2;0;2
89;04.09.2014;2014;09;04;Torstai;0;2;2;3;0;3
89;04.09.2014;2014;09;05;Torstai;3;9;12;3;1;4
89;04.09.2014;2014;09;06;Torstai;23;63;86;5;9;14
89;04.09.2014;2014;09;07;Torstai;70;242;312;5;36;41
89;04.09.2014;2014;09;08;Torstai;39;249;288;6;22;28
89;04.09.2014;2014;09;09;Torstai;58;155;213;8;14;22
89;04.09.2014;2014;09;10;Torstai;61;111;172;15;32;47
89;04.09.2014;2014;09;11;Torstai;84;133;217;18;35;53
89;04.09.2014;2014;09;12;Torstai;80;92;172;16;20;36
89;04.09.2014;2014;09;13;Torstai;136;104;240;22;8;30
89;04.09.2014;2014;09;14;Torstai;157;109;266;16;22;38
89;04.09.2014;2014;09;15;Torstai;236;123;359;24;19;43
89;04.09.2014;2014;09;16;Torstai;237;134;371;23;23;46
89;04.09.2014;2014;09;17;Torstai;157;104;261;25;34;59
89;04.09.2014;2014;09;18;Torstai;127;73;200;18;31;49
89;04.09.2014;2014;09;19;Torstai;106;83;189;29;24;53
89;04.09.2014;2014;09;20;Torstai;102;59;161;20;21;41
89;04.09.2014;2014;09;21;Torstai;58;29;87;20;13;33
89;04.09.2014;2014;09;22;Torstai;35;18;53;6;1;7
89;04.09.2014;2014;09;23;Torstai;7;3;10;1;4;5
89;05.09.2014;2014;09;00;Perjantai;6;4;10;1;1;2
89;05.09.2014;2014;09;01;Perjantai;4;2;6;1;1;2
89;05.09.2014;2014;09;02;Perjantai;2;1;3;0;0;0
89;05.09.2014;2014;09;03;Perjantai;3;5;8;2;0;2
89;05.09.2014;2014;09;04;Perjantai;6;2;8;0;1;1
89;05.09.2014;2014;09;05;Perjantai;3;11;14;1;4;5
89;05.09.2014;2014;09;06;Perjantai;26;70;96;4;5;9
89;05.09.2014;2014;09;07;Perjantai;62;235;297;8;33;41
89;05.09.2014;2014;09;08;Perjantai;45;220;265;9;31;40
89;05.09.2014;2014;09;09;Perjantai;59;147;206;13;37;50
89;05.09.2014;2014;09;10;Perjantai;62;100;162;17;24;41
89;05.09.2014;2014;09;11;Perjantai;82;110;192;21;29;50
89;05.09.2014;2014;09;12;Perjantai;99;142;241;22;25;47
89;05.09.2014;2014;09;13;Perjantai;140;100;240;31;21;52
89;05.09.2014;2014;09;14;Perjantai;194;152;346;16;20;36
89;05.09.2014;2014;09;15;Perjantai;248;132;380;21;20;41
89;05.09.2014;2014;09;16;Perjantai;180;128;308;16;19;35
89;05.09.2014;2014;09;17;Perjantai;141;102;243;26;20;46
89;05.09.2014;2014;09;18;Perjantai;92;89;181;24;18;42
89;05.09.2014;2014;09;19;Perjantai;100;73;173;21;28;49
89;05.09.2014;2014;09;20;Perjantai;85;46;131;17;16;33
89;05.09.2014;2014;09;21;Perjantai;68;63;131;9;12;21
89;05.09.2014;2014;09;22;Perjantai;35;50;85;3;9;12
89;05.09.2014;2014;09;23;Perjantai;29;30;59;13;13;26
89;06.09.2014;2014;09;00;Lauantai;22;20;42;2;6;8
89;06.09.2014;2014;09;01;Lauantai;28;16;44;7;2;9
89;06.09.2014;2014;09;02;Lauantai;38;7;45;1;2;3
89;06.09.2014;2014;09;03;Lauantai;24;6;30;3;1;4
89;06.09.2014;2014;09;04;Lauantai;26;4;30;8;1;9
89;06.09.2014;2014;09;05;Lauantai;6;4;10;4;2;6
89;06.09.2014;2014;09;06;Lauantai;5;9;14;0;1;1
89;06.09.2014;2014;09;07;Lauantai;7;23;30;6;8;14
89;06.09.2014;2014;09;08;Lauantai;8;23;31;4;10;14
89;06.09.2014;2014;09;09;Lauantai;14;67;81;12;21;33
89;06.09.2014;2014;09;10;Lauantai;32;96;128;13;23;36
89;06.09.2014;2014;09;11;Lauantai;49;97;146;24;37;61
89;06.09.2014;2014;09;12;Lauantai;84;132;216;19;26;45
89;06.09.2014;2014;09;13;Lauantai;101;93;194;29;40;69
89;06.09.2014;2014;09;14;Lauantai;125;83;208;27;27;54
89;06.09.2014;2014;09;15;Lauantai;113;91;204;25;39;64
89;06.09.2014;2014;09;16;Lauantai;117;92;209;28;26;54
89;06.09.2014;2014;09;17;Lauantai;88;89;177;26;33;59
89;06.09.2014;2014;09;18;Lauantai;60;71;131;28;29;57
89;06.09.2014;2014;09;19;Lauantai;61;69;130;19;26;45
89;06.09.2014;2014;09;20;Lauantai;55;29;84;18;16;34
89;06.09.2014;2014;09;21;Lauantai;38;38;76;14;8;22
89;06.09.2014;2014;09;22;Lauantai;26;39;65;11;9;20
89;06.09.2014;2014;09;23;Lauantai;19;27;46;6;7;13
89;07.09.2014;2014;09;00;Sunnuntai;29;32;61;4;4;8
89;07.09.2014;2014;09;01;Sunnuntai;28;11;39;1;5;6
89;07.09.2014;2014;09;02;Sunnuntai;10;7;17;2;0;2
89;07.09.2014;2014;09;03;Sunnuntai;37;4;41;6;0;6
89;07.09.2014;2014;09;04;Sunnuntai;18;9;27;3;0;3
89;07.09.2014;2014;09;05;Sunnuntai;10;1;11;2;2;4
89;07.09.2014;2014;09;06;Sunnuntai;3;7;10;0;1;1
89;07.09.2014;2014;09;07;Sunnuntai;11;10;21;1;3;4
89;07.09.2014;2014;09;08;Sunnuntai;3;9;12;5;3;8
89;07.09.2014;2014;09;09;Sunnuntai;10;25;35;12;26;38
89;07.09.2014;2014;09;10;Sunnuntai;27;62;89;19;24;43
89;07.09.2014;2014;09;11;Sunnuntai;43;50;93;31;41;72
89;07.09.2014;2014;09;12;Sunnuntai;69;102;171;31;41;72
89;07.09.2014;2014;09;13;Sunnuntai;72;89;161;33;38;71
89;07.09.2014;2014;09;14;Sunnuntai;85;97;182;29;37;66
89;07.09.2014;2014;09;15;Sunnuntai;81;71;152;17;31;48
89;07.09.2014;2014;09;16;Sunnuntai;93;86;179;38;44;82
89;07.09.2014;2014;09;17;Sunnuntai;84;83;167;25;29;54
89;07.09.2014;2014;09;18;Sunnuntai;91;97;188;30;43;73
89;07.09.2014;2014;09;19;Sunnuntai;82;45;127;28;35;63
89;07.09.2014;2014;09;20;Sunnuntai;46;46;92;29;26;55
89;07.09.2014;2014;09;21;Sunnuntai;31;20;51;8;11;19
89;07.09.2014;2014;09;22;Sunnuntai;17;9;26;3;4;7
89;07.09.2014;2014;09;23;Sunnuntai;7;6;13;2;5;7
89;08.09.2014;2014;09;00;Maanantai;6;6;12;2;0;2
89;08.09.2014;2014;09;01;Maanantai;4;2;6;0;0;0
89;08.09.2014;2014;09;02;Maanantai;2;0;2;2;2;4
89;08.09.2014;2014;09;03;Maanantai;3;1;4;0;0;0
89;08.09.2014;2014;09;04;Maanantai;1;1;2;2;1;3
89;08.09.2014;2014;09;05;Maanantai;5;16;21;1;0;1
89;08.09.2014;2014;09;06;Maanantai;19;81;100;3;5;8
89;08.09.2014;2014;09;07;Maanantai;76;263;339;7;23;30
89;08.09.2014;2014;09;08;Maanantai;50;276;326;7;22;29
89;08.09.2014;2014;09;09;Maanantai;53;206;259;2;26;28
89;08.09.2014;2014;09;10;Maanantai;70;167;237;16;26;42
89;08.09.2014;2014;09;11;Maanantai;99;141;240;22;18;40
89;08.09.2014;2014;09;12;Maanantai;130;147;277;20;23;43
89;08.09.2014;2014;09;13;Maanantai;135;121;256;25;27;52
89;08.09.2014;2014;09;14;Maanantai;209;89;298;32;18;50
89;08.09.2014;2014;09;15;Maanantai;281;132;413;30;12;42
89;08.09.2014;2014;09;16;Maanantai;292;123;415;25;19;44
89;08.09.2014;2014;09;17;Maanantai;179;121;300;23;23;46
89;08.09.2014;2014;09;18;Maanantai;146;97;243;36;27;63
89;08.09.2014;2014;09;19;Maanantai;114;78;192;36;35;71
89;08.09.2014;2014;09;20;Maanantai;96;56;152;22;17;39
89;08.09.2014;2014;09;21;Maanantai;69;29;98;12;6;18
89;08.09.2014;2014;09;22;Maanantai;15;22;37;7;4;11
89;08.09.2014;2014;09;23;Maanantai;12;9;21;3;2;5
89;09.09.2014;2014;09;00;Tiistai;4;8;12;1;2;3
89;09.09.2014;2014;09;01;Tiistai;5;2;7;1;0;1
89;09.09.2014;2014;09;02;Tiistai;1;0;1;0;0;0
89;09.09.2014;2014;09;03;Tiistai;6;3;9;0;1;1
89;09.09.2014;2014;09;04;Tiistai;3;5;8;0;0;0
89;09.09.2014;2014;09;05;Tiistai;4;16;20;0;1;1
89;09.09.2014;2014;09;06;Tiistai;22;78;100;3;4;7
89;09.09.2014;2014;09;07;Tiistai;72;268;340;4;20;24
89;09.09.2014;2014;09;08;Tiistai;55;295;350;11;47;58
89;09.09.2014;2014;09;09;Tiistai;64;185;249;16;34;50
89;09.09.2014;2014;09;10;Tiistai;59;114;173;21;56;77
89;09.09.2014;2014;09;11;Tiistai;97;134;231;42;35;77
89;09.09.2014;2014;09;12;Tiistai;122;148;270;26;27;53
89;09.09.2014;2014;09;13;Tiistai;141;121;262;15;21;36
89;09.09.2014;2014;09;14;Tiistai;208;124;332;28;31;59
89;09.09.2014;2014;09;15;Tiistai;270;125;395;16;15;31
89;09.09.2014;2014;09;16;Tiistai;302;132;434;15;16;31
89;09.09.2014;2014;09;17;Tiistai;153;108;261;23;24;47
89;09.09.2014;2014;09;18;Tiistai;123;92;215;31;36;67
89;09.09.2014;2014;09;19;Tiistai;129;75;204;32;28;60
89;09.09.2014;2014;09;20;Tiistai;82;56;138;29;28;57
89;09.09.2014;2014;09;21;Tiistai;58;38;96;20;14;34
89;09.09.2014;2014;09;22;Tiistai;15;16;31;7;7;14
89;09.09.2014;2014;09;23;Tiistai;17;3;20;3;3;6
89;10.09.2014;2014;09;00;Keskiviikko;5;7;12;0;1;1
89;10.09.2014;2014;09;01;Keskiviikko;6;1;7;1;2;3
89;10.09.2014;2014;09;02;Keskiviikko;2;1;3;0;0;0
89;10.09.2014;2014;09;03;Keskiviikko;4;6;10;1;0;1
89;10.09.2014;2014;09;04;Keskiviikko;2;4;6;2;0;2
89;10.09.2014;2014;09;05;Keskiviikko;6;21;27;4;4;8
89;10.09.2014;2014;09;06;Keskiviikko;22;68;90;4;9;13
89;10.09.2014;2014;09;07;Keskiviikko;84;259;343;6;29;35
89;10.09.2014;2014;09;08;Keskiviikko;54;273;327;10;30;40
89;10.09.2014;2014;09;09;Keskiviikko;66;171;237;5;16;21
89;10.09.2014;2014;09;10;Keskiviikko;77;139;216;9;29;38
89;10.09.2014;2014;09;11;Keskiviikko;83;110;193;18;25;43
89;10.09.2014;2014;09;12;Keskiviikko;119;131;250;21;26;47
89;10.09.2014;2014;09;13;Keskiviikko;143;109;252;16;23;39
89;10.09.2014;2014;09;14;Keskiviikko;206;138;344;24;33;57
89;10.09.2014;2014;09;15;Keskiviikko;227;134;361;36;17;53
89;10.09.2014;2014;09;16;Keskiviikko;294;156;450;26;18;44
89;10.09.2014;2014;09;17;Keskiviikko;175;173;348;19;40;59
89;10.09.2014;2014;09;18;Keskiviikko;138;129;267;29;39;68
89;10.09.2014;2014;09;19;Keskiviikko;122;114;236;31;24;55
89;10.09.2014;2014;09;20;Keskiviikko;103;46;149;20;23;43
89;10.09.2014;2014;09;21;Keskiviikko;94;56;150;14;12;26
89;10.09.2014;2014;09;22;Keskiviikko;29;21;50;6;7;13
89;10.09.2014;2014;09;23;Keskiviikko;31;14;45;0;1;1
89;11.09.2014;2014;09;00;Torstai;13;19;32;4;2;6
89;11.09.2014;2014;09;01;Torstai;12;6;18;0;0;0
89;11.09.2014;2014;09;02;Torstai;13;6;19;0;2;2
89;11.09.2014;2014;09;03;Torstai;10;2;12;0;0;0
89;11.09.2014;2014;09;04;Torstai;10;6;16;1;0;1
89;11.09.2014;2014;09;05;Torstai;5;13;18;2;1;3
89;11.09.2014;2014;09;06;Torstai;19;66;85;3;8;11
89;11.09.2014;2014;09;07;Torstai;77;228;305;4;30;34
89;11.09.2014;2014;09;08;Torstai;55;284;339;22;77;99
89;11.09.2014;2014;09;09;Torstai;60;133;193;67;37;104
89;11.09.2014;2014;09;10;Torstai;65;88;153;32;16;48
89;11.09.2014;2014;09;11;Torstai;98;104;202;28;21;49
89;11.09.2014;2014;09;12;Torstai;71;103;174;19;17;36
89;11.09.2014;2014;09;13;Torstai;109;106;215;17;17;34
89;11.09.2014;2014;09;14;Torstai;154;101;255;24;20;44
89;11.09.2014;2014;09;15;Torstai;223;125;348;15;35;50
89;11.09.2014;2014;09;16;Torstai;238;129;367;37;23;60
89;11.09.2014;2014;09;17;Torstai;164;100;264;17;25;42
89;11.09.2014;2014;09;18;Torstai;116;108;224;11;27;38
89;11.09.2014;2014;09;19;Torstai;109;74;183;34;28;62
89;11.09.2014;2014;09;20;Torstai;95;64;159;12;25;37
89;11.09.2014;2014;09;21;Torstai;66;33;99;17;12;29
89;11.09.2014;2014;09;22;Torstai;31;20;51;2;3;5
89;11.09.2014;2014;09;23;Torstai;18;6;24;2;4;6
89;12.09.2014;2014;09;00;Perjantai;12;2;14;1;2;3
89;12.09.2014;2014;09;01;Perjantai;9;1;10;1;0;1
89;12.09.2014;2014;09;02;Perjantai;10;1;11;0;1;1
89;12.09.2014;2014;09;03;Perjantai;7;2;9;0;0;0
89;12.09.2014;2014;09;04;Perjantai;2;1;3;0;0;0
89;12.09.2014;2014;09;05;Perjantai;2;14;16;2;0;2
89;12.09.2014;2014;09;06;Perjantai;19;61;80;3;3;6
89;12.09.2014;2014;09;07;Perjantai;59;210;269;5;21;26
89;12.09.2014;2014;09;08;Perjantai;42;214;256;6;25;31
89;12.09.2014;2014;09;09;Perjantai;46;149;195;12;20;32
89;12.09.2014;2014;09;10;Perjantai;64;110;174;12;22;34
89;12.09.2014;2014;09;11;Perjantai;73;93;166;16;23;39
89;12.09.2014;2014;09;12;Perjantai;106;83;189;20;20;40
89;12.09.2014;2014;09;13;Perjantai;128;98;226;25;18;43
89;12.09.2014;2014;09;14;Perjantai;173;115;288;21;28;49
89;12.09.2014;2014;09;15;Perjantai;198;105;303;25;23;48
89;12.09.2014;2014;09;16;Perjantai;182;106;288;22;22;44
89;12.09.2014;2014;09;17;Perjantai;140;104;244;18;23;41
89;12.09.2014;2014;09;18;Perjantai;75;78;153;20;30;50
89;12.09.2014;2014;09;19;Perjantai;75;56;131;22;20;42
89;12.09.2014;2014;09;20;Perjantai;66;52;118;12;19;31
89;12.09.2014;2014;09;21;Perjantai;45;42;87;10;14;24
89;12.09.2014;2014;09;22;Perjantai;32;46;78;4;8;12
89;12.09.2014;2014;09;23;Perjantai;29;22;51;7;10;17
89;13.09.2014;2014;09;00;Lauantai;18;30;48;5;5;10
89;13.09.2014;2014;09;01;Lauantai;22;16;38;3;2;5
89;13.09.2014;2014;09;02;Lauantai;16;6;22;4;1;5
89;13.09.2014;2014;09;03;Lauantai;13;8;21;4;0;4
89;13.09.2014;2014;09;04;Lauantai;21;2;23;3;0;3
89;13.09.2014;2014;09;05;Lauantai;6;3;9;2;1;3
89;13.09.2014;2014;09;06;Lauantai;10;14;24;1;4;5
89;13.09.2014;2014;09;07;Lauantai;5;17;22;5;6;11
89;13.09.2014;2014;09;08;Lauantai;7;34;41;7;9;16
89;13.09.2014;2014;09;09;Lauantai;34;64;98;7;19;26
89;13.09.2014;2014;09;10;Lauantai;32;64;96;22;32;54
89;13.09.2014;2014;09;11;Lauantai;53;95;148;15;36;51
89;13.09.2014;2014;09;12;Lauantai;94;97;191;30;38;68
89;13.09.2014;2014;09;13;Lauantai;89;107;196;27;21;48
89;13.09.2014;2014;09;14;Lauantai;105;122;227;32;34;66
89;13.09.2014;2014;09;15;Lauantai;117;93;210;29;34;63
89;13.09.2014;2014;09;16;Lauantai;105;75;180;22;37;59
89;13.09.2014;2014;09;17;Lauantai;91;80;171;28;18;46
89;13.09.2014;2014;09;18;Lauantai;67;66;133;21;32;53
89;13.09.2014;2014;09;19;Lauantai;44;53;97;17;19;36
89;13.09.2014;2014;09;20;Lauantai;50;32;82;13;16;29
89;13.09.2014;2014;09;21;Lauantai;25;48;73;13;16;29
89;13.09.2014;2014;09;22;Lauantai;20;32;52;6;9;15
89;13.09.2014;2014;09;23;Lauantai;21;32;53;1;11;12
89;14.09.2014;2014;09;00;Sunnuntai;20;30;50;9;9;18
89;14.09.2014;2014;09;01;Sunnuntai;27;10;37;3;8;11
89;14.09.2014;2014;09;02;Sunnuntai;29;4;33;4;1;5
89;14.09.2014;2014;09;03;Sunnuntai;23;1;24;4;1;5
89;14.09.2014;2014;09;04;Sunnuntai;31;7;38;7;0;7
89;14.09.2014;2014;09;05;Sunnuntai;12;0;12;3;2;5
89;14.09.2014;2014;09;06;Sunnuntai;8;14;22;0;0;0
89;14.09.2014;2014;09;07;Sunnuntai;3;6;9;2;1;3
89;14.09.2014;2014;09;08;Sunnuntai;11;14;25;8;14;22
89;14.09.2014;2014;09;09;Sunnuntai;13;42;55;10;23;33
89;14.09.2014;2014;09;10;Sunnuntai;35;62;97;21;31;52
89;14.09.2014;2014;09;11;Sunnuntai;52;92;144;20;56;76
89;14.09.2014;2014;09;12;Sunnuntai;75;102;177;73;44;117
89;14.09.2014;2014;09;13;Sunnuntai;96;104;200;48;55;103
89;14.09.2014;2014;09;14;Sunnuntai;88;91;179;28;34;62
89;14.09.2014;2014;09;15;Sunnuntai;115;88;203;32;28;60
89;14.09.2014;2014;09;16;Sunnuntai;64;66;130;22;44;66
89;14.09.2014;2014;09;17;Sunnuntai;85;53;138;23;41;64
89;14.09.2014;2014;09;18;Sunnuntai;70;63;133;26;28;54
89;14.09.2014;2014;09;19;Sunnuntai;65;46;111;26;19;45
89;14.09.2014;2014;09;20;Sunnuntai;47;30;77;15;21;36
89;14.09.2014;2014;09;21;Sunnuntai;30;24;54;10;12;22
89;14.09.2014;2014;09;22;Sunnuntai;14;5;19;2;4;6
89;14.09.2014;2014;09;23;Sunnuntai;7;8;15;1;2;3
89;15.09.2014;2014;09;00;Maanantai;1;1;2;0;0;0
89;15.09.2014;2014;09;01;Maanantai;1;1;2;2;2;4
89;15.09.2014;2014;09;02;Maanantai;5;1;6;0;2;2
89;15.09.2014;2014;09;03;Maanantai;2;3;5;0;0;0
89;15.09.2014;2014;09;04;Maanantai;1;3;4;1;1;2
89;15.09.2014;2014;09;05;Maanantai;6;13;19;1;2;3
89;15.09.2014;2014;09;06;Maanantai;19;62;81;5;1;6
89;15.09.2014;2014;09;07;Maanantai;73;207;280;5;25;30
89;15.09.2014;2014;09;08;Maanantai;56;281;337;7;21;28
89;15.09.2014;2014;09;09;Maanantai;46;167;213;12;27;39
89;15.09.2014;2014;09;10;Maanantai;46;97;143;22;37;59
89;15.09.2014;2014;09;11;Maanantai;93;103;196;9;17;26
89;15.09.2014;2014;09;12;Maanantai;111;116;227;17;24;41
89;15.09.2014;2014;09;13;Maanantai;124;96;220;21;19;40
89;15.09.2014;2014;09;14;Maanantai;190;89;279;20;25;45
89;15.09.2014;2014;09;15;Maanantai;249;131;380;23;36;59
89;15.09.2014;2014;09;16;Maanantai;271;154;425;29;19;48
89;15.09.2014;2014;09;17;Maanantai;170;114;284;26;24;50
89;15.09.2014;2014;09;18;Maanantai;136;109;245;27;31;58
89;15.09.2014;2014;09;19;Maanantai;101;66;167;31;23;54
89;15.09.2014;2014;09;20;Maanantai;87;42;129;19;22;41
89;15.09.2014;2014;09;21;Maanantai;38;23;61;14;16;30
89;15.09.2014;2014;09;22;Maanantai;14;16;30;6;8;14
89;15.09.2014;2014;09;23;Maanantai;7;4;11;2;3;5
89;16.09.2014;2014;09;00;Tiistai;1;3;4;2;0;2
89;16.09.2014;2014;09;01;Tiistai;3;2;5;0;1;1
89;16.09.2014;2014;09;02;Tiistai;0;0;0;0;1;1
89;16.09.2014;2014;09;03;Tiistai;0;5;5;0;0;0
89;16.09.2014;2014;09;04;Tiistai;2;3;5;1;0;1
89;16.09.2014;2014;09;05;Tiistai;4;8;12;1;1;2
89;16.09.2014;2014;09;06;Tiistai;24;66;90;7;5;12
89;16.09.2014;2014;09;07;Tiistai;66;260;326;6;26;32
89;16.09.2014;2014;09;08;Tiistai;57;307;364;7;33;40
89;16.09.2014;2014;09;09;Tiistai;61;144;205;21;27;48
89;16.09.2014;2014;09;10;Tiistai;62;99;161;8;24;32
89;16.09.2014;2014;09;11;Tiistai;89;109;198;15;26;41
89;16.09.2014;2014;09;12;Tiistai;76;89;165;19;18;37
89;16.09.2014;2014;09;13;Tiistai;114;94;208;15;20;35
89;16.09.2014;2014;09;14;Tiistai;182;102;284;17;23;40
89;16.09.2014;2014;09;15;Tiistai;251;119;370;26;31;57
89;16.09.2014;2014;09;16;Tiistai;289;129;418;21;21;42
89;16.09.2014;2014;09;17;Tiistai;150;141;291;26;27;53
89;16.09.2014;2014;09;18;Tiistai;102;77;179;26;27;53
89;16.09.2014;2014;09;19;Tiistai;118;66;184;23;46;69
89;16.09.2014;2014;09;20;Tiistai;78;63;141;29;20;49
89;16.09.2014;2014;09;21;Tiistai;43;29;72;11;10;21
89;16.09.2014;2014;09;22;Tiistai;26;5;31;6;4;10
89;16.09.2014;2014;09;23;Tiistai;6;3;9;1;1;2
89;17.09.2014;2014;09;00;Keskiviikko;3;1;4;2;0;2
89;17.09.2014;2014;09;01;Keskiviikko;1;1;2;0;0;0
89;17.09.2014;2014;09;02;Keskiviikko;1;0;1;1;0;1
89;17.09.2014;2014;09;03;Keskiviikko;0;2;2;0;0;0
89;17.09.2014;2014;09;04;Keskiviikko;2;1;3;0;0;0
89;17.09.2014;2014;09;05;Keskiviikko;5;14;19;2;0;2
89;17.09.2014;2014;09;06;Keskiviikko;28;69;97;3;7;10
89;17.09.2014;2014;09;07;Keskiviikko;67;247;314;8;25;33
89;17.09.2014;2014;09;08;Keskiviikko;47;289;336;10;19;29
89;17.09.2014;2014;09;09;Keskiviikko;65;156;221;19;33;52
89;17.09.2014;2014;09;10;Keskiviikko;49;85;134;26;37;63
89;17.09.2014;2014;09;11;Keskiviikko;88;110;198;20;29;49
89;17.09.2014;2014;09;12;Keskiviikko;89;120;209;33;27;60
89;17.09.2014;2014;09;13;Keskiviikko;131;92;223;17;23;40
89;17.09.2014;2014;09;14;Keskiviikko;185;117;302;23;23;46
89;17.09.2014;2014;09;15;Keskiviikko;224;115;339;32;36;68
89;17.09.2014;2014;09;16;Keskiviikko;244;117;361;24;38;62
89;17.09.2014;2014;09;17;Keskiviikko;162;134;296;20;29;49
89;17.09.2014;2014;09;18;Keskiviikko;141;92;233;42;29;71
89;17.09.2014;2014;09;19;Keskiviikko;108;67;175;25;24;49
89;17.09.2014;2014;09;20;Keskiviikko;95;60;155;26;23;49
89;17.09.2014;2014;09;21;Keskiviikko;53;32;85;10;10;20
89;17.09.2014;2014;09;22;Keskiviikko;42;13;55;3;4;7
89;17.09.2014;2014;09;23;Keskiviikko;17;15;32;0;1;1
89;18.09.2014;2014;09;00;Torstai;13;8;21;2;0;2
89;18.09.2014;2014;09;01;Torstai;8;1;9;1;2;3
89;18.09.2014;2014;09;02;Torstai;11;5;16;0;0;0
89;18.09.2014;2014;09;03;Torstai;15;4;19;4;2;6
89;18.09.2014;2014;09;04;Torstai;4;3;7;0;0;0
89;18.09.2014;2014;09;05;Torstai;9;13;22;2;0;2
89;18.09.2014;2014;09;06;Torstai;25;59;84;3;3;6
89;18.09.2014;2014;09;07;Torstai;62;230;292;6;23;29
89;18.09.2014;2014;09;08;Torstai;58;280;338;14;26;40
89;18.09.2014;2014;09;09;Torstai;59;153;212;10;17;27
89;18.09.2014;2014;09;10;Torstai;49;103;152;15;27;42
89;18.09.2014;2014;09;11;Torstai;79;103;182;22;34;56
89;18.09.2014;2014;09;12;Torstai;90;87;177;34;24;58
89;18.09.2014;2014;09;13;Torstai;107;80;187;20;14;34
89;18.09.2014;2014;09;14;Torstai;172;124;296;14;24;38
89;18.09.2014;2014;09;15;Torstai;232;111;343;26;28;54
89;18.09.2014;2014;09;16;Torstai;251;134;385;14;21;35
89;18.09.2014;2014;09;17;Torstai;135;104;239;25;24;49
89;18.09.2014;2014;09;18;Torstai;101;75;176;28;30;58
89;18.09.2014;2014;09;19;Torstai;104;64;168;31;29;60
89;18.09.2014;2014;09;20;Torstai;80;39;119;23;27;50
89;18.09.2014;2014;09;21;Torstai;41;27;68;9;7;16
89;18.09.2014;2014;09;22;Torstai;24;19;43;4;0;4
89;18.09.2014;2014;09;23;Torstai;11;11;22;1;3;4
89;19.09.2014;2014;09;00;Perjantai;14;2;16;1;0;1
89;19.09.2014;2014;09;01;Perjantai;13;3;16;1;2;3
89;19.09.2014;2014;09;02;Perjantai;10;1;11;0;1;1
89;19.09.2014;2014;09;03;Perjantai;3;2;5;0;0;0
89;19.09.2014;2014;09;04;Perjantai;3;1;4;0;0;0
89;19.09.2014;2014;09;05;Perjantai;4;11;15;1;0;1
89;19.09.2014;2014;09;06;Perjantai;19;52;71;2;4;6
89;19.09.2014;2014;09;07;Perjantai;62;203;265;4;26;30
89;19.09.2014;2014;09;08;Perjantai;40;246;286;4;31;35
89;19.09.2014;2014;09;09;Perjantai;36;114;150;8;18;26
89;19.09.2014;2014;09;10;Perjantai;48;96;144;24;19;43
89;19.09.2014;2014;09;11;Perjantai;84;84;168;20;31;51
89;19.09.2014;2014;09;12;Perjantai;101;97;198;16;17;33
89;19.09.2014;2014;09;13;Perjantai;155;114;269;18;50;68
89;19.09.2014;2014;09;14;Perjantai;156;105;261;34;22;56
89;19.09.2014;2014;09;15;Perjantai;211;112;323;21;30;51
89;19.09.2014;2014;09;16;Perjantai;148;94;242;23;19;42
89;19.09.2014;2014;09;17;Perjantai;124;76;200;21;18;39
89;19.09.2014;2014;09;18;Perjantai;85;66;151;28;23;51
89;19.09.2014;2014;09;19;Perjantai;72;75;147;14;21;35
89;19.09.2014;2014;09;20;Perjantai;56;28;84;16;12;28
89;19.09.2014;2014;09;21;Perjantai;42;35;77;9;10;19
89;19.09.2014;2014;09;22;Perjantai;31;36;67;4;8;12
89;19.09.2014;2014;09;23;Perjantai;23;26;49;3;4;7
89;20.09.2014;2014;09;00;Lauantai;20;37;57;5;4;9
89;20.09.2014;2014;09;01;Lauantai;29;20;49;1;4;5
89;20.09.2014;2014;09;02;Lauantai;20;6;26;5;0;5
89;20.09.2014;2014;09;03;Lauantai;13;3;16;3;5;8
89;20.09.2014;2014;09;04;Lauantai;14;8;22;6;1;7
89;20.09.2014;2014;09;05;Lauantai;5;6;11;1;2;3
89;20.09.2014;2014;09;06;Lauantai;5;10;15;0;1;1
89;20.09.2014;2014;09;07;Lauantai;11;13;24;4;7;11
89;20.09.2014;2014;09;08;Lauantai;2;40;42;8;10;18
89;20.09.2014;2014;09;09;Lauantai;18;65;83;13;19;32
89;20.09.2014;2014;09;10;Lauantai;32;104;136;12;29;41
89;20.09.2014;2014;09;11;Lauantai;54;103;157;19;26;45
89;20.09.2014;2014;09;12;Lauantai;84;94;178;23;33;56
89;20.09.2014;2014;09;13;Lauantai;81;89;170;26;44;70
89;20.09.2014;2014;09;14;Lauantai;74;91;165;15;32;47
89;20.09.2014;2014;09;15;Lauantai;103;74;177;26;24;50
89;20.09.2014;2014;09;16;Lauantai;78;68;146;25;25;50
89;20.09.2014;2014;09;17;Lauantai;73;58;131;22;27;49
89;20.09.2014;2014;09;18;Lauantai;52;68;120;11;34;45
89;20.09.2014;2014;09;19;Lauantai;76;67;143;20;18;38
89;20.09.2014;2014;09;20;Lauantai;29;31;60;10;14;24
89;20.09.2014;2014;09;21;Lauantai;29;33;62;5;11;16
89;20.09.2014;2014;09;22;Lauantai;24;27;51;2;12;14
89;20.09.2014;2014;09;23;Lauantai;27;43;70;3;6;9
89;21.09.2014;2014;09;00;Sunnuntai;30;24;54;6;6;12
89;21.09.2014;2014;09;01;Sunnuntai;13;13;26;2;4;6
89;21.09.2014;2014;09;02;Sunnuntai;14;9;23;3;3;6
89;21.09.2014;2014;09;03;Sunnuntai;45;7;52;5;1;6
89;21.09.2014;2014;09;04;Sunnuntai;14;2;16;7;0;7
89;21.09.2014;2014;09;05;Sunnuntai;6;4;10;3;0;3
89;21.09.2014;2014;09;06;Sunnuntai;3;13;16;1;0;1
89;21.09.2014;2014;09;07;Sunnuntai;5;5;10;2;1;3
89;21.09.2014;2014;09;08;Sunnuntai;4;14;18;7;8;15
89;21.09.2014;2014;09;09;Sunnuntai;15;22;37;9;19;28
89;21.09.2014;2014;09;10;Sunnuntai;21;28;49;22;23;45
89;21.09.2014;2014;09;11;Sunnuntai;21;68;89;23;32;55
89;21.09.2014;2014;09;12;Sunnuntai;54;64;118;18;27;45
89;21.09.2014;2014;09;13;Sunnuntai;61;80;141;31;44;75
89;21.09.2014;2014;09;14;Sunnuntai;69;73;142;29;18;47
89;21.09.2014;2014;09;15;Sunnuntai;103;68;171;30;30;60
89;21.09.2014;2014;09;16;Sunnuntai;86;74;160;25;25;50
89;21.09.2014;2014;09;17;Sunnuntai;70;59;129;27;30;57
89;21.09.2014;2014;09;18;Sunnuntai;58;36;94;26;28;54
89;21.09.2014;2014;09;19;Sunnuntai;46;36;82;16;18;34
89;21.09.2014;2014;09;20;Sunnuntai;28;36;64;14;14;28
89;21.09.2014;2014;09;21;Sunnuntai;26;15;41;10;7;17
89;21.09.2014;2014;09;22;Sunnuntai;16;3;19;2;3;5
89;21.09.2014;2014;09;23;Sunnuntai;4;1;5;5;1;6
89;22.09.2014;2014;09;00;Maanantai;3;3;6;0;1;1
89;22.09.2014;2014;09;01;Maanantai;3;1;4;1;1;2
89;22.09.2014;2014;09;02;Maanantai;4;1;5;0;0;0
89;22.09.2014;2014;09;03;Maanantai;1;0;1;0;0;0
89;22.09.2014;2014;09;04;Maanantai;2;3;5;4;0;4
89;22.09.2014;2014;09;05;Maanantai;4;14;18;0;0;0
89;22.09.2014;2014;09;06;Maanantai;20;59;79;3;4;7
89;22.09.2014;2014;09;07;Maanantai;57;208;265;6;19;25
89;22.09.2014;2014;09;08;Maanantai;68;279;347;2;25;27
89;22.09.2014;2014;09;09;Maanantai;53;143;196;7;28;35
89;22.09.2014;2014;09;10;Maanantai;68;95;163;18;26;44
89;22.09.2014;2014;09;11;Maanantai;77;100;177;14;33;47
89;22.09.2014;2014;09;12;Maanantai;100;118;218;23;28;51
89;22.09.2014;2014;09;13;Maanantai;104;82;186;14;16;30
89;22.09.2014;2014;09;14;Maanantai;146;89;235;20;32;52
89;22.09.2014;2014;09;15;Maanantai;212;96;308;29;22;51
89;22.09.2014;2014;09;16;Maanantai;213;125;338;27;19;46
89;22.09.2014;2014;09;17;Maanantai;164;84;248;26;27;53
89;22.09.2014;2014;09;18;Maanantai;87;84;171;27;22;49
89;22.09.2014;2014;09;19;Maanantai;99;50;149;21;32;53
89;22.09.2014;2014;09;20;Maanantai;64;36;100;18;23;41
89;22.09.2014;2014;09;21;Maanantai;43;28;71;14;6;20
89;22.09.2014;2014;09;22;Maanantai;15;10;25;5;3;8
89;22.09.2014;2014;09;23;Maanantai;7;7;14;2;1;3
89;23.09.2014;2014;09;00;Tiistai;6;2;8;0;0;0
89;23.09.2014;2014;09;01;Tiistai;3;8;11;0;0;0
89;23.09.2014;2014;09;02;Tiistai;2;0;2;1;1;2
89;23.09.2014;2014;09;03;Tiistai;1;3;4;0;0;0
89;23.09.2014;2014;09;04;Tiistai;1;3;4;2;0;2
89;23.09.2014;2014;09;05;Tiistai;4;14;18;2;0;2
89;23.09.2014;2014;09;06;Tiistai;24;71;95;6;6;12
89;23.09.2014;2014;09;07;Tiistai;62;227;289;7;19;26
89;23.09.2014;2014;09;08;Tiistai;58;275;333;8;29;37
89;23.09.2014;2014;09;09;Tiistai;44;135;179;20;30;50
89;23.09.2014;2014;09;10;Tiistai;38;84;122;20;27;47
89;23.09.2014;2014;09;11;Tiistai;87;86;173;13;26;39
89;23.09.2014;2014;09;12;Tiistai;88;98;186;21;18;39
89;23.09.2014;2014;09;13;Tiistai;94;80;174;17;20;37
89;23.09.2014;2014;09;14;Tiistai;187;94;281;21;29;50
89;23.09.2014;2014;09;15;Tiistai;227;116;343;28;26;54
89;23.09.2014;2014;09;16;Tiistai;247;114;361;27;12;39
89;23.09.2014;2014;09;17;Tiistai;149;79;228;22;17;39
89;23.09.2014;2014;09;18;Tiistai;69;68;137;21;23;44
89;23.09.2014;2014;09;19;Tiistai;84;51;135;29;30;59
89;23.09.2014;2014;09;20;Tiistai;54;48;102;26;22;48
89;23.09.2014;2014;09;21;Tiistai;34;25;59;5;8;13
89;23.09.2014;2014;09;22;Tiistai;16;9;25;2;2;4
89;23.09.2014;2014;09;23;Tiistai;7;6;13;3;1;4
89;24.09.2014;2014;09;00;Keskiviikko;2;4;6;1;1;2
89;24.09.2014;2014;09;01;Keskiviikko;1;1;2;1;0;1
89;24.09.2014;2014;09;02;Keskiviikko;4;0;4;0;0;0
89;24.09.2014;2014;09;03;Keskiviikko;6;1;7;0;0;0
89;24.09.2014;2014;09;04;Keskiviikko;0;2;2;0;0;0
89;24.09.2014;2014;09;05;Keskiviikko;2;16;18;0;1;1
89;24.09.2014;2014;09;06;Keskiviikko;21;44;65;3;4;7
89;24.09.2014;2014;09;07;Keskiviikko;59;183;242;2;17;19
89;24.09.2014;2014;09;08;Keskiviikko;62;213;275;4;23;27
89;24.09.2014;2014;09;09;Keskiviikko;48;118;166;7;31;38
89;24.09.2014;2014;09;10;Keskiviikko;32;75;107;14;19;33
89;24.09.2014;2014;09;11;Keskiviikko;56;56;112;17;14;31
89;24.09.2014;2014;09;12;Keskiviikko;47;53;100;12;8;20
89;24.09.2014;2014;09;13;Keskiviikko;95;63;158;35;13;48
89;24.09.2014;2014;09;14;Keskiviikko;126;74;200;21;9;30
89;24.09.2014;2014;09;15;Keskiviikko;127;71;198;9;11;20
89;24.09.2014;2014;09;16;Keskiviikko;166;89;255;21;17;38
89;24.09.2014;2014;09;17;Keskiviikko;87;61;148;20;6;26
89;24.09.2014;2014;09;18;Keskiviikko;55;53;108;10;6;16
89;24.09.2014;2014;09;19;Keskiviikko;69;38;107;7;13;20
89;24.09.2014;2014;09;20;Keskiviikko;47;36;83;15;16;31
89;24.09.2014;2014;09;21;Keskiviikko;38;10;48;3;2;5
89;24.09.2014;2014;09;22;Keskiviikko;13;10;23;0;2;2
89;24.09.2014;2014;09;23;Keskiviikko;3;2;5;1;1;2
89;25.09.2014;2014;09;00;Torstai;4;2;6;0;0;0
89;25.09.2014;2014;09;01;Torstai;10;1;11;0;0;0
89;25.09.2014;2014;09;02;Torstai;2;0;2;0;0;0
89;25.09.2014;2014;09;03;Torstai;3;3;6;0;0;0
89;25.09.2014;2014;09;04;Torstai;1;5;6;2;0;2
89;25.09.2014;2014;09;05;Torstai;2;11;13;0;1;1
89;25.09.2014;2014;09;06;Torstai;23;56;79;4;3;7
89;25.09.2014;2014;09;07;Torstai;60;159;219;5;24;29
89;25.09.2014;2014;09;08;Torstai;50;215;265;19;29;48
89;25.09.2014;2014;09;09;Torstai;47;108;155;12;24;36
89;25.09.2014;2014;09;10;Torstai;58;91;149;21;26;47
89;25.09.2014;2014;09;11;Torstai;72;80;152;17;28;45
89;25.09.2014;2014;09;12;Torstai;68;92;160;16;21;37
89;25.09.2014;2014;09;13;Torstai;105;60;165;15;21;36
89;25.09.2014;2014;09;14;Torstai;138;90;228;18;17;35
89;25.09.2014;2014;09;15;Torstai;201;127;328;21;18;39
89;25.09.2014;2014;09;16;Torstai;188;101;289;22;19;41
89;25.09.2014;2014;09;17;Torstai;127;98;225;15;25;40
89;25.09.2014;2014;09;18;Torstai;80;82;162;27;30;57
89;25.09.2014;2014;09;19;Torstai;84;56;140;20;24;44
89;25.09.2014;2014;09;20;Torstai;73;31;104;15;22;37
89;25.09.2014;2014;09;21;Torstai;47;27;74;10;11;21
89;25.09.2014;2014;09;22;Torstai;28;20;48;7;4;11
89;25.09.2014;2014;09;23;Torstai;19;4;23;3;2;5
89;26.09.2014;2014;09;00;Perjantai;11;5;16;2;3;5
89;26.09.2014;2014;09;01;Perjantai;10;1;11;0;0;0
89;26.09.2014;2014;09;02;Perjantai;5;0;5;0;0;0
89;26.09.2014;2014;09;03;Perjantai;9;4;13;3;1;4
89;26.09.2014;2014;09;04;Perjantai;6;3;9;1;0;1
89;26.09.2014;2014;09;05;Perjantai;3;9;12;0;0;0
89;26.09.2014;2014;09;06;Perjantai;17;64;81;5;3;8
89;26.09.2014;2014;09;07;Perjantai;45;169;214;6;18;24
89;26.09.2014;2014;09;08;Perjantai;46;226;272;7;27;34
89;26.09.2014;2014;09;09;Perjantai;46;102;148;21;48;69
89;26.09.2014;2014;09;10;Perjantai;36;82;118;24;21;45
89;26.09.2014;2014;09;11;Perjantai;69;89;158;18;14;32
89;26.09.2014;2014;09;12;Perjantai;101;100;201;12;25;37
89;26.09.2014;2014;09;13;Perjantai;133;95;228;17;33;50
89;26.09.2014;2014;09;14;Perjantai;165;74;239;20;20;40
89;26.09.2014;2014;09;15;Perjantai;193;96;289;27;18;45
89;26.09.2014;2014;09;16;Perjantai;138;76;214;20;21;41
89;26.09.2014;2014;09;17;Perjantai;106;71;177;14;21;35
89;26.09.2014;2014;09;18;Perjantai;63;46;109;18;21;39
89;26.09.2014;2014;09;19;Perjantai;50;28;78;8;10;18
89;26.09.2014;2014;09;20;Perjantai;31;24;55;14;7;21
89;26.09.2014;2014;09;21;Perjantai;22;14;36;2;7;9
89;26.09.2014;2014;09;22;Perjantai;11;20;31;1;9;10
89;26.09.2014;2014;09;23;Perjantai;14;23;37;0;9;9
89;27.09.2014;2014;09;00;Lauantai;10;15;25;3;2;5
89;27.09.2014;2014;09;01;Lauantai;7;9;16;8;9;17
89;27.09.2014;2014;09;02;Lauantai;7;2;9;5;0;5
89;27.09.2014;2014;09;03;Lauantai;10;2;12;6;1;7
89;27.09.2014;2014;09;04;Lauantai;7;1;8;8;2;10
89;27.09.2014;2014;09;05;Lauantai;2;5;7;0;2;2
89;27.09.2014;2014;09;06;Lauantai;6;10;16;1;1;2
89;27.09.2014;2014;09;07;Lauantai;5;14;19;6;2;8
89;27.09.2014;2014;09;08;Lauantai;16;27;43;4;11;15
89;27.09.2014;2014;09;09;Lauantai;13;52;65;13;23;36
89;27.09.2014;2014;09;10;Lauantai;35;69;104;17;24;41
89;27.09.2014;2014;09;11;Lauantai;50;73;123;20;41;61
89;27.09.2014;2014;09;12;Lauantai;68;84;152;21;23;44
89;27.09.2014;2014;09;13;Lauantai;61;95;156;28;54;82
89;27.09.2014;2014;09;14;Lauantai;69;54;123;13;17;30
89;27.09.2014;2014;09;15;Lauantai;55;43;98;5;16;21
89;27.09.2014;2014;09;16;Lauantai;50;43;93;32;23;55
89;27.09.2014;2014;09;17;Lauantai;49;59;108;18;26;44
89;27.09.2014;2014;09;18;Lauantai;45;44;89;19;20;39
89;27.09.2014;2014;09;19;Lauantai;54;23;77;16;22;38
89;27.09.2014;2014;09;20;Lauantai;26;30;56;11;12;23
89;27.09.2014;2014;09;21;Lauantai;19;21;40;6;10;16
89;27.09.2014;2014;09;22;Lauantai;18;26;44;3;6;9
89;27.09.2014;2014;09;23;Lauantai;14;21;35;2;3;5
89;28.09.2014;2014;09;00;Sunnuntai;12;21;33;1;2;3
89;28.09.2014;2014;09;01;Sunnuntai;23;14;37;4;5;9
89;28.09.2014;2014;09;02;Sunnuntai;25;8;33;6;0;6
89;28.09.2014;2014;09;03;Sunnuntai;22;3;25;8;1;9
89;28.09.2014;2014;09;04;Sunnuntai;14;1;15;7;1;8
89;28.09.2014;2014;09;05;Sunnuntai;8;1;9;1;0;1
89;28.09.2014;2014;09;06;Sunnuntai;5;1;6;0;0;0
89;28.09.2014;2014;09;07;Sunnuntai;4;8;12;4;1;5
89;28.09.2014;2014;09;08;Sunnuntai;5;10;15;7;13;20
89;28.09.2014;2014;09;09;Sunnuntai;12;24;36;16;36;52
89;28.09.2014;2014;09;10;Sunnuntai;34;37;71;22;32;54
89;28.09.2014;2014;09;11;Sunnuntai;56;90;146;38;37;75
89;28.09.2014;2014;09;12;Sunnuntai;55;81;136;29;62;91
89;28.09.2014;2014;09;13;Sunnuntai;78;79;157;32;39;71
89;28.09.2014;2014;09;14;Sunnuntai;105;99;204;30;38;68
89;28.09.2014;2014;09;15;Sunnuntai;75;64;139;29;35;64
89;28.09.2014;2014;09;16;Sunnuntai;64;46;110;22;25;47
89;28.09.2014;2014;09;17;Sunnuntai;69;50;119;33;42;75
89;28.09.2014;2014;09;18;Sunnuntai;59;29;88;19;29;48
89;28.09.2014;2014;09;19;Sunnuntai;31;28;59;15;15;30
89;28.09.2014;2014;09;20;Sunnuntai;43;17;60;8;6;14
89;28.09.2014;2014;09;21;Sunnuntai;24;21;45;6;5;11
89;28.09.2014;2014;09;22;Sunnuntai;8;4;12;7;3;10
89;28.09.2014;2014;09;23;Sunnuntai;6;5;11;1;3;4
89;29.09.2014;2014;09;00;Maanantai;5;4;9;1;1;2
89;29.09.2014;2014;09;01;Maanantai;1;4;5;0;0;0
89;29.09.2014;2014;09;02;Maanantai;0;1;1;0;0;0
89;29.09.2014;2014;09;03;Maanantai;1;4;5;0;0;0
89;29.09.2014;2014;09;04;Maanantai;2;3;5;0;0;0
89;29.09.2014;2014;09;05;Maanantai;1;12;13;1;0;1
89;29.09.2014;2014;09;06;Maanantai;25;60;85;4;7;11
89;29.09.2014;2014;09;07;Maanantai;62;221;283;4;28;32
89;29.09.2014;2014;09;08;Maanantai;52;268;320;6;30;36
89;29.09.2014;2014;09;09;Maanantai;50;149;199;17;39;56
89;29.09.2014;2014;09;10;Maanantai;48;100;148;20;23;43
89;29.09.2014;2014;09;11;Maanantai;97;95;192;16;20;36
89;29.09.2014;2014;09;12;Maanantai;82;100;182;17;30;47
89;29.09.2014;2014;09;13;Maanantai;127;74;201;40;29;69
89;29.09.2014;2014;09;14;Maanantai;166;97;263;28;19;47
89;29.09.2014;2014;09;15;Maanantai;207;104;311;32;25;57
89;29.09.2014;2014;09;16;Maanantai;213;120;333;28;34;62
89;29.09.2014;2014;09;17;Maanantai;142;97;239;30;23;53
89;29.09.2014;2014;09;18;Maanantai;125;93;218;33;20;53
89;29.09.2014;2014;09;19;Maanantai;71;54;125;26;26;52
89;29.09.2014;2014;09;20;Maanantai;75;38;113;19;20;39
89;29.09.2014;2014;09;21;Maanantai;38;22;60;8;14;22
89;29.09.2014;2014;09;22;Maanantai;28;7;35;4;6;10
89;29.09.2014;2014;09;23;Maanantai;4;7;11;3;2;5
89;30.09.2014;2014;09;00;Tiistai;3;3;6;0;4;4
89;30.09.2014;2014;09;01;Tiistai;1;1;2;0;0;0
89;30.09.2014;2014;09;02;Tiistai;4;0;4;0;0;0
89;30.09.2014;2014;09;03;Tiistai;2;3;5;0;1;1
89;30.09.2014;2014;09;04;Tiistai;1;4;5;0;0;0
89;30.09.2014;2014;09;05;Tiistai;2;10;12;0;0;0
89;30.09.2014;2014;09;06;Tiistai;19;62;81;9;7;16
89;30.09.2014;2014;09;07;Tiistai;65;235;300;7;26;33
89;30.09.2014;2014;09;08;Tiistai;49;300;349;13;64;77
89;30.09.2014;2014;09;09;Tiistai;61;151;212;17;24;41
89;30.09.2014;2014;09;10;Tiistai;54;97;151;15;31;46
89;30.09.2014;2014;09;11;Tiistai;91;119;210;28;28;56
89;30.09.2014;2014;09;12;Tiistai;67;91;158;19;20;39
89;30.09.2014;2014;09;13;Tiistai;117;85;202;23;20;43
89;30.09.2014;2014;09;14;Tiistai;175;75;250;28;22;50
89;30.09.2014;2014;09;15;Tiistai;212;120;332;25;30;55
89;30.09.2014;2014;09;16;Tiistai;242;124;366;21;21;42
89;30.09.2014;2014;09;17;Tiistai;133;120;253;20;32;52
89;30.09.2014;2014;09;18;Tiistai;139;98;237;34;36;70
89;30.09.2014;2014;09;19;Tiistai;88;82;170;42;25;67
89;30.09.2014;2014;09;20;Tiistai;75;33;108;16;22;38
89;30.09.2014;2014;09;21;Tiistai;51;29;80;15;12;27
89;30.09.2014;2014;09;22;Tiistai;24;8;32;4;5;9
89;30.09.2014;2014;09;23;Tiistai;18;7;25;3;1;4
89;01.10.2014;2014;10;00;Keskiviikko;9;5;14;4;1;5
89;01.10.2014;2014;10;01;Keskiviikko;8;1;9;1;1;2
89;01.10.2014;2014;10;02;Keskiviikko;5;2;7;1;0;1
89;01.10.2014;2014;10;03;Keskiviikko;2;1;3;1;0;1
89;01.10.2014;2014;10;04;Keskiviikko;1;4;5;4;0;4
89;01.10.2014;2014;10;05;Keskiviikko;3;11;14;2;3;5
89;01.10.2014;2014;10;06;Keskiviikko;20;67;87;4;6;10
89;01.10.2014;2014;10;07;Keskiviikko;70;236;306;5;30;35
89;01.10.2014;2014;10;08;Keskiviikko;50;263;313;11;20;31
89;01.10.2014;2014;10;09;Keskiviikko;56;134;190;17;47;64
89;01.10.2014;2014;10;10;Keskiviikko;47;106;153;20;35;55
89;01.10.2014;2014;10;11;Keskiviikko;82;99;181;16;28;44
89;01.10.2014;2014;10;12;Keskiviikko;59;90;149;19;21;40
89;01.10.2014;2014;10;13;Keskiviikko;131;71;202;33;20;53
89;01.10.2014;2014;10;14;Keskiviikko;167;100;267;29;20;49
89;01.10.2014;2014;10;15;Keskiviikko;204;124;328;31;24;55
89;01.10.2014;2014;10;16;Keskiviikko;254;110;364;15;19;34
89;01.10.2014;2014;10;17;Keskiviikko;170;121;291;23;30;53
89;01.10.2014;2014;10;18;Keskiviikko;101;101;202;29;47;76
89;01.10.2014;2014;10;19;Keskiviikko;106;58;164;33;41;74
89;01.10.2014;2014;10;20;Keskiviikko;73;52;125;17;20;37
89;01.10.2014;2014;10;21;Keskiviikko;51;22;73;16;14;30
89;01.10.2014;2014;10;22;Keskiviikko;29;25;54;1;6;7
89;01.10.2014;2014;10;23;Keskiviikko;23;6;29;0;1;1
89;02.10.2014;2014;10;00;Torstai;9;1;10;1;2;3
89;02.10.2014;2014;10;01;Torstai;7;2;9;3;4;7
89;02.10.2014;2014;10;02;Torstai;6;2;8;1;1;2
89;02.10.2014;2014;10;03;Torstai;12;3;15;1;0;1
89;02.10.2014;2014;10;04;Torstai;4;2;6;3;2;5
89;02.10.2014;2014;10;05;Torstai;2;6;8;3;2;5
89;02.10.2014;2014;10;06;Torstai;22;51;73;0;6;6
89;02.10.2014;2014;10;07;Torstai;57;195;252;5;21;26
89;02.10.2014;2014;10;08;Torstai;37;259;296;5;17;22
89;02.10.2014;2014;10;09;Torstai;49;137;186;11;32;43
89;02.10.2014;2014;10;10;Torstai;53;95;148;20;21;41
89;02.10.2014;2014;10;11;Torstai;70;84;154;18;20;38
89;02.10.2014;2014;10;12;Torstai;59;77;136;14;16;30
89;02.10.2014;2014;10;13;Torstai;83;53;136;15;13;28
89;02.10.2014;2014;10;14;Torstai;124;72;196;18;23;41
89;02.10.2014;2014;10;15;Torstai;185;91;276;19;15;34
89;02.10.2014;2014;10;16;Torstai;216;121;337;17;31;48
89;02.10.2014;2014;10;17;Torstai;124;91;215;31;26;57
89;02.10.2014;2014;10;18;Torstai;119;88;207;38;28;66
89;02.10.2014;2014;10;19;Torstai;88;58;146;27;36;63
89;02.10.2014;2014;10;20;Torstai;65;49;114;25;20;45
89;02.10.2014;2014;10;21;Torstai;42;21;63;16;10;26
89;02.10.2014;2014;10;22;Torstai;29;5;34;10;6;16
89;02.10.2014;2014;10;23;Torstai;8;8;16;2;1;3
89;03.10.2014;2014;10;00;Perjantai;8;2;10;0;2;2
89;03.10.2014;2014;10;01;Perjantai;1;3;4;0;0;0
89;03.10.2014;2014;10;02;Perjantai;4;1;5;0;0;0
89;03.10.2014;2014;10;03;Perjantai;5;1;6;0;0;0
89;03.10.2014;2014;10;04;Perjantai;2;2;4;2;0;2
89;03.10.2014;2014;10;05;Perjantai;3;5;8;0;2;2
89;03.10.2014;2014;10;06;Perjantai;21;50;71;6;6;12
89;03.10.2014;2014;10;07;Perjantai;44;179;223;7;26;33
89;03.10.2014;2014;10;08;Perjantai;34;216;250;6;15;21
89;03.10.2014;2014;10;09;Perjantai;49;139;188;7;32;39
89;03.10.2014;2014;10;10;Perjantai;45;100;145;20;32;52
89;03.10.2014;2014;10;11;Perjantai;70;101;171;23;38;61
89;03.10.2014;2014;10;12;Perjantai;98;92;190;29;38;67
89;03.10.2014;2014;10;13;Perjantai;125;93;218;18;24;42
89;03.10.2014;2014;10;14;Perjantai;150;92;242;23;20;43
89;03.10.2014;2014;10;15;Perjantai;182;89;271;18;15;33
89;03.10.2014;2014;10;16;Perjantai;170;93;263;24;19;43
89;03.10.2014;2014;10;17;Perjantai;115;99;214;14;31;45
89;03.10.2014;2014;10;18;Perjantai;87;88;175;18;15;33
89;03.10.2014;2014;10;19;Perjantai;64;65;129;16;9;25
89;03.10.2014;2014;10;20;Perjantai;65;35;100;13;9;22
89;03.10.2014;2014;10;21;Perjantai;34;14;48;8;9;17
89;03.10.2014;2014;10;22;Perjantai;33;29;62;4;5;9
89;03.10.2014;2014;10;23;Perjantai;26;24;50;5;11;16
89;04.10.2014;2014;10;00;Lauantai;27;27;54;2;6;8
89;04.10.2014;2014;10;01;Lauantai;20;11;31;2;3;5
89;04.10.2014;2014;10;02;Lauantai;11;8;19;10;1;11
89;04.10.2014;2014;10;03;Lauantai;19;2;21;10;0;10
89;04.10.2014;2014;10;04;Lauantai;14;2;16;6;1;7
89;04.10.2014;2014;10;05;Lauantai;4;0;4;2;1;3
89;04.10.2014;2014;10;06;Lauantai;6;9;15;2;1;3
89;04.10.2014;2014;10;07;Lauantai;4;11;15;5;6;11
89;04.10.2014;2014;10;08;Lauantai;15;35;50;8;10;18
89;04.10.2014;2014;10;09;Lauantai;20;61;81;15;24;39
89;04.10.2014;2014;10;10;Lauantai;32;100;132;18;23;41
89;04.10.2014;2014;10;11;Lauantai;54;95;149;10;33;43
89;04.10.2014;2014;10;12;Lauantai;82;117;199;24;43;67
89;04.10.2014;2014;10;13;Lauantai;87;99;186;30;50;80
89;04.10.2014;2014;10;14;Lauantai;96;98;194;33;45;78
89;04.10.2014;2014;10;15;Lauantai;87;73;160;43;27;70
89;04.10.2014;2014;10;16;Lauantai;95;63;158;26;24;50
89;04.10.2014;2014;10;17;Lauantai;71;78;149;18;35;53
89;04.10.2014;2014;10;18;Lauantai;51;48;99;19;10;29
89;04.10.2014;2014;10;19;Lauantai;43;45;88;11;21;32
89;04.10.2014;2014;10;20;Lauantai;43;46;89;10;11;21
89;04.10.2014;2014;10;21;Lauantai;35;27;62;3;9;12
89;04.10.2014;2014;10;22;Lauantai;28;47;75;6;6;12
89;04.10.2014;2014;10;23;Lauantai;21;27;48;2;7;9
89;05.10.2014;2014;10;00;Sunnuntai;23;19;42;4;4;8
89;05.10.2014;2014;10;01;Sunnuntai;19;10;29;2;4;6
89;05.10.2014;2014;10;02;Sunnuntai;30;5;35;8;1;9
89;05.10.2014;2014;10;03;Sunnuntai;28;2;30;10;0;10
89;05.10.2014;2014;10;04;Sunnuntai;19;0;19;7;0;7
89;05.10.2014;2014;10;05;Sunnuntai;6;0;6;1;2;3
89;05.10.2014;2014;10;06;Sunnuntai;5;7;12;0;3;3
89;05.10.2014;2014;10;07;Sunnuntai;4;7;11;3;1;4
89;05.10.2014;2014;10;08;Sunnuntai;6;12;18;7;6;13
89;05.10.2014;2014;10;09;Sunnuntai;11;26;37;12;18;30
89;05.10.2014;2014;10;10;Sunnuntai;26;36;62;23;31;54
89;05.10.2014;2014;10;11;Sunnuntai;40;66;106;32;39;71
89;05.10.2014;2014;10;12;Sunnuntai;52;90;142;34;39;73
89;05.10.2014;2014;10;13;Sunnuntai;72;75;147;33;48;81
89;05.10.2014;2014;10;14;Sunnuntai;57;92;149;29;38;67
89;05.10.2014;2014;10;15;Sunnuntai;73;58;131;34;27;61
89;05.10.2014;2014;10;16;Sunnuntai;59;69;128;30;41;71
89;05.10.2014;2014;10;17;Sunnuntai;72;51;123;30;21;51
89;05.10.2014;2014;10;18;Sunnuntai;58;44;102;25;31;56
89;05.10.2014;2014;10;19;Sunnuntai;41;33;74;23;23;46
89;05.10.2014;2014;10;20;Sunnuntai;29;29;58;15;13;28
89;05.10.2014;2014;10;21;Sunnuntai;17;14;31;2;2;4
89;05.10.2014;2014;10;22;Sunnuntai;7;7;14;3;0;3
89;05.10.2014;2014;10;23;Sunnuntai;9;3;12;0;3;3
89;06.10.2014;2014;10;00;Maanantai;2;0;2;1;0;1
89;06.10.2014;2014;10;01;Maanantai;0;1;1;1;0;1
89;06.10.2014;2014;10;02;Maanantai;0;1;1;0;0;0
89;06.10.2014;2014;10;03;Maanantai;3;1;4;0;0;0
89;06.10.2014;2014;10;04;Maanantai;0;4;4;0;0;0
89;06.10.2014;2014;10;05;Maanantai;4;14;18;0;2;2
89;06.10.2014;2014;10;06;Maanantai;13;58;71;2;4;6
89;06.10.2014;2014;10;07;Maanantai;57;202;259;11;27;38
89;06.10.2014;2014;10;08;Maanantai;45;258;303;7;27;34
89;06.10.2014;2014;10;09;Maanantai;55;173;228;14;26;40
89;06.10.2014;2014;10;10;Maanantai;49;90;139;14;15;29
89;06.10.2014;2014;10;11;Maanantai;68;83;151;8;31;39
89;06.10.2014;2014;10;12;Maanantai;93;94;187;27;16;43
89;06.10.2014;2014;10;13;Maanantai;105;75;180;14;20;34
89;06.10.2014;2014;10;14;Maanantai;166;74;240;31;25;56
89;06.10.2014;2014;10;15;Maanantai;197;101;298;24;23;47
89;06.10.2014;2014;10;16;Maanantai;223;114;337;14;11;25
89;06.10.2014;2014;10;17;Maanantai;132;80;212;21;19;40
89;06.10.2014;2014;10;18;Maanantai;88;74;162;30;25;55
89;06.10.2014;2014;10;19;Maanantai;83;55;138;32;33;65
89;06.10.2014;2014;10;20;Maanantai;56;35;91;27;28;55
89;06.10.2014;2014;10;21;Maanantai;46;27;73;12;16;28
89;06.10.2014;2014;10;22;Maanantai;12;16;28;1;3;4
89;06.10.2014;2014;10;23;Maanantai;7;10;17;2;2;4
89;07.10.2014;2014;10;00;Tiistai;0;1;1;0;0;0
89;07.10.2014;2014;10;01;Tiistai;1;0;1;1;0;1
89;07.10.2014;2014;10;02;Tiistai;1;1;2;0;0;0
89;07.10.2014;2014;10;03;Tiistai;2;2;4;1;0;1
89;07.10.2014;2014;10;04;Tiistai;1;5;6;1;0;1
89;07.10.2014;2014;10;05;Tiistai;6;13;19;1;4;5
89;07.10.2014;2014;10;06;Tiistai;17;61;78;2;5;7
89;07.10.2014;2014;10;07;Tiistai;56;229;285;7;32;39
89;07.10.2014;2014;10;08;Tiistai;61;264;325;9;26;35
89;07.10.2014;2014;10;09;Tiistai;47;148;195;14;32;46
89;07.10.2014;2014;10;10;Tiistai;43;99;142;17;28;45
89;07.10.2014;2014;10;11;Tiistai;86;101;187;20;18;38
89;07.10.2014;2014;10;12;Tiistai;79;89;168;16;26;42
89;07.10.2014;2014;10;13;Tiistai;107;65;172;12;12;24
89;07.10.2014;2014;10;14;Tiistai;143;83;226;18;36;54
89;07.10.2014;2014;10;15;Tiistai;207;91;298;66;45;111
89;07.10.2014;2014;10;16;Tiistai;236;137;373;36;24;60
89;07.10.2014;2014;10;17;Tiistai;141;129;270;39;36;75
89;07.10.2014;2014;10;18;Tiistai;110;76;186;30;47;77
89;07.10.2014;2014;10;19;Tiistai;83;53;136;32;35;67
89;07.10.2014;2014;10;20;Tiistai;81;29;110;23;9;32
89;07.10.2014;2014;10;21;Tiistai;36;13;49;13;18;31
89;07.10.2014;2014;10;22;Tiistai;16;7;23;4;6;10
89;07.10.2014;2014;10;23;Tiistai;5;7;12;2;2;4
89;08.10.2014;2014;10;00;Keskiviikko;6;0;6;0;0;0
89;08.10.2014;2014;10;01;Keskiviikko;9;0;9;1;0;1
89;08.10.2014;2014;10;02;Keskiviikko;0;3;3;2;0;2
89;08.10.2014;2014;10;03;Keskiviikko;0;0;0;0;1;1
89;08.10.2014;2014;10;04;Keskiviikko;3;3;6;1;0;1
89;08.10.2014;2014;10;05;Keskiviikko;5;18;23;1;3;4
89;08.10.2014;2014;10;06;Keskiviikko;23;70;93;6;7;13
89;08.10.2014;2014;10;07;Keskiviikko;55;234;289;2;30;32
89;08.10.2014;2014;10;08;Keskiviikko;59;267;326;11;49;60
89;08.10.2014;2014;10;09;Keskiviikko;56;167;223;19;35;54
89;08.10.2014;2014;10;10;Keskiviikko;61;108;169;17;33;50
89;08.10.2014;2014;10;11;Keskiviikko;88;111;199;24;20;44
89;08.10.2014;2014;10;12;Keskiviikko;103;111;214;20;47;67
89;08.10.2014;2014;10;13;Keskiviikko;132;81;213;30;19;49
89;08.10.2014;2014;10;14;Keskiviikko;174;98;272;22;15;37
89;08.10.2014;2014;10;15;Keskiviikko;195;131;326;25;29;54
89;08.10.2014;2014;10;16;Keskiviikko;233;121;354;19;30;49
89;08.10.2014;2014;10;17;Keskiviikko;153;96;249;15;30;45
89;08.10.2014;2014;10;18;Keskiviikko;125;89;214;32;24;56
89;08.10.2014;2014;10;19;Keskiviikko;86;50;136;19;35;54
89;08.10.2014;2014;10;20;Keskiviikko;81;36;117;15;20;35
89;08.10.2014;2014;10;21;Keskiviikko;34;18;52;6;5;11
89;08.10.2014;2014;10;22;Keskiviikko;24;6;30;4;3;7
89;08.10.2014;2014;10;23;Keskiviikko;4;16;20;0;1;1
89;09.10.2014;2014;10;00;Torstai;7;4;11;0;1;1
89;09.10.2014;2014;10;01;Torstai;6;0;6;1;0;1
89;09.10.2014;2014;10;02;Torstai;4;1;5;1;0;1
89;09.10.2014;2014;10;03;Torstai;5;2;7;0;0;0
89;09.10.2014;2014;10;04;Torstai;3;3;6;3;1;4
89;09.10.2014;2014;10;05;Torstai;5;11;16;0;1;1
89;09.10.2014;2014;10;06;Torstai;24;50;74;3;8;11
89;09.10.2014;2014;10;07;Torstai;47;185;232;8;29;37
89;09.10.2014;2014;10;08;Torstai;43;250;293;9;31;40
89;09.10.2014;2014;10;09;Torstai;39;137;176;9;30;39
89;09.10.2014;2014;10;10;Torstai;52;74;126;12;21;33
89;09.10.2014;2014;10;11;Torstai;79;95;174;23;23;46
89;09.10.2014;2014;10;12;Torstai;67;99;166;19;16;35
89;09.10.2014;2014;10;13;Torstai;110;48;158;20;12;32
89;09.10.2014;2014;10;14;Torstai;113;72;185;15;13;28
89;09.10.2014;2014;10;15;Torstai;151;88;239;30;16;46
89;09.10.2014;2014;10;16;Torstai;195;90;285;26;15;41
89;09.10.2014;2014;10;17;Torstai;105;80;185;13;18;31
89;09.10.2014;2014;10;18;Torstai;90;62;152;28;48;76
89;09.10.2014;2014;10;19;Torstai;68;34;102;30;21;51
89;09.10.2014;2014;10;20;Torstai;55;39;94;10;11;21
89;09.10.2014;2014;10;21;Torstai;50;21;71;11;4;15
89;09.10.2014;2014;10;22;Torstai;26;22;48;4;5;9
89;09.10.2014;2014;10;23;Torstai;8;9;17;4;1;5
89;10.10.2014;2014;10;00;Perjantai;9;3;12;1;1;2
89;10.10.2014;2014;10;01;Perjantai;10;2;12;2;0;2
89;10.10.2014;2014;10;02;Perjantai;5;0;5;0;1;1
89;10.10.2014;2014;10;03;Perjantai;8;1;9;0;0;0
89;10.10.2014;2014;10;04;Perjantai;4;4;8;0;0;0
89;10.10.2014;2014;10;05;Perjantai;7;12;19;0;1;1
89;10.10.2014;2014;10;06;Perjantai;16;43;59;0;7;7
89;10.10.2014;2014;10;07;Perjantai;30;133;163;6;19;25
89;10.10.2014;2014;10;08;Perjantai;37;172;209;3;18;21
89;10.10.2014;2014;10;09;Perjantai;32;96;128;11;18;29
89;10.10.2014;2014;10;10;Perjantai;27;52;79;5;12;17
89;10.10.2014;2014;10;11;Perjantai;37;55;92;9;19;28
89;10.10.2014;2014;10;12;Perjantai;44;38;82;13;15;28
89;10.10.2014;2014;10;13;Perjantai;88;61;149;6;8;14
89;10.10.2014;2014;10;14;Perjantai;115;70;185;19;22;41
89;10.10.2014;2014;10;15;Perjantai;128;61;189;12;10;22
89;10.10.2014;2014;10;16;Perjantai;101;83;184;21;20;41
89;10.10.2014;2014;10;17;Perjantai;76;51;127;13;15;28
89;10.10.2014;2014;10;18;Perjantai;46;48;94;10;22;32
89;10.10.2014;2014;10;19;Perjantai;36;31;67;13;14;27
89;10.10.2014;2014;10;20;Perjantai;35;18;53;7;8;15
89;10.10.2014;2014;10;21;Perjantai;40;15;55;10;8;18
89;10.10.2014;2014;10;22;Perjantai;23;17;40;7;8;15
89;10.10.2014;2014;10;23;Perjantai;23;12;35;4;3;7
89;11.10.2014;2014;10;00;Lauantai;15;12;27;2;3;5
89;11.10.2014;2014;10;01;Lauantai;10;3;13;5;3;8
89;11.10.2014;2014;10;02;Lauantai;13;7;20;5;2;7
89;11.10.2014;2014;10;03;Lauantai;20;4;24;4;0;4
89;11.10.2014;2014;10;04;Lauantai;3;2;5;1;0;1
89;11.10.2014;2014;10;05;Lauantai;3;3;6;0;0;0
89;11.10.2014;2014;10;06;Lauantai;1;17;18;1;4;5
89;11.10.2014;2014;10;07;Lauantai;7;21;28;5;7;12
89;11.10.2014;2014;10;08;Lauantai;17;19;36;7;6;13
89;11.10.2014;2014;10;09;Lauantai;11;57;68;8;13;21
89;11.10.2014;2014;10;10;Lauantai;25;81;106;13;22;35
89;11.10.2014;2014;10;11;Lauantai;37;87;124;17;34;51
89;11.10.2014;2014;10;12;Lauantai;53;95;148;18;25;43
89;11.10.2014;2014;10;13;Lauantai;68;59;127;24;33;57
89;11.10.2014;2014;10;14;Lauantai;81;64;145;17;21;38
89;11.10.2014;2014;10;15;Lauantai;93;70;163;27;45;72
89;11.10.2014;2014;10;16;Lauantai;77;37;114;21;15;36
89;11.10.2014;2014;10;17;Lauantai;54;39;93;20;20;40
89;11.10.2014;2014;10;18;Lauantai;66;35;101;14;22;36
89;11.10.2014;2014;10;19;Lauantai;45;32;77;20;19;39
89;11.10.2014;2014;10;20;Lauantai;24;19;43;8;8;16
89;11.10.2014;2014;10;21;Lauantai;28;28;56;3;4;7
89;11.10.2014;2014;10;22;Lauantai;16;14;30;5;6;11
89;11.10.2014;2014;10;23;Lauantai;22;23;45;5;6;11
89;12.10.2014;2014;10;00;Sunnuntai;14;12;26;1;4;5
89;12.10.2014;2014;10;01;Sunnuntai;14;10;24;3;1;4
89;12.10.2014;2014;10;02;Sunnuntai;9;2;11;3;1;4
89;12.10.2014;2014;10;03;Sunnuntai;33;1;34;8;1;9
89;12.10.2014;2014;10;04;Sunnuntai;13;2;15;6;0;6
89;12.10.2014;2014;10;05;Sunnuntai;7;2;9;3;1;4
89;12.10.2014;2014;10;06;Sunnuntai;5;8;13;1;2;3
89;12.10.2014;2014;10;07;Sunnuntai;2;6;8;4;3;7
89;12.10.2014;2014;10;08;Sunnuntai;2;16;18;11;6;17
89;12.10.2014;2014;10;09;Sunnuntai;6;28;34;9;30;39
89;12.10.2014;2014;10;10;Sunnuntai;16;40;56;31;48;79
89;12.10.2014;2014;10;11;Sunnuntai;26;55;81;33;41;74
89;12.10.2014;2014;10;12;Sunnuntai;44;85;129;34;50;84
89;12.10.2014;2014;10;13;Sunnuntai;61;85;146;38;43;81
89;12.10.2014;2014;10;14;Sunnuntai;66;76;142;35;43;78
89;12.10.2014;2014;10;15;Sunnuntai;72;48;120;23;26;49
89;12.10.2014;2014;10;16;Sunnuntai;81;62;143;38;33;71
89;12.10.2014;2014;10;17;Sunnuntai;71;48;119;23;27;50
89;12.10.2014;2014;10;18;Sunnuntai;51;37;88;29;36;65
89;12.10.2014;2014;10;19;Sunnuntai;50;31;81;19;12;31
89;12.10.2014;2014;10;20;Sunnuntai;42;21;63;14;7;21
89;12.10.2014;2014;10;21;Sunnuntai;20;12;32;9;11;20
89;12.10.2014;2014;10;22;Sunnuntai;16;3;19;4;2;6
89;12.10.2014;2014;10;23;Sunnuntai;6;2;8;2;1;3
89;13.10.2014;2014;10;00;Maanantai;4;4;8;1;1;2
89;13.10.2014;2014;10;01;Maanantai;4;3;7;2;0;2
89;13.10.2014;2014;10;02;Maanantai;3;0;3;0;1;1
89;13.10.2014;2014;10;03;Maanantai;2;1;3;0;0;0
89;13.10.2014;2014;10;04;Maanantai;1;2;3;2;0;2
89;13.10.2014;2014;10;05;Maanantai;4;8;12;1;1;2
89;13.10.2014;2014;10;06;Maanantai;22;47;69;2;6;8
89;13.10.2014;2014;10;07;Maanantai;48;179;227;9;21;30
89;13.10.2014;2014;10;08;Maanantai;45;279;324;7;20;27
89;13.10.2014;2014;10;09;Maanantai;52;142;194;13;27;40
89;13.10.2014;2014;10;10;Maanantai;49;108;157;7;31;38
89;13.10.2014;2014;10;11;Maanantai;81;87;168;20;31;51
89;13.10.2014;2014;10;12;Maanantai;67;92;159;20;39;59
89;13.10.2014;2014;10;13;Maanantai;90;81;171;35;27;62
89;13.10.2014;2014;10;14;Maanantai;168;63;231;31;16;47
89;13.10.2014;2014;10;15;Maanantai;175;76;251;20;15;35
89;13.10.2014;2014;10;16;Maanantai;209;102;311;17;20;37
89;13.10.2014;2014;10;17;Maanantai;122;78;200;16;13;29
89;13.10.2014;2014;10;18;Maanantai;88;60;148;20;15;35
89;13.10.2014;2014;10;19;Maanantai;59;24;83;18;15;33
89;13.10.2014;2014;10;20;Maanantai;55;18;73;11;8;19
89;13.10.2014;2014;10;21;Maanantai;38;12;50;4;12;16
89;13.10.2014;2014;10;22;Maanantai;18;11;29;3;4;7
89;13.10.2014;2014;10;23;Maanantai;6;4;10;1;1;2
89;14.10.2014;2014;10;00;Tiistai;3;1;4;1;1;2
89;14.10.2014;2014;10;01;Tiistai;0;0;0;0;3;3
89;14.10.2014;2014;10;02;Tiistai;0;3;3;0;0;0
89;14.10.2014;2014;10;03;Tiistai;1;2;3;0;0;0
89;14.10.2014;2014;10;04;Tiistai;1;4;5;0;0;0
89;14.10.2014;2014;10;05;Tiistai;3;8;11;1;3;4
89;14.10.2014;2014;10;06;Tiistai;19;53;72;8;8;16
89;14.10.2014;2014;10;07;Tiistai;60;203;263;8;19;27
89;14.10.2014;2014;10;08;Tiistai;47;261;308;17;27;44
89;14.10.2014;2014;10;09;Tiistai;44;136;180;6;31;37
89;14.10.2014;2014;10;10;Tiistai;54;83;137;12;30;42
89;14.10.2014;2014;10;11;Tiistai;69;84;153;27;30;57
89;14.10.2014;2014;10;12;Tiistai;43;80;123;17;36;53
89;14.10.2014;2014;10;13;Tiistai;93;79;172;25;27;52
89;14.10.2014;2014;10;14;Tiistai;138;97;235;26;83;109
89;14.10.2014;2014;10;15;Tiistai;196;102;298;65;26;91
89;14.10.2014;2014;10;16;Tiistai;222;115;337;31;37;68
89;14.10.2014;2014;10;17;Tiistai;123;104;227;41;37;78
89;14.10.2014;2014;10;18;Tiistai;99;61;160;36;35;71
89;14.10.2014;2014;10;19;Tiistai;82;45;127;29;20;49
89;14.10.2014;2014;10;20;Tiistai;54;36;90;22;20;42
89;14.10.2014;2014;10;21;Tiistai;54;28;82;13;9;22
89;14.10.2014;2014;10;22;Tiistai;19;12;31;2;3;5
89;14.10.2014;2014;10;23;Tiistai;10;3;13;2;1;3
89;15.10.2014;2014;10;00;Keskiviikko;8;3;11;0;0;0
89;15.10.2014;2014;10;01;Keskiviikko;1;1;2;0;0;0
89;15.10.2014;2014;10;02;Keskiviikko;3;2;5;1;1;2
89;15.10.2014;2014;10;03;Keskiviikko;1;1;2;0;0;0
89;15.10.2014;2014;10;04;Keskiviikko;1;0;1;1;0;1
89;15.10.2014;2014;10;05;Keskiviikko;4;9;13;1;1;2
89;15.10.2014;2014;10;06;Keskiviikko;20;52;72;4;7;11
89;15.10.2014;2014;10;07;Keskiviikko;51;192;243;5;33;38
89;15.10.2014;2014;10;08;Keskiviikko;41;225;266;6;33;39
89;15.10.2014;2014;10;09;Keskiviikko;41;129;170;15;49;64
89;15.10.2014;2014;10;10;Keskiviikko;42;88;130;10;35;45
89;15.10.2014;2014;10;11;Keskiviikko;69;81;150;37;50;87
89;15.10.2014;2014;10;12;Keskiviikko;64;81;145;25;37;62
89;15.10.2014;2014;10;13;Keskiviikko;84;83;167;27;31;58
89;15.10.2014;2014;10;14;Keskiviikko;169;104;273;26;29;55
89;15.10.2014;2014;10;15;Keskiviikko;160;101;261;40;32;72
89;15.10.2014;2014;10;16;Keskiviikko;202;105;307;39;26;65
89;15.10.2014;2014;10;17;Keskiviikko;111;97;208;34;46;80
89;15.10.2014;2014;10;18;Keskiviikko;95;66;161;20;35;55
89;15.10.2014;2014;10;19;Keskiviikko;82;48;130;36;26;62
89;15.10.2014;2014;10;20;Keskiviikko;60;35;95;19;17;36
89;15.10.2014;2014;10;21;Keskiviikko;51;14;65;11;6;17
89;15.10.2014;2014;10;22;Keskiviikko;17;6;23;7;1;8
89;15.10.2014;2014;10;23;Keskiviikko;9;5;14;1;3;4
89;16.10.2014;2014;10;00;Torstai;6;8;14;4;1;5
89;16.10.2014;2014;10;01;Torstai;0;2;2;3;3;6
89;16.10.2014;2014;10;02;Torstai;8;0;8;0;1;1
89;16.10.2014;2014;10;03;Torstai;9;1;10;0;0;0
89;16.10.2014;2014;10;04;Torstai;6;3;9;2;0;2
89;16.10.2014;2014;10;05;Torstai;3;7;10;1;0;1
89;16.10.2014;2014;10;06;Torstai;22;44;66;3;6;9
89;16.10.2014;2014;10;07;Torstai;42;155;197;11;33;44
89;16.10.2014;2014;10;08;Torstai;27;232;259;5;34;39
89;16.10.2014;2014;10;09;Torstai;39;124;163;12;37;49
89;16.10.2014;2014;10;10;Torstai;45;72;117;23;28;51
89;16.10.2014;2014;10;11;Torstai;45;79;124;21;46;67
89;16.10.2014;2014;10;12;Torstai;70;84;154;24;28;52
89;16.10.2014;2014;10;13;Torstai;80;76;156;28;40;68
89;16.10.2014;2014;10;14;Torstai;120;98;218;31;32;63
89;16.10.2014;2014;10;15;Torstai;171;119;290;34;28;62
89;16.10.2014;2014;10;16;Torstai;243;98;341;31;29;60
89;16.10.2014;2014;10;17;Torstai;119;94;213;27;30;57
89;16.10.2014;2014;10;18;Torstai;83;78;161;30;32;62
89;16.10.2014;2014;10;19;Torstai;86;36;122;27;25;52
89;16.10.2014;2014;10;20;Torstai;69;38;107;20;17;37
89;16.10.2014;2014;10;21;Torstai;29;17;46;10;8;18
89;16.10.2014;2014;10;22;Torstai;21;16;37;4;2;6
89;16.10.2014;2014;10;23;Torstai;15;19;34;7;2;9
89;17.10.2014;2014;10;00;Perjantai;11;2;13;3;0;3
89;17.10.2014;2014;10;01;Perjantai;9;2;11;2;0;2
89;17.10.2014;2014;10;02;Perjantai;5;0;5;5;0;5
89;17.10.2014;2014;10;03;Perjantai;5;1;6;0;1;1
89;17.10.2014;2014;10;04;Perjantai;7;2;9;0;0;0
89;17.10.2014;2014;10;05;Perjantai;2;7;9;2;1;3
89;17.10.2014;2014;10;06;Perjantai;16;30;46;4;4;8
89;17.10.2014;2014;10;07;Perjantai;35;157;192;4;27;31
89;17.10.2014;2014;10;08;Perjantai;32;188;220;10;35;45
89;17.10.2014;2014;10;09;Perjantai;40;116;156;9;26;35
89;17.10.2014;2014;10;10;Perjantai;44;82;126;12;32;44
89;17.10.2014;2014;10;11;Perjantai;67;82;149;10;29;39
89;17.10.2014;2014;10;12;Perjantai;81;87;168;16;28;44
89;17.10.2014;2014;10;13;Perjantai;129;95;224;24;29;53
89;17.10.2014;2014;10;14;Perjantai;146;87;233;24;31;55
89;17.10.2014;2014;10;15;Perjantai;157;87;244;29;27;56
89;17.10.2014;2014;10;16;Perjantai;144;88;232;30;20;50
89;17.10.2014;2014;10;17;Perjantai;79;61;140;26;32;58
89;17.10.2014;2014;10;18;Perjantai;79;43;122;21;34;55
89;17.10.2014;2014;10;19;Perjantai;51;48;99;14;14;28
89;17.10.2014;2014;10;20;Perjantai;26;28;54;11;12;23
89;17.10.2014;2014;10;21;Perjantai;19;16;35;9;10;19
89;17.10.2014;2014;10;22;Perjantai;23;25;48;4;5;9
89;17.10.2014;2014;10;23;Perjantai;30;19;49;3;2;5
89;18.10.2014;2014;10;00;Lauantai;10;14;24;2;3;5
89;18.10.2014;2014;10;01;Lauantai;15;5;20;1;2;3
89;18.10.2014;2014;10;02;Lauantai;11;4;15;4;2;6
89;18.10.2014;2014;10;03;Lauantai;6;8;14;4;1;5
89;18.10.2014;2014;10;04;Lauantai;8;4;12;3;0;3
89;18.10.2014;2014;10;05;Lauantai;2;5;7;0;2;2
89;18.10.2014;2014;10;06;Lauantai;4;3;7;0;0;0
89;18.10.2014;2014;10;07;Lauantai;6;7;13;7;4;11
89;18.10.2014;2014;10;08;Lauantai;11;16;27;8;16;24
89;18.10.2014;2014;10;09;Lauantai;8;43;51;7;19;26
89;18.10.2014;2014;10;10;Lauantai;11;80;91;14;34;48
89;18.10.2014;2014;10;11;Lauantai;33;59;92;19;38;57
89;18.10.2014;2014;10;12;Lauantai;55;78;133;17;34;51
89;18.10.2014;2014;10;13;Lauantai;71;65;136;24;35;59
89;18.10.2014;2014;10;14;Lauantai;64;57;121;26;31;57
89;18.10.2014;2014;10;15;Lauantai;61;52;113;26;23;49
89;18.10.2014;2014;10;16;Lauantai;39;42;81;13;18;31
89;18.10.2014;2014;10;17;Lauantai;57;41;98;33;15;48
89;18.10.2014;2014;10;18;Lauantai;41;33;74;12;13;25
89;18.10.2014;2014;10;19;Lauantai;32;17;49;5;8;13
89;18.10.2014;2014;10;20;Lauantai;16;29;45;6;9;15
89;18.10.2014;2014;10;21;Lauantai;23;22;45;8;4;12
89;18.10.2014;2014;10;22;Lauantai;14;25;39;1;6;7
89;18.10.2014;2014;10;23;Lauantai;8;25;33;1;7;8
89;19.10.2014;2014;10;00;Sunnuntai;16;19;35;4;3;7
89;19.10.2014;2014;10;01;Sunnuntai;15;9;24;3;2;5
89;19.10.2014;2014;10;02;Sunnuntai;14;2;16;4;1;5
89;19.10.2014;2014;10;03;Sunnuntai;14;1;15;2;3;5
89;19.10.2014;2014;10;04;Sunnuntai;16;1;17;20;0;20
89;19.10.2014;2014;10;05;Sunnuntai;11;3;14;1;3;4
89;19.10.2014;2014;10;06;Sunnuntai;6;4;10;1;1;2
89;19.10.2014;2014;10;07;Sunnuntai;4;9;13;1;0;1
89;19.10.2014;2014;10;08;Sunnuntai;1;5;6;7;5;12
89;19.10.2014;2014;10;09;Sunnuntai;4;11;15;6;7;13
89;19.10.2014;2014;10;10;Sunnuntai;5;12;17;6;12;18
89;19.10.2014;2014;10;11;Sunnuntai;13;16;29;8;15;23
89;19.10.2014;2014;10;12;Sunnuntai;13;33;46;7;16;23
89;19.10.2014;2014;10;13;Sunnuntai;25;39;64;12;28;40
89;19.10.2014;2014;10;14;Sunnuntai;26;28;54;20;24;44
89;19.10.2014;2014;10;15;Sunnuntai;37;22;59;16;12;28
89;19.10.2014;2014;10;16;Sunnuntai;37;21;58;24;21;45
89;19.10.2014;2014;10;17;Sunnuntai;25;20;45;16;16;32
89;19.10.2014;2014;10;18;Sunnuntai;27;32;59;15;20;35
89;19.10.2014;2014;10;19;Sunnuntai;18;15;33;7;12;19
89;19.10.2014;2014;10;20;Sunnuntai;20;11;31;9;14;23
89;19.10.2014;2014;10;21;Sunnuntai;6;13;19;3;3;6
89;19.10.2014;2014;10;22;Sunnuntai;7;7;14;2;1;3
89;19.10.2014;2014;10;23;Sunnuntai;9;5;14;2;1;3
89;20.10.2014;2014;10;00;Maanantai;5;4;9;1;0;1
89;20.10.2014;2014;10;01;Maanantai;2;1;3;1;1;2
89;20.10.2014;2014;10;02;Maanantai;1;0;1;2;0;2
89;20.10.2014;2014;10;03;Maanantai;0;2;2;1;1;2
89;20.10.2014;2014;10;04;Maanantai;3;1;4;1;0;1
89;20.10.2014;2014;10;05;Maanantai;2;10;12;1;1;2
89;20.10.2014;2014;10;06;Maanantai;16;35;51;0;8;8
89;20.10.2014;2014;10;07;Maanantai;40;114;154;2;17;19
89;20.10.2014;2014;10;08;Maanantai;20;127;147;8;31;39
89;20.10.2014;2014;10;09;Maanantai;24;81;105;11;28;39
89;20.10.2014;2014;10;10;Maanantai;27;66;93;24;24;48
89;20.10.2014;2014;10;11;Maanantai;62;62;124;22;18;40
89;20.10.2014;2014;10;12;Maanantai;49;88;137;33;41;74
89;20.10.2014;2014;10;13;Maanantai;57;74;131;16;21;37
89;20.10.2014;2014;10;14;Maanantai;98;49;147;20;24;44
89;20.10.2014;2014;10;15;Maanantai;112;48;160;20;20;40
89;20.10.2014;2014;10;16;Maanantai;130;78;208;29;21;50
89;20.10.2014;2014;10;17;Maanantai;97;41;138;21;21;42
89;20.10.2014;2014;10;18;Maanantai;67;45;112;32;25;57
89;20.10.2014;2014;10;19;Maanantai;50;18;68;19;25;44
89;20.10.2014;2014;10;20;Maanantai;34;14;48;16;24;40
89;20.10.2014;2014;10;21;Maanantai;29;13;42;4;10;14
89;20.10.2014;2014;10;22;Maanantai;13;4;17;2;0;2
89;20.10.2014;2014;10;23;Maanantai;4;5;9;3;3;6
89;21.10.2014;2014;10;00;Tiistai;1;0;1;1;0;1
89;21.10.2014;2014;10;01;Tiistai;9;0;9;0;0;0
89;21.10.2014;2014;10;02;Tiistai;2;2;4;0;0;0
89;21.10.2014;2014;10;03;Tiistai;3;2;5;0;0;0
89;21.10.2014;2014;10;04;Tiistai;3;4;7;0;0;0
89;21.10.2014;2014;10;05;Tiistai;2;6;8;3;3;6
89;21.10.2014;2014;10;06;Tiistai;14;38;52;6;9;15
89;21.10.2014;2014;10;07;Tiistai;31;110;141;7;9;16
89;21.10.2014;2014;10;08;Tiistai;19;125;144;9;25;34
89;21.10.2014;2014;10;09;Tiistai;27;79;106;7;20;27
89;21.10.2014;2014;10;10;Tiistai;27;65;92;17;38;55
89;21.10.2014;2014;10;11;Tiistai;50;88;138;27;33;60
89;21.10.2014;2014;10;12;Tiistai;61;84;145;29;34;63
89;21.10.2014;2014;10;13;Tiistai;79;59;138;18;18;36
89;21.10.2014;2014;10;14;Tiistai;94;62;156;15;18;33
89;21.10.2014;2014;10;15;Tiistai;118;59;177;28;22;50
89;21.10.2014;2014;10;16;Tiistai;133;65;198;24;13;37
89;21.10.2014;2014;10;17;Tiistai;71;55;126;32;24;56
89;21.10.2014;2014;10;18;Tiistai;70;36;106;30;25;55
89;21.10.2014;2014;10;19;Tiistai;47;23;70;23;17;40
89;21.10.2014;2014;10;20;Tiistai;32;26;58;11;15;26
89;21.10.2014;2014;10;21;Tiistai;23;16;39;9;5;14
89;21.10.2014;2014;10;22;Tiistai;23;8;31;5;3;8
89;21.10.2014;2014;10;23;Tiistai;10;8;18;3;3;6
89;22.10.2014;2014;10;00;Keskiviikko;4;4;8;0;0;0
89;22.10.2014;2014;10;01;Keskiviikko;2;1;3;3;0;3
89;22.10.2014;2014;10;02;Keskiviikko;3;0;3;3;0;3
89;22.10.2014;2014;10;03;Keskiviikko;3;0;3;5;0;5
89;22.10.2014;2014;10;04;Keskiviikko;5;4;9;0;0;0
89;22.10.2014;2014;10;05;Keskiviikko;4;6;10;1;1;2
89;22.10.2014;2014;10;06;Keskiviikko;17;42;59;3;6;9
89;22.10.2014;2014;10;07;Keskiviikko;25;105;130;1;16;17
89;22.10.2014;2014;10;08;Keskiviikko;20;125;145;8;26;34
89;22.10.2014;2014;10;09;Keskiviikko;20;70;90;6;14;20
89;22.10.2014;2014;10;10;Keskiviikko;28;41;69;12;25;37
89;22.10.2014;2014;10;11;Keskiviikko;40;58;98;21;38;59
89;22.10.2014;2014;10;12;Keskiviikko;48;71;119;26;31;57
89;22.10.2014;2014;10;13;Keskiviikko;55;49;104;19;21;40
89;22.10.2014;2014;10;14;Keskiviikko;99;59;158;35;37;72
89;22.10.2014;2014;10;15;Keskiviikko;101;71;172;24;29;53
89;22.10.2014;2014;10;16;Keskiviikko;116;61;177;17;16;33
89;22.10.2014;2014;10;17;Keskiviikko;85;57;142;25;25;50
89;22.10.2014;2014;10;18;Keskiviikko;72;42;114;23;25;48
89;22.10.2014;2014;10;19;Keskiviikko;52;31;83;26;26;52
89;22.10.2014;2014;10;20;Keskiviikko;46;20;66;15;10;25
89;22.10.2014;2014;10;21;Keskiviikko;24;23;47;3;7;10
89;22.10.2014;2014;10;22;Keskiviikko;13;7;20;3;2;5
89;22.10.2014;2014;10;23;Keskiviikko;11;8;19;1;3;4
89;23.10.2014;2014;10;00;Torstai;6;9;15;3;1;4
89;23.10.2014;2014;10;01;Torstai;5;1;6;1;0;1
89;23.10.2014;2014;10;02;Torstai;6;0;6;1;0;1
89;23.10.2014;2014;10;03;Torstai;8;2;10;0;0;0
89;23.10.2014;2014;10;04;Torstai;4;3;7;0;0;0
89;23.10.2014;2014;10;05;Torstai;1;7;8;2;0;2
89;23.10.2014;2014;10;06;Torstai;15;27;42;2;4;6
89;23.10.2014;2014;10;07;Torstai;25;101;126;3;14;17
89;23.10.2014;2014;10;08;Torstai;17;111;128;9;27;36
89;23.10.2014;2014;10;09;Torstai;18;70;88;7;16;23
89;23.10.2014;2014;10;10;Torstai;28;51;79;14;20;34
89;23.10.2014;2014;10;11;Torstai;37;59;96;15;37;52
89;23.10.2014;2014;10;12;Torstai;41;70;111;33;43;76
89;23.10.2014;2014;10;13;Torstai;77;49;126;26;22;48
89;23.10.2014;2014;10;14;Torstai;67;58;125;17;30;47
89;23.10.2014;2014;10;15;Torstai;95;65;160;22;26;48
89;23.10.2014;2014;10;16;Torstai;137;59;196;29;22;51
89;23.10.2014;2014;10;17;Torstai;79;47;126;20;24;44
89;23.10.2014;2014;10;18;Torstai;72;53;125;18;24;42
89;23.10.2014;2014;10;19;Torstai;46;28;74;15;8;23
89;23.10.2014;2014;10;20;Torstai;45;17;62;9;7;16
89;23.10.2014;2014;10;21;Torstai;21;12;33;6;4;10
89;23.10.2014;2014;10;22;Torstai;19;4;23;3;2;5
89;23.10.2014;2014;10;23;Torstai;10;8;18;3;3;6
89;24.10.2014;2014;10;00;Perjantai;4;2;6;0;0;0
89;24.10.2014;2014;10;01;Perjantai;5;2;7;0;0;0
89;24.10.2014;2014;10;02;Perjantai;2;1;3;5;0;5
89;24.10.2014;2014;10;03;Perjantai;1;1;2;1;0;1
89;24.10.2014;2014;10;04;Perjantai;2;2;4;1;0;1
89;24.10.2014;2014;10;05;Perjantai;1;7;8;2;1;3
89;24.10.2014;2014;10;06;Perjantai;12;32;44;5;10;15
89;24.10.2014;2014;10;07;Perjantai;20;52;72;3;14;17
89;24.10.2014;2014;10;08;Perjantai;10;101;111;7;38;45
89;24.10.2014;2014;10;09;Perjantai;15;35;50;11;24;35
89;24.10.2014;2014;10;10;Perjantai;14;32;46;14;18;32
89;24.10.2014;2014;10;11;Perjantai;30;20;50;10;20;30
89;24.10.2014;2014;10;12;Perjantai;28;44;72;16;27;43
89;24.10.2014;2014;10;13;Perjantai;46;49;95;15;20;35
89;24.10.2014;2014;10;14;Perjantai;54;36;90;29;15;44
89;24.10.2014;2014;10;15;Perjantai;51;42;93;23;17;40
89;24.10.2014;2014;10;16;Perjantai;62;33;95;31;14;45
89;24.10.2014;2014;10;17;Perjantai;38;22;60;23;11;34
89;24.10.2014;2014;10;18;Perjantai;16;22;38;10;18;28
89;24.10.2014;2014;10;19;Perjantai;22;6;28;15;15;30
89;24.10.2014;2014;10;20;Perjantai;18;7;25;11;7;18
89;24.10.2014;2014;10;21;Perjantai;18;7;25;10;3;13
89;24.10.2014;2014;10;22;Perjantai;12;3;15;8;7;15
89;24.10.2014;2014;10;23;Perjantai;5;7;12;2;7;9
89;25.10.2014;2014;10;00;Lauantai;1;1;2;2;7;9
89;25.10.2014;2014;10;01;Lauantai;2;3;5;3;4;7
89;25.10.2014;2014;10;02;Lauantai;1;0;1;14;5;19
89;25.10.2014;2014;10;03;Lauantai;6;0;6;10;0;10
89;25.10.2014;2014;10;04;Lauantai;5;0;5;4;1;5
89;25.10.2014;2014;10;05;Lauantai;1;0;1;1;3;4
89;25.10.2014;2014;10;06;Lauantai;1;6;7;2;2;4
89;25.10.2014;2014;10;07;Lauantai;3;6;9;6;6;12
89;25.10.2014;2014;10;08;Lauantai;2;9;11;3;7;10
89;25.10.2014;2014;10;09;Lauantai;3;13;16;6;12;18
89;25.10.2014;2014;10;10;Lauantai;9;23;32;4;9;13
89;25.10.2014;2014;10;11;Lauantai;5;27;32;10;9;19
89;25.10.2014;2014;10;12;Lauantai;23;13;36;9;23;32
89;25.10.2014;2014;10;13;Lauantai;14;17;31;15;13;28
89;25.10.2014;2014;10;14;Lauantai;29;19;48;17;9;26
89;25.10.2014;2014;10;15;Lauantai;15;12;27;10;7;17
89;25.10.2014;2014;10;16;Lauantai;20;13;33;10;15;25
89;25.10.2014;2014;10;17;Lauantai;10;14;24;14;8;22
89;25.10.2014;2014;10;18;Lauantai;17;14;31;3;6;9
89;25.10.2014;2014;10;19;Lauantai;9;14;23;7;6;13
89;25.10.2014;2014;10;20;Lauantai;15;8;23;5;3;8
89;25.10.2014;2014;10;21;Lauantai;11;9;20;3;3;6
89;25.10.2014;2014;10;22;Lauantai;8;2;10;1;3;4
89;25.10.2014;2014;10;23;Lauantai;6;6;12;3;5;8
89;26.10.2014;2014;10;00;Sunnuntai;5;5;10;4;1;5
89;26.10.2014;2014;10;01;Sunnuntai;3;4;7;4;1;5
89;26.10.2014;2014;10;02;Sunnuntai;9;4;13;4;0;4
89;26.10.2014;2014;10;03;Sunnuntai;6;1;7;5;0;5
89;26.10.2014;2014;10;04;Sunnuntai;2;0;2;0;0;0
89;26.10.2014;2014;10;05;Sunnuntai;0;1;1;1;2;3
89;26.10.2014;2014;10;06;Sunnuntai;1;1;2;1;3;4
89;26.10.2014;2014;10;07;Sunnuntai;6;4;10;6;4;10
89;26.10.2014;2014;10;08;Sunnuntai;6;4;10;2;5;7
89;26.10.2014;2014;10;09;Sunnuntai;10;11;21;9;11;20
89;26.10.2014;2014;10;10;Sunnuntai;2;17;19;18;21;39
89;26.10.2014;2014;10;11;Sunnuntai;10;27;37;34;37;71
89;26.10.2014;2014;10;12;Sunnuntai;20;47;67;27;41;68
89;26.10.2014;2014;10;13;Sunnuntai;27;40;67;24;26;50
89;26.10.2014;2014;10;14;Sunnuntai;42;47;89;35;41;76
89;26.10.2014;2014;10;15;Sunnuntai;34;40;74;24;20;44
89;26.10.2014;2014;10;16;Sunnuntai;35;17;52;18;12;30
89;26.10.2014;2014;10;17;Sunnuntai;25;28;53;7;13;20
89;26.10.2014;2014;10;18;Sunnuntai;19;15;34;11;10;21
89;26.10.2014;2014;10;19;Sunnuntai;15;16;31;10;14;24
89;26.10.2014;2014;10;20;Sunnuntai;28;13;41;18;13;31
89;26.10.2014;2014;10;21;Sunnuntai;10;3;13;5;7;12
89;26.10.2014;2014;10;22;Sunnuntai;6;7;13;4;1;5
89;26.10.2014;2014;10;23;Sunnuntai;8;0;8;1;1;2
89;27.10.2014;2014;10;00;Maanantai;2;1;3;1;2;3
89;27.10.2014;2014;10;01;Maanantai;1;2;3;2;1;3
89;27.10.2014;2014;10;02;Maanantai;2;1;3;1;1;2
89;27.10.2014;2014;10;03;Maanantai;1;3;4;1;1;2
89;27.10.2014;2014;10;04;Maanantai;1;1;2;0;0;0
89;27.10.2014;2014;10;05;Maanantai;2;14;16;1;1;2
89;27.10.2014;2014;10;06;Maanantai;12;41;53;5;9;14
89;27.10.2014;2014;10;07;Maanantai;46;199;245;5;28;33
89;27.10.2014;2014;10;08;Maanantai;52;212;264;9;36;45
89;27.10.2014;2014;10;09;Maanantai;34;121;155;6;30;36
89;27.10.2014;2014;10;10;Maanantai;46;64;110;26;27;53
89;27.10.2014;2014;10;11;Maanantai;61;87;148;15;19;34
89;27.10.2014;2014;10;12;Maanantai;55;101;156;17;32;49
89;27.10.2014;2014;10;13;Maanantai;87;70;157;26;32;58
89;27.10.2014;2014;10;14;Maanantai;141;77;218;23;18;41
89;27.10.2014;2014;10;15;Maanantai;160;114;274;21;39;60
89;27.10.2014;2014;10;16;Maanantai;204;94;298;41;26;67
89;27.10.2014;2014;10;17;Maanantai;108;84;192;36;26;62
89;27.10.2014;2014;10;18;Maanantai;106;64;170;24;26;50
89;27.10.2014;2014;10;19;Maanantai;64;34;98;39;33;72
89;27.10.2014;2014;10;20;Maanantai;45;22;67;21;22;43
89;27.10.2014;2014;10;21;Maanantai;47;20;67;11;10;21
89;27.10.2014;2014;10;22;Maanantai;18;5;23;3;7;10
89;27.10.2014;2014;10;23;Maanantai;5;5;10;4;4;8
89;28.10.2014;2014;10;00;Tiistai;1;0;1;0;0;0
89;28.10.2014;2014;10;01;Tiistai;1;0;1;0;0;0
89;28.10.2014;2014;10;02;Tiistai;3;2;5;0;0;0
89;28.10.2014;2014;10;03;Tiistai;0;2;2;0;0;0
89;28.10.2014;2014;10;04;Tiistai;0;4;4;0;0;0
89;28.10.2014;2014;10;05;Tiistai;5;11;16;2;0;2
89;28.10.2014;2014;10;06;Tiistai;15;47;62;3;15;18
89;28.10.2014;2014;10;07;Tiistai;58;205;263;9;33;42
89;28.10.2014;2014;10;08;Tiistai;34;230;264;14;41;55
89;28.10.2014;2014;10;09;Tiistai;53;134;187;11;25;36
89;28.10.2014;2014;10;10;Tiistai;38;67;105;13;35;48
89;28.10.2014;2014;10;11;Tiistai;56;82;138;27;38;65
89;28.10.2014;2014;10;12;Tiistai;50;64;114;25;27;52
89;28.10.2014;2014;10;13;Tiistai;86;62;148;28;23;51
89;28.10.2014;2014;10;14;Tiistai;127;68;195;26;17;43
89;28.10.2014;2014;10;15;Tiistai;153;79;232;31;13;44
89;28.10.2014;2014;10;16;Tiistai;216;95;311;28;25;53
89;28.10.2014;2014;10;17;Tiistai;96;65;161;25;26;51
89;28.10.2014;2014;10;18;Tiistai;76;61;137;30;29;59
89;28.10.2014;2014;10;19;Tiistai;55;39;94;22;23;45
89;28.10.2014;2014;10;20;Tiistai;58;22;80;18;21;39
89;28.10.2014;2014;10;21;Tiistai;49;19;68;12;10;22
89;28.10.2014;2014;10;22;Tiistai;9;13;22;2;4;6
89;28.10.2014;2014;10;23;Tiistai;6;9;15;3;3;6
89;29.10.2014;2014;10;00;Keskiviikko;2;1;3;1;0;1
89;29.10.2014;2014;10;01;Keskiviikko;5;4;9;1;1;2
89;29.10.2014;2014;10;02;Keskiviikko;2;0;2;0;0;0
89;29.10.2014;2014;10;03;Keskiviikko;4;1;5;1;0;1
89;29.10.2014;2014;10;04;Keskiviikko;3;4;7;0;0;0
89;29.10.2014;2014;10;05;Keskiviikko;3;7;10;3;2;5
89;29.10.2014;2014;10;06;Keskiviikko;15;35;50;5;10;15
89;29.10.2014;2014;10;07;Keskiviikko;35;170;205;3;21;24
89;29.10.2014;2014;10;08;Keskiviikko;33;200;233;9;25;34
89;29.10.2014;2014;10;09;Keskiviikko;36;102;138;8;32;40
89;29.10.2014;2014;10;10;Keskiviikko;34;64;98;15;21;36
89;29.10.2014;2014;10;11;Keskiviikko;52;80;132;30;22;52
89;29.10.2014;2014;10;12;Keskiviikko;56;55;111;28;27;55
89;29.10.2014;2014;10;13;Keskiviikko;92;77;169;24;41;65
89;29.10.2014;2014;10;14;Keskiviikko;128;67;195;24;40;64
89;29.10.2014;2014;10;15;Keskiviikko;131;71;202;31;32;63
89;29.10.2014;2014;10;16;Keskiviikko;171;91;262;35;24;59
89;29.10.2014;2014;10;17;Keskiviikko;93;83;176;23;31;54
89;29.10.2014;2014;10;18;Keskiviikko;79;76;155;35;25;60
89;29.10.2014;2014;10;19;Keskiviikko;66;30;96;34;24;58
89;29.10.2014;2014;10;20;Keskiviikko;66;24;90;15;22;37
89;29.10.2014;2014;10;21;Keskiviikko;45;22;67;7;11;18
89;29.10.2014;2014;10;22;Keskiviikko;21;15;36;3;1;4
89;29.10.2014;2014;10;23;Keskiviikko;8;3;11;5;3;8
89;30.10.2014;2014;10;00;Torstai;5;3;8;0;0;0
89;30.10.2014;2014;10;01;Torstai;3;6;9;0;1;1
89;30.10.2014;2014;10;02;Torstai;7;1;8;0;1;1
89;30.10.2014;2014;10;03;Torstai;2;5;7;0;0;0
89;30.10.2014;2014;10;04;Torstai;2;1;3;1;0;1
89;30.10.2014;2014;10;05;Torstai;1;14;15;2;2;4
89;30.10.2014;2014;10;06;Torstai;17;30;47;2;11;13
89;30.10.2014;2014;10;07;Torstai;48;158;206;8;33;41
89;30.10.2014;2014;10;08;Torstai;42;221;263;14;31;45
89;30.10.2014;2014;10;09;Torstai;38;122;160;9;22;31
89;30.10.2014;2014;10;10;Torstai;45;75;120;16;28;44
89;30.10.2014;2014;10;11;Torstai;55;102;157;17;37;54
89;30.10.2014;2014;10;12;Torstai;72;84;156;15;31;46
89;30.10.2014;2014;10;13;Torstai;96;82;178;20;20;40
89;30.10.2014;2014;10;14;Torstai;125;83;208;22;29;51
89;30.10.2014;2014;10;15;Torstai;174;107;281;26;21;47
89;30.10.2014;2014;10;16;Torstai;199;90;289;34;20;54
89;30.10.2014;2014;10;17;Torstai;108;67;175;24;25;49
89;30.10.2014;2014;10;18;Torstai;70;46;116;24;33;57
89;30.10.2014;2014;10;19;Torstai;65;36;101;17;19;36
89;30.10.2014;2014;10;20;Torstai;54;39;93;21;17;38
89;30.10.2014;2014;10;21;Torstai;49;26;75;12;2;14
89;30.10.2014;2014;10;22;Torstai;27;13;40;5;2;7
89;30.10.2014;2014;10;23;Torstai;4;7;11;1;1;2
89;31.10.2014;2014;10;00;Perjantai;5;9;14;1;2;3
89;31.10.2014;2014;10;01;Perjantai;5;2;7;0;1;1
89;31.10.2014;2014;10;02;Perjantai;7;2;9;1;0;1
89;31.10.2014;2014;10;03;Perjantai;4;2;6;0;0;0
89;31.10.2014;2014;10;04;Perjantai;3;5;8;0;0;0
89;31.10.2014;2014;10;05;Perjantai;3;9;12;2;1;3
89;31.10.2014;2014;10;06;Perjantai;17;39;56;5;9;14
89;31.10.2014;2014;10;07;Perjantai;32;143;175;3;32;35
89;31.10.2014;2014;10;08;Perjantai;44;189;233;5;22;27
89;31.10.2014;2014;10;09;Perjantai;45;96;141;10;30;40
89;31.10.2014;2014;10;10;Perjantai;40;49;89;12;16;28
89;31.10.2014;2014;10;11;Perjantai;52;87;139;18;24;42
89;31.10.2014;2014;10;12;Perjantai;72;98;170;18;35;53
89;31.10.2014;2014;10;13;Perjantai;96;73;169;26;31;57
89;31.10.2014;2014;10;14;Perjantai;129;81;210;37;32;69
89;31.10.2014;2014;10;15;Perjantai;129;65;194;27;28;55
89;31.10.2014;2014;10;16;Perjantai;134;98;232;27;29;56
89;31.10.2014;2014;10;17;Perjantai;74;55;129;21;14;35
89;31.10.2014;2014;10;18;Perjantai;49;43;92;8;14;22
89;31.10.2014;2014;10;19;Perjantai;39;45;84;13;18;31
89;31.10.2014;2014;10;20;Perjantai;31;18;49;6;5;11
89;31.10.2014;2014;10;21;Perjantai;17;17;34;9;10;19
89;31.10.2014;2014;10;22;Perjantai;22;12;34;5;7;12
89;31.10.2014;2014;10;23;Perjantai;13;31;44;1;10;11
89;01.11.2014;2014;11;00;Lauantai;11;19;30;4;4;8
89;01.11.2014;2014;11;01;Lauantai;10;9;19;6;5;11
89;01.11.2014;2014;11;02;Lauantai;9;2;11;11;1;12
89;01.11.2014;2014;11;03;Lauantai;19;1;20;12;1;13
89;01.11.2014;2014;11;04;Lauantai;7;2;9;9;0;9
89;01.11.2014;2014;11;05;Lauantai;10;1;11;1;0;1
89;01.11.2014;2014;11;06;Lauantai;3;7;10;3;1;4
89;01.11.2014;2014;11;07;Lauantai;3;9;12;5;6;11
89;01.11.2014;2014;11;08;Lauantai;3;11;14;11;11;22
89;01.11.2014;2014;11;09;Lauantai;13;18;31;12;18;30
89;01.11.2014;2014;11;10;Lauantai;16;25;41;30;38;68
89;01.11.2014;2014;11;11;Lauantai;27;26;53;41;42;83
89;01.11.2014;2014;11;12;Lauantai;28;36;64;38;41;79
89;01.11.2014;2014;11;13;Lauantai;30;47;77;43;61;104
89;01.11.2014;2014;11;14;Lauantai;53;35;88;30;47;77
89;01.11.2014;2014;11;15;Lauantai;45;41;86;30;30;60
89;01.11.2014;2014;11;16;Lauantai;42;39;81;21;32;53
89;01.11.2014;2014;11;17;Lauantai;27;32;59;22;18;40
89;01.11.2014;2014;11;18;Lauantai;33;18;51;20;13;33
89;01.11.2014;2014;11;19;Lauantai;29;38;67;6;14;20
89;01.11.2014;2014;11;20;Lauantai;22;17;39;4;8;12
89;01.11.2014;2014;11;21;Lauantai;26;23;49;10;7;17
89;01.11.2014;2014;11;22;Lauantai;20;25;45;1;10;11
89;01.11.2014;2014;11;23;Lauantai;12;8;20;2;5;7
89;02.11.2014;2014;11;00;Sunnuntai;8;19;27;4;1;5
89;02.11.2014;2014;11;01;Sunnuntai;19;15;34;4;6;10
89;02.11.2014;2014;11;02;Sunnuntai;15;5;20;6;2;8
89;02.11.2014;2014;11;03;Sunnuntai;17;2;19;6;2;8
89;02.11.2014;2014;11;04;Sunnuntai;10;0;10;4;0;4
89;02.11.2014;2014;11;05;Sunnuntai;3;0;3;0;0;0
89;02.11.2014;2014;11;06;Sunnuntai;5;2;7;3;1;4
89;02.11.2014;2014;11;07;Sunnuntai;1;3;4;2;5;7
89;02.11.2014;2014;11;08;Sunnuntai;5;3;8;1;4;5
89;02.11.2014;2014;11;09;Sunnuntai;4;8;12;5;9;14
89;02.11.2014;2014;11;10;Sunnuntai;0;11;11;8;21;29
89;02.11.2014;2014;11;11;Sunnuntai;7;14;21;22;24;46
89;02.11.2014;2014;11;12;Sunnuntai;8;32;40;14;34;48
89;02.11.2014;2014;11;13;Sunnuntai;16;25;41;32;24;56
89;02.11.2014;2014;11;14;Sunnuntai;16;24;40;34;29;63
89;02.11.2014;2014;11;15;Sunnuntai;27;22;49;25;22;47
89;02.11.2014;2014;11;16;Sunnuntai;21;21;42;31;18;49
89;02.11.2014;2014;11;17;Sunnuntai;22;19;41;22;24;46
89;02.11.2014;2014;11;18;Sunnuntai;23;11;34;13;20;33
89;02.11.2014;2014;11;19;Sunnuntai;15;9;24;18;18;36
89;02.11.2014;2014;11;20;Sunnuntai;12;5;17;9;15;24
89;02.11.2014;2014;11;21;Sunnuntai;10;6;16;8;6;14
89;02.11.2014;2014;11;22;Sunnuntai;6;4;10;6;2;8
89;02.11.2014;2014;11;23;Sunnuntai;4;3;7;1;2;3
89;03.11.2014;2014;11;00;Maanantai;1;0;1;3;1;4
89;03.11.2014;2014;11;01;Maanantai;0;3;3;1;0;1
89;03.11.2014;2014;11;02;Maanantai;2;0;2;0;0;0
89;03.11.2014;2014;11;03;Maanantai;2;0;2;1;0;1
89;03.11.2014;2014;11;04;Maanantai;2;3;5;2;0;2
89;03.11.2014;2014;11;05;Maanantai;2;7;9;1;0;1
89;03.11.2014;2014;11;06;Maanantai;19;32;51;3;8;11
89;03.11.2014;2014;11;07;Maanantai;31;131;162;5;34;39
89;03.11.2014;2014;11;08;Maanantai;23;170;193;4;30;34
89;03.11.2014;2014;11;09;Maanantai;30;78;108;6;28;34
89;03.11.2014;2014;11;10;Maanantai;20;30;50;11;18;29
89;03.11.2014;2014;11;11;Maanantai;30;46;76;20;20;40
89;03.11.2014;2014;11;12;Maanantai;45;41;86;12;19;31
89;03.11.2014;2014;11;13;Maanantai;48;43;91;17;27;44
89;03.11.2014;2014;11;14;Maanantai;99;60;159;28;15;43
89;03.11.2014;2014;11;15;Maanantai;120;65;185;30;26;56
89;03.11.2014;2014;11;16;Maanantai;151;52;203;44;25;69
89;03.11.2014;2014;11;17;Maanantai;81;52;133;34;20;54
89;03.11.2014;2014;11;18;Maanantai;47;47;94;26;35;61
89;03.11.2014;2014;11;19;Maanantai;52;24;76;28;18;46
89;03.11.2014;2014;11;20;Maanantai;38;16;54;14;11;25
89;03.11.2014;2014;11;21;Maanantai;34;7;41;9;10;19
89;03.11.2014;2014;11;22;Maanantai;12;11;23;6;5;11
89;03.11.2014;2014;11;23;Maanantai;6;5;11;1;6;7
89;04.11.2014;2014;11;00;Tiistai;0;2;2;2;1;3
89;04.11.2014;2014;11;01;Tiistai;2;0;2;0;1;1
89;04.11.2014;2014;11;02;Tiistai;1;2;3;0;0;0
89;04.11.2014;2014;11;03;Tiistai;2;2;4;0;0;0
89;04.11.2014;2014;11;04;Tiistai;0;4;4;0;1;1
89;04.11.2014;2014;11;05;Tiistai;4;8;12;1;0;1
89;04.11.2014;2014;11;06;Tiistai;14;42;56;8;9;17
89;04.11.2014;2014;11;07;Tiistai;48;154;202;10;29;39
89;04.11.2014;2014;11;08;Tiistai;33;226;259;7;45;52
89;04.11.2014;2014;11;09;Tiistai;44;121;165;11;60;71
89;04.11.2014;2014;11;10;Tiistai;48;78;126;27;32;59
89;04.11.2014;2014;11;11;Tiistai;68;80;148;42;39;81
89;04.11.2014;2014;11;12;Tiistai;67;83;150;22;22;44
89;04.11.2014;2014;11;13;Tiistai;65;64;129;18;22;40
89;04.11.2014;2014;11;14;Tiistai;125;71;196;35;32;67
89;04.11.2014;2014;11;15;Tiistai;184;68;252;40;30;70
89;04.11.2014;2014;11;16;Tiistai;184;86;270;25;21;46
89;04.11.2014;2014;11;17;Tiistai;91;58;149;17;24;41
89;04.11.2014;2014;11;18;Tiistai;77;59;136;32;27;59
89;04.11.2014;2014;11;19;Tiistai;50;38;88;21;15;36
89;04.11.2014;2014;11;20;Tiistai;59;18;77;22;12;34
89;04.11.2014;2014;11;21;Tiistai;37;18;55;4;10;14
89;04.11.2014;2014;11;22;Tiistai;10;7;17;2;0;2
89;04.11.2014;2014;11;23;Tiistai;7;6;13;0;1;1
89;05.11.2014;2014;11;00;Keskiviikko;6;4;10;0;0;0
89;05.11.2014;2014;11;01;Keskiviikko;6;0;6;2;1;3
89;05.11.2014;2014;11;02;Keskiviikko;3;1;4;0;0;0
89;05.11.2014;2014;11;03;Keskiviikko;1;1;2;2;1;3
89;05.11.2014;2014;11;04;Keskiviikko;2;2;4;6;3;9
89;05.11.2014;2014;11;05;Keskiviikko;2;4;6;3;1;4
89;05.11.2014;2014;11;06;Keskiviikko;16;30;46;10;8;18
89;05.11.2014;2014;11;07;Keskiviikko;37;161;198;6;49;55
89;05.11.2014;2014;11;08;Keskiviikko;29;188;217;13;48;61
89;05.11.2014;2014;11;09;Keskiviikko;30;87;117;13;44;57
89;05.11.2014;2014;11;10;Keskiviikko;23;69;92;27;34;61
89;05.11.2014;2014;11;11;Keskiviikko;40;77;117;28;42;70
89;05.11.2014;2014;11;12;Keskiviikko;64;80;144;40;49;89
89;05.11.2014;2014;11;13;Keskiviikko;74;67;141;39;26;65
89;05.11.2014;2014;11;14;Keskiviikko;109;63;172;42;32;74
89;05.11.2014;2014;11;15;Keskiviikko;109;74;183;45;33;78
89;05.11.2014;2014;11;16;Keskiviikko;157;60;217;49;27;76
89;05.11.2014;2014;11;17;Keskiviikko;75;50;125;32;26;58
89;05.11.2014;2014;11;18;Keskiviikko;61;46;107;26;30;56
89;05.11.2014;2014;11;19;Keskiviikko;50;30;80;29;20;49
89;05.11.2014;2014;11;20;Keskiviikko;48;12;60;11;16;27
89;05.11.2014;2014;11;21;Keskiviikko;36;12;48;11;6;17
89;05.11.2014;2014;11;22;Keskiviikko;15;15;30;5;7;12
89;05.11.2014;2014;11;23;Keskiviikko;8;3;11;3;0;3
89;06.11.2014;2014;11;00;Torstai;7;2;9;2;0;2
89;06.11.2014;2014;11;01;Torstai;5;0;5;1;0;1
89;06.11.2014;2014;11;02;Torstai;3;1;4;0;0;0
89;06.11.2014;2014;11;03;Torstai;10;0;10;1;1;2
89;06.11.2014;2014;11;04;Torstai;3;3;6;0;0;0
89;06.11.2014;2014;11;05;Torstai;2;12;14;1;3;4
89;06.11.2014;2014;11;06;Torstai;15;31;46;2;9;11
89;06.11.2014;2014;11;07;Torstai;37;140;177;7;52;59
89;06.11.2014;2014;11;08;Torstai;21;181;202;19;39;58
89;06.11.2014;2014;11;09;Torstai;31;80;111;10;40;50
89;06.11.2014;2014;11;10;Torstai;25;72;97;17;27;44
89;06.11.2014;2014;11;11;Torstai;42;62;104;25;37;62
89;06.11.2014;2014;11;12;Torstai;46;70;116;25;24;49
89;06.11.2014;2014;11;13;Torstai;57;50;107;29;26;55
89;06.11.2014;2014;11;14;Torstai;93;60;153;43;25;68
89;06.11.2014;2014;11;15;Torstai;117;70;187;33;22;55
89;06.11.2014;2014;11;16;Torstai;133;72;205;37;25;62
89;06.11.2014;2014;11;17;Torstai;71;52;123;25;19;44
89;06.11.2014;2014;11;18;Torstai;69;44;113;33;17;50
89;06.11.2014;2014;11;19;Torstai;57;37;94;19;17;36
89;06.11.2014;2014;11;20;Torstai;51;27;78;11;16;27
89;06.11.2014;2014;11;21;Torstai;31;12;43;10;10;20
89;06.11.2014;2014;11;22;Torstai;14;17;31;5;5;10
89;06.11.2014;2014;11;23;Torstai;13;13;26;2;2;4
89;07.11.2014;2014;11;00;Perjantai;9;1;10;6;0;6
89;07.11.2014;2014;11;01;Perjantai;10;3;13;1;0;1
89;07.11.2014;2014;11;02;Perjantai;3;2;5;0;0;0
89;07.11.2014;2014;11;03;Perjantai;11;4;15;3;0;3
89;07.11.2014;2014;11;04;Perjantai;1;1;2;0;1;1
89;07.11.2014;2014;11;05;Perjantai;4;9;13;3;1;4
89;07.11.2014;2014;11;06;Perjantai;15;41;56;7;11;18
89;07.11.2014;2014;11;07;Perjantai;33;149;182;7;44;51
89;07.11.2014;2014;11;08;Perjantai;24;180;204;17;42;59
89;07.11.2014;2014;11;09;Perjantai;23;84;107;15;36;51
89;07.11.2014;2014;11;10;Perjantai;34;49;83;17;30;47
89;07.11.2014;2014;11;11;Perjantai;39;49;88;20;42;62
89;07.11.2014;2014;11;12;Perjantai;52;61;113;24;37;61
89;07.11.2014;2014;11;13;Perjantai;80;56;136;25;27;52
89;07.11.2014;2014;11;14;Perjantai;105;48;153;25;24;49
89;07.11.2014;2014;11;15;Perjantai;129;59;188;34;18;52
89;07.11.2014;2014;11;16;Perjantai;85;50;135;41;22;63
89;07.11.2014;2014;11;17;Perjantai;41;37;78;23;24;47
89;07.11.2014;2014;11;18;Perjantai;59;37;96;12;17;29
89;07.11.2014;2014;11;19;Perjantai;30;22;52;11;11;22
89;07.11.2014;2014;11;20;Perjantai;13;31;44;8;12;20
89;07.11.2014;2014;11;21;Perjantai;26;18;44;15;8;23
89;07.11.2014;2014;11;22;Perjantai;18;10;28;6;3;9
89;07.11.2014;2014;11;23;Perjantai;12;7;19;7;3;10
89;08.11.2014;2014;11;00;Lauantai;12;5;17;2;6;8
89;08.11.2014;2014;11;01;Lauantai;10;3;13;2;2;4
89;08.11.2014;2014;11;02;Lauantai;8;0;8;8;1;9
89;08.11.2014;2014;11;03;Lauantai;8;1;9;9;0;9
89;08.11.2014;2014;11;04;Lauantai;5;0;5;4;0;4
89;08.11.2014;2014;11;05;Lauantai;2;2;4;1;1;2
89;08.11.2014;2014;11;06;Lauantai;6;9;15;1;3;4
89;08.11.2014;2014;11;07;Lauantai;4;8;12;4;5;9
89;08.11.2014;2014;11;08;Lauantai;16;19;35;5;10;15
89;08.11.2014;2014;11;09;Lauantai;7;30;37;13;21;34
89;08.11.2014;2014;11;10;Lauantai;12;47;59;24;38;62
89;08.11.2014;2014;11;11;Lauantai;25;55;80;30;50;80
89;08.11.2014;2014;11;12;Lauantai;45;57;102;41;42;83
89;08.11.2014;2014;11;13;Lauantai;43;40;83;33;30;63
89;08.11.2014;2014;11;14;Lauantai;40;52;92;25;40;65
89;08.11.2014;2014;11;15;Lauantai;54;33;87;35;36;71
89;08.11.2014;2014;11;16;Lauantai;46;30;76;30;15;45
89;08.11.2014;2014;11;17;Lauantai;28;23;51;16;19;35
89;08.11.2014;2014;11;18;Lauantai;41;36;77;15;14;29
89;08.11.2014;2014;11;19;Lauantai;18;12;30;13;15;28
89;08.11.2014;2014;11;20;Lauantai;20;11;31;4;8;12
89;08.11.2014;2014;11;21;Lauantai;9;23;32;2;7;9
89;08.11.2014;2014;11;22;Lauantai;11;16;27;8;6;14
89;08.11.2014;2014;11;23;Lauantai;10;13;23;2;4;6
89;09.11.2014;2014;11;00;Sunnuntai;10;8;18;4;4;8
89;09.11.2014;2014;11;01;Sunnuntai;7;3;10;10;0;10
89;09.11.2014;2014;11;02;Sunnuntai;11;3;14;4;0;4
89;09.11.2014;2014;11;03;Sunnuntai;10;2;12;4;3;7
89;09.11.2014;2014;11;04;Sunnuntai;12;2;14;7;1;8
89;09.11.2014;2014;11;05;Sunnuntai;2;1;3;1;2;3
89;09.11.2014;2014;11;06;Sunnuntai;2;6;8;1;4;5
89;09.11.2014;2014;11;07;Sunnuntai;4;2;6;5;3;8
89;09.11.2014;2014;11;08;Sunnuntai;2;9;11;6;5;11
89;09.11.2014;2014;11;09;Sunnuntai;12;11;23;19;17;36
89;09.11.2014;2014;11;10;Sunnuntai;3;17;20;26;31;57
89;09.11.2014;2014;11;11;Sunnuntai;19;26;45;28;37;65
89;09.11.2014;2014;11;12;Sunnuntai;28;20;48;19;40;59
89;09.11.2014;2014;11;13;Sunnuntai;18;25;43;40;33;73
89;09.11.2014;2014;11;14;Sunnuntai;39;26;65;22;33;55
89;09.11.2014;2014;11;15;Sunnuntai;27;21;48;21;34;55
89;09.11.2014;2014;11;16;Sunnuntai;21;21;42;21;14;35
89;09.11.2014;2014;11;17;Sunnuntai;23;27;50;22;13;35
89;09.11.2014;2014;11;18;Sunnuntai;18;25;43;10;16;26
89;09.11.2014;2014;11;19;Sunnuntai;14;17;31;18;15;33
89;09.11.2014;2014;11;20;Sunnuntai;15;18;33;17;10;27
89;09.11.2014;2014;11;21;Sunnuntai;13;8;21;6;5;11
89;09.11.2014;2014;11;22;Sunnuntai;13;8;21;7;0;7
89;09.11.2014;2014;11;23;Sunnuntai;2;2;4;4;2;6
89;10.11.2014;2014;11;00;Maanantai;2;5;7;0;0;0
89;10.11.2014;2014;11;01;Maanantai;1;1;2;0;1;1
89;10.11.2014;2014;11;02;Maanantai;5;1;6;0;2;2
89;10.11.2014;2014;11;03;Maanantai;0;2;2;0;0;0
89;10.11.2014;2014;11;04;Maanantai;8;12;20;1;0;1
89;10.11.2014;2014;11;05;Maanantai;4;12;16;2;2;4
89;10.11.2014;2014;11;06;Maanantai;12;34;46;4;5;9
89;10.11.2014;2014;11;07;Maanantai;39;153;192;14;34;48
89;10.11.2014;2014;11;08;Maanantai;37;187;224;8;42;50
89;10.11.2014;2014;11;09;Maanantai;35;120;155;12;36;48
89;10.11.2014;2014;11;10;Maanantai;30;70;100;28;35;63
89;10.11.2014;2014;11;11;Maanantai;54;51;105;25;37;62
89;10.11.2014;2014;11;12;Maanantai;56;80;136;20;21;41
89;10.11.2014;2014;11;13;Maanantai;75;57;132;29;18;47
89;10.11.2014;2014;11;14;Maanantai;115;62;177;29;32;61
89;10.11.2014;2014;11;15;Maanantai;122;48;170;30;28;58
89;10.11.2014;2014;11;16;Maanantai;167;72;239;36;22;58
89;10.11.2014;2014;11;17;Maanantai;67;59;126;26;32;58
89;10.11.2014;2014;11;18;Maanantai;67;61;128;28;30;58
89;10.11.2014;2014;11;19;Maanantai;59;35;94;44;26;70
89;10.11.2014;2014;11;20;Maanantai;53;32;85;27;25;52
89;10.11.2014;2014;11;21;Maanantai;37;13;50;8;11;19
89;10.11.2014;2014;11;22;Maanantai;16;7;23;7;3;10
89;10.11.2014;2014;11;23;Maanantai;6;6;12;3;1;4
89;11.11.2014;2014;11;00;Tiistai;2;0;2;1;0;1
89;11.11.2014;2014;11;01;Tiistai;4;3;7;0;1;1
89;11.11.2014;2014;11;02;Tiistai;2;1;3;3;0;3
89;11.11.2014;2014;11;03;Tiistai;0;2;2;0;0;0
89;11.11.2014;2014;11;04;Tiistai;2;3;5;0;0;0
89;11.11.2014;2014;11;05;Tiistai;1;7;8;1;0;1
89;11.11.2014;2014;11;06;Tiistai;15;43;58;3;7;10
89;11.11.2014;2014;11;07;Tiistai;30;142;172;8;35;43
89;11.11.2014;2014;11;08;Tiistai;25;173;198;11;37;48
89;11.11.2014;2014;11;09;Tiistai;22;91;113;7;23;30
89;11.11.2014;2014;11;10;Tiistai;16;38;54;10;23;33
89;11.11.2014;2014;11;11;Tiistai;44;31;75;12;13;25
89;11.11.2014;2014;11;12;Tiistai;29;31;60;8;13;21
89;11.11.2014;2014;11;13;Tiistai;43;31;74;16;14;30
89;11.11.2014;2014;11;14;Tiistai;90;50;140;29;12;41
89;11.11.2014;2014;11;15;Tiistai;132;49;181;21;19;40
89;11.11.2014;2014;11;16;Tiistai;126;57;183;32;20;52
89;11.11.2014;2014;11;17;Tiistai;58;42;100;24;15;39
89;11.11.2014;2014;11;18;Tiistai;45;39;84;18;22;40
89;11.11.2014;2014;11;19;Tiistai;60;28;88;26;24;50
89;11.11.2014;2014;11;20;Tiistai;43;22;65;22;21;43
89;11.11.2014;2014;11;21;Tiistai;34;14;48;15;10;25
89;11.11.2014;2014;11;22;Tiistai;8;5;13;4;2;6
89;11.11.2014;2014;11;23;Tiistai;7;4;11;3;3;6
89;12.11.2014;2014;11;00;Keskiviikko;1;3;4;2;1;3
89;12.11.2014;2014;11;01;Keskiviikko;4;1;5;0;1;1
89;12.11.2014;2014;11;02;Keskiviikko;2;1;3;0;0;0
89;12.11.2014;2014;11;03;Keskiviikko;1;3;4;1;0;1
89;12.11.2014;2014;11;04;Keskiviikko;0;4;4;0;0;0
89;12.11.2014;2014;11;05;Keskiviikko;5;4;9;1;1;2
89;12.11.2014;2014;11;06;Keskiviikko;12;42;54;4;10;14
89;12.11.2014;2014;11;07;Keskiviikko;33;143;176;12;41;53
89;12.11.2014;2014;11;08;Keskiviikko;36;189;225;4;37;41
89;12.11.2014;2014;11;09;Keskiviikko;24;124;148;21;39;60
89;12.11.2014;2014;11;10;Keskiviikko;35;65;100;19;44;63
89;12.11.2014;2014;11;11;Keskiviikko;47;67;114;39;37;76
89;12.11.2014;2014;11;12;Keskiviikko;65;59;124;27;29;56
89;12.11.2014;2014;11;13;Keskiviikko;102;66;168;21;23;44
89;12.11.2014;2014;11;14;Keskiviikko;103;78;181;33;29;62
89;12.11.2014;2014;11;15;Keskiviikko;141;72;213;31;26;57
89;12.11.2014;2014;11;16;Keskiviikko;140;77;217;27;14;41
89;12.11.2014;2014;11;17;Keskiviikko;85;83;168;0;0;0
89;12.11.2014;2014;11;18;Keskiviikko;62;52;114;17;8;25
89;12.11.2014;2014;11;19;Keskiviikko;68;43;111;36;19;55
89;12.11.2014;2014;11;20;Keskiviikko;49;29;78;22;24;46
89;12.11.2014;2014;11;21;Keskiviikko;32;17;49;3;10;13
89;12.11.2014;2014;11;22;Keskiviikko;14;13;27;2;2;4
89;12.11.2014;2014;11;23;Keskiviikko;4;10;14;1;4;5
89;13.11.2014;2014;11;00;Torstai;7;5;12;2;4;6
89;13.11.2014;2014;11;01;Torstai;3;0;3;2;1;3
89;13.11.2014;2014;11;02;Torstai;1;0;1;0;1;1
89;13.11.2014;2014;11;03;Torstai;4;2;6;1;0;1
89;13.11.2014;2014;11;04;Torstai;4;2;6;0;0;0
89;13.11.2014;2014;11;05;Torstai;3;5;8;1;2;3
89;13.11.2014;2014;11;06;Torstai;12;41;53;2;6;8
89;13.11.2014;2014;11;07;Torstai;31;146;177;5;27;32
89;13.11.2014;2014;11;08;Torstai;35;220;255;14;35;49
89;13.11.2014;2014;11;09;Torstai;40;78;118;15;39;54
89;13.11.2014;2014;11;10;Torstai;36;41;77;18;27;45
89;13.11.2014;2014;11;11;Torstai;48;64;112;32;36;68
89;13.11.2014;2014;11;12;Torstai;52;60;112;24;32;56
89;13.11.2014;2014;11;13;Torstai;61;66;127;24;38;62
89;13.11.2014;2014;11;14;Torstai;87;48;135;37;38;75
89;13.11.2014;2014;11;15;Torstai;142;63;205;36;22;58
89;13.11.2014;2014;11;16;Torstai;150;82;232;30;24;54
89;13.11.2014;2014;11;17;Torstai;77;49;126;34;27;61
89;13.11.2014;2014;11;18;Torstai;57;50;107;26;27;53
89;13.11.2014;2014;11;19;Torstai;56;25;81;21;27;48
89;13.11.2014;2014;11;20;Torstai;43;29;72;22;11;33
89;13.11.2014;2014;11;21;Torstai;19;19;38;8;10;18
89;13.11.2014;2014;11;22;Torstai;22;15;37;3;2;5
89;13.11.2014;2014;11;23;Torstai;7;5;12;5;3;8
89;14.11.2014;2014;11;00;Perjantai;13;2;15;2;1;3
89;14.11.2014;2014;11;01;Perjantai;9;3;12;2;1;3
89;14.11.2014;2014;11;02;Perjantai;5;1;6;0;2;2
89;14.11.2014;2014;11;03;Perjantai;4;3;7;0;0;0
89;14.11.2014;2014;11;04;Perjantai;4;4;8;2;0;2
89;14.11.2014;2014;11;05;Perjantai;1;10;11;2;3;5
89;14.11.2014;2014;11;06;Perjantai;16;38;54;2;12;14
89;14.11.2014;2014;11;07;Perjantai;34;129;163;10;31;41
89;14.11.2014;2014;11;08;Perjantai;31;165;196;4;33;37
89;14.11.2014;2014;11;09;Perjantai;31;92;123;4;25;29
89;14.11.2014;2014;11;10;Perjantai;28;53;81;14;23;37
89;14.11.2014;2014;11;11;Perjantai;44;69;113;19;41;60
89;14.11.2014;2014;11;12;Perjantai;51;63;114;23;29;52
89;14.11.2014;2014;11;13;Perjantai;87;48;135;24;32;56
89;14.11.2014;2014;11;14;Perjantai;105;61;166;22;20;42
89;14.11.2014;2014;11;15;Perjantai;129;74;203;31;20;51
89;14.11.2014;2014;11;16;Perjantai;115;57;172;29;17;46
89;14.11.2014;2014;11;17;Perjantai;59;49;108;30;27;57
89;14.11.2014;2014;11;18;Perjantai;43;38;81;18;16;34
89;14.11.2014;2014;11;19;Perjantai;31;22;53;26;14;40
89;14.11.2014;2014;11;20;Perjantai;34;24;58;12;11;23
89;14.11.2014;2014;11;21;Perjantai;31;16;47;6;4;10
89;14.11.2014;2014;11;22;Perjantai;18;24;42;9;7;16
89;14.11.2014;2014;11;23;Perjantai;17;17;34;3;4;7
89;15.11.2014;2014;11;00;Lauantai;17;14;31;6;1;7
89;15.11.2014;2014;11;01;Lauantai;13;9;22;4;5;9
89;15.11.2014;2014;11;02;Lauantai;13;6;19;6;2;8
89;15.11.2014;2014;11;03;Lauantai;8;1;9;8;1;9
89;15.11.2014;2014;11;04;Lauantai;8;2;10;2;1;3
89;15.11.2014;2014;11;05;Lauantai;3;3;6;1;2;3
89;15.11.2014;2014;11;06;Lauantai;1;5;6;1;4;5
89;15.11.2014;2014;11;07;Lauantai;7;12;19;3;7;10
89;15.11.2014;2014;11;08;Lauantai;5;21;26;7;10;17
89;15.11.2014;2014;11;09;Lauantai;12;40;52;8;30;38
89;15.11.2014;2014;11;10;Lauantai;16;59;75;11;38;49
89;15.11.2014;2014;11;11;Lauantai;24;58;82;29;36;65
89;15.11.2014;2014;11;12;Lauantai;48;55;103;23;38;61
89;15.11.2014;2014;11;13;Lauantai;38;70;108;32;36;68
89;15.11.2014;2014;11;14;Lauantai;62;60;122;36;29;65
89;15.11.2014;2014;11;15;Lauantai;55;45;100;27;36;63
89;15.11.2014;2014;11;16;Lauantai;59;33;92;19;26;45
89;15.11.2014;2014;11;17;Lauantai;39;40;79;18;27;45
89;15.11.2014;2014;11;18;Lauantai;40;29;69;24;17;41
89;15.11.2014;2014;11;19;Lauantai;24;22;46;15;18;33
89;15.11.2014;2014;11;20;Lauantai;23;22;45;9;13;22
89;15.11.2014;2014;11;21;Lauantai;13;21;34;7;8;15
89;15.11.2014;2014;11;22;Lauantai;16;18;34;1;9;10
89;15.11.2014;2014;11;23;Lauantai;15;20;35;5;4;9
89;16.11.2014;2014;11;00;Sunnuntai;5;26;31;6;11;17
89;16.11.2014;2014;11;01;Sunnuntai;12;14;26;7;1;8
89;16.11.2014;2014;11;02;Sunnuntai;15;4;19;8;3;11
89;16.11.2014;2014;11;03;Sunnuntai;14;5;19;11;0;11
89;16.11.2014;2014;11;04;Sunnuntai;14;0;14;12;2;14
89;16.11.2014;2014;11;05;Sunnuntai;3;0;3;0;0;0
89;16.11.2014;2014;11;06;Sunnuntai;3;3;6;1;3;4
89;16.11.2014;2014;11;07;Sunnuntai;2;5;7;6;2;8
89;16.11.2014;2014;11;08;Sunnuntai;2;2;4;6;8;14
89;16.11.2014;2014;11;09;Sunnuntai;8;20;28;15;21;36
89;16.11.2014;2014;11;10;Sunnuntai;8;26;34;21;30;51
89;16.11.2014;2014;11;11;Sunnuntai;14;31;45;34;47;81
89;16.11.2014;2014;11;12;Sunnuntai;18;49;67;36;50;86
89;16.11.2014;2014;11;13;Sunnuntai;27;48;75;39;57;96
89;16.11.2014;2014;11;14;Sunnuntai;43;37;80;38;53;91
89;16.11.2014;2014;11;15;Sunnuntai;42;48;90;32;26;58
89;16.11.2014;2014;11;16;Sunnuntai;38;32;70;25;23;48
89;16.11.2014;2014;11;17;Sunnuntai;30;35;65;27;19;46
89;16.11.2014;2014;11;18;Sunnuntai;37;24;61;18;34;52
89;16.11.2014;2014;11;19;Sunnuntai;30;22;52;14;19;33
89;16.11.2014;2014;11;20;Sunnuntai;27;17;44;10;12;22
89;16.11.2014;2014;11;21;Sunnuntai;18;19;37;6;9;15
89;16.11.2014;2014;11;22;Sunnuntai;9;2;11;2;1;3
89;16.11.2014;2014;11;23;Sunnuntai;3;1;4;3;0;3
89;17.11.2014;2014;11;00;Maanantai;3;3;6;1;1;2
89;17.11.2014;2014;11;01;Maanantai;2;1;3;0;2;2
89;17.11.2014;2014;11;02;Maanantai;0;0;0;1;0;1
89;17.11.2014;2014;11;03;Maanantai;1;3;4;0;1;1
89;17.11.2014;2014;11;04;Maanantai;1;3;4;0;0;0
89;17.11.2014;2014;11;05;Maanantai;2;10;12;1;1;2
89;17.11.2014;2014;11;06;Maanantai;11;31;42;3;5;8
89;17.11.2014;2014;11;07;Maanantai;35;160;195;10;37;47
89;17.11.2014;2014;11;08;Maanantai;32;195;227;5;48;53
89;17.11.2014;2014;11;09;Maanantai;25;113;138;10;42;52
89;17.11.2014;2014;11;10;Maanantai;29;74;103;35;33;68
89;17.11.2014;2014;11;11;Maanantai;60;68;128;30;23;53
89;17.11.2014;2014;11;12;Maanantai;53;56;109;29;27;56
89;17.11.2014;2014;11;13;Maanantai;59;62;121;30;32;62
89;17.11.2014;2014;11;14;Maanantai;125;49;174;31;23;54
89;17.11.2014;2014;11;15;Maanantai;137;75;212;26;26;52
89;17.11.2014;2014;11;16;Maanantai;139;79;218;37;17;54
89;17.11.2014;2014;11;17;Maanantai;81;57;138;32;22;54
89;17.11.2014;2014;11;18;Maanantai;58;39;97;27;27;54
89;17.11.2014;2014;11;19;Maanantai;43;29;72;26;29;55
89;17.11.2014;2014;11;20;Maanantai;41;18;59;18;18;36
89;17.11.2014;2014;11;21;Maanantai;32;12;44;6;5;11
89;17.11.2014;2014;11;22;Maanantai;14;15;29;4;2;6
89;17.11.2014;2014;11;23;Maanantai;7;4;11;3;3;6
89;18.11.2014;2014;11;00;Tiistai;3;2;5;1;1;2
89;18.11.2014;2014;11;01;Tiistai;1;1;2;1;2;3
89;18.11.2014;2014;11;02;Tiistai;3;0;3;2;0;2
89;18.11.2014;2014;11;03;Tiistai;0;2;2;0;0;0
89;18.11.2014;2014;11;04;Tiistai;0;3;3;0;0;0
89;18.11.2014;2014;11;05;Tiistai;1;6;7;2;3;5
89;18.11.2014;2014;11;06;Tiistai;18;37;55;3;8;11
89;18.11.2014;2014;11;07;Tiistai;43;149;192;10;35;45
89;18.11.2014;2014;11;08;Tiistai;32;201;233;12;82;94
89;18.11.2014;2014;11;09;Tiistai;43;97;140;11;38;49
89;18.11.2014;2014;11;10;Tiistai;36;65;101;64;29;93
89;18.11.2014;2014;11;11;Tiistai;55;69;124;27;27;54
89;18.11.2014;2014;11;12;Tiistai;64;75;139;36;33;69
89;18.11.2014;2014;11;13;Tiistai;58;65;123;24;23;47
89;18.11.2014;2014;11;14;Tiistai;113;52;165;28;16;44
89;18.11.2014;2014;11;15;Tiistai;141;64;205;35;22;57
89;18.11.2014;2014;11;16;Tiistai;140;79;219;36;15;51
89;18.11.2014;2014;11;17;Tiistai;91;61;152;38;25;63
89;18.11.2014;2014;11;18;Tiistai;57;41;98;38;26;64
89;18.11.2014;2014;11;19;Tiistai;70;26;96;35;32;67
89;18.11.2014;2014;11;20;Tiistai;49;25;74;28;20;48
89;18.11.2014;2014;11;21;Tiistai;25;15;40;14;5;19
89;18.11.2014;2014;11;22;Tiistai;10;12;22;3;5;8
89;18.11.2014;2014;11;23;Tiistai;8;2;10;0;2;2
89;19.11.2014;2014;11;00;Keskiviikko;4;2;6;1;0;1
89;19.11.2014;2014;11;01;Keskiviikko;2;1;3;0;0;0
89;19.11.2014;2014;11;02;Keskiviikko;1;0;1;0;0;0
89;19.11.2014;2014;11;03;Keskiviikko;3;1;4;0;0;0
89;19.11.2014;2014;11;04;Keskiviikko;1;4;5;0;0;0
89;19.11.2014;2014;11;05;Keskiviikko;0;9;9;2;1;3
89;19.11.2014;2014;11;06;Keskiviikko;16;44;60;1;10;11
89;19.11.2014;2014;11;07;Keskiviikko;46;141;187;8;32;40
89;19.11.2014;2014;11;08;Keskiviikko;48;208;256;10;39;49
89;19.11.2014;2014;11;09;Keskiviikko;34;108;142;10;43;53
89;19.11.2014;2014;11;10;Keskiviikko;38;67;105;16;35;51
89;19.11.2014;2014;11;11;Keskiviikko;58;54;112;34;29;63
89;19.11.2014;2014;11;12;Keskiviikko;64;89;153;32;37;69
89;19.11.2014;2014;11;13;Keskiviikko;99;59;158;30;32;62
89;19.11.2014;2014;11;14;Keskiviikko;135;70;205;35;25;60
89;19.11.2014;2014;11;15;Keskiviikko;134;79;213;55;24;79
89;19.11.2014;2014;11;16;Keskiviikko;150;75;225;34;27;61
89;19.11.2014;2014;11;17;Keskiviikko;99;65;164;33;19;52
89;19.11.2014;2014;11;18;Keskiviikko;62;49;111;34;36;70
89;19.11.2014;2014;11;19;Keskiviikko;54;36;90;40;28;68
89;19.11.2014;2014;11;20;Keskiviikko;51;21;72;24;14;38
89;19.11.2014;2014;11;21;Keskiviikko;50;14;64;11;17;28
89;19.11.2014;2014;11;22;Keskiviikko;25;10;35;7;4;11
89;19.11.2014;2014;11;23;Keskiviikko;5;10;15;2;1;3
89;20.11.2014;2014;11;00;Torstai;5;5;10;3;1;4
89;20.11.2014;2014;11;01;Torstai;4;0;4;1;0;1
89;20.11.2014;2014;11;02;Torstai;8;1;9;2;0;2
89;20.11.2014;2014;11;03;Torstai;5;5;10;2;0;2
89;20.11.2014;2014;11;04;Torstai;8;3;11;3;0;3
89;20.11.2014;2014;11;05;Torstai;3;15;18;3;0;3
89;20.11.2014;2014;11;06;Torstai;15;38;53;2;7;9
89;20.11.2014;2014;11;07;Torstai;39;160;199;7;36;43
89;20.11.2014;2014;11;08;Torstai;28;202;230;11;42;53
89;20.11.2014;2014;11;09;Torstai;33;87;120;14;29;43
89;20.11.2014;2014;11;10;Torstai;38;68;106;22;29;51
89;20.11.2014;2014;11;11;Torstai;53;68;121;15;41;56
89;20.11.2014;2014;11;12;Torstai;66;77;143;27;36;63
89;20.11.2014;2014;11;13;Torstai;88;42;130;28;28;56
89;20.11.2014;2014;11;14;Torstai;108;64;172;26;25;51
89;20.11.2014;2014;11;15;Torstai;145;67;212;32;30;62
89;20.11.2014;2014;11;16;Torstai;139;89;228;39;50;89
89;20.11.2014;2014;11;17;Torstai;95;79;174;50;60;110
89;20.11.2014;2014;11;18;Torstai;77;41;118;64;49;113
89;20.11.2014;2014;11;19;Torstai;75;48;123;45;47;92
89;20.11.2014;2014;11;20;Torstai;71;37;108;37;34;71
89;20.11.2014;2014;11;21;Torstai;42;24;66;13;12;25
89;20.11.2014;2014;11;22;Torstai;32;5;37;8;6;14
89;20.11.2014;2014;11;23;Torstai;6;5;11;3;1;4
89;21.11.2014;2014;11;00;Perjantai;7;5;12;3;2;5
89;21.11.2014;2014;11;01;Perjantai;8;3;11;0;1;1
89;21.11.2014;2014;11;02;Perjantai;6;1;7;1;0;1
89;21.11.2014;2014;11;03;Perjantai;0;1;1;3;0;3
89;21.11.2014;2014;11;04;Perjantai;8;4;12;1;0;1
89;21.11.2014;2014;11;05;Perjantai;5;13;18;1;3;4
89;21.11.2014;2014;11;06;Perjantai;15;53;68;4;5;9
89;21.11.2014;2014;11;07;Perjantai;36;118;154;9;30;39
89;21.11.2014;2014;11;08;Perjantai;29;181;210;11;39;50
89;21.11.2014;2014;11;09;Perjantai;21;80;101;17;25;42
89;21.11.2014;2014;11;10;Perjantai;30;70;100;17;29;46
89;21.11.2014;2014;11;11;Perjantai;44;48;92;26;35;61
89;21.11.2014;2014;11;12;Perjantai;58;82;140;19;27;46
89;21.11.2014;2014;11;13;Perjantai;76;59;135;28;41;69
89;21.11.2014;2014;11;14;Perjantai;85;70;155;40;27;67
89;21.11.2014;2014;11;15;Perjantai;128;95;223;36;41;77
89;21.11.2014;2014;11;16;Perjantai;100;70;170;43;51;94
89;21.11.2014;2014;11;17;Perjantai;87;95;182;41;64;105
89;21.11.2014;2014;11;18;Perjantai;61;51;112;50;54;104
89;21.11.2014;2014;11;19;Perjantai;82;41;123;65;64;129
89;21.11.2014;2014;11;20;Perjantai;55;32;87;34;31;65
89;21.11.2014;2014;11;21;Perjantai;39;20;59;16;12;28
89;21.11.2014;2014;11;22;Perjantai;20;11;31;8;15;23
89;21.11.2014;2014;11;23;Perjantai;15;11;26;6;9;15
89;22.11.2014;2014;11;00;Lauantai;16;11;27;6;3;9
89;22.11.2014;2014;11;01;Lauantai;17;16;33;4;2;6
89;22.11.2014;2014;11;02;Lauantai;14;3;17;10;4;14
89;22.11.2014;2014;11;03;Lauantai;16;1;17;6;0;6
89;22.11.2014;2014;11;04;Lauantai;13;5;18;14;0;14
89;22.11.2014;2014;11;05;Lauantai;4;3;7;1;1;2
89;22.11.2014;2014;11;06;Lauantai;7;12;19;1;2;3
89;22.11.2014;2014;11;07;Lauantai;4;11;15;4;3;7
89;22.11.2014;2014;11;08;Lauantai;9;24;33;9;14;23
89;22.11.2014;2014;11;09;Lauantai;5;28;33;13;25;38
89;22.11.2014;2014;11;10;Lauantai;16;37;53;16;27;43
89;22.11.2014;2014;11;11;Lauantai;21;47;68;21;47;68
89;22.11.2014;2014;11;12;Lauantai;51;43;94;32;57;89
89;22.11.2014;2014;11;13;Lauantai;37;50;87;32;37;69
89;22.11.2014;2014;11;14;Lauantai;55;64;119;30;37;67
89;22.11.2014;2014;11;15;Lauantai;48;35;83;44;36;80
89;22.11.2014;2014;11;16;Lauantai;50;62;112;38;53;91
89;22.11.2014;2014;11;17;Lauantai;56;53;109;51;76;127
89;22.11.2014;2014;11;18;Lauantai;50;40;90;47;52;99
89;22.11.2014;2014;11;19;Lauantai;51;25;76;38;55;93
89;22.11.2014;2014;11;20;Lauantai;24;16;40;23;23;46
89;22.11.2014;2014;11;21;Lauantai;18;19;37;17;17;34
89;22.11.2014;2014;11;22;Lauantai;26;17;43;12;13;25
89;22.11.2014;2014;11;23;Lauantai;12;11;23;11;14;25
89;23.11.2014;2014;11;00;Sunnuntai;16;15;31;1;3;4
89;23.11.2014;2014;11;01;Sunnuntai;17;6;23;6;2;8
89;23.11.2014;2014;11;02;Sunnuntai;9;6;15;8;6;14
89;23.11.2014;2014;11;03;Sunnuntai;18;3;21;10;2;12
89;23.11.2014;2014;11;04;Sunnuntai;11;2;13;9;1;10
89;23.11.2014;2014;11;05;Sunnuntai;3;1;4;6;0;6
89;23.11.2014;2014;11;06;Sunnuntai;4;3;7;1;2;3
89;23.11.2014;2014;11;07;Sunnuntai;2;5;7;8;6;14
89;23.11.2014;2014;11;08;Sunnuntai;3;2;5;10;10;20
89;23.11.2014;2014;11;09;Sunnuntai;5;7;12;21;25;46
89;23.11.2014;2014;11;10;Sunnuntai;8;19;27;21;38;59
89;23.11.2014;2014;11;11;Sunnuntai;12;50;62;39;47;86
89;23.11.2014;2014;11;12;Sunnuntai;18;56;74;46;61;107
89;23.11.2014;2014;11;13;Sunnuntai;34;43;77;46;71;117
89;23.11.2014;2014;11;14;Sunnuntai;36;42;78;55;48;103
89;23.11.2014;2014;11;15;Sunnuntai;50;31;81;40;55;95
89;23.11.2014;2014;11;16;Sunnuntai;43;28;71;63;52;115
89;23.11.2014;2014;11;17;Sunnuntai;39;48;87;76;123;199
89;23.11.2014;2014;11;18;Sunnuntai;39;28;67;87;75;162
89;23.11.2014;2014;11;19;Sunnuntai;43;35;78;57;61;118
89;23.11.2014;2014;11;20;Sunnuntai;40;12;52;28;28;56
89;23.11.2014;2014;11;21;Sunnuntai;29;8;37;14;10;24
89;23.11.2014;2014;11;22;Sunnuntai;8;8;16;6;3;9
89;23.11.2014;2014;11;23;Sunnuntai;11;4;15;1;1;2
89;24.11.2014;2014;11;00;Maanantai;4;7;11;1;0;1
89;24.11.2014;2014;11;01;Maanantai;5;0;5;1;0;1
89;24.11.2014;2014;11;02;Maanantai;1;0;1;0;0;0
89;24.11.2014;2014;11;03;Maanantai;2;1;3;1;0;1
89;24.11.2014;2014;11;04;Maanantai;1;3;4;0;0;0
89;24.11.2014;2014;11;05;Maanantai;2;7;9;1;2;3
89;24.11.2014;2014;11;06;Maanantai;14;35;49;3;8;11
89;24.11.2014;2014;11;07;Maanantai;38;129;167;9;38;47
89;24.11.2014;2014;11;08;Maanantai;30;186;216;10;47;57
89;24.11.2014;2014;11;09;Maanantai;32;82;114;11;32;43
89;24.11.2014;2014;11;10;Maanantai;43;71;114;17;30;47
89;24.11.2014;2014;11;11;Maanantai;59;68;127;26;32;58
89;24.11.2014;2014;11;12;Maanantai;70;81;151;23;30;53
89;24.11.2014;2014;11;13;Maanantai;77;51;128;41;32;73
89;24.11.2014;2014;11;14;Maanantai;90;57;147;42;18;60
89;24.11.2014;2014;11;15;Maanantai;141;70;211;45;47;92
89;24.11.2014;2014;11;16;Maanantai;146;82;228;48;31;79
89;24.11.2014;2014;11;17;Maanantai;73;54;127;32;26;58
89;24.11.2014;2014;11;18;Maanantai;54;50;104;41;39;80
89;24.11.2014;2014;11;19;Maanantai;58;32;90;32;36;68
89;24.11.2014;2014;11;20;Maanantai;52;21;73;31;21;52
89;24.11.2014;2014;11;21;Maanantai;30;21;51;13;7;20
89;24.11.2014;2014;11;22;Maanantai;17;5;22;5;2;7
89;24.11.2014;2014;11;23;Maanantai;5;2;7;4;3;7
89;25.11.2014;2014;11;00;Tiistai;5;1;6;3;0;3
89;25.11.2014;2014;11;01;Tiistai;1;2;3;2;0;2
89;25.11.2014;2014;11;02;Tiistai;1;2;3;3;1;4
89;25.11.2014;2014;11;03;Tiistai;0;4;4;0;0;0
89;25.11.2014;2014;11;04;Tiistai;4;2;6;0;0;0
89;25.11.2014;2014;11;05;Tiistai;2;6;8;2;0;2
89;25.11.2014;2014;11;06;Tiistai;20;44;64;7;10;17
89;25.11.2014;2014;11;07;Tiistai;32;132;164;10;39;49
89;25.11.2014;2014;11;08;Tiistai;36;187;223;6;36;42
89;25.11.2014;2014;11;09;Tiistai;34;88;122;9;29;38
89;25.11.2014;2014;11;10;Tiistai;36;82;118;13;35;48
89;25.11.2014;2014;11;11;Tiistai;36;60;96;24;26;50
89;25.11.2014;2014;11;12;Tiistai;56;57;113;28;27;55
89;25.11.2014;2014;11;13;Tiistai;92;51;143;27;23;50
89;25.11.2014;2014;11;14;Tiistai;92;76;168;25;30;55
89;25.11.2014;2014;11;15;Tiistai;144;66;210;38;26;64
89;25.11.2014;2014;11;16;Tiistai;127;79;206;37;39;76
89;25.11.2014;2014;11;17;Tiistai;87;73;160;44;37;81
89;25.11.2014;2014;11;18;Tiistai;72;39;111;37;49;86
89;25.11.2014;2014;11;19;Tiistai;53;31;84;39;35;74
89;25.11.2014;2014;11;20;Tiistai;49;32;81;33;21;54
89;25.11.2014;2014;11;21;Tiistai;36;15;51;19;5;24
89;25.11.2014;2014;11;22;Tiistai;21;0;21;15;0;15
89;25.11.2014;2014;11;23;Tiistai;7;1;8;5;1;6
89;26.11.2014;2014;11;00;Keskiviikko;2;2;4;3;1;4
89;26.11.2014;2014;11;01;Keskiviikko;0;1;1;1;0;1
89;26.11.2014;2014;11;02;Keskiviikko;1;0;1;0;0;0
89;26.11.2014;2014;11;03;Keskiviikko;1;0;1;0;1;1
89;26.11.2014;2014;11;04;Keskiviikko;2;1;3;0;0;0
89;26.11.2014;2014;11;05;Keskiviikko;7;3;10;2;2;4
89;26.11.2014;2014;11;06;Keskiviikko;24;28;52;2;6;8
89;26.11.2014;2014;11;07;Keskiviikko;88;94;182;30;22;52
89;26.11.2014;2014;11;08;Keskiviikko;93;106;199;34;29;63
89;26.11.2014;2014;11;09;Keskiviikko;50;76;126;24;25;49
89;26.11.2014;2014;11;10;Keskiviikko;43;52;95;25;29;54
89;26.11.2014;2014;11;11;Keskiviikko;54;54;108;35;40;75
89;26.11.2014;2014;11;12;Keskiviikko;58;84;142;32;26;58
89;26.11.2014;2014;11;13;Keskiviikko;82;92;174;32;26;58
89;26.11.2014;2014;11;14;Keskiviikko;92;83;175;36;31;67
89;26.11.2014;2014;11;15;Keskiviikko;83;100;183;43;30;73
89;26.11.2014;2014;11;16;Keskiviikko;109;127;236;41;43;84
89;26.11.2014;2014;11;17;Keskiviikko;59;71;130;36;37;73
89;26.11.2014;2014;11;18;Keskiviikko;50;67;117;38;40;78
89;26.11.2014;2014;11;19;Keskiviikko;52;48;100;52;43;95
89;26.11.2014;2014;11;20;Keskiviikko;39;41;80;30;32;62
89;26.11.2014;2014;11;21;Keskiviikko;26;27;53;10;9;19
89;26.11.2014;2014;11;22;Keskiviikko;20;16;36;3;5;8
89;26.11.2014;2014;11;23;Keskiviikko;10;7;17;3;3;6
89;27.11.2014;2014;11;00;Torstai;1;6;7;2;2;4
89;27.11.2014;2014;11;01;Torstai;1;3;4;1;1;2
89;27.11.2014;2014;11;02;Torstai;2;2;4;0;1;1
89;27.11.2014;2014;11;03;Torstai;1;2;3;1;0;1
89;27.11.2014;2014;11;04;Torstai;3;1;4;1;1;2
89;27.11.2014;2014;11;05;Torstai;5;9;14;1;2;3
89;27.11.2014;2014;11;06;Torstai;21;29;50;3;7;10
89;27.11.2014;2014;11;07;Torstai;89;89;178;15;25;40
89;27.11.2014;2014;11;08;Torstai;103;105;208;27;23;50
89;27.11.2014;2014;11;09;Torstai;45;70;115;32;27;59
89;27.11.2014;2014;11;10;Torstai;53;45;98;31;34;65
89;27.11.2014;2014;11;11;Torstai;55;59;114;33;30;63
89;27.11.2014;2014;11;12;Torstai;55;59;114;28;33;61
89;27.11.2014;2014;11;13;Torstai;60;55;115;43;34;77
89;27.11.2014;2014;11;14;Torstai;90;98;188;36;37;73
89;27.11.2014;2014;11;15;Torstai;127;116;243;34;47;81
89;27.11.2014;2014;11;16;Torstai;122;117;239;26;37;63
89;27.11.2014;2014;11;17;Torstai;77;92;169;52;45;97
89;27.11.2014;2014;11;18;Torstai;91;81;172;58;60;118
89;27.11.2014;2014;11;19;Torstai;74;64;138;38;48;86
89;27.11.2014;2014;11;20;Torstai;38;46;84;32;29;61
89;27.11.2014;2014;11;21;Torstai;33;37;70;14;10;24
89;27.11.2014;2014;11;22;Torstai;8;15;23;5;10;15
89;27.11.2014;2014;11;23;Torstai;5;10;15;2;4;6
89;28.11.2014;2014;11;00;Perjantai;10;12;22;2;2;4
89;28.11.2014;2014;11;01;Perjantai;3;4;7;1;1;2
89;28.11.2014;2014;11;02;Perjantai;2;3;5;3;3;6
89;28.11.2014;2014;11;03;Perjantai;4;6;10;0;0;0
89;28.11.2014;2014;11;04;Perjantai;2;2;4;0;0;0
89;28.11.2014;2014;11;05;Perjantai;7;8;15;4;3;7
89;28.11.2014;2014;11;06;Perjantai;27;24;51;7;8;15
89;28.11.2014;2014;11;07;Perjantai;72;86;158;24;10;34
89;28.11.2014;2014;11;08;Perjantai;84;90;174;23;19;42
89;28.11.2014;2014;11;09;Perjantai;66;62;128;23;23;46
89;28.11.2014;2014;11;10;Perjantai;44;39;83;25;24;49
89;28.11.2014;2014;11;11;Perjantai;58;69;127;22;32;54
89;28.11.2014;2014;11;12;Perjantai;42;59;101;34;28;62
89;28.11.2014;2014;11;13;Perjantai;70;84;154;39;38;77
89;28.11.2014;2014;11;14;Perjantai;83;113;196;34;34;68
89;28.11.2014;2014;11;15;Perjantai;94;99;193;30;29;59
89;28.11.2014;2014;11;16;Perjantai;85;87;172;35;25;60
89;28.11.2014;2014;11;17;Perjantai;64;80;144;33;31;64
89;28.11.2014;2014;11;18;Perjantai;48;52;100;33;39;72
89;28.11.2014;2014;11;19;Perjantai;37;38;75;33;28;61
89;28.11.2014;2014;11;20;Perjantai;29;38;67;20;22;42
89;28.11.2014;2014;11;21;Perjantai;20;20;40;14;14;28
89;28.11.2014;2014;11;22;Perjantai;19;39;58;7;4;11
89;28.11.2014;2014;11;23;Perjantai;16;17;33;8;3;11
89;29.11.2014;2014;11;00;Lauantai;15;15;30;6;5;11
89;29.11.2014;2014;11;01;Lauantai;7;22;29;4;3;7
89;29.11.2014;2014;11;02;Lauantai;11;9;20;3;9;12
89;29.11.2014;2014;11;03;Lauantai;9;3;12;6;4;10
89;29.11.2014;2014;11;04;Lauantai;0;5;5;3;2;5
89;29.11.2014;2014;11;05;Lauantai;5;5;10;1;1;2
89;29.11.2014;2014;11;06;Lauantai;8;7;15;0;4;4
89;29.11.2014;2014;11;07;Lauantai;6;8;14;10;12;22
89;29.11.2014;2014;11;08;Lauantai;13;14;27;9;15;24
89;29.11.2014;2014;11;09;Lauantai;23;24;47;14;17;31
89;29.11.2014;2014;11;10;Lauantai;29;31;60;33;30;63
89;29.11.2014;2014;11;11;Lauantai;58;47;105;23;35;58
89;29.11.2014;2014;11;12;Lauantai;48;38;86;40;42;82
89;29.11.2014;2014;11;13;Lauantai;63;65;128;40;40;80
89;29.11.2014;2014;11;14;Lauantai;62;76;138;37;27;64
89;29.11.2014;2014;11;15;Lauantai;44;58;102;26;24;50
89;29.11.2014;2014;11;16;Lauantai;32;45;77;27;38;65
89;29.11.2014;2014;11;17;Lauantai;54;48;102;26;34;60
89;29.11.2014;2014;11;18;Lauantai;36;39;75;22;32;54
89;29.11.2014;2014;11;19;Lauantai;31;45;76;24;15;39
89;29.11.2014;2014;11;20;Lauantai;33;29;62;16;7;23
89;29.11.2014;2014;11;21;Lauantai;27;19;46;11;9;20
89;29.11.2014;2014;11;22;Lauantai;16;19;35;4;6;10
89;29.11.2014;2014;11;23;Lauantai;7;17;24;4;6;10
89;30.11.2014;2014;11;00;Sunnuntai;15;21;36;1;3;4
89;30.11.2014;2014;11;01;Sunnuntai;17;9;26;6;5;11
89;30.11.2014;2014;11;02;Sunnuntai;6;7;13;3;9;12
89;30.11.2014;2014;11;03;Sunnuntai;10;10;20;7;6;13
89;30.11.2014;2014;11;04;Sunnuntai;10;8;18;5;3;8
89;30.11.2014;2014;11;05;Sunnuntai;4;1;5;4;2;6
89;30.11.2014;2014;11;06;Sunnuntai;2;2;4;3;2;5
89;30.11.2014;2014;11;07;Sunnuntai;5;3;8;6;4;10
89;30.11.2014;2014;11;08;Sunnuntai;6;8;14;7;6;13
89;30.11.2014;2014;11;09;Sunnuntai;15;19;34;23;25;48
89;30.11.2014;2014;11;10;Sunnuntai;16;25;41;22;28;50
89;30.11.2014;2014;11;11;Sunnuntai;30;36;66;33;60;93
89;30.11.2014;2014;11;12;Sunnuntai;46;44;90;48;48;96
89;30.11.2014;2014;11;13;Sunnuntai;33;56;89;37;42;79
89;30.11.2014;2014;11;14;Sunnuntai;44;41;85;46;39;85
89;30.11.2014;2014;11;15;Sunnuntai;31;51;82;34;28;62
89;30.11.2014;2014;11;16;Sunnuntai;36;39;75;33;44;77
89;30.11.2014;2014;11;17;Sunnuntai;39;39;78;34;31;65
89;30.11.2014;2014;11;18;Sunnuntai;28;30;58;31;33;64
89;30.11.2014;2014;11;19;Sunnuntai;27;30;57;22;27;49
89;30.11.2014;2014;11;20;Sunnuntai;21;26;47;13;23;36
89;30.11.2014;2014;11;21;Sunnuntai;14;13;27;8;6;14
89;30.11.2014;2014;11;22;Sunnuntai;13;9;22;5;5;10
89;30.11.2014;2014;11;23;Sunnuntai;3;1;4;2;2;4
89;01.12.2014;2014;12;00;Maanantai;1;4;5;3;0;3
89;01.12.2014;2014;12;01;Maanantai;1;2;3;2;0;2
89;01.12.2014;2014;12;02;Maanantai;1;2;3;0;1;1
89;01.12.2014;2014;12;03;Maanantai;2;0;2;0;0;0
89;01.12.2014;2014;12;04;Maanantai;3;1;4;0;1;1
89;01.12.2014;2014;12;05;Maanantai;3;6;9;1;1;2
89;01.12.2014;2014;12;06;Maanantai;31;22;53;5;5;10
89;01.12.2014;2014;12;07;Maanantai;95;97;192;21;25;46
89;01.12.2014;2014;12;08;Maanantai;115;97;212;25;21;46
89;01.12.2014;2014;12;09;Maanantai;64;81;145;25;23;48
89;01.12.2014;2014;12;10;Maanantai;54;58;112;25;20;45
89;01.12.2014;2014;12;11;Maanantai;66;57;123;21;24;45
89;01.12.2014;2014;12;12;Maanantai;69;58;127;21;22;43
89;01.12.2014;2014;12;13;Maanantai;70;74;144;26;26;52
89;01.12.2014;2014;12;14;Maanantai;90;95;185;32;24;56
89;01.12.2014;2014;12;15;Maanantai;110;103;213;27;31;58
89;01.12.2014;2014;12;16;Maanantai;121;119;240;33;31;64
89;01.12.2014;2014;12;17;Maanantai;59;61;120;20;31;51
89;01.12.2014;2014;12;18;Maanantai;59;74;133;29;24;53
89;01.12.2014;2014;12;19;Maanantai;61;41;102;34;29;63
89;01.12.2014;2014;12;20;Maanantai;34;31;65;28;27;55
89;01.12.2014;2014;12;21;Maanantai;26;27;53;13;8;21
89;01.12.2014;2014;12;22;Maanantai;16;13;29;3;8;11
89;01.12.2014;2014;12;23;Maanantai;10;9;19;1;3;4
89;02.12.2014;2014;12;00;Tiistai;1;4;5;2;2;4
89;02.12.2014;2014;12;01;Tiistai;0;0;0;3;0;3
89;02.12.2014;2014;12;02;Tiistai;2;1;3;0;1;1
89;02.12.2014;2014;12;03;Tiistai;2;2;4;0;1;1
89;02.12.2014;2014;12;04;Tiistai;2;5;7;1;1;2
89;02.12.2014;2014;12;05;Tiistai;6;4;10;1;0;1
89;02.12.2014;2014;12;06;Tiistai;30;26;56;9;10;19
89;02.12.2014;2014;12;07;Tiistai;98;93;191;13;21;34
89;02.12.2014;2014;12;08;Tiistai;95;138;233;35;23;58
89;02.12.2014;2014;12;09;Tiistai;63;59;122;19;13;32
89;02.12.2014;2014;12;10;Tiistai;53;38;91;28;20;48
89;02.12.2014;2014;12;11;Tiistai;47;53;100;17;13;30
89;02.12.2014;2014;12;12;Tiistai;42;54;96;24;30;54
89;02.12.2014;2014;12;13;Tiistai;55;57;112;24;24;48
89;02.12.2014;2014;12;14;Tiistai;77;82;159;66;77;143
89;02.12.2014;2014;12;15;Tiistai;93;105;198;20;31;51
89;02.12.2014;2014;12;16;Tiistai;101;110;211;21;28;49
89;02.12.2014;2014;12;17;Tiistai;60;67;127;23;23;46
89;02.12.2014;2014;12;18;Tiistai;53;52;105;27;29;56
89;02.12.2014;2014;12;19;Tiistai;33;45;78;29;27;56
89;02.12.2014;2014;12;20;Tiistai;34;41;75;26;25;51
89;02.12.2014;2014;12;21;Tiistai;15;21;36;9;11;20
89;02.12.2014;2014;12;22;Tiistai;9;13;22;2;6;8
89;02.12.2014;2014;12;23;Tiistai;3;5;8;2;3;5
89;03.12.2014;2014;12;00;Keskiviikko;6;2;8;2;1;3
89;03.12.2014;2014;12;01;Keskiviikko;2;3;5;0;0;0
89;03.12.2014;2014;12;02;Keskiviikko;1;0;1;0;1;1
89;03.12.2014;2014;12;03;Keskiviikko;4;2;6;0;1;1
89;03.12.2014;2014;12;04;Keskiviikko;7;4;11;3;3;6
89;03.12.2014;2014;12;05;Keskiviikko;6;10;16;2;0;2
89;03.12.2014;2014;12;06;Keskiviikko;26;29;55;5;10;15
89;03.12.2014;2014;12;07;Keskiviikko;83;94;177;29;26;55
89;03.12.2014;2014;12;08;Keskiviikko;96;129;225;18;20;38
89;03.12.2014;2014;12;09;Keskiviikko;83;67;150;26;27;53
89;03.12.2014;2014;12;10;Keskiviikko;45;37;82;23;24;47
89;03.12.2014;2014;12;11;Keskiviikko;60;49;109;36;37;73
89;03.12.2014;2014;12;12;Keskiviikko;53;45;98;36;29;65
89;03.12.2014;2014;12;13;Keskiviikko;74;67;141;31;31;62
89;03.12.2014;2014;12;14;Keskiviikko;69;79;148;29;37;66
89;03.12.2014;2014;12;15;Keskiviikko;88;95;183;27;25;52
89;03.12.2014;2014;12;16;Keskiviikko;66;103;169;13;21;34
89;03.12.2014;2014;12;17;Keskiviikko;67;64;131;20;20;40
89;03.12.2014;2014;12;18;Keskiviikko;35;38;73;15;25;40
89;03.12.2014;2014;12;19;Keskiviikko;40;38;78;17;18;35
89;03.12.2014;2014;12;20;Keskiviikko;19;31;50;8;15;23
89;03.12.2014;2014;12;21;Keskiviikko;16;19;35;5;5;10
89;03.12.2014;2014;12;22;Keskiviikko;13;15;28;1;3;4
89;03.12.2014;2014;12;23;Keskiviikko;4;5;9;2;1;3
89;04.12.2014;2014;12;00;Torstai;2;4;6;1;2;3
89;04.12.2014;2014;12;01;Torstai;9;0;9;2;2;4
89;04.12.2014;2014;12;02;Torstai;4;4;8;2;1;3
89;04.12.2014;2014;12;03;Torstai;4;4;8;3;0;3
89;04.12.2014;2014;12;04;Torstai;4;8;12;1;2;3
89;04.12.2014;2014;12;05;Torstai;12;7;19;2;2;4
89;04.12.2014;2014;12;06;Torstai;25;29;54;6;4;10
89;04.12.2014;2014;12;07;Torstai;85;78;163;18;22;40
89;04.12.2014;2014;12;08;Torstai;98;97;195;23;25;48
89;04.12.2014;2014;12;09;Torstai;68;53;121;21;12;33
89;04.12.2014;2014;12;10;Torstai;52;55;107;19;21;40
89;04.12.2014;2014;12;11;Torstai;44;56;100;32;25;57
89;04.12.2014;2014;12;12;Torstai;61;46;107;27;23;50
89;04.12.2014;2014;12;13;Torstai;59;55;114;26;22;48
89;04.12.2014;2014;12;14;Torstai;71;83;154;34;27;61
89;04.12.2014;2014;12;15;Torstai;103;87;190;35;35;70
89;04.12.2014;2014;12;16;Torstai;110;96;206;28;35;63
89;04.12.2014;2014;12;17;Torstai;51;62;113;23;31;54
89;04.12.2014;2014;12;18;Torstai;48;48;96;24;30;54
89;04.12.2014;2014;12;19;Torstai;41;38;79;23;22;45
89;04.12.2014;2014;12;20;Torstai;34;39;73;15;14;29
89;04.12.2014;2014;12;21;Torstai;28;23;51;11;11;22
89;04.12.2014;2014;12;22;Torstai;6;9;15;11;2;13
89;04.12.2014;2014;12;23;Torstai;11;6;17;1;3;4
89;05.12.2014;2014;12;00;Perjantai;5;6;11;0;1;1
89;05.12.2014;2014;12;01;Perjantai;4;2;6;0;1;1
89;05.12.2014;2014;12;02;Perjantai;2;3;5;1;1;2
89;05.12.2014;2014;12;03;Perjantai;2;0;2;0;0;0
89;05.12.2014;2014;12;04;Perjantai;5;5;10;0;0;0
89;05.12.2014;2014;12;05;Perjantai;2;5;7;0;2;2
89;05.12.2014;2014;12;06;Perjantai;22;23;45;4;8;12
89;05.12.2014;2014;12;07;Perjantai;62;71;133;16;29;45
89;05.12.2014;2014;12;08;Perjantai;73;110;183;22;25;47
89;05.12.2014;2014;12;09;Perjantai;55;35;90;17;23;40
89;05.12.2014;2014;12;10;Perjantai;35;32;67;13;34;47
89;05.12.2014;2014;12;11;Perjantai;57;60;117;30;26;56
89;05.12.2014;2014;12;12;Perjantai;45;53;98;26;28;54
89;05.12.2014;2014;12;13;Perjantai;49;78;127;20;24;44
89;05.12.2014;2014;12;14;Perjantai;81;92;173;33;21;54
89;05.12.2014;2014;12;15;Perjantai;81;84;165;18;19;37
89;05.12.2014;2014;12;16;Perjantai;66;78;144;16;17;33
89;05.12.2014;2014;12;17;Perjantai;61;50;111;17;21;38
89;05.12.2014;2014;12;18;Perjantai;31;42;73;19;24;43
89;05.12.2014;2014;12;19;Perjantai;30;33;63;10;16;26
89;05.12.2014;2014;12;20;Perjantai;24;32;56;6;14;20
89;05.12.2014;2014;12;21;Perjantai;16;13;29;13;7;20
89;05.12.2014;2014;12;22;Perjantai;16;19;35;6;2;8
89;05.12.2014;2014;12;23;Perjantai;20;8;28;6;4;10
89;06.12.2014;2014;12;00;Lauantai;21;9;30;8;7;15
89;06.12.2014;2014;12;01;Lauantai;14;15;29;4;5;9
89;06.12.2014;2014;12;02;Lauantai;6;9;15;7;5;12
89;06.12.2014;2014;12;03;Lauantai;7;12;19;7;10;17
89;06.12.2014;2014;12;04;Lauantai;5;4;9;3;6;9
89;06.12.2014;2014;12;05;Lauantai;3;2;5;3;2;5
89;06.12.2014;2014;12;06;Lauantai;7;5;12;0;0;0
89;06.12.2014;2014;12;07;Lauantai;4;5;9;2;4;6
89;06.12.2014;2014;12;08;Lauantai;5;2;7;7;4;11
89;06.12.2014;2014;12;09;Lauantai;11;11;22;14;6;20
89;06.12.2014;2014;12;10;Lauantai;4;15;19;16;24;40
89;06.12.2014;2014;12;11;Lauantai;19;18;37;36;24;60
89;06.12.2014;2014;12;12;Lauantai;22;17;39;44;44;88
89;06.12.2014;2014;12;13;Lauantai;10;19;29;19;28;47
89;06.12.2014;2014;12;14;Lauantai;25;17;42;37;38;75
89;06.12.2014;2014;12;15;Lauantai;25;17;42;24;30;54
89;06.12.2014;2014;12;16;Lauantai;18;33;51;13;22;35
89;06.12.2014;2014;12;17;Lauantai;36;36;72;28;38;66
89;06.12.2014;2014;12;18;Lauantai;28;25;53;15;17;32
89;06.12.2014;2014;12;19;Lauantai;8;13;21;15;7;22
89;06.12.2014;2014;12;20;Lauantai;15;19;34;3;3;6
89;06.12.2014;2014;12;21;Lauantai;9;13;22;7;6;13
89;06.12.2014;2014;12;22;Lauantai;12;16;28;3;12;15
89;06.12.2014;2014;12;23;Lauantai;16;14;30;3;9;12
89;07.12.2014;2014;12;00;Sunnuntai;22;17;39;5;3;8
89;07.12.2014;2014;12;01;Sunnuntai;7;4;11;2;5;7
89;07.12.2014;2014;12;02;Sunnuntai;5;5;10;10;11;21
89;07.12.2014;2014;12;03;Sunnuntai;14;5;19;3;2;5
89;07.12.2014;2014;12;04;Sunnuntai;9;4;13;3;7;10
89;07.12.2014;2014;12;05;Sunnuntai;1;3;4;3;1;4
89;07.12.2014;2014;12;06;Sunnuntai;3;4;7;1;1;2
89;07.12.2014;2014;12;07;Sunnuntai;3;2;5;5;4;9
89;07.12.2014;2014;12;08;Sunnuntai;4;3;7;11;6;17
89;07.12.2014;2014;12;09;Sunnuntai;10;5;15;6;14;20
89;07.12.2014;2014;12;10;Sunnuntai;23;19;42;19;24;43
89;07.12.2014;2014;12;11;Sunnuntai;30;36;66;33;41;74
89;07.12.2014;2014;12;12;Sunnuntai;37;30;67;33;41;74
89;07.12.2014;2014;12;13;Sunnuntai;32;19;51;37;38;75
89;07.12.2014;2014;12;14;Sunnuntai;65;16;81;42;11;53
89;07.12.2014;2014;12;15;Sunnuntai;37;29;66;18;17;35
89;07.12.2014;2014;12;16;Sunnuntai;24;21;45;29;22;51
89;07.12.2014;2014;12;17;Sunnuntai;21;21;42;28;26;54
89;07.12.2014;2014;12;18;Sunnuntai;22;15;37;18;17;35
89;07.12.2014;2014;12;19;Sunnuntai;20;18;38;16;19;35
89;07.12.2014;2014;12;20;Sunnuntai;23;18;41;12;19;31
89;07.12.2014;2014;12;21;Sunnuntai;15;7;22;2;3;5
89;07.12.2014;2014;12;22;Sunnuntai;3;2;5;5;1;6
89;07.12.2014;2014;12;23;Sunnuntai;4;7;11;1;1;2
89;08.12.2014;2014;12;00;Maanantai;3;3;6;0;1;1
89;08.12.2014;2014;12;01;Maanantai;0;1;1;2;1;3
89;08.12.2014;2014;12;02;Maanantai;0;1;1;0;2;2
89;08.12.2014;2014;12;03;Maanantai;3;2;5;1;2;3
89;08.12.2014;2014;12;04;Maanantai;2;4;6;0;0;0
89;08.12.2014;2014;12;05;Maanantai;11;1;12;6;1;7
89;08.12.2014;2014;12;06;Maanantai;29;29;58;5;6;11
89;08.12.2014;2014;12;07;Maanantai;86;65;151;19;23;42
89;08.12.2014;2014;12;08;Maanantai;75;86;161;23;31;54
89;08.12.2014;2014;12;09;Maanantai;60;71;131;19;25;44
89;08.12.2014;2014;12;10;Maanantai;41;49;90;24;24;48
89;08.12.2014;2014;12;11;Maanantai;58;44;102;26;22;48
89;08.12.2014;2014;12;12;Maanantai;49;55;104;17;30;47
89;08.12.2014;2014;12;13;Maanantai;57;59;116;21;27;48
89;08.12.2014;2014;12;14;Maanantai;80;72;152;32;33;65
89;08.12.2014;2014;12;15;Maanantai;85;81;166;35;30;65
89;08.12.2014;2014;12;16;Maanantai;164;68;232;34;25;59
89;08.12.2014;2014;12;17;Maanantai;83;43;126;28;27;55
89;08.12.2014;2014;12;18;Maanantai;122;15;137;58;8;66
89;08.12.2014;2014;12;19;Maanantai;89;11;100;53;7;60
89;08.12.2014;2014;12;20;Maanantai;81;2;83;45;4;49
89;08.12.2014;2014;12;21;Maanantai;43;5;48;23;2;25
89;08.12.2014;2014;12;22;Maanantai;18;0;18;7;1;8
89;08.12.2014;2014;12;23;Maanantai;22;1;23;10;0;10
89;09.12.2014;2014;12;00;Tiistai;7;0;7;2;0;2
89;09.12.2014;2014;12;01;Tiistai;12;0;12;4;1;5
89;09.12.2014;2014;12;02;Tiistai;3;0;3;1;0;1
89;09.12.2014;2014;12;03;Tiistai;4;0;4;0;0;0
89;09.12.2014;2014;12;04;Tiistai;4;0;4;2;0;2
89;09.12.2014;2014;12;05;Tiistai;16;1;17;3;1;4
89;09.12.2014;2014;12;06;Tiistai;66;4;70;19;0;19
89;09.12.2014;2014;12;07;Tiistai;163;1;164;48;4;52
89;09.12.2014;2014;12;08;Tiistai;236;3;239;45;1;46
89;09.12.2014;2014;12;09;Tiistai;133;4;137;40;4;44
89;09.12.2014;2014;12;10;Tiistai;109;2;111;52;1;53
89;09.12.2014;2014;12;11;Tiistai;132;2;134;60;5;65
89;09.12.2014;2014;12;12;Tiistai;149;0;149;82;5;87
89;09.12.2014;2014;12;13;Tiistai;137;1;138;65;0;65
89;09.12.2014;2014;12;14;Tiistai;159;7;166;63;6;69
89;09.12.2014;2014;12;15;Tiistai;204;11;215;68;0;68
89;09.12.2014;2014;12;16;Tiistai;199;5;204;48;1;49
89;09.12.2014;2014;12;17;Tiistai;138;4;142;56;3;59
89;09.12.2014;2014;12;18;Tiistai;118;3;121;57;2;59
89;09.12.2014;2014;12;19;Tiistai;82;6;88;47;1;48
89;09.12.2014;2014;12;20;Tiistai;67;3;70;43;0;43
89;09.12.2014;2014;12;21;Tiistai;43;1;44;20;0;20
89;09.12.2014;2014;12;22;Tiistai;26;0;26;6;0;6
89;09.12.2014;2014;12;23;Tiistai;8;0;8;6;0;6
89;10.12.2014;2014;12;00;Keskiviikko;8;0;8;3;0;3
89;10.12.2014;2014;12;01;Keskiviikko;2;2;4;1;1;2
89;10.12.2014;2014;12;02;Keskiviikko;6;0;6;5;1;6
89;10.12.2014;2014;12;03;Keskiviikko;1;0;1;1;0;1
89;10.12.2014;2014;12;04;Keskiviikko;2;4;6;2;0;2
89;10.12.2014;2014;12;05;Keskiviikko;3;7;10;2;2;4
89;10.12.2014;2014;12;06;Keskiviikko;22;20;42;7;5;12
89;10.12.2014;2014;12;07;Keskiviikko;85;84;169;19;25;44
89;10.12.2014;2014;12;08;Keskiviikko;97;86;183;20;28;48
89;10.12.2014;2014;12;09;Keskiviikko;74;71;145;27;18;45
89;10.12.2014;2014;12;10;Keskiviikko;43;50;93;23;24;47
89;10.12.2014;2014;12;11;Keskiviikko;52;52;104;28;29;57
89;10.12.2014;2014;12;12;Keskiviikko;61;69;130;25;34;59
89;10.12.2014;2014;12;13;Keskiviikko;77;63;140;27;29;56
89;10.12.2014;2014;12;14;Keskiviikko;82;79;161;28;25;53
89;10.12.2014;2014;12;15;Keskiviikko;99;88;187;38;32;70
89;10.12.2014;2014;12;16;Keskiviikko;109;90;199;38;24;62
89;10.12.2014;2014;12;17;Keskiviikko;76;73;149;27;28;55
89;10.12.2014;2014;12;18;Keskiviikko;63;51;114;32;20;52
89;10.12.2014;2014;12;19;Keskiviikko;46;49;95;20;23;43
89;10.12.2014;2014;12;20;Keskiviikko;23;32;55;16;18;34
89;10.12.2014;2014;12;21;Keskiviikko;38;28;66;4;6;10
89;10.12.2014;2014;12;22;Keskiviikko;14;8;22;5;2;7
89;10.12.2014;2014;12;23;Keskiviikko;12;5;17;3;2;5
89;11.12.2014;2014;12;00;Torstai;10;4;14;5;1;6
89;11.12.2014;2014;12;01;Torstai;4;4;8;4;2;6
89;11.12.2014;2014;12;02;Torstai;5;3;8;2;0;2
89;11.12.2014;2014;12;03;Torstai;6;4;10;0;0;0
89;11.12.2014;2014;12;04;Torstai;4;0;4;2;0;2
89;11.12.2014;2014;12;05;Torstai;12;1;13;1;1;2
89;11.12.2014;2014;12;06;Torstai;41;5;46;11;1;12
89;11.12.2014;2014;12;07;Torstai;135;43;178;29;19;48
89;11.12.2014;2014;12;08;Torstai;153;52;205;30;22;52
89;11.12.2014;2014;12;09;Torstai;99;20;119;24;8;32
89;11.12.2014;2014;12;10;Torstai;95;9;104;30;6;36
89;11.12.2014;2014;12;11;Torstai;86;17;103;45;17;62
89;11.12.2014;2014;12;12;Torstai;85;38;123;38;25;63
89;11.12.2014;2014;12;13;Torstai;65;55;120;25;20;45
89;11.12.2014;2014;12;14;Torstai;108;89;197;34;24;58
89;11.12.2014;2014;12;15;Torstai;104;113;217;25;19;44
89;11.12.2014;2014;12;16;Torstai;85;100;185;25;19;44
89;11.12.2014;2014;12;17;Torstai;61;75;136;22;20;42
89;11.12.2014;2014;12;18;Torstai;52;65;117;29;19;48
89;11.12.2014;2014;12;19;Torstai;42;41;83;15;26;41
89;11.12.2014;2014;12;20;Torstai;44;50;94;12;23;35
89;11.12.2014;2014;12;21;Torstai;25;29;54;9;11;20
89;11.12.2014;2014;12;22;Torstai;12;19;31;9;4;13
89;11.12.2014;2014;12;23;Torstai;9;17;26;4;2;6
89;12.12.2014;2014;12;00;Perjantai;4;3;7;1;0;1
89;12.12.2014;2014;12;01;Perjantai;4;3;7;1;3;4
89;12.12.2014;2014;12;02;Perjantai;2;4;6;0;0;0
89;12.12.2014;2014;12;03;Perjantai;3;4;7;0;0;0
89;12.12.2014;2014;12;04;Perjantai;5;2;7;0;2;2
89;12.12.2014;2014;12;05;Perjantai;5;4;9;2;1;3
89;12.12.2014;2014;12;06;Perjantai;14;28;42;4;7;11
89;12.12.2014;2014;12;07;Perjantai;60;82;142;24;18;42
89;12.12.2014;2014;12;08;Perjantai;78;90;168;24;23;47
89;12.12.2014;2014;12;09;Perjantai;60;48;108;21;20;41
89;12.12.2014;2014;12;10;Perjantai;47;46;93;20;22;42
89;12.12.2014;2014;12;11;Perjantai;70;66;136;27;33;60
89;12.12.2014;2014;12;12;Perjantai;49;44;93;31;19;50
89;12.12.2014;2014;12;13;Perjantai;72;74;146;21;22;43
89;12.12.2014;2014;12;14;Perjantai;75;78;153;25;25;50
89;12.12.2014;2014;12;15;Perjantai;90;95;185;22;28;50
89;12.12.2014;2014;12;16;Perjantai;73;92;165;17;28;45
89;12.12.2014;2014;12;17;Perjantai;67;51;118;26;18;44
89;12.12.2014;2014;12;18;Perjantai;46;48;94;29;20;49
89;12.12.2014;2014;12;19;Perjantai;44;46;90;18;21;39
89;12.12.2014;2014;12;20;Perjantai;46;27;73;17;17;34
89;12.12.2014;2014;12;21;Perjantai;23;33;56;14;6;20
89;12.12.2014;2014;12;22;Perjantai;22;24;46;9;7;16
89;12.12.2014;2014;12;23;Perjantai;19;27;46;6;2;8
89;13.12.2014;2014;12;00;Lauantai;9;15;24;7;6;13
89;13.12.2014;2014;12;01;Lauantai;11;10;21;5;5;10
89;13.12.2014;2014;12;02;Lauantai;9;15;24;7;2;9
89;13.12.2014;2014;12;03;Lauantai;1;5;6;5;7;12
89;13.12.2014;2014;12;04;Lauantai;18;7;25;5;2;7
89;13.12.2014;2014;12;05;Lauantai;4;3;7;4;2;6
89;13.12.2014;2014;12;06;Lauantai;5;5;10;1;1;2
89;13.12.2014;2014;12;07;Lauantai;6;8;14;4;7;11
89;13.12.2014;2014;12;08;Lauantai;18;16;34;9;6;15
89;13.12.2014;2014;12;09;Lauantai;17;38;55;20;17;37
89;13.12.2014;2014;12;10;Lauantai;18;21;39;15;14;29
89;13.12.2014;2014;12;11;Lauantai;44;55;99;25;31;56
89;13.12.2014;2014;12;12;Lauantai;60;55;115;37;30;67
89;13.12.2014;2014;12;13;Lauantai;54;59;113;41;43;84
89;13.12.2014;2014;12;14;Lauantai;36;64;100;51;36;87
89;13.12.2014;2014;12;15;Lauantai;38;51;89;31;53;84
89;13.12.2014;2014;12;16;Lauantai;42;41;83;34;26;60
89;13.12.2014;2014;12;17;Lauantai;43;42;85;23;39;62
89;13.12.2014;2014;12;18;Lauantai;38;40;78;25;27;52
89;13.12.2014;2014;12;19;Lauantai;28;31;59;21;27;48
89;13.12.2014;2014;12;20;Lauantai;23;29;52;8;13;21
89;13.12.2014;2014;12;21;Lauantai;21;26;47;9;6;15
89;13.12.2014;2014;12;22;Lauantai;12;21;33;12;5;17
89;13.12.2014;2014;12;23;Lauantai;19;18;37;5;10;15
89;14.12.2014;2014;12;00;Sunnuntai;15;10;25;12;3;15
89;14.12.2014;2014;12;01;Sunnuntai;17;9;26;7;7;14
89;14.12.2014;2014;12;02;Sunnuntai;15;4;19;10;3;13
89;14.12.2014;2014;12;03;Sunnuntai;7;17;24;12;6;18
89;14.12.2014;2014;12;04;Sunnuntai;5;7;12;4;3;7
89;14.12.2014;2014;12;05;Sunnuntai;3;2;5;1;0;1
89;14.12.2014;2014;12;06;Sunnuntai;5;7;12;1;2;3
89;14.12.2014;2014;12;07;Sunnuntai;0;5;5;5;4;9
89;14.12.2014;2014;12;08;Sunnuntai;2;3;5;6;6;12
89;14.12.2014;2014;12;09;Sunnuntai;10;9;19;11;15;26
89;14.12.2014;2014;12;10;Sunnuntai;10;21;31;31;27;58
89;14.12.2014;2014;12;11;Sunnuntai;22;29;51;48;37;85
89;14.12.2014;2014;12;12;Sunnuntai;29;47;76;46;53;99
89;14.12.2014;2014;12;13;Sunnuntai;32;40;72;38;49;87
89;14.12.2014;2014;12;14;Sunnuntai;43;39;82;51;45;96
89;14.12.2014;2014;12;15;Sunnuntai;29;42;71;30;41;71
89;14.12.2014;2014;12;16;Sunnuntai;35;51;86;20;32;52
89;14.12.2014;2014;12;17;Sunnuntai;24;35;59;27;24;51
89;14.12.2014;2014;12;18;Sunnuntai;24;37;61;28;33;61
89;14.12.2014;2014;12;19;Sunnuntai;21;23;44;26;24;50
89;14.12.2014;2014;12;20;Sunnuntai;16;20;36;15;18;33
89;14.12.2014;2014;12;21;Sunnuntai;14;15;29;11;5;16
89;14.12.2014;2014;12;22;Sunnuntai;8;10;18;4;3;7
89;14.12.2014;2014;12;23;Sunnuntai;4;3;7;2;0;2
89;15.12.2014;2014;12;00;Maanantai;3;2;5;2;1;3
89;15.12.2014;2014;12;01;Maanantai;2;3;5;1;0;1
89;15.12.2014;2014;12;02;Maanantai;1;1;2;0;0;0
89;15.12.2014;2014;12;03;Maanantai;1;2;3;2;1;3
89;15.12.2014;2014;12;04;Maanantai;1;2;3;3;1;4
89;15.12.2014;2014;12;05;Maanantai;10;5;15;1;0;1
89;15.12.2014;2014;12;06;Maanantai;30;19;49;4;8;12
89;15.12.2014;2014;12;07;Maanantai;76;91;167;15;16;31
89;15.12.2014;2014;12;08;Maanantai;71;102;173;22;31;53
89;15.12.2014;2014;12;09;Maanantai;59;61;120;22;27;49
89;15.12.2014;2014;12;10;Maanantai;44;56;100;17;25;42
89;15.12.2014;2014;12;11;Maanantai;37;52;89;39;39;78
89;15.12.2014;2014;12;12;Maanantai;44;50;94;30;27;57
89;15.12.2014;2014;12;13;Maanantai;75;56;131;20;29;49
89;15.12.2014;2014;12;14;Maanantai;80;70;150;31;32;63
89;15.12.2014;2014;12;15;Maanantai;94;88;182;17;35;52
89;15.12.2014;2014;12;16;Maanantai;90;113;203;26;40;66
89;15.12.2014;2014;12;17;Maanantai;58;65;123;20;38;58
89;15.12.2014;2014;12;18;Maanantai;52;36;88;19;22;41
89;15.12.2014;2014;12;19;Maanantai;27;36;63;16;16;32
89;15.12.2014;2014;12;20;Maanantai;32;23;55;9;16;25
89;15.12.2014;2014;12;21;Maanantai;21;25;46;9;6;15
89;15.12.2014;2014;12;22;Maanantai;12;11;23;2;7;9
89;15.12.2014;2014;12;23;Maanantai;6;3;9;1;0;1
89;16.12.2014;2014;12;00;Tiistai;1;4;5;0;3;3
89;16.12.2014;2014;12;01;Tiistai;4;1;5;2;0;2
89;16.12.2014;2014;12;02;Tiistai;1;2;3;1;0;1
89;16.12.2014;2014;12;03;Tiistai;4;1;5;0;0;0
89;16.12.2014;2014;12;04;Tiistai;2;5;7;0;1;1
89;16.12.2014;2014;12;05;Tiistai;6;6;12;2;1;3
89;16.12.2014;2014;12;06;Tiistai;26;29;55;8;2;10
89;16.12.2014;2014;12;07;Tiistai;62;86;148;26;19;45
89;16.12.2014;2014;12;08;Tiistai;100;105;205;20;30;50
89;16.12.2014;2014;12;09;Tiistai;46;64;110;24;24;48
89;16.12.2014;2014;12;10;Tiistai;38;49;87;27;23;50
89;16.12.2014;2014;12;11;Tiistai;45;45;90;24;25;49
89;16.12.2014;2014;12;12;Tiistai;35;53;88;18;19;37
89;16.12.2014;2014;12;13;Tiistai;63;61;124;22;20;42
89;16.12.2014;2014;12;14;Tiistai;60;82;142;27;22;49
89;16.12.2014;2014;12;15;Tiistai;87;113;200;30;22;52
89;16.12.2014;2014;12;16;Tiistai;118;83;201;29;32;61
89;16.12.2014;2014;12;17;Tiistai;57;73;130;17;31;48
89;16.12.2014;2014;12;18;Tiistai;59;48;107;27;28;55
89;16.12.2014;2014;12;19;Tiistai;51;39;90;16;24;40
89;16.12.2014;2014;12;20;Tiistai;28;31;59;12;21;33
89;16.12.2014;2014;12;21;Tiistai;31;28;59;13;10;23
89;16.12.2014;2014;12;22;Tiistai;8;12;20;5;2;7
89;16.12.2014;2014;12;23;Tiistai;5;15;20;5;3;8
89;17.12.2014;2014;12;00;Keskiviikko;1;2;3;0;1;1
89;17.12.2014;2014;12;01;Keskiviikko;1;3;4;3;0;3
89;17.12.2014;2014;12;02;Keskiviikko;1;5;6;1;3;4
89;17.12.2014;2014;12;03;Keskiviikko;2;5;7;0;2;2
89;17.12.2014;2014;12;04;Keskiviikko;1;5;6;1;4;5
89;17.12.2014;2014;12;05;Keskiviikko;6;7;13;1;0;1
89;17.12.2014;2014;12;06;Keskiviikko;32;30;62;4;5;9
89;17.12.2014;2014;12;07;Keskiviikko;84;95;179;33;37;70
89;17.12.2014;2014;12;08;Keskiviikko;88;87;175;23;24;47
89;17.12.2014;2014;12;09;Keskiviikko;56;44;100;20;24;44
89;17.12.2014;2014;12;10;Keskiviikko;36;48;84;19;15;34
89;17.12.2014;2014;12;11;Keskiviikko;40;45;85;24;32;56
89;17.12.2014;2014;12;12;Keskiviikko;57;57;114;29;39;68
89;17.12.2014;2014;12;13;Keskiviikko;65;62;127;33;30;63
89;17.12.2014;2014;12;14;Keskiviikko;59;84;143;25;36;61
89;17.12.2014;2014;12;15;Keskiviikko;97;77;174;28;31;59
89;17.12.2014;2014;12;16;Keskiviikko;79;111;190;21;26;47
89;17.12.2014;2014;12;17;Keskiviikko;67;71;138;24;43;67
89;17.12.2014;2014;12;18;Keskiviikko;51;39;90;45;45;90
89;17.12.2014;2014;12;19;Keskiviikko;39;51;90;39;33;72
89;17.12.2014;2014;12;20;Keskiviikko;36;31;67;15;17;32
89;17.12.2014;2014;12;21;Keskiviikko;24;29;53;6;4;10
89;17.12.2014;2014;12;22;Keskiviikko;8;12;20;5;8;13
89;17.12.2014;2014;12;23;Keskiviikko;8;10;18;4;4;8
89;18.12.2014;2014;12;00;Torstai;5;3;8;1;3;4
89;18.12.2014;2014;12;01;Torstai;3;3;6;1;0;1
89;18.12.2014;2014;12;02;Torstai;1;1;2;1;1;2
89;18.12.2014;2014;12;03;Torstai;4;3;7;2;0;2
89;18.12.2014;2014;12;04;Torstai;2;4;6;1;4;5
89;18.12.2014;2014;12;05;Torstai;11;6;17;1;1;2
89;18.12.2014;2014;12;06;Torstai;25;29;54;9;5;14
89;18.12.2014;2014;12;07;Torstai;66;78;144;17;29;46
89;18.12.2014;2014;12;08;Torstai;92;103;195;20;25;45
89;18.12.2014;2014;12;09;Torstai;47;42;89;25;24;49
89;18.12.2014;2014;12;10;Torstai;52;47;99;23;21;44
89;18.12.2014;2014;12;11;Torstai;60;57;117;33;18;51
89;18.12.2014;2014;12;12;Torstai;60;71;131;18;38;56
89;18.12.2014;2014;12;13;Torstai;76;69;145;28;31;59
89;18.12.2014;2014;12;14;Torstai;73;66;139;16;28;44
89;18.12.2014;2014;12;15;Torstai;79;95;174;33;37;70
89;18.12.2014;2014;12;16;Torstai;100;117;217;31;30;61
89;18.12.2014;2014;12;17;Torstai;64;59;123;18;25;43
89;18.12.2014;2014;12;18;Torstai;58;53;111;30;33;63
89;18.12.2014;2014;12;19;Torstai;46;37;83;29;21;50
89;18.12.2014;2014;12;20;Torstai;33;39;72;15;18;33
89;18.12.2014;2014;12;21;Torstai;20;24;44;5;17;22
89;18.12.2014;2014;12;22;Torstai;15;6;21;7;7;14
89;18.12.2014;2014;12;23;Torstai;7;9;16;11;3;14
89;19.12.2014;2014;12;00;Perjantai;6;5;11;0;1;1
89;19.12.2014;2014;12;01;Perjantai;10;3;13;0;2;2
89;19.12.2014;2014;12;02;Perjantai;2;3;5;3;3;6
89;19.12.2014;2014;12;03;Perjantai;4;1;5;1;2;3
89;19.12.2014;2014;12;04;Perjantai;1;4;5;3;3;6
89;19.12.2014;2014;12;05;Perjantai;7;3;10;1;1;2
89;19.12.2014;2014;12;06;Perjantai;39;12;51;10;3;13
89;19.12.2014;2014;12;07;Perjantai;86;27;113;26;8;34
89;19.12.2014;2014;12;08;Perjantai;123;40;163;40;16;56
89;19.12.2014;2014;12;09;Perjantai;96;27;123;31;9;40
89;19.12.2014;2014;12;10;Perjantai;75;26;101;36;18;54
89;19.12.2014;2014;12;11;Perjantai;94;22;116;36;16;52
89;19.12.2014;2014;12;12;Perjantai;95;28;123;25;22;47
89;19.12.2014;2014;12;13;Perjantai;101;25;126;32;19;51
89;19.12.2014;2014;12;14;Perjantai;133;21;154;32;15;47
89;19.12.2014;2014;12;15;Perjantai;132;31;163;44;9;53
89;19.12.2014;2014;12;16;Perjantai;156;17;173;44;8;52
89;19.12.2014;2014;12;17;Perjantai;97;19;116;21;8;29
89;19.12.2014;2014;12;18;Perjantai;74;14;88;42;10;52
89;19.12.2014;2014;12;19;Perjantai;77;9;86;26;5;31
89;19.12.2014;2014;12;20;Perjantai;57;15;72;26;11;37
89;19.12.2014;2014;12;21;Perjantai;39;4;43;16;3;19
89;19.12.2014;2014;12;22;Perjantai;25;8;33;14;9;23
89;19.12.2014;2014;12;23;Perjantai;29;5;34;9;1;10
89;20.12.2014;2014;12;00;Lauantai;37;6;43;13;5;18
89;20.12.2014;2014;12;01;Lauantai;22;1;23;4;3;7
89;20.12.2014;2014;12;02;Lauantai;15;3;18;5;0;5
89;20.12.2014;2014;12;03;Lauantai;14;4;18;7;4;11
89;20.12.2014;2014;12;04;Lauantai;12;1;13;9;1;10
89;20.12.2014;2014;12;05;Lauantai;1;0;1;3;9;12
89;20.12.2014;2014;12;06;Lauantai;16;3;19;3;0;3
89;20.12.2014;2014;12;07;Lauantai;8;1;9;11;2;13
89;20.12.2014;2014;12;08;Lauantai;44;5;49;21;3;24
89;20.12.2014;2014;12;09;Lauantai;37;4;41;38;8;46
89;20.12.2014;2014;12;10;Lauantai;61;13;74;52;12;64
89;20.12.2014;2014;12;11;Lauantai;45;11;56;64;7;71
89;20.12.2014;2014;12;12;Lauantai;71;9;80;50;7;57
89;20.12.2014;2014;12;13;Lauantai;58;11;69;41;18;59
89;20.12.2014;2014;12;14;Lauantai;59;12;71;44;15;59
89;20.12.2014;2014;12;15;Lauantai;59;15;74;44;18;62
89;20.12.2014;2014;12;16;Lauantai;47;0;47;47;15;62
89;20.12.2014;2014;12;17;Lauantai;60;4;64;50;11;61
89;20.12.2014;2014;12;18;Lauantai;46;0;46;41;2;43
89;20.12.2014;2014;12;19;Lauantai;34;4;38;35;12;47
89;20.12.2014;2014;12;20;Lauantai;37;5;42;25;6;31
89;20.12.2014;2014;12;21;Lauantai;20;1;21;15;4;19
89;20.12.2014;2014;12;22;Lauantai;29;4;33;13;5;18
89;20.12.2014;2014;12;23;Lauantai;21;5;26;13;3;16
89;21.12.2014;2014;12;00;Sunnuntai;26;6;32;8;3;11
89;21.12.2014;2014;12;01;Sunnuntai;7;3;10;4;0;4
89;21.12.2014;2014;12;02;Sunnuntai;21;2;23;3;0;3
89;21.12.2014;2014;12;03;Sunnuntai;14;7;21;7;3;10
89;21.12.2014;2014;12;04;Sunnuntai;7;10;17;3;2;5
89;21.12.2014;2014;12;05;Sunnuntai;6;0;6;1;2;3
89;21.12.2014;2014;12;06;Sunnuntai;9;3;12;5;2;7
89;21.12.2014;2014;12;07;Sunnuntai;3;0;3;6;1;7
89;21.12.2014;2014;12;08;Sunnuntai;7;0;7;18;1;19
89;21.12.2014;2014;12;09;Sunnuntai;16;1;17;32;2;34
89;21.12.2014;2014;12;10;Sunnuntai;24;1;25;39;13;52
89;21.12.2014;2014;12;11;Sunnuntai;30;8;38;68;22;90
89;21.12.2014;2014;12;12;Sunnuntai;61;4;65;59;18;77
89;21.12.2014;2014;12;13;Sunnuntai;47;9;56;83;18;101
89;21.12.2014;2014;12;14;Sunnuntai;67;10;77;62;12;74
89;21.12.2014;2014;12;15;Sunnuntai;52;4;56;63;6;69
89;21.12.2014;2014;12;16;Sunnuntai;51;16;67;47;11;58
89;21.12.2014;2014;12;17;Sunnuntai;40;1;41;36;1;37
89;21.12.2014;2014;12;18;Sunnuntai;50;3;53;55;0;55
89;21.12.2014;2014;12;19;Sunnuntai;30;0;30;33;0;33
89;21.12.2014;2014;12;20;Sunnuntai;36;5;41;39;6;45
89;21.12.2014;2014;12;21;Sunnuntai;37;4;41;22;1;23
89;21.12.2014;2014;12;22;Sunnuntai;27;1;28;10;2;12
89;21.12.2014;2014;12;23;Sunnuntai;11;3;14;8;0;8
89;22.12.2014;2014;12;00;Maanantai;9;0;9;3;0;3
89;22.12.2014;2014;12;01;Maanantai;9;5;14;1;1;2
89;22.12.2014;2014;12;02;Maanantai;2;2;4;2;0;2
89;22.12.2014;2014;12;03;Maanantai;0;0;0;1;0;1
89;22.12.2014;2014;12;04;Maanantai;3;0;3;1;0;1
89;22.12.2014;2014;12;05;Maanantai;12;1;13;0;0;0
89;22.12.2014;2014;12;06;Maanantai;29;0;29;8;0;8
89;22.12.2014;2014;12;07;Maanantai;86;2;88;30;1;31
89;22.12.2014;2014;12;08;Maanantai;77;0;77;26;1;27
89;22.12.2014;2014;12;09;Maanantai;67;2;69;39;3;42
89;22.12.2014;2014;12;10;Maanantai;65;2;67;39;4;43
89;22.12.2014;2014;12;11;Maanantai;80;4;84;43;6;49
89;22.12.2014;2014;12;12;Maanantai;106;7;113;66;5;71
89;22.12.2014;2014;12;13;Maanantai;81;2;83;69;1;70
89;22.12.2014;2014;12;14;Maanantai;99;3;102;50;3;53
89;22.12.2014;2014;12;15;Maanantai;104;4;108;68;5;73
89;22.12.2014;2014;12;16;Maanantai;130;10;140;47;4;51
89;22.12.2014;2014;12;17;Maanantai;90;4;94;45;1;46
89;22.12.2014;2014;12;18;Maanantai;63;2;65;44;1;45
89;22.12.2014;2014;12;19;Maanantai;56;2;58;39;1;40
89;22.12.2014;2014;12;20;Maanantai;48;0;48;27;0;27
89;22.12.2014;2014;12;21;Maanantai;38;0;38;26;2;28
89;22.12.2014;2014;12;22;Maanantai;18;0;18;6;0;6
89;22.12.2014;2014;12;23;Maanantai;11;0;11;6;0;6
89;23.12.2014;2014;12;00;Tiistai;10;0;10;3;1;4
89;23.12.2014;2014;12;01;Tiistai;4;0;4;3;0;3
89;23.12.2014;2014;12;02;Tiistai;3;2;5;1;0;1
89;23.12.2014;2014;12;03;Tiistai;3;0;3;0;0;0
89;23.12.2014;2014;12;04;Tiistai;5;1;6;4;0;4
89;23.12.2014;2014;12;05;Tiistai;8;0;8;1;0;1
89;23.12.2014;2014;12;06;Tiistai;36;1;37;6;0;6
89;23.12.2014;2014;12;07;Tiistai;56;0;56;22;0;22
89;23.12.2014;2014;12;08;Tiistai;64;2;66;18;1;19
89;23.12.2014;2014;12;09;Tiistai;70;1;71;29;1;30
89;23.12.2014;2014;12;10;Tiistai;69;1;70;37;1;38
89;23.12.2014;2014;12;11;Tiistai;75;0;75;60;1;61
89;23.12.2014;2014;12;12;Tiistai;88;4;92;53;4;57
89;23.12.2014;2014;12;13;Tiistai;90;3;93;45;2;47
89;23.12.2014;2014;12;14;Tiistai;104;1;105;51;0;51
89;23.12.2014;2014;12;15;Tiistai;100;3;103;43;0;43
89;23.12.2014;2014;12;16;Tiistai;72;2;74;35;2;37
89;23.12.2014;2014;12;17;Tiistai;50;0;50;34;0;34
89;23.12.2014;2014;12;18;Tiistai;54;0;54;36;1;37
89;23.12.2014;2014;12;19;Tiistai;33;1;34;34;0;34
89;23.12.2014;2014;12;20;Tiistai;24;0;24;31;1;32
89;23.12.2014;2014;12;21;Tiistai;27;1;28;16;2;18
89;23.12.2014;2014;12;22;Tiistai;12;1;13;10;0;10
89;23.12.2014;2014;12;23;Tiistai;12;0;12;6;0;6
89;24.12.2014;2014;12;00;Keskiviikko;6;0;6;1;0;1
89;24.12.2014;2014;12;01;Keskiviikko;3;0;3;5;0;5
89;24.12.2014;2014;12;02;Keskiviikko;2;0;2;1;0;1
89;24.12.2014;2014;12;03;Keskiviikko;1;0;1;0;0;0
89;24.12.2014;2014;12;04;Keskiviikko;1;0;1;0;0;0
89;24.12.2014;2014;12;05;Keskiviikko;0;0;0;0;0;0
89;24.12.2014;2014;12;06;Keskiviikko;9;0;9;6;0;6
89;24.12.2014;2014;12;07;Keskiviikko;7;1;8;9;0;9
89;24.12.2014;2014;12;08;Keskiviikko;6;0;6;17;0;17
89;24.12.2014;2014;12;09;Keskiviikko;13;0;13;27;0;27
89;24.12.2014;2014;12;10;Keskiviikko;11;0;11;32;0;32
89;24.12.2014;2014;12;11;Keskiviikko;29;1;30;28;2;30
89;24.12.2014;2014;12;12;Keskiviikko;25;0;25;23;2;25
89;24.12.2014;2014;12;13;Keskiviikko;15;4;19;41;4;45
89;24.12.2014;2014;12;14;Keskiviikko;12;0;12;29;2;31
89;24.12.2014;2014;12;15;Keskiviikko;16;0;16;22;0;22
89;24.12.2014;2014;12;16;Keskiviikko;8;0;8;20;0;20
89;24.12.2014;2014;12;17;Keskiviikko;3;0;3;7;0;7
89;24.12.2014;2014;12;18;Keskiviikko;7;0;7;12;1;13
89;24.12.2014;2014;12;19;Keskiviikko;9;0;9;11;0;11
89;24.12.2014;2014;12;20;Keskiviikko;9;0;9;6;1;7
89;24.12.2014;2014;12;21;Keskiviikko;6;1;7;4;0;4
89;24.12.2014;2014;12;22;Keskiviikko;7;0;7;3;0;3
89;24.12.2014;2014;12;23;Keskiviikko;1;0;1;6;0;6
89;25.12.2014;2014;12;00;Torstai;4;0;4;4;0;4
89;25.12.2014;2014;12;01;Torstai;8;0;8;1;0;1
89;25.12.2014;2014;12;02;Torstai;2;0;2;1;0;1
89;25.12.2014;2014;12;03;Torstai;2;0;2;6;1;7
89;25.12.2014;2014;12;04;Torstai;2;0;2;0;0;0
89;25.12.2014;2014;12;05;Torstai;1;0;1;0;0;0
89;25.12.2014;2014;12;06;Torstai;5;0;5;3;0;3
89;25.12.2014;2014;12;07;Torstai;2;0;2;3;0;3
89;25.12.2014;2014;12;08;Torstai;2;0;2;10;0;10
89;25.12.2014;2014;12;09;Torstai;1;0;1;9;0;9
89;25.12.2014;2014;12;10;Torstai;6;0;6;24;1;25
89;25.12.2014;2014;12;11;Torstai;13;0;13;43;0;43
89;25.12.2014;2014;12;12;Torstai;21;0;21;57;1;58
89;25.12.2014;2014;12;13;Torstai;16;1;17;76;0;76
89;25.12.2014;2014;12;14;Torstai;17;1;18;70;0;70
89;25.12.2014;2014;12;15;Torstai;15;0;15;40;0;40
89;25.12.2014;2014;12;16;Torstai;6;0;6;42;0;42
89;25.12.2014;2014;12;17;Torstai;8;0;8;41;0;41
89;25.12.2014;2014;12;18;Torstai;7;0;7;39;0;39
89;25.12.2014;2014;12;19;Torstai;15;0;15;45;0;45
89;25.12.2014;2014;12;20;Torstai;10;0;10;25;0;25
89;25.12.2014;2014;12;21;Torstai;15;0;15;12;0;12
89;25.12.2014;2014;12;22;Torstai;7;0;7;11;0;11
89;25.12.2014;2014;12;23;Torstai;13;0;13;4;0;4
89;26.12.2014;2014;12;00;Perjantai;5;0;5;3;0;3
89;26.12.2014;2014;12;01;Perjantai;2;0;2;4;0;4
89;26.12.2014;2014;12;02;Perjantai;2;0;2;1;0;1
89;26.12.2014;2014;12;03;Perjantai;6;0;6;2;0;2
89;26.12.2014;2014;12;04;Perjantai;4;0;4;1;0;1
89;26.12.2014;2014;12;05;Perjantai;1;0;1;2;0;2
89;26.12.2014;2014;12;06;Perjantai;5;0;5;5;0;5
89;26.12.2014;2014;12;07;Perjantai;4;0;4;10;0;10
89;26.12.2014;2014;12;08;Perjantai;5;0;5;12;0;12
89;26.12.2014;2014;12;09;Perjantai;6;0;6;23;0;23
89;26.12.2014;2014;12;10;Perjantai;16;0;16;37;0;37
89;26.12.2014;2014;12;11;Perjantai;21;0;21;68;1;69
89;26.12.2014;2014;12;12;Perjantai;28;0;28;69;2;71
89;26.12.2014;2014;12;13;Perjantai;26;0;26;102;0;102
89;26.12.2014;2014;12;14;Perjantai;29;0;29;56;0;56
89;26.12.2014;2014;12;15;Perjantai;26;0;26;44;0;44
89;26.12.2014;2014;12;16;Perjantai;11;0;11;42;2;44
89;26.12.2014;2014;12;17;Perjantai;20;0;20;30;1;31
89;26.12.2014;2014;12;18;Perjantai;30;0;30;32;1;33
89;26.12.2014;2014;12;19;Perjantai;23;0;23;22;0;22
89;26.12.2014;2014;12;20;Perjantai;18;0;18;25;0;25
89;26.12.2014;2014;12;21;Perjantai;14;1;15;10;0;10
89;26.12.2014;2014;12;22;Perjantai;12;0;12;11;0;11
89;26.12.2014;2014;12;23;Perjantai;9;0;9;7;0;7
89;27.12.2014;2014;12;00;Lauantai;11;0;11;8;0;8
89;27.12.2014;2014;12;01;Lauantai;11;0;11;4;0;4
89;27.12.2014;2014;12;02;Lauantai;8;0;8;6;0;6
89;27.12.2014;2014;12;03;Lauantai;7;0;7;5;0;5
89;27.12.2014;2014;12;04;Lauantai;16;0;16;10;0;10
89;27.12.2014;2014;12;05;Lauantai;7;0;7;7;0;7
89;27.12.2014;2014;12;06;Lauantai;10;0;10;3;0;3
89;27.12.2014;2014;12;07;Lauantai;10;0;10;7;0;7
89;27.12.2014;2014;12;08;Lauantai;9;0;9;9;0;9
89;27.12.2014;2014;12;09;Lauantai;24;2;26;25;0;25
89;27.12.2014;2014;12;10;Lauantai;38;0;38;43;0;43
89;27.12.2014;2014;12;11;Lauantai;48;0;48;50;0;50
89;27.12.2014;2014;12;12;Lauantai;54;0;54;80;0;80
89;27.12.2014;2014;12;13;Lauantai;49;0;49;63;1;64
89;27.12.2014;2014;12;14;Lauantai;56;0;56;77;0;77
89;27.12.2014;2014;12;15;Lauantai;48;0;48;76;0;76
89;27.12.2014;2014;12;16;Lauantai;44;2;46;50;7;57
89;27.12.2014;2014;12;17;Lauantai;21;3;24;53;0;53
89;27.12.2014;2014;12;18;Lauantai;33;0;33;32;0;32
89;27.12.2014;2014;12;19;Lauantai;31;0;31;33;0;33
89;27.12.2014;2014;12;20;Lauantai;28;0;28;24;0;24
89;27.12.2014;2014;12;21;Lauantai;17;0;17;11;0;11
89;27.12.2014;2014;12;22;Lauantai;10;0;10;10;0;10
89;27.12.2014;2014;12;23;Lauantai;18;1;19;7;0;7
89;28.12.2014;2014;12;00;Sunnuntai;16;2;18;6;0;6
89;28.12.2014;2014;12;01;Sunnuntai;9;0;9;3;0;3
89;28.12.2014;2014;12;02;Sunnuntai;7;0;7;4;0;4
89;28.12.2014;2014;12;03;Sunnuntai;10;0;10;6;0;6
89;28.12.2014;2014;12;04;Sunnuntai;12;0;12;5;0;5
89;28.12.2014;2014;12;05;Sunnuntai;0;0;0;1;0;1
89;28.12.2014;2014;12;06;Sunnuntai;7;0;7;4;0;4
89;28.12.2014;2014;12;07;Sunnuntai;4;0;4;3;0;3
89;28.12.2014;2014;12;08;Sunnuntai;3;0;3;6;0;6
89;28.12.2014;2014;12;09;Sunnuntai;10;1;11;8;0;8
89;28.12.2014;2014;12;10;Sunnuntai;15;0;15;23;1;24
89;28.12.2014;2014;12;11;Sunnuntai;30;0;30;33;0;33
89;28.12.2014;2014;12;12;Sunnuntai;28;1;29;39;2;41
89;28.12.2014;2014;12;13;Sunnuntai;37;0;37;56;0;56
89;28.12.2014;2014;12;14;Sunnuntai;21;0;21;51;0;51
89;28.12.2014;2014;12;15;Sunnuntai;37;0;37;40;5;45
89;28.12.2014;2014;12;16;Sunnuntai;21;1;22;43;0;43
89;28.12.2014;2014;12;17;Sunnuntai;19;0;19;36;1;37
89;28.12.2014;2014;12;18;Sunnuntai;24;0;24;30;2;32
89;28.12.2014;2014;12;19;Sunnuntai;21;1;22;37;1;38
89;28.12.2014;2014;12;20;Sunnuntai;20;0;20;26;0;26
89;28.12.2014;2014;12;21;Sunnuntai;14;0;14;24;0;24
89;28.12.2014;2014;12;22;Sunnuntai;7;0;7;7;1;8
89;28.12.2014;2014;12;23;Sunnuntai;12;0;12;2;0;2
89;29.12.2014;2014;12;00;Maanantai;6;0;6;9;1;10
89;29.12.2014;2014;12;01;Maanantai;3;0;3;6;0;6
89;29.12.2014;2014;12;02;Maanantai;1;0;1;2;0;2
89;29.12.2014;2014;12;03;Maanantai;4;0;4;2;0;2
89;29.12.2014;2014;12;04;Maanantai;7;0;7;2;0;2
89;29.12.2014;2014;12;05;Maanantai;11;0;11;5;0;5
89;29.12.2014;2014;12;06;Maanantai;31;1;32;7;1;8
89;29.12.2014;2014;12;07;Maanantai;58;1;59;30;0;30
89;29.12.2014;2014;12;08;Maanantai;66;0;66;32;1;33
89;29.12.2014;2014;12;09;Maanantai;50;0;50;37;2;39
89;29.12.2014;2014;12;10;Maanantai;52;0;52;53;1;54
89;29.12.2014;2014;12;11;Maanantai;44;0;44;70;4;74
89;29.12.2014;2014;12;12;Maanantai;60;1;61;76;6;82
89;29.12.2014;2014;12;13;Maanantai;61;0;61;67;4;71
89;29.12.2014;2014;12;14;Maanantai;64;6;70;96;9;105
89;29.12.2014;2014;12;15;Maanantai;100;5;105;73;4;77
89;29.12.2014;2014;12;16;Maanantai;96;1;97;60;1;61
89;29.12.2014;2014;12;17;Maanantai;79;1;80;54;0;54
89;29.12.2014;2014;12;18;Maanantai;74;0;74;54;1;55
89;29.12.2014;2014;12;19;Maanantai;49;1;50;50;0;50
89;29.12.2014;2014;12;20;Maanantai;36;0;36;38;2;40
89;29.12.2014;2014;12;21;Maanantai;22;1;23;19;0;19
89;29.12.2014;2014;12;22;Maanantai;11;0;11;12;0;12
89;29.12.2014;2014;12;23;Maanantai;7;0;7;7;1;8
89;30.12.2014;2014;12;00;Tiistai;5;0;5;6;0;6
89;30.12.2014;2014;12;01;Tiistai;7;0;7;3;0;3
89;30.12.2014;2014;12;02;Tiistai;3;0;3;2;0;2
89;30.12.2014;2014;12;03;Tiistai;0;0;0;0;0;0
89;30.12.2014;2014;12;04;Tiistai;5;0;5;9;0;9
89;30.12.2014;2014;12;05;Tiistai;4;0;4;1;0;1
89;30.12.2014;2014;12;06;Tiistai;33;0;33;5;0;5
89;30.12.2014;2014;12;07;Tiistai;76;1;77;33;1;34
89;30.12.2014;2014;12;08;Tiistai;73;0;73;39;0;39
89;30.12.2014;2014;12;09;Tiistai;47;0;47;37;0;37
89;30.12.2014;2014;12;10;Tiistai;54;0;54;49;0;49
89;30.12.2014;2014;12;11;Tiistai;55;1;56;53;3;56
89;30.12.2014;2014;12;12;Tiistai;71;1;72;92;2;94
89;30.12.2014;2014;12;13;Tiistai;63;13;76;47;10;57
89;30.12.2014;2014;12;14;Tiistai;107;9;116;68;15;83
89;30.12.2014;2014;12;15;Tiistai;103;5;108;72;8;80
89;30.12.2014;2014;12;16;Tiistai;112;1;113;80;0;80
89;30.12.2014;2014;12;17;Tiistai;82;0;82;63;1;64
89;30.12.2014;2014;12;18;Tiistai;55;14;69;48;8;56
89;30.12.2014;2014;12;19;Tiistai;40;7;47;36;5;41
89;30.12.2014;2014;12;20;Tiistai;38;0;38;53;2;55
89;30.12.2014;2014;12;21;Tiistai;34;0;34;25;0;25
89;30.12.2014;2014;12;22;Tiistai;11;0;11;12;0;12
89;30.12.2014;2014;12;23;Tiistai;3;1;4;9;0;9
89;31.12.2014;2014;12;00;Keskiviikko;3;0;3;2;0;2
89;31.12.2014;2014;12;01;Keskiviikko;7;1;8;1;0;1
89;31.12.2014;2014;12;02;Keskiviikko;1;0;1;1;1;2
89;31.12.2014;2014;12;03;Keskiviikko;4;1;5;1;0;1
89;31.12.2014;2014;12;04;Keskiviikko;4;0;4;5;5;10
89;31.12.2014;2014;12;05;Keskiviikko;3;6;9;0;0;0
89;31.12.2014;2014;12;06;Keskiviikko;12;22;34;6;4;10
89;31.12.2014;2014;12;07;Keskiviikko;27;35;62;10;13;23
89;31.12.2014;2014;12;08;Keskiviikko;36;25;61;13;16;29
89;31.12.2014;2014;12;09;Keskiviikko;27;31;58;15;12;27
89;31.12.2014;2014;12;10;Keskiviikko;31;30;61;28;20;48
89;31.12.2014;2014;12;11;Keskiviikko;35;35;70;36;43;79
89;31.12.2014;2014;12;12;Keskiviikko;50;40;90;36;43;79
89;31.12.2014;2014;12;13;Keskiviikko;39;43;82;29;41;70
89;31.12.2014;2014;12;14;Keskiviikko;42;42;84;43;44;87
89;31.12.2014;2014;12;15;Keskiviikko;56;57;113;44;34;78
89;31.12.2014;2014;12;16;Keskiviikko;46;39;85;22;19;41
89;31.12.2014;2014;12;17;Keskiviikko;22;29;51;12;24;36
89;31.12.2014;2014;12;18;Keskiviikko;32;26;58;15;14;29
89;31.12.2014;2014;12;19;Keskiviikko;40;29;69;50;37;87
89;31.12.2014;2014;12;20;Keskiviikko;39;42;81;43;32;75
89;31.12.2014;2014;12;21;Keskiviikko;19;16;35;25;14;39
89;31.12.2014;2014;12;22;Keskiviikko;21;16;37;13;13;26
89;31.12.2014;2014;12;23;Keskiviikko;26;21;47;19;20;39
89;01.01.2015;2015;01;00;Torstai;21;22;43;18;20;38
89;01.01.2015;2015;01;01;Torstai;13;12;25;13;8;21
89;01.01.2015;2015;01;02;Torstai;12;16;28;13;13;26
89;01.01.2015;2015;01;03;Torstai;14;17;31;10;19;29
89;01.01.2015;2015;01;04;Torstai;11;11;22;20;27;47
89;01.01.2015;2015;01;05;Torstai;7;8;15;5;1;6
89;01.01.2015;2015;01;06;Torstai;9;8;17;5;5;10
89;01.01.2015;2015;01;07;Torstai;0;6;6;4;5;9
89;01.01.2015;2015;01;08;Torstai;3;2;5;5;4;9
89;01.01.2015;2015;01;09;Torstai;3;6;9;8;9;17
89;01.01.2015;2015;01;10;Torstai;8;6;14;8;13;21
89;01.01.2015;2015;01;11;Torstai;10;12;22;33;33;66
89;01.01.2015;2015;01;12;Torstai;15;12;27;29;55;84
89;01.01.2015;2015;01;13;Torstai;15;13;28;51;58;109
89;01.01.2015;2015;01;14;Torstai;15;19;34;52;32;84
89;01.01.2015;2015;01;15;Torstai;23;22;45;38;43;81
89;01.01.2015;2015;01;16;Torstai;10;14;24;34;35;69
89;01.01.2015;2015;01;17;Torstai;12;16;28;32;20;52
89;01.01.2015;2015;01;18;Torstai;17;12;29;42;34;76
89;01.01.2015;2015;01;19;Torstai;8;9;17;21;29;50
89;01.01.2015;2015;01;20;Torstai;18;13;31;11;16;27
89;01.01.2015;2015;01;21;Torstai;7;7;14;11;6;17
89;01.01.2015;2015;01;22;Torstai;7;6;13;6;4;10
89;01.01.2015;2015;01;23;Torstai;1;2;3;1;4;5
89;02.01.2015;2015;01;00;Perjantai;1;0;1;2;2;4
89;02.01.2015;2015;01;01;Perjantai;0;1;1;2;1;3
89;02.01.2015;2015;01;02;Perjantai;1;0;1;2;0;2
89;02.01.2015;2015;01;03;Perjantai;2;3;5;3;1;4
89;02.01.2015;2015;01;04;Perjantai;3;2;5;0;4;4
89;02.01.2015;2015;01;05;Perjantai;4;5;9;3;1;4
89;02.01.2015;2015;01;06;Perjantai;6;12;18;3;3;6
89;02.01.2015;2015;01;07;Perjantai;29;25;54;10;10;20
89;02.01.2015;2015;01;08;Perjantai;27;24;51;11;15;26
89;02.01.2015;2015;01;09;Perjantai;24;27;51;28;13;41
89;02.01.2015;2015;01;10;Perjantai;29;28;57;23;28;51
89;02.01.2015;2015;01;11;Perjantai;39;32;71;27;31;58
89;02.01.2015;2015;01;12;Perjantai;43;37;80;45;12;57
89;02.01.2015;2015;01;13;Perjantai;47;47;94;33;34;67
89;02.01.2015;2015;01;14;Perjantai;39;39;78;30;19;49
89;02.01.2015;2015;01;15;Perjantai;47;41;88;26;28;54
89;02.01.2015;2015;01;16;Perjantai;50;45;95;19;21;40
89;02.01.2015;2015;01;17;Perjantai;36;31;67;17;24;41
89;02.01.2015;2015;01;18;Perjantai;24;16;40;21;20;41
89;02.01.2015;2015;01;19;Perjantai;20;13;33;14;18;32
89;02.01.2015;2015;01;20;Perjantai;13;23;36;10;12;22
89;02.01.2015;2015;01;21;Perjantai;16;9;25;5;10;15
89;02.01.2015;2015;01;22;Perjantai;6;4;10;10;7;17
89;02.01.2015;2015;01;23;Perjantai;7;10;17;6;3;9
89;03.01.2015;2015;01;00;Lauantai;8;3;11;7;5;12
89;03.01.2015;2015;01;01;Lauantai;7;3;10;4;3;7
89;03.01.2015;2015;01;02;Lauantai;3;1;4;1;2;3
89;03.01.2015;2015;01;03;Lauantai;2;2;4;1;2;3
89;03.01.2015;2015;01;04;Lauantai;3;2;5;4;5;9
89;03.01.2015;2015;01;05;Lauantai;1;1;2;0;2;2
89;03.01.2015;2015;01;06;Lauantai;5;5;10;1;2;3
89;03.01.2015;2015;01;07;Lauantai;4;2;6;3;5;8
89;03.01.2015;2015;01;08;Lauantai;7;6;13;7;5;12
89;03.01.2015;2015;01;09;Lauantai;14;16;30;14;17;31
89;03.01.2015;2015;01;10;Lauantai;13;12;25;27;31;58
89;03.01.2015;2015;01;11;Lauantai;16;20;36;22;34;56
89;03.01.2015;2015;01;12;Lauantai;22;26;48;42;36;78
89;03.01.2015;2015;01;13;Lauantai;24;34;58;39;38;77
89;03.01.2015;2015;01;14;Lauantai;23;23;46;29;32;61
89;03.01.2015;2015;01;15;Lauantai;31;28;59;28;27;55
89;03.01.2015;2015;01;16;Lauantai;22;20;42;30;25;55
89;03.01.2015;2015;01;17;Lauantai;18;18;36;26;33;59
89;03.01.2015;2015;01;18;Lauantai;15;17;32;23;34;57
89;03.01.2015;2015;01;19;Lauantai;10;15;25;21;22;43
89;03.01.2015;2015;01;20;Lauantai;8;7;15;12;14;26
89;03.01.2015;2015;01;21;Lauantai;15;9;24;13;11;24
89;03.01.2015;2015;01;22;Lauantai;1;4;5;4;9;13
89;03.01.2015;2015;01;23;Lauantai;8;2;10;4;3;7
89;04.01.2015;2015;01;00;Sunnuntai;9;4;13;1;6;7
89;04.01.2015;2015;01;01;Sunnuntai;6;0;6;10;5;15
89;04.01.2015;2015;01;02;Sunnuntai;2;6;8;2;2;4
89;04.01.2015;2015;01;03;Sunnuntai;3;5;8;3;7;10
89;04.01.2015;2015;01;04;Sunnuntai;4;1;5;2;3;5
89;04.01.2015;2015;01;05;Sunnuntai;1;2;3;8;2;10
89;04.01.2015;2015;01;06;Sunnuntai;2;5;7;2;0;2
89;04.01.2015;2015;01;07;Sunnuntai;3;5;8;4;2;6
89;04.01.2015;2015;01;08;Sunnuntai;3;1;4;3;8;11
89;04.01.2015;2015;01;09;Sunnuntai;3;6;9;11;10;21
89;04.01.2015;2015;01;10;Sunnuntai;15;15;30;27;30;57
89;04.01.2015;2015;01;11;Sunnuntai;19;19;38;32;35;67
89;04.01.2015;2015;01;12;Sunnuntai;12;29;41;49;49;98
89;04.01.2015;2015;01;13;Sunnuntai;23;21;44;50;50;100
89;04.01.2015;2015;01;14;Sunnuntai;22;29;51;38;49;87
89;04.01.2015;2015;01;15;Sunnuntai;26;24;50;50;41;91
89;04.01.2015;2015;01;16;Sunnuntai;18;15;33;23;33;56
89;04.01.2015;2015;01;17;Sunnuntai;19;19;38;32;32;64
89;04.01.2015;2015;01;18;Sunnuntai;10;19;29;25;21;46
89;04.01.2015;2015;01;19;Sunnuntai;17;15;32;27;21;48
89;04.01.2015;2015;01;20;Sunnuntai;12;12;24;20;18;38
89;04.01.2015;2015;01;21;Sunnuntai;11;10;21;13;13;26
89;04.01.2015;2015;01;22;Sunnuntai;12;8;20;3;8;11
89;04.01.2015;2015;01;23;Sunnuntai;6;1;7;3;1;4
89;05.01.2015;2015;01;00;Maanantai;3;1;4;5;1;6
89;05.01.2015;2015;01;01;Maanantai;1;3;4;1;0;1
89;05.01.2015;2015;01;02;Maanantai;1;3;4;1;1;2
89;05.01.2015;2015;01;03;Maanantai;2;2;4;1;0;1
89;05.01.2015;2015;01;04;Maanantai;1;0;1;2;0;2
89;05.01.2015;2015;01;05;Maanantai;5;2;7;0;0;0
89;05.01.2015;2015;01;06;Maanantai;14;17;31;7;3;10
89;05.01.2015;2015;01;07;Maanantai;35;24;59;15;17;32
89;05.01.2015;2015;01;08;Maanantai;32;34;66;15;14;29
89;05.01.2015;2015;01;09;Maanantai;19;27;46;18;19;37
89;05.01.2015;2015;01;10;Maanantai;24;19;43;22;24;46
89;05.01.2015;2015;01;11;Maanantai;35;17;52;26;28;54
89;05.01.2015;2015;01;12;Maanantai;25;28;53;25;39;64
89;05.01.2015;2015;01;13;Maanantai;46;40;86;26;26;52
89;05.01.2015;2015;01;14;Maanantai;26;35;61;25;34;59
89;05.01.2015;2015;01;15;Maanantai;31;51;82;36;42;78
89;05.01.2015;2015;01;16;Maanantai;39;38;77;25;40;65
89;05.01.2015;2015;01;17;Maanantai;35;30;65;19;19;38
89;05.01.2015;2015;01;18;Maanantai;32;24;56;8;17;25
89;05.01.2015;2015;01;19;Maanantai;10;19;29;11;18;29
89;05.01.2015;2015;01;20;Maanantai;10;9;19;11;11;22
89;05.01.2015;2015;01;21;Maanantai;9;5;14;12;7;19
89;05.01.2015;2015;01;22;Maanantai;10;2;12;5;2;7
89;05.01.2015;2015;01;23;Maanantai;10;5;15;2;4;6
89;06.01.2015;2015;01;00;Tiistai;2;7;9;6;6;12
89;06.01.2015;2015;01;01;Tiistai;3;1;4;0;1;1
89;06.01.2015;2015;01;02;Tiistai;0;0;0;5;1;6
89;06.01.2015;2015;01;03;Tiistai;4;2;6;1;0;1
89;06.01.2015;2015;01;04;Tiistai;1;3;4;1;0;1
89;06.01.2015;2015;01;05;Tiistai;1;0;1;0;0;0
89;06.01.2015;2015;01;06;Tiistai;8;4;12;0;2;2
89;06.01.2015;2015;01;07;Tiistai;0;4;4;1;1;2
89;06.01.2015;2015;01;08;Tiistai;3;2;5;4;3;7
89;06.01.2015;2015;01;09;Tiistai;4;6;10;12;5;17
89;06.01.2015;2015;01;10;Tiistai;5;6;11;17;9;26
89;06.01.2015;2015;01;11;Tiistai;9;18;27;20;21;41
89;06.01.2015;2015;01;12;Tiistai;8;10;18;32;33;65
89;06.01.2015;2015;01;13;Tiistai;18;20;38;36;53;89
89;06.01.2015;2015;01;14;Tiistai;19;20;39;34;38;72
89;06.01.2015;2015;01;15;Tiistai;12;10;22;19;18;37
89;06.01.2015;2015;01;16;Tiistai;14;16;30;29;24;53
89;06.01.2015;2015;01;17;Tiistai;12;7;19;23;24;47
89;06.01.2015;2015;01;18;Tiistai;19;19;38;22;20;42
89;06.01.2015;2015;01;19;Tiistai;13;11;24;21;16;37
89;06.01.2015;2015;01;20;Tiistai;11;10;21;12;20;32
89;06.01.2015;2015;01;21;Tiistai;8;7;15;8;10;18
89;06.01.2015;2015;01;22;Tiistai;7;3;10;2;2;4
89;06.01.2015;2015;01;23;Tiistai;4;5;9;3;5;8
89;07.01.2015;2015;01;00;Keskiviikko;3;2;5;1;2;3
89;07.01.2015;2015;01;01;Keskiviikko;0;1;1;1;1;2
89;07.01.2015;2015;01;02;Keskiviikko;0;0;0;2;0;2
89;07.01.2015;2015;01;03;Keskiviikko;1;2;3;2;0;2
89;07.01.2015;2015;01;04;Keskiviikko;3;3;6;1;0;1
89;07.01.2015;2015;01;05;Keskiviikko;3;5;8;3;1;4
89;07.01.2015;2015;01;06;Keskiviikko;16;22;38;9;7;16
89;07.01.2015;2015;01;07;Keskiviikko;67;75;142;21;33;54
89;07.01.2015;2015;01;08;Keskiviikko;76;78;154;32;29;61
89;07.01.2015;2015;01;09;Keskiviikko;46;51;97;28;31;59
89;07.01.2015;2015;01;10;Keskiviikko;22;34;56;23;24;47
89;07.01.2015;2015;01;11;Keskiviikko;29;25;54;32;27;59
89;07.01.2015;2015;01;12;Keskiviikko;31;34;65;27;32;59
89;07.01.2015;2015;01;13;Keskiviikko;46;52;98;43;34;77
89;07.01.2015;2015;01;14;Keskiviikko;61;54;115;39;44;83
89;07.01.2015;2015;01;15;Keskiviikko;64;61;125;33;39;72
89;07.01.2015;2015;01;16;Keskiviikko;71;76;147;34;45;79
89;07.01.2015;2015;01;17;Keskiviikko;31;53;84;47;40;87
89;07.01.2015;2015;01;18;Keskiviikko;38;36;74;34;22;56
89;07.01.2015;2015;01;19;Keskiviikko;27;25;52;26;27;53
89;07.01.2015;2015;01;20;Keskiviikko;18;19;37;15;22;37
89;07.01.2015;2015;01;21;Keskiviikko;17;15;32;14;14;28
89;07.01.2015;2015;01;22;Keskiviikko;5;7;12;10;6;16
89;07.01.2015;2015;01;23;Keskiviikko;3;7;10;6;9;15
89;08.01.2015;2015;01;00;Torstai;3;2;5;4;2;6
89;08.01.2015;2015;01;01;Torstai;3;2;5;1;0;1
89;08.01.2015;2015;01;02;Torstai;1;0;1;1;0;1
89;08.01.2015;2015;01;03;Torstai;1;2;3;2;2;4
89;08.01.2015;2015;01;04;Torstai;3;0;3;0;1;1
89;08.01.2015;2015;01;05;Torstai;5;4;9;1;9;10
89;08.01.2015;2015;01;06;Torstai;26;23;49;8;7;15
89;08.01.2015;2015;01;07;Torstai;63;86;149;25;23;48
89;08.01.2015;2015;01;08;Torstai;96;100;196;26;38;64
89;08.01.2015;2015;01;09;Torstai;39;38;77;21;23;44
89;08.01.2015;2015;01;10;Torstai;22;31;53;21;29;50
89;08.01.2015;2015;01;11;Torstai;40;49;89;38;34;72
89;08.01.2015;2015;01;12;Torstai;52;34;86;30;24;54
89;08.01.2015;2015;01;13;Torstai;41;42;83;23;23;46
89;08.01.2015;2015;01;14;Torstai;54;62;116;40;34;74
89;08.01.2015;2015;01;15;Torstai;87;64;151;42;34;76
89;08.01.2015;2015;01;16;Torstai;94;96;190;41;29;70
89;08.01.2015;2015;01;17;Torstai;49;49;98;34;35;69
89;08.01.2015;2015;01;18;Torstai;41;30;71;38;32;70
89;08.01.2015;2015;01;19;Torstai;33;31;64;35;41;76
89;08.01.2015;2015;01;20;Torstai;31;27;58;15;15;30
89;08.01.2015;2015;01;21;Torstai;12;19;31;8;9;17
89;08.01.2015;2015;01;22;Torstai;10;10;20;8;11;19
89;08.01.2015;2015;01;23;Torstai;2;2;4;4;5;9
89;09.01.2015;2015;01;00;Perjantai;1;3;4;5;1;6
89;09.01.2015;2015;01;01;Perjantai;1;1;2;1;1;2
89;09.01.2015;2015;01;02;Perjantai;3;0;3;1;0;1
89;09.01.2015;2015;01;03;Perjantai;2;2;4;0;1;1
89;09.01.2015;2015;01;04;Perjantai;6;3;9;1;0;1
89;09.01.2015;2015;01;05;Perjantai;3;4;7;1;2;3
89;09.01.2015;2015;01;06;Perjantai;23;28;51;6;5;11
89;09.01.2015;2015;01;07;Perjantai;67;103;170;23;31;54
89;09.01.2015;2015;01;08;Perjantai;87;68;155;34;24;58
89;09.01.2015;2015;01;09;Perjantai;51;47;98;25;32;57
89;09.01.2015;2015;01;10;Perjantai;29;37;66;25;32;57
89;09.01.2015;2015;01;11;Perjantai;48;30;78;38;35;73
89;09.01.2015;2015;01;12;Perjantai;49;30;79;33;29;62
89;09.01.2015;2015;01;13;Perjantai;49;49;98;35;54;89
89;09.01.2015;2015;01;14;Perjantai;53;66;119;27;41;68
89;09.01.2015;2015;01;15;Perjantai;58;61;119;38;36;74
89;09.01.2015;2015;01;16;Perjantai;79;79;158;29;38;67
89;09.01.2015;2015;01;17;Perjantai;51;52;103;40;24;64
89;09.01.2015;2015;01;18;Perjantai;40;28;68;25;17;42
89;09.01.2015;2015;01;19;Perjantai;29;24;53;26;27;53
89;09.01.2015;2015;01;20;Perjantai;21;21;42;22;7;29
89;09.01.2015;2015;01;21;Perjantai;14;17;31;9;16;25
89;09.01.2015;2015;01;22;Perjantai;8;11;19;6;12;18
89;09.01.2015;2015;01;23;Perjantai;14;4;18;1;6;7
89;10.01.2015;2015;01;00;Lauantai;5;7;12;3;1;4
89;10.01.2015;2015;01;01;Lauantai;6;5;11;2;5;7
89;10.01.2015;2015;01;02;Lauantai;9;2;11;0;6;6
89;10.01.2015;2015;01;03;Lauantai;3;4;7;4;4;8
89;10.01.2015;2015;01;04;Lauantai;5;1;6;3;3;6
89;10.01.2015;2015;01;05;Lauantai;0;0;0;3;0;3
89;10.01.2015;2015;01;06;Lauantai;6;5;11;5;7;12
89;10.01.2015;2015;01;07;Lauantai;11;4;15;2;0;2
89;10.01.2015;2015;01;08;Lauantai;5;8;13;9;6;15
89;10.01.2015;2015;01;09;Lauantai;13;20;33;16;13;29
89;10.01.2015;2015;01;10;Lauantai;16;13;29;17;27;44
89;10.01.2015;2015;01;11;Lauantai;24;17;41;28;29;57
89;10.01.2015;2015;01;12;Lauantai;31;23;54;42;29;71
89;10.01.2015;2015;01;13;Lauantai;25;30;55;43;30;73
89;10.01.2015;2015;01;14;Lauantai;24;28;52;30;20;50
89;10.01.2015;2015;01;15;Lauantai;24;23;47;22;36;58
89;10.01.2015;2015;01;16;Lauantai;23;34;57;20;33;53
89;10.01.2015;2015;01;17;Lauantai;21;10;31;27;21;48
89;10.01.2015;2015;01;18;Lauantai;17;18;35;18;15;33
89;10.01.2015;2015;01;19;Lauantai;23;12;35;10;9;19
89;10.01.2015;2015;01;20;Lauantai;9;11;20;9;5;14
89;10.01.2015;2015;01;21;Lauantai;6;5;11;0;0;0
89;10.01.2015;2015;01;22;Lauantai;9;7;16;0;0;0
89;10.01.2015;2015;01;23;Lauantai;7;5;12;0;0;0
89;11.01.2015;2015;01;00;Sunnuntai;7;5;12;1;6;7
89;11.01.2015;2015;01;01;Sunnuntai;3;1;4;10;5;15
89;11.01.2015;2015;01;02;Sunnuntai;6;4;10;2;2;4
89;11.01.2015;2015;01;03;Sunnuntai;2;2;4;3;7;10
89;11.01.2015;2015;01;04;Sunnuntai;6;3;9;2;3;5
89;11.01.2015;2015;01;05;Sunnuntai;1;0;1;8;2;10
89;11.01.2015;2015;01;06;Sunnuntai;3;1;4;2;0;2
89;11.01.2015;2015;01;07;Sunnuntai;3;0;3;4;2;6
89;11.01.2015;2015;01;08;Sunnuntai;2;0;2;3;8;11
89;11.01.2015;2015;01;09;Sunnuntai;6;3;9;11;10;21
89;11.01.2015;2015;01;10;Sunnuntai;16;15;31;27;30;57
89;11.01.2015;2015;01;11;Sunnuntai;11;10;21;32;35;67
89;11.01.2015;2015;01;12;Sunnuntai;18;18;36;49;49;98
89;11.01.2015;2015;01;13;Sunnuntai;22;22;44;50;50;100
89;11.01.2015;2015;01;14;Sunnuntai;25;24;49;38;49;87
89;11.01.2015;2015;01;15;Sunnuntai;25;24;49;50;41;91
89;11.01.2015;2015;01;16;Sunnuntai;14;12;26;23;33;56
89;11.01.2015;2015;01;17;Sunnuntai;15;13;28;32;32;64
89;11.01.2015;2015;01;18;Sunnuntai;18;15;33;25;21;46
89;11.01.2015;2015;01;19;Sunnuntai;11;9;20;27;21;48
89;11.01.2015;2015;01;20;Sunnuntai;16;15;31;20;18;38
89;11.01.2015;2015;01;21;Sunnuntai;10;8;18;13;13;26
89;11.01.2015;2015;01;22;Sunnuntai;4;2;6;3;8;11
89;11.01.2015;2015;01;23;Sunnuntai;4;3;7;3;1;4
89;12.01.2015;2015;01;00;Maanantai;2;0;2;0;0;0
89;12.01.2015;2015;01;01;Maanantai;1;0;1;0;0;0
89;12.01.2015;2015;01;02;Maanantai;0;0;0;0;0;0
89;12.01.2015;2015;01;03;Maanantai;1;1;2;0;0;0
89;12.01.2015;2015;01;04;Maanantai;3;1;4;0;0;0
89;12.01.2015;2015;01;05;Maanantai;7;5;12;0;0;0
89;12.01.2015;2015;01;06;Maanantai;22;21;43;0;0;0
89;12.01.2015;2015;01;07;Maanantai;64;62;126;0;0;0
89;12.01.2015;2015;01;08;Maanantai;64;64;128;0;0;0
89;12.01.2015;2015;01;09;Maanantai;39;36;75;0;0;0
89;12.01.2015;2015;01;10;Maanantai;28;25;53;0;0;0
89;12.01.2015;2015;01;11;Maanantai;28;27;55;0;0;0
89;12.01.2015;2015;01;12;Maanantai;29;28;57;0;0;0
89;12.01.2015;2015;01;13;Maanantai;25;21;46;0;0;0
89;12.01.2015;2015;01;14;Maanantai;35;35;70;0;0;0
89;12.01.2015;2015;01;15;Maanantai;54;51;105;0;0;0
89;12.01.2015;2015;01;16;Maanantai;75;72;147;0;0;0
89;12.01.2015;2015;01;17;Maanantai;35;33;68;0;0;0
89;12.01.2015;2015;01;18;Maanantai;27;24;51;0;0;0
89;12.01.2015;2015;01;19;Maanantai;21;18;39;0;0;0
89;12.01.2015;2015;01;20;Maanantai;16;16;32;0;0;0
89;12.01.2015;2015;01;21;Maanantai;13;12;25;0;0;0
89;12.01.2015;2015;01;22;Maanantai;5;2;7;0;0;0
89;12.01.2015;2015;01;23;Maanantai;2;1;3;0;0;0
89;13.01.2015;2015;01;00;Tiistai;2;0;2;0;0;0
89;13.01.2015;2015;01;01;Tiistai;1;0;1;0;0;0
89;13.01.2015;2015;01;02;Tiistai;0;0;0;0;0;0
89;13.01.2015;2015;01;03;Tiistai;1;0;1;0;0;0
89;13.01.2015;2015;01;04;Tiistai;1;0;1;0;0;0
89;13.01.2015;2015;01;05;Tiistai;5;3;8;0;0;0
89;13.01.2015;2015;01;06;Tiistai;19;18;37;0;0;0
89;13.01.2015;2015;01;07;Tiistai;79;77;156;0;0;0
89;13.01.2015;2015;01;08;Tiistai;77;77;154;0;0;0
89;13.01.2015;2015;01;09;Tiistai;48;47;95;0;0;0
89;13.01.2015;2015;01;10;Tiistai;34;32;66;0;0;0
89;13.01.2015;2015;01;11;Tiistai;28;26;54;0;0;0
89;13.01.2015;2015;01;12;Tiistai;31;28;59;0;0;0
89;13.01.2015;2015;01;13;Tiistai;35;32;67;0;0;0
89;13.01.2015;2015;01;14;Tiistai;64;61;125;0;0;0
89;13.01.2015;2015;01;15;Tiistai;78;76;154;0;0;0
89;13.01.2015;2015;01;16;Tiistai;79;77;156;0;0;0
89;13.01.2015;2015;01;17;Tiistai;53;52;105;0;0;0
89;13.01.2015;2015;01;18;Tiistai;35;33;68;0;0;0
89;13.01.2015;2015;01;19;Tiistai;34;33;67;0;0;0
89;13.01.2015;2015;01;20;Tiistai;29;28;57;0;0;0
89;13.01.2015;2015;01;21;Tiistai;14;12;26;0;0;0
89;13.01.2015;2015;01;22;Tiistai;9;6;15;0;0;0
89;13.01.2015;2015;01;23;Tiistai;3;1;4;0;0;0
89;14.01.2015;2015;01;00;Keskiviikko;4;1;5;0;0;0
89;14.01.2015;2015;01;01;Keskiviikko;3;2;5;0;0;0
89;14.01.2015;2015;01;02;Keskiviikko;1;0;1;0;0;0
89;14.01.2015;2015;01;03;Keskiviikko;1;0;1;0;0;0
89;14.01.2015;2015;01;04;Keskiviikko;2;0;2;0;0;0
89;14.01.2015;2015;01;05;Keskiviikko;6;3;9;0;0;0
89;14.01.2015;2015;01;06;Keskiviikko;19;16;35;0;0;0
89;14.01.2015;2015;01;07;Keskiviikko;84;82;166;0;0;0
89;14.01.2015;2015;01;08;Keskiviikko;74;72;146;0;0;0
89;14.01.2015;2015;01;09;Keskiviikko;46;46;92;0;0;0
89;14.01.2015;2015;01;10;Keskiviikko;39;37;76;0;0;0
89;14.01.2015;2015;01;11;Keskiviikko;35;34;69;0;0;0
89;14.01.2015;2015;01;12;Keskiviikko;41;39;80;0;0;0
89;14.01.2015;2015;01;13;Keskiviikko;47;45;92;0;0;0
89;14.01.2015;2015;01;14;Keskiviikko;60;57;117;0;0;0
89;14.01.2015;2015;01;15;Keskiviikko;70;69;139;0;0;0
89;14.01.2015;2015;01;16;Keskiviikko;89;87;176;0;0;0
89;14.01.2015;2015;01;17;Keskiviikko;51;50;101;0;0;0
89;14.01.2015;2015;01;18;Keskiviikko;35;33;68;0;0;0
89;14.01.2015;2015;01;19;Keskiviikko;24;22;46;0;0;0
89;14.01.2015;2015;01;20;Keskiviikko;16;14;30;0;0;0
89;14.01.2015;2015;01;21;Keskiviikko;12;11;23;0;0;0
89;14.01.2015;2015;01;22;Keskiviikko;5;3;8;0;0;0
89;14.01.2015;2015;01;23;Keskiviikko;5;3;8;0;0;0
89;15.01.2015;2015;01;00;Torstai;2;0;2;0;0;0
89;15.01.2015;2015;01;01;Torstai;2;1;3;0;0;0
89;15.01.2015;2015;01;02;Torstai;2;0;2;0;0;0
89;15.01.2015;2015;01;03;Torstai;0;0;0;0;0;0
89;15.01.2015;2015;01;04;Torstai;5;2;7;0;0;0
89;15.01.2015;2015;01;05;Torstai;5;2;7;0;0;0
89;15.01.2015;2015;01;06;Torstai;24;22;46;0;0;0
89;15.01.2015;2015;01;07;Torstai;84;82;166;0;0;0
89;15.01.2015;2015;01;08;Torstai;76;74;150;0;0;0
89;15.01.2015;2015;01;09;Torstai;50;49;99;0;0;0
89;15.01.2015;2015;01;10;Torstai;42;39;81;0;0;0
89;15.01.2015;2015;01;11;Torstai;42;41;83;0;0;0
89;15.01.2015;2015;01;12;Torstai;42;40;82;0;0;0
89;15.01.2015;2015;01;13;Torstai;47;44;91;0;0;0
89;15.01.2015;2015;01;14;Torstai;71;69;140;0;0;0
89;15.01.2015;2015;01;15;Torstai;84;81;165;0;0;0
89;15.01.2015;2015;01;16;Torstai;105;103;208;0;0;0
89;15.01.2015;2015;01;17;Torstai;66;63;129;0;0;0
89;15.01.2015;2015;01;18;Torstai;48;46;94;0;0;0
89;15.01.2015;2015;01;19;Torstai;41;40;81;0;0;0
89;15.01.2015;2015;01;20;Torstai;34;31;65;0;0;0
89;15.01.2015;2015;01;21;Torstai;26;25;51;0;0;0
89;15.01.2015;2015;01;22;Torstai;12;9;21;0;0;0
89;15.01.2015;2015;01;23;Torstai;4;4;8;0;0;0
89;16.01.2015;2015;01;00;Perjantai;3;1;4;0;0;0
89;16.01.2015;2015;01;01;Perjantai;1;1;2;0;0;0
89;16.01.2015;2015;01;02;Perjantai;3;2;5;0;0;0
89;16.01.2015;2015;01;03;Perjantai;3;3;6;0;0;0
89;16.01.2015;2015;01;04;Perjantai;3;0;3;0;0;0
89;16.01.2015;2015;01;05;Perjantai;3;2;5;0;0;0
89;16.01.2015;2015;01;06;Perjantai;26;25;51;0;0;0
89;16.01.2015;2015;01;07;Perjantai;60;57;117;0;0;0
89;16.01.2015;2015;01;08;Perjantai;71;68;139;0;0;0
89;16.01.2015;2015;01;09;Perjantai;35;34;69;0;0;0
89;16.01.2015;2015;01;10;Perjantai;26;26;52;0;0;0
89;16.01.2015;2015;01;11;Perjantai;38;34;72;0;0;0
89;16.01.2015;2015;01;12;Perjantai;42;36;78;0;0;0
89;16.01.2015;2015;01;13;Perjantai;44;46;90;0;0;0
89;16.01.2015;2015;01;14;Perjantai;51;43;94;0;0;0
89;16.01.2015;2015;01;15;Perjantai;79;63;142;0;0;0
89;16.01.2015;2015;01;16;Perjantai;71;47;118;0;0;0
89;16.01.2015;2015;01;17;Perjantai;48;43;91;0;0;0
89;16.01.2015;2015;01;18;Perjantai;31;36;67;0;0;0
89;16.01.2015;2015;01;19;Perjantai;34;37;71;0;0;0
89;16.01.2015;2015;01;20;Perjantai;20;22;42;0;0;0
89;16.01.2015;2015;01;21;Perjantai;18;14;32;0;0;0
89;16.01.2015;2015;01;22;Perjantai;14;12;26;0;0;0
89;16.01.2015;2015;01;23;Perjantai;11;6;17;0;0;0
89;17.01.2015;2015;01;00;Lauantai;7;3;10;0;0;0
89;17.01.2015;2015;01;01;Lauantai;5;10;15;0;0;0
89;17.01.2015;2015;01;02;Lauantai;4;2;6;0;0;0
89;17.01.2015;2015;01;03;Lauantai;5;8;13;0;0;0
89;17.01.2015;2015;01;04;Lauantai;5;2;7;0;0;0
89;17.01.2015;2015;01;05;Lauantai;1;4;5;0;0;0
89;17.01.2015;2015;01;06;Lauantai;6;3;9;0;0;0
89;17.01.2015;2015;01;07;Lauantai;3;8;11;0;0;0
89;17.01.2015;2015;01;08;Lauantai;9;10;19;0;0;0
89;17.01.2015;2015;01;09;Lauantai;15;16;31;0;0;0
89;17.01.2015;2015;01;10;Lauantai;27;13;40;0;0;0
89;17.01.2015;2015;01;11;Lauantai;18;19;37;0;0;0
89;17.01.2015;2015;01;12;Lauantai;15;29;44;0;0;0
89;17.01.2015;2015;01;13;Lauantai;24;23;47;0;0;0
89;17.01.2015;2015;01;14;Lauantai;32;25;57;0;0;0
89;17.01.2015;2015;01;15;Lauantai;38;27;65;0;0;0
89;17.01.2015;2015;01;16;Lauantai;25;24;49;0;0;0
89;17.01.2015;2015;01;17;Lauantai;16;24;40;0;0;0
89;17.01.2015;2015;01;18;Lauantai;24;16;40;0;0;0
89;17.01.2015;2015;01;19;Lauantai;21;12;33;0;0;0
89;17.01.2015;2015;01;20;Lauantai;12;17;29;0;0;0
89;17.01.2015;2015;01;21;Lauantai;7;5;12;0;0;0
89;17.01.2015;2015;01;22;Lauantai;4;9;13;0;0;0
89;17.01.2015;2015;01;23;Lauantai;8;11;19;0;0;0
89;18.01.2015;2015;01;00;Sunnuntai;14;13;27;0;0;0
89;18.01.2015;2015;01;01;Sunnuntai;2;10;12;0;0;0
89;18.01.2015;2015;01;02;Sunnuntai;1;3;4;0;0;0
89;18.01.2015;2015;01;03;Sunnuntai;4;4;8;0;0;0
89;18.01.2015;2015;01;04;Sunnuntai;4;3;7;0;0;0
89;18.01.2015;2015;01;05;Sunnuntai;3;1;4;0;0;0
89;18.01.2015;2015;01;06;Sunnuntai;1;7;8;0;0;0
89;18.01.2015;2015;01;07;Sunnuntai;2;4;6;0;0;0
89;18.01.2015;2015;01;08;Sunnuntai;1;0;1;0;0;0
89;18.01.2015;2015;01;09;Sunnuntai;4;5;9;0;0;0
89;18.01.2015;2015;01;10;Sunnuntai;10;9;19;0;0;0
89;18.01.2015;2015;01;11;Sunnuntai;21;19;40;0;0;0
89;18.01.2015;2015;01;12;Sunnuntai;22;34;56;0;0;0
89;18.01.2015;2015;01;13;Sunnuntai;24;22;46;0;0;0
89;18.01.2015;2015;01;14;Sunnuntai;20;35;55;0;0;0
89;18.01.2015;2015;01;15;Sunnuntai;27;26;53;0;0;0
89;18.01.2015;2015;01;16;Sunnuntai;24;25;49;0;0;0
89;18.01.2015;2015;01;17;Sunnuntai;12;18;30;0;0;0
89;18.01.2015;2015;01;18;Sunnuntai;27;19;46;0;0;0
89;18.01.2015;2015;01;19;Sunnuntai;20;18;38;0;0;0
89;18.01.2015;2015;01;20;Sunnuntai;11;14;25;0;0;0
89;18.01.2015;2015;01;21;Sunnuntai;14;13;27;0;0;0
89;18.01.2015;2015;01;22;Sunnuntai;7;6;13;0;0;0
89;18.01.2015;2015;01;23;Sunnuntai;2;2;4;0;0;0
89;19.01.2015;2015;01;00;Maanantai;0;3;3;4;1;5
89;19.01.2015;2015;01;01;Maanantai;2;1;3;0;2;2
89;19.01.2015;2015;01;02;Maanantai;0;0;0;0;0;0
89;19.01.2015;2015;01;03;Maanantai;0;1;1;0;0;0
89;19.01.2015;2015;01;04;Maanantai;5;7;12;0;0;0
89;19.01.2015;2015;01;05;Maanantai;7;7;14;2;0;2
89;19.01.2015;2015;01;06;Maanantai;10;22;32;4;12;16
89;19.01.2015;2015;01;07;Maanantai;59;70;129;30;33;63
89;19.01.2015;2015;01;08;Maanantai;77;72;149;32;37;69
89;19.01.2015;2015;01;09;Maanantai;64;65;129;36;39;75
89;19.01.2015;2015;01;10;Maanantai;42;23;65;37;15;52
89;19.01.2015;2015;01;11;Maanantai;37;32;69;34;26;60
89;19.01.2015;2015;01;12;Maanantai;49;43;92;33;29;62
89;19.01.2015;2015;01;13;Maanantai;46;33;79;52;37;89
89;19.01.2015;2015;01;14;Maanantai;47;53;100;37;31;68
89;19.01.2015;2015;01;15;Maanantai;92;56;148;45;38;83
89;19.01.2015;2015;01;16;Maanantai;110;56;166;54;36;90
89;19.01.2015;2015;01;17;Maanantai;65;42;107;41;27;68
89;19.01.2015;2015;01;18;Maanantai;30;39;69;30;23;53
89;19.01.2015;2015;01;19;Maanantai;35;23;58;30;13;43
89;19.01.2015;2015;01;20;Maanantai;29;23;52;26;17;43
89;19.01.2015;2015;01;21;Maanantai;25;20;45;5;13;18
89;19.01.2015;2015;01;22;Maanantai;5;5;10;6;4;10
89;19.01.2015;2015;01;23;Maanantai;0;3;3;2;1;3
89;20.01.2015;2015;01;00;Tiistai;0;2;2;1;1;2
89;20.01.2015;2015;01;01;Tiistai;0;0;0;1;0;1
89;20.01.2015;2015;01;02;Tiistai;0;0;0;0;0;0
89;20.01.2015;2015;01;03;Tiistai;1;0;1;0;0;0
89;20.01.2015;2015;01;04;Tiistai;3;2;5;0;0;0
89;20.01.2015;2015;01;05;Tiistai;3;3;6;2;1;3
89;20.01.2015;2015;01;06;Tiistai;19;12;31;10;6;16
89;20.01.2015;2015;01;07;Tiistai;73;56;129;44;34;78
89;20.01.2015;2015;01;08;Tiistai;71;64;135;36;25;61
89;20.01.2015;2015;01;09;Tiistai;61;25;86;29;26;55
89;20.01.2015;2015;01;10;Tiistai;37;18;55;23;11;34
89;20.01.2015;2015;01;11;Tiistai;26;20;46;29;29;58
89;20.01.2015;2015;01;12;Tiistai;28;21;49;29;24;53
89;20.01.2015;2015;01;13;Tiistai;40;24;64;38;19;57
89;20.01.2015;2015;01;14;Tiistai;50;31;81;41;35;76
89;20.01.2015;2015;01;15;Tiistai;67;37;104;41;36;77
89;20.01.2015;2015;01;16;Tiistai;83;46;129;44;37;81
89;20.01.2015;2015;01;17;Tiistai;42;30;72;36;29;65
89;20.01.2015;2015;01;18;Tiistai;37;19;56;27;14;41
89;20.01.2015;2015;01;19;Tiistai;31;20;51;26;19;45
89;20.01.2015;2015;01;20;Tiistai;13;3;16;29;11;40
89;20.01.2015;2015;01;21;Tiistai;13;14;27;8;14;22
89;20.01.2015;2015;01;22;Tiistai;13;4;17;6;2;8
89;20.01.2015;2015;01;23;Tiistai;4;4;8;3;0;3
89;21.01.2015;2015;01;00;Keskiviikko;4;1;5;1;1;2
89;21.01.2015;2015;01;01;Keskiviikko;0;2;2;3;2;5
89;21.01.2015;2015;01;02;Keskiviikko;0;0;0;0;2;2
89;21.01.2015;2015;01;03;Keskiviikko;0;0;0;0;0;0
89;21.01.2015;2015;01;04;Keskiviikko;1;2;3;0;0;0
89;21.01.2015;2015;01;05;Keskiviikko;6;3;9;1;1;2
89;21.01.2015;2015;01;06;Keskiviikko;16;14;30;13;7;20
89;21.01.2015;2015;01;07;Keskiviikko;63;64;127;26;40;66
89;21.01.2015;2015;01;08;Keskiviikko;82;80;162;24;37;61
89;21.01.2015;2015;01;09;Keskiviikko;42;36;78;28;31;59
89;21.01.2015;2015;01;10;Keskiviikko;26;31;57;22;28;50
89;21.01.2015;2015;01;11;Keskiviikko;29;23;52;30;41;71
89;21.01.2015;2015;01;12;Keskiviikko;28;33;61;39;33;72
89;21.01.2015;2015;01;13;Keskiviikko;43;37;80;28;35;63
89;21.01.2015;2015;01;14;Keskiviikko;54;47;101;39;43;82
89;21.01.2015;2015;01;15;Keskiviikko;65;60;125;41;45;86
89;21.01.2015;2015;01;16;Keskiviikko;73;63;136;48;50;98
89;21.01.2015;2015;01;17;Keskiviikko;48;58;106;39;40;79
89;21.01.2015;2015;01;18;Keskiviikko;30;24;54;43;40;83
89;21.01.2015;2015;01;19;Keskiviikko;32;23;55;34;28;62
89;21.01.2015;2015;01;20;Keskiviikko;27;13;40;35;18;53
89;21.01.2015;2015;01;21;Keskiviikko;17;12;29;14;13;27
89;21.01.2015;2015;01;22;Keskiviikko;15;7;22;4;4;8
89;21.01.2015;2015;01;23;Keskiviikko;8;2;10;1;2;3
89;22.01.2015;2015;01;00;Torstai;1;1;2;2;0;2
89;22.01.2015;2015;01;01;Torstai;2;1;3;2;1;3
89;22.01.2015;2015;01;02;Torstai;0;0;0;1;1;2
89;22.01.2015;2015;01;03;Torstai;1;1;2;4;1;5
89;22.01.2015;2015;01;04;Torstai;2;0;2;2;1;3
89;22.01.2015;2015;01;05;Torstai;4;2;6;0;5;5
89;22.01.2015;2015;01;06;Torstai;21;13;34;10;10;20
89;22.01.2015;2015;01;07;Torstai;60;59;119;36;38;74
89;22.01.2015;2015;01;08;Torstai;60;67;127;46;39;85
89;22.01.2015;2015;01;09;Torstai;58;37;95;26;15;41
89;22.01.2015;2015;01;10;Torstai;43;18;61;21;19;40
89;22.01.2015;2015;01;11;Torstai;44;18;62;27;24;51
89;22.01.2015;2015;01;12;Torstai;46;25;71;34;20;54
89;22.01.2015;2015;01;13;Torstai;44;27;71;33;24;57
89;22.01.2015;2015;01;14;Torstai;69;15;84;66;22;88
89;22.01.2015;2015;01;15;Torstai;95;53;148;35;33;68
89;22.01.2015;2015;01;16;Torstai;76;61;137;51;41;92
89;22.01.2015;2015;01;17;Torstai;36;32;68;30;29;59
89;22.01.2015;2015;01;18;Torstai;42;27;69;40;30;70
89;22.01.2015;2015;01;19;Torstai;22;18;40;31;19;50
89;22.01.2015;2015;01;20;Torstai;26;10;36;11;11;22
89;22.01.2015;2015;01;21;Torstai;18;16;34;8;7;15
89;22.01.2015;2015;01;22;Torstai;8;6;14;3;4;7
89;22.01.2015;2015;01;23;Torstai;6;3;9;2;1;3
89;23.01.2015;2015;01;00;Perjantai;2;1;3;1;2;3
89;23.01.2015;2015;01;01;Perjantai;2;1;3;0;1;1
89;23.01.2015;2015;01;02;Perjantai;3;0;3;1;0;1
89;23.01.2015;2015;01;03;Perjantai;3;0;3;0;0;0
89;23.01.2015;2015;01;04;Perjantai;1;1;2;1;2;3
89;23.01.2015;2015;01;05;Perjantai;2;1;3;1;1;2
89;23.01.2015;2015;01;06;Perjantai;15;11;26;17;7;24
89;23.01.2015;2015;01;07;Perjantai;52;38;90;31;32;63
89;23.01.2015;2015;01;08;Perjantai;51;48;99;30;38;68
89;23.01.2015;2015;01;09;Perjantai;38;37;75;26;18;44
89;23.01.2015;2015;01;10;Perjantai;28;27;55;30;11;41
89;23.01.2015;2015;01;11;Perjantai;32;26;58;22;26;48
89;23.01.2015;2015;01;12;Perjantai;30;22;52;29;27;56
89;23.01.2015;2015;01;13;Perjantai;18;32;50;34;25;59
89;23.01.2015;2015;01;14;Perjantai;55;44;99;35;30;65
89;23.01.2015;2015;01;15;Perjantai;64;63;127;33;32;65
89;23.01.2015;2015;01;16;Perjantai;48;56;104;35;33;68
89;23.01.2015;2015;01;17;Perjantai;28;46;74;30;33;63
89;23.01.2015;2015;01;18;Perjantai;25;16;41;19;22;41
89;23.01.2015;2015;01;19;Perjantai;18;15;33;27;30;57
89;23.01.2015;2015;01;20;Perjantai;18;14;32;13;13;26
89;23.01.2015;2015;01;21;Perjantai;16;15;31;9;11;20
89;23.01.2015;2015;01;22;Perjantai;12;6;18;5;7;12
89;23.01.2015;2015;01;23;Perjantai;5;8;13;2;7;9
89;24.01.2015;2015;01;00;Lauantai;2;3;5;3;5;8
89;24.01.2015;2015;01;01;Lauantai;5;6;11;2;5;7
89;24.01.2015;2015;01;02;Lauantai;2;3;5;5;5;10
89;24.01.2015;2015;01;03;Lauantai;2;4;6;2;4;6
89;24.01.2015;2015;01;04;Lauantai;3;4;7;2;3;5
89;24.01.2015;2015;01;05;Lauantai;1;2;3;3;0;3
89;24.01.2015;2015;01;06;Lauantai;5;6;11;1;2;3
89;24.01.2015;2015;01;07;Lauantai;7;4;11;3;4;7
89;24.01.2015;2015;01;08;Lauantai;13;8;21;7;8;15
89;24.01.2015;2015;01;09;Lauantai;11;12;23;8;12;20
89;24.01.2015;2015;01;10;Lauantai;16;12;28;27;21;48
89;24.01.2015;2015;01;11;Lauantai;34;20;54;31;35;66
89;24.01.2015;2015;01;12;Lauantai;28;26;54;33;34;67
89;24.01.2015;2015;01;13;Lauantai;41;18;59;53;36;89
89;24.01.2015;2015;01;14;Lauantai;37;32;69;38;26;64
89;24.01.2015;2015;01;15;Lauantai;33;25;58;41;32;73
89;24.01.2015;2015;01;16;Lauantai;18;20;38;35;30;65
89;24.01.2015;2015;01;17;Lauantai;12;20;32;33;22;55
89;24.01.2015;2015;01;18;Lauantai;17;18;35;33;21;54
89;24.01.2015;2015;01;19;Lauantai;18;9;27;22;14;36
89;24.01.2015;2015;01;20;Lauantai;17;12;29;18;19;37
89;24.01.2015;2015;01;21;Lauantai;16;7;23;14;13;27
89;24.01.2015;2015;01;22;Lauantai;11;6;17;15;11;26
89;24.01.2015;2015;01;23;Lauantai;12;4;16;7;6;13
89;25.01.2015;2015;01;00;Sunnuntai;2;5;7;12;5;17
89;25.01.2015;2015;01;01;Sunnuntai;8;4;12;9;4;13
89;25.01.2015;2015;01;02;Sunnuntai;8;3;11;8;6;14
89;25.01.2015;2015;01;03;Sunnuntai;6;2;8;8;7;15
89;25.01.2015;2015;01;04;Sunnuntai;3;1;4;7;9;16
89;25.01.2015;2015;01;05;Sunnuntai;0;6;6;7;6;13
89;25.01.2015;2015;01;06;Sunnuntai;6;3;9;4;1;5
89;25.01.2015;2015;01;07;Sunnuntai;3;3;6;3;4;7
89;25.01.2015;2015;01;08;Sunnuntai;5;1;6;10;8;18
89;25.01.2015;2015;01;09;Sunnuntai;9;13;22;21;14;35
89;25.01.2015;2015;01;10;Sunnuntai;3;8;11;27;29;56
89;25.01.2015;2015;01;11;Sunnuntai;13;14;27;36;46;82
89;25.01.2015;2015;01;12;Sunnuntai;25;24;49;52;45;97
89;25.01.2015;2015;01;13;Sunnuntai;19;26;45;76;54;130
89;25.01.2015;2015;01;14;Sunnuntai;29;30;59;65;68;133
89;25.01.2015;2015;01;15;Sunnuntai;24;24;48;33;38;71
89;25.01.2015;2015;01;16;Sunnuntai;18;30;48;39;31;70
89;25.01.2015;2015;01;17;Sunnuntai;18;22;40;25;41;66
89;25.01.2015;2015;01;18;Sunnuntai;12;17;29;39;34;73
89;25.01.2015;2015;01;19;Sunnuntai;21;14;35;17;30;47
89;25.01.2015;2015;01;20;Sunnuntai;11;10;21;16;23;39
89;25.01.2015;2015;01;21;Sunnuntai;8;13;21;9;13;22
89;25.01.2015;2015;01;22;Sunnuntai;4;4;8;8;4;12
89;25.01.2015;2015;01;23;Sunnuntai;5;1;6;4;2;6
89;26.01.2015;2015;01;00;Maanantai;2;2;4;2;1;3
89;26.01.2015;2015;01;01;Maanantai;1;0;1;1;1;2
89;26.01.2015;2015;01;02;Maanantai;0;0;0;0;1;1
89;26.01.2015;2015;01;03;Maanantai;0;2;2;2;1;3
89;26.01.2015;2015;01;04;Maanantai;2;0;2;3;2;5
89;26.01.2015;2015;01;05;Maanantai;6;4;10;1;2;3
89;26.01.2015;2015;01;06;Maanantai;15;21;36;5;6;11
89;26.01.2015;2015;01;07;Maanantai;78;71;149;30;27;57
89;26.01.2015;2015;01;08;Maanantai;93;85;178;25;44;69
89;26.01.2015;2015;01;09;Maanantai;45;44;89;32;36;68
89;26.01.2015;2015;01;10;Maanantai;45;40;85;23;35;58
89;26.01.2015;2015;01;11;Maanantai;42;38;80;37;40;77
89;26.01.2015;2015;01;12;Maanantai;38;42;80;30;37;67
89;26.01.2015;2015;01;13;Maanantai;38;42;80;35;24;59
89;26.01.2015;2015;01;14;Maanantai;55;52;107;37;47;84
89;26.01.2015;2015;01;15;Maanantai;69;79;148;43;57;100
89;26.01.2015;2015;01;16;Maanantai;80;82;162;45;40;85
89;26.01.2015;2015;01;17;Maanantai;42;44;86;40;30;70
89;26.01.2015;2015;01;18;Maanantai;48;26;74;32;31;63
89;26.01.2015;2015;01;19;Maanantai;19;24;43;21;26;47
89;26.01.2015;2015;01;20;Maanantai;18;23;41;25;19;44
89;26.01.2015;2015;01;21;Maanantai;12;14;26;12;16;28
89;26.01.2015;2015;01;22;Maanantai;5;2;7;7;9;16
89;26.01.2015;2015;01;23;Maanantai;0;1;1;2;1;3
89;27.01.2015;2015;01;00;Tiistai;2;2;4;1;0;1
89;27.01.2015;2015;01;01;Tiistai;2;0;2;1;1;2
89;27.01.2015;2015;01;02;Tiistai;0;0;0;0;0;0
89;27.01.2015;2015;01;03;Tiistai;0;0;0;0;1;1
89;27.01.2015;2015;01;04;Tiistai;1;3;4;3;0;3
89;27.01.2015;2015;01;05;Tiistai;5;4;9;16;13;29
89;27.01.2015;2015;01;06;Tiistai;16;23;39;11;4;15
89;27.01.2015;2015;01;07;Tiistai;70;71;141;26;41;67
89;27.01.2015;2015;01;08;Tiistai;60;84;144;40;34;74
89;27.01.2015;2015;01;09;Tiistai;44;42;86;27;41;68
89;27.01.2015;2015;01;10;Tiistai;37;26;63;38;49;87
89;27.01.2015;2015;01;11;Tiistai;26;32;58;44;44;88
89;27.01.2015;2015;01;12;Tiistai;37;49;86;28;35;63
89;27.01.2015;2015;01;13;Tiistai;43;36;79;37;39;76
89;27.01.2015;2015;01;14;Tiistai;56;58;114;30;45;75
89;27.01.2015;2015;01;15;Tiistai;80;83;163;30;47;77
89;27.01.2015;2015;01;16;Tiistai;91;90;181;42;57;99
89;27.01.2015;2015;01;17;Tiistai;59;51;110;34;40;74
89;27.01.2015;2015;01;18;Tiistai;25;33;58;43;47;90
89;27.01.2015;2015;01;19;Tiistai;38;32;70;37;29;66
89;27.01.2015;2015;01;20;Tiistai;21;30;51;36;25;61
89;27.01.2015;2015;01;21;Tiistai;19;21;40;13;16;29
89;27.01.2015;2015;01;22;Tiistai;4;9;13;3;15;18
89;27.01.2015;2015;01;23;Tiistai;5;3;8;2;2;4
89;28.01.2015;2015;01;00;Keskiviikko;2;4;6;2;2;4
89;28.01.2015;2015;01;01;Keskiviikko;0;4;4;2;3;5
89;28.01.2015;2015;01;02;Keskiviikko;1;1;2;0;0;0
89;28.01.2015;2015;01;03;Keskiviikko;0;2;2;0;0;0
89;28.01.2015;2015;01;04;Keskiviikko;2;2;4;1;1;2
89;28.01.2015;2015;01;05;Keskiviikko;1;6;7;3;0;3
89;28.01.2015;2015;01;06;Keskiviikko;13;19;32;13;8;21
89;28.01.2015;2015;01;07;Keskiviikko;79;77;156;36;18;54
89;28.01.2015;2015;01;08;Keskiviikko;58;89;147;30;34;64
89;28.01.2015;2015;01;09;Keskiviikko;38;42;80;31;21;52
89;28.01.2015;2015;01;10;Keskiviikko;32;43;75;17;26;43
89;28.01.2015;2015;01;11;Keskiviikko;38;28;66;30;30;60
89;28.01.2015;2015;01;12;Keskiviikko;34;29;63;46;26;72
89;28.01.2015;2015;01;13;Keskiviikko;40;28;68;28;32;60
89;28.01.2015;2015;01;14;Keskiviikko;47;56;103;33;54;87
89;28.01.2015;2015;01;15;Keskiviikko;68;61;129;35;35;70
89;28.01.2015;2015;01;16;Keskiviikko;65;77;142;49;45;94
89;28.01.2015;2015;01;17;Keskiviikko;60;52;112;43;34;77
89;28.01.2015;2015;01;18;Keskiviikko;24;25;49;34;27;61
89;28.01.2015;2015;01;19;Keskiviikko;23;26;49;29;23;52
89;28.01.2015;2015;01;20;Keskiviikko;21;18;39;28;26;54
89;28.01.2015;2015;01;21;Keskiviikko;14;20;34;18;16;34
89;28.01.2015;2015;01;22;Keskiviikko;5;3;8;4;8;12
89;28.01.2015;2015;01;23;Keskiviikko;2;4;6;5;6;11
89;29.01.2015;2015;01;00;Torstai;3;0;3;3;1;4
89;29.01.2015;2015;01;01;Torstai;0;3;3;1;2;3
89;29.01.2015;2015;01;02;Torstai;2;0;2;0;2;2
89;29.01.2015;2015;01;03;Torstai;1;1;2;3;5;8
89;29.01.2015;2015;01;04;Torstai;5;1;6;0;3;3
89;29.01.2015;2015;01;05;Torstai;3;3;6;4;2;6
89;29.01.2015;2015;01;06;Torstai;13;21;34;6;9;15
89;29.01.2015;2015;01;07;Torstai;62;58;120;29;19;48
89;29.01.2015;2015;01;08;Torstai;64;66;130;39;39;78
89;29.01.2015;2015;01;09;Torstai;42;23;65;30;34;64
89;29.01.2015;2015;01;10;Torstai;27;28;55;27;24;51
89;29.01.2015;2015;01;11;Torstai;26;31;57;30;24;54
89;29.01.2015;2015;01;12;Torstai;22;30;52;31;26;57
89;29.01.2015;2015;01;13;Torstai;28;34;62;39;34;73
89;29.01.2015;2015;01;14;Torstai;33;36;69;39;38;77
89;29.01.2015;2015;01;15;Torstai;46;42;88;27;22;49
89;29.01.2015;2015;01;16;Torstai;63;68;131;40;42;82
89;29.01.2015;2015;01;17;Torstai;34;49;83;29;38;67
89;29.01.2015;2015;01;18;Torstai;32;23;55;24;27;51
89;29.01.2015;2015;01;19;Torstai;42;19;61;26;33;59
89;29.01.2015;2015;01;20;Torstai;17;23;40;28;16;44
89;29.01.2015;2015;01;21;Torstai;14;11;25;22;19;41
89;29.01.2015;2015;01;22;Torstai;11;10;21;7;5;12
89;29.01.2015;2015;01;23;Torstai;1;7;8;7;7;14
89;30.01.2015;2015;01;00;Perjantai;2;2;4;1;2;3
89;30.01.2015;2015;01;01;Perjantai;1;1;2;0;1;1
89;30.01.2015;2015;01;02;Perjantai;0;0;0;1;0;1
89;30.01.2015;2015;01;03;Perjantai;1;4;5;0;0;0
89;30.01.2015;2015;01;04;Perjantai;3;2;5;1;2;3
89;30.01.2015;2015;01;05;Perjantai;7;4;11;1;1;2
89;30.01.2015;2015;01;06;Perjantai;17;14;31;17;7;24
89;30.01.2015;2015;01;07;Perjantai;60;56;116;31;32;63
89;30.01.2015;2015;01;08;Perjantai;62;61;123;30;38;68
89;30.01.2015;2015;01;09;Perjantai;40;37;77;26;18;44
89;30.01.2015;2015;01;10;Perjantai;39;38;77;30;11;41
89;30.01.2015;2015;01;11;Perjantai;34;33;67;22;26;48
89;30.01.2015;2015;01;12;Perjantai;37;35;72;29;27;56
89;30.01.2015;2015;01;13;Perjantai;40;37;77;34;25;59
89;30.01.2015;2015;01;14;Perjantai;42;40;82;35;30;65
89;30.01.2015;2015;01;15;Perjantai;56;53;109;33;32;65
89;30.01.2015;2015;01;16;Perjantai;58;56;114;35;33;68
89;30.01.2015;2015;01;17;Perjantai;33;31;64;30;33;63
89;30.01.2015;2015;01;18;Perjantai;26;23;49;19;22;41
89;30.01.2015;2015;01;19;Perjantai;26;25;51;27;30;57
89;30.01.2015;2015;01;20;Perjantai;19;16;35;13;13;26
89;30.01.2015;2015;01;21;Perjantai;14;12;26;9;11;20
89;30.01.2015;2015;01;22;Perjantai;11;10;21;5;7;12
89;30.01.2015;2015;01;23;Perjantai;8;8;16;2;7;9
89;31.01.2015;2015;01;00;Lauantai;5;4;9;3;5;8
89;31.01.2015;2015;01;01;Lauantai;5;2;7;2;5;7
89;31.01.2015;2015;01;02;Lauantai;5;3;8;5;5;10
89;31.01.2015;2015;01;03;Lauantai;7;4;11;2;4;6
89;31.01.2015;2015;01;04;Lauantai;6;3;9;2;3;5
89;31.01.2015;2015;01;05;Lauantai;2;1;3;3;0;3
89;31.01.2015;2015;01;06;Lauantai;4;3;7;1;2;3
89;31.01.2015;2015;01;07;Lauantai;3;2;5;3;4;7
89;31.01.2015;2015;01;08;Lauantai;8;5;13;7;8;15
89;31.01.2015;2015;01;09;Lauantai;16;14;30;8;12;20
89;31.01.2015;2015;01;10;Lauantai;12;10;22;27;21;48
89;31.01.2015;2015;01;11;Lauantai;26;24;50;31;35;66
89;31.01.2015;2015;01;12;Lauantai;27;26;53;33;34;67
89;31.01.2015;2015;01;13;Lauantai;31;31;62;53;36;89
89;31.01.2015;2015;01;14;Lauantai;31;29;60;38;26;64
89;31.01.2015;2015;01;15;Lauantai;19;15;34;41;32;73
89;31.01.2015;2015;01;16;Lauantai;33;32;65;35;30;65
89;31.01.2015;2015;01;17;Lauantai;15;12;27;33;22;55
89;31.01.2015;2015;01;18;Lauantai;23;19;42;33;21;54
89;31.01.2015;2015;01;19;Lauantai;17;14;31;22;14;36
89;31.01.2015;2015;01;20;Lauantai;20;17;37;18;19;37
89;31.01.2015;2015;01;21;Lauantai;17;14;31;14;13;27
89;31.01.2015;2015;01;22;Lauantai;8;6;14;15;11;26
89;31.01.2015;2015;01;23;Lauantai;7;7;14;7;6;13
89;01.02.2015;2015;02;00;Sunnuntai;13;9;22;12;5;17
89;01.02.2015;2015;02;01;Sunnuntai;7;4;11;9;4;13
89;01.02.2015;2015;02;02;Sunnuntai;6;5;11;8;6;14
89;01.02.2015;2015;02;03;Sunnuntai;7;6;13;8;7;15
89;01.02.2015;2015;02;04;Sunnuntai;5;3;8;7;9;16
89;01.02.2015;2015;02;05;Sunnuntai;2;0;2;7;6;13
89;01.02.2015;2015;02;06;Sunnuntai;2;0;2;4;1;5
89;01.02.2015;2015;02;07;Sunnuntai;2;2;4;3;4;7
89;01.02.2015;2015;02;08;Sunnuntai;2;0;2;10;8;18
89;01.02.2015;2015;02;09;Sunnuntai;7;4;11;21;14;35
89;01.02.2015;2015;02;10;Sunnuntai;9;7;16;27;29;56
89;01.02.2015;2015;02;11;Sunnuntai;14;13;27;36;46;82
89;01.02.2015;2015;02;12;Sunnuntai;13;12;25;52;45;97
89;01.02.2015;2015;02;13;Sunnuntai;11;9;20;76;54;130
89;01.02.2015;2015;02;14;Sunnuntai;20;17;37;65;68;133
89;01.02.2015;2015;02;15;Sunnuntai;11;10;21;33;38;71
89;01.02.2015;2015;02;16;Sunnuntai;12;11;23;39;31;70
89;01.02.2015;2015;02;17;Sunnuntai;13;11;24;25;41;66
89;01.02.2015;2015;02;18;Sunnuntai;12;9;21;39;34;73
89;01.02.2015;2015;02;19;Sunnuntai;8;4;12;17;30;47
89;01.02.2015;2015;02;20;Sunnuntai;7;6;13;16;23;39
89;01.02.2015;2015;02;21;Sunnuntai;6;3;9;9;13;22
89;01.02.2015;2015;02;22;Sunnuntai;6;3;9;8;4;12
89;01.02.2015;2015;02;23;Sunnuntai;3;2;5;4;2;6
89;02.02.2015;2015;02;00;Maanantai;1;1;2;0;0;0
89;02.02.2015;2015;02;01;Maanantai;2;1;3;0;0;0
89;02.02.2015;2015;02;02;Maanantai;0;0;0;0;0;0
89;02.02.2015;2015;02;03;Maanantai;3;2;5;0;0;0
89;02.02.2015;2015;02;04;Maanantai;2;1;3;0;0;0
89;02.02.2015;2015;02;05;Maanantai;6;4;10;5;5;10
89;02.02.2015;2015;02;06;Maanantai;18;17;35;20;16;36
89;02.02.2015;2015;02;07;Maanantai;64;62;126;30;40;70
89;02.02.2015;2015;02;08;Maanantai;65;62;127;30;20;50
89;02.02.2015;2015;02;09;Maanantai;42;40;82;25;30;55
89;02.02.2015;2015;02;10;Maanantai;31;27;58;20;25;45
89;02.02.2015;2015;02;11;Maanantai;34;32;66;28;20;48
89;02.02.2015;2015;02;12;Maanantai;24;45;69;25;42;67
89;02.02.2015;2015;02;13;Maanantai;38;33;71;29;35;64
89;02.02.2015;2015;02;14;Maanantai;26;43;69;35;33;68
89;02.02.2015;2015;02;15;Maanantai;64;50;114;40;44;84
89;02.02.2015;2015;02;16;Maanantai;85;87;172;42;45;87
89;02.02.2015;2015;02;17;Maanantai;46;46;92;33;30;63
89;02.02.2015;2015;02;18;Maanantai;31;30;61;43;37;80
89;02.02.2015;2015;02;19;Maanantai;31;21;52;26;31;57
89;02.02.2015;2015;02;20;Maanantai;8;22;30;26;26;52
89;02.02.2015;2015;02;21;Maanantai;14;14;28;8;17;25
89;02.02.2015;2015;02;22;Maanantai;6;3;9;6;6;12
89;02.02.2015;2015;02;23;Maanantai;5;0;5;5;3;8
89;03.02.2015;2015;02;00;Tiistai;0;1;1;1;2;3
89;03.02.2015;2015;02;01;Tiistai;2;1;3;1;2;3
89;03.02.2015;2015;02;02;Tiistai;0;1;1;1;0;1
89;03.02.2015;2015;02;03;Tiistai;0;2;2;0;2;2
89;03.02.2015;2015;02;04;Tiistai;1;2;3;0;1;1
89;03.02.2015;2015;02;05;Tiistai;4;4;8;6;1;7
89;03.02.2015;2015;02;06;Tiistai;23;14;37;12;8;20
89;03.02.2015;2015;02;07;Tiistai;60;80;140;47;46;93
89;03.02.2015;2015;02;08;Tiistai;65;81;146;38;41;79
89;03.02.2015;2015;02;09;Tiistai;25;28;53;25;37;62
89;03.02.2015;2015;02;10;Tiistai;28;27;55;39;29;68
89;03.02.2015;2015;02;11;Tiistai;28;35;63;36;35;71
89;03.02.2015;2015;02;12;Tiistai;34;27;61;40;28;68
89;03.02.2015;2015;02;13;Tiistai;31;35;66;39;31;70
89;03.02.2015;2015;02;14;Tiistai;48;48;96;44;38;82
89;03.02.2015;2015;02;15;Tiistai;60;66;126;56;37;93
89;03.02.2015;2015;02;16;Tiistai;68;71;139;51;48;99
89;03.02.2015;2015;02;17;Tiistai;50;43;93;34;48;82
89;03.02.2015;2015;02;18;Tiistai;36;33;69;44;43;87
89;03.02.2015;2015;02;19;Tiistai;24;25;49;29;35;64
89;03.02.2015;2015;02;20;Tiistai;19;12;31;24;26;50
89;03.02.2015;2015;02;21;Tiistai;21;17;38;8;14;22
89;03.02.2015;2015;02;22;Tiistai;5;7;12;8;8;16
89;03.02.2015;2015;02;23;Tiistai;1;3;4;2;4;6
89;04.02.2015;2015;02;00;Keskiviikko;1;1;2;3;2;5
89;04.02.2015;2015;02;01;Keskiviikko;3;1;4;2;1;3
89;04.02.2015;2015;02;02;Keskiviikko;1;1;2;3;0;3
89;04.02.2015;2015;02;03;Keskiviikko;0;3;3;3;2;5
89;04.02.2015;2015;02;04;Keskiviikko;1;1;2;2;1;3
89;04.02.2015;2015;02;05;Keskiviikko;3;3;6;4;4;8
89;04.02.2015;2015;02;06;Keskiviikko;12;13;25;12;18;30
89;04.02.2015;2015;02;07;Keskiviikko;60;69;129;44;41;85
89;04.02.2015;2015;02;08;Keskiviikko;66;64;130;34;43;77
89;04.02.2015;2015;02;09;Keskiviikko;40;34;74;31;42;73
89;04.02.2015;2015;02;10;Keskiviikko;23;34;57;35;28;63
89;04.02.2015;2015;02;11;Keskiviikko;27;33;60;39;35;74
89;04.02.2015;2015;02;12;Keskiviikko;37;35;72;40;52;92
89;04.02.2015;2015;02;13;Keskiviikko;36;40;76;42;43;85
89;04.02.2015;2015;02;14;Keskiviikko;43;55;98;57;48;105
89;04.02.2015;2015;02;15;Keskiviikko;54;40;94;51;45;96
89;04.02.2015;2015;02;16;Keskiviikko;69;71;140;65;63;128
89;04.02.2015;2015;02;17;Keskiviikko;35;41;76;45;51;96
89;04.02.2015;2015;02;18;Keskiviikko;30;27;57;42;51;93
89;04.02.2015;2015;02;19;Keskiviikko;22;19;41;45;45;90
89;04.02.2015;2015;02;20;Keskiviikko;22;13;35;32;17;49
89;04.02.2015;2015;02;21;Keskiviikko;10;11;21;22;16;38
89;04.02.2015;2015;02;22;Keskiviikko;4;6;10;6;10;16
89;04.02.2015;2015;02;23;Keskiviikko;1;3;4;2;1;3
89;05.02.2015;2015;02;00;Torstai;1;1;2;1;2;3
89;05.02.2015;2015;02;01;Torstai;1;0;1;2;0;2
89;05.02.2015;2015;02;02;Torstai;1;2;3;1;0;1
89;05.02.2015;2015;02;03;Torstai;1;0;1;0;0;0
89;05.02.2015;2015;02;04;Torstai;2;2;4;2;1;3
89;05.02.2015;2015;02;05;Torstai;5;1;6;1;1;2
89;05.02.2015;2015;02;06;Torstai;16;12;28;11;14;25
89;05.02.2015;2015;02;07;Torstai;67;72;139;46;38;84
89;05.02.2015;2015;02;08;Torstai;64;78;142;40;45;85
89;05.02.2015;2015;02;09;Torstai;38;39;77;42;38;80
89;05.02.2015;2015;02;10;Torstai;30;23;53;27;31;58
89;05.02.2015;2015;02;11;Torstai;37;35;72;41;32;73
89;05.02.2015;2015;02;12;Torstai;37;37;74;25;29;54
89;05.02.2015;2015;02;13;Torstai;37;34;71;35;34;69
89;05.02.2015;2015;02;14;Torstai;48;55;103;47;48;95
89;05.02.2015;2015;02;15;Torstai;51;75;126;54;51;105
89;05.02.2015;2015;02;16;Torstai;75;83;158;60;55;115
89;05.02.2015;2015;02;17;Torstai;44;30;74;54;45;99
89;05.02.2015;2015;02;18;Torstai;36;37;73;49;37;86
89;05.02.2015;2015;02;19;Torstai;30;20;50;34;39;73
89;05.02.2015;2015;02;20;Torstai;27;21;48;22;25;47
89;05.02.2015;2015;02;21;Torstai;16;9;25;19;11;30
89;05.02.2015;2015;02;22;Torstai;7;18;25;14;8;22
89;05.02.2015;2015;02;23;Torstai;6;3;9;7;4;11
89;06.02.2015;2015;02;00;Perjantai;1;2;3;3;2;5
89;06.02.2015;2015;02;01;Perjantai;8;4;12;2;3;5
89;06.02.2015;2015;02;02;Perjantai;1;5;6;5;3;8
89;06.02.2015;2015;02;03;Perjantai;3;2;5;0;3;3
89;06.02.2015;2015;02;04;Perjantai;3;2;5;3;2;5
89;06.02.2015;2015;02;05;Perjantai;5;3;8;4;2;6
89;06.02.2015;2015;02;06;Perjantai;11;20;31;10;10;20
89;06.02.2015;2015;02;07;Perjantai;40;59;99;40;41;81
89;06.02.2015;2015;02;08;Perjantai;53;61;114;55;42;97
89;06.02.2015;2015;02;09;Perjantai;44;49;93;30;43;73
89;06.02.2015;2015;02;10;Perjantai;38;42;80;30;28;58
89;06.02.2015;2015;02;11;Perjantai;51;41;92;41;53;94
89;06.02.2015;2015;02;12;Perjantai;33;44;77;58;49;107
89;06.02.2015;2015;02;13;Perjantai;35;49;84;63;56;119
89;06.02.2015;2015;02;14;Perjantai;71;48;119;58;69;127
89;06.02.2015;2015;02;15;Perjantai;84;54;138;50;45;95
89;06.02.2015;2015;02;16;Perjantai;66;55;121;49;58;107
89;06.02.2015;2015;02;17;Perjantai;37;43;80;44;37;81
89;06.02.2015;2015;02;18;Perjantai;34;25;59;44;37;81
89;06.02.2015;2015;02;19;Perjantai;17;22;39;27;35;62
89;06.02.2015;2015;02;20;Perjantai;9;28;37;15;31;46
89;06.02.2015;2015;02;21;Perjantai;10;14;24;14;11;25
89;06.02.2015;2015;02;22;Perjantai;5;5;10;6;11;17
89;06.02.2015;2015;02;23;Perjantai;7;11;18;6;11;17
89;07.02.2015;2015;02;00;Lauantai;5;2;7;11;11;22
89;07.02.2015;2015;02;01;Lauantai;5;6;11;6;1;7
89;07.02.2015;2015;02;02;Lauantai;3;1;4;7;7;14
89;07.02.2015;2015;02;03;Lauantai;3;6;9;7;8;15
89;07.02.2015;2015;02;04;Lauantai;2;1;3;8;3;11
89;07.02.2015;2015;02;05;Lauantai;0;1;1;7;2;9
89;07.02.2015;2015;02;06;Lauantai;7;1;8;1;3;4
89;07.02.2015;2015;02;07;Lauantai;2;7;9;8;6;14
89;07.02.2015;2015;02;08;Lauantai;13;7;20;11;15;26
89;07.02.2015;2015;02;09;Lauantai;15;13;28;21;15;36
89;07.02.2015;2015;02;10;Lauantai;16;21;37;29;29;58
89;07.02.2015;2015;02;11;Lauantai;25;32;57;35;51;86
89;07.02.2015;2015;02;12;Lauantai;29;36;65;38;38;76
89;07.02.2015;2015;02;13;Lauantai;28;33;61;41;39;80
89;07.02.2015;2015;02;14;Lauantai;26;40;66;44;47;91
89;07.02.2015;2015;02;15;Lauantai;29;30;59;58;52;110
89;07.02.2015;2015;02;16;Lauantai;30;33;63;39;39;78
89;07.02.2015;2015;02;17;Lauantai;13;16;29;27;31;58
89;07.02.2015;2015;02;18;Lauantai;21;24;45;39;26;65
89;07.02.2015;2015;02;19;Lauantai;22;22;44;23;19;42
89;07.02.2015;2015;02;20;Lauantai;11;19;30;17;12;29
89;07.02.2015;2015;02;21;Lauantai;13;8;21;7;8;15
89;07.02.2015;2015;02;22;Lauantai;10;4;14;12;9;21
89;07.02.2015;2015;02;23;Lauantai;7;12;19;7;6;13
89;08.02.2015;2015;02;00;Sunnuntai;7;7;14;5;5;10
89;08.02.2015;2015;02;01;Sunnuntai;0;5;5;9;3;12
89;08.02.2015;2015;02;02;Sunnuntai;3;4;7;6;6;12
89;08.02.2015;2015;02;03;Sunnuntai;7;2;9;6;9;15
89;08.02.2015;2015;02;04;Sunnuntai;5;4;9;3;8;11
89;08.02.2015;2015;02;05;Sunnuntai;1;0;1;0;0;0
89;08.02.2015;2015;02;06;Sunnuntai;1;1;2;0;0;0
89;08.02.2015;2015;02;07;Sunnuntai;3;2;5;0;0;0
89;08.02.2015;2015;02;08;Sunnuntai;4;1;5;0;0;0
89;08.02.2015;2015;02;09;Sunnuntai;6;5;11;0;0;0
89;08.02.2015;2015;02;10;Sunnuntai;10;8;18;0;0;0
89;08.02.2015;2015;02;11;Sunnuntai;19;17;36;0;0;0
89;08.02.2015;2015;02;12;Sunnuntai;30;25;55;1;0;1
89;08.02.2015;2015;02;13;Sunnuntai;25;29;54;2;6;8
89;08.02.2015;2015;02;14;Sunnuntai;34;33;67;3;4;7
89;08.02.2015;2015;02;15;Sunnuntai;24;16;40;7;6;13
89;08.02.2015;2015;02;16;Sunnuntai;20;16;36;21;15;36
89;08.02.2015;2015;02;17;Sunnuntai;19;16;35;7;9;16
89;08.02.2015;2015;02;18;Sunnuntai;19;16;35;14;14;28
89;08.02.2015;2015;02;19;Sunnuntai;13;10;23;9;8;17
89;08.02.2015;2015;02;20;Sunnuntai;6;14;20;7;2;9
89;08.02.2015;2015;02;21;Sunnuntai;7;10;17;3;3;6
89;08.02.2015;2015;02;22;Sunnuntai;4;0;4;4;4;8
89;08.02.2015;2015;02;23;Sunnuntai;2;2;4;1;4;5
89;09.02.2015;2015;02;00;Maanantai;1;0;1;2;0;2
89;09.02.2015;2015;02;01;Maanantai;1;0;1;1;1;2
89;09.02.2015;2015;02;02;Maanantai;0;0;0;0;0;0
89;09.02.2015;2015;02;03;Maanantai;1;1;2;0;0;0
89;09.02.2015;2015;02;04;Maanantai;0;0;0;2;1;3
89;09.02.2015;2015;02;05;Maanantai;7;3;10;2;1;3
89;09.02.2015;2015;02;06;Maanantai;17;16;33;3;8;11
89;09.02.2015;2015;02;07;Maanantai;71;62;133;18;17;35
89;09.02.2015;2015;02;08;Maanantai;77;73;150;55;51;106
89;09.02.2015;2015;02;09;Maanantai;55;47;102;25;48;73
89;09.02.2015;2015;02;10;Maanantai;22;25;47;30;30;60
89;09.02.2015;2015;02;11;Maanantai;50;38;88;39;42;81
89;09.02.2015;2015;02;12;Maanantai;34;48;82;29;33;62
89;09.02.2015;2015;02;13;Maanantai;43;41;84;41;29;70
89;09.02.2015;2015;02;14;Maanantai;44;49;93;43;47;90
89;09.02.2015;2015;02;15;Maanantai;76;70;146;51;62;113
89;09.02.2015;2015;02;16;Maanantai;82;82;164;46;55;101
89;09.02.2015;2015;02;17;Maanantai;59;49;108;40;39;79
89;09.02.2015;2015;02;18;Maanantai;31;33;64;45;41;86
89;09.02.2015;2015;02;19;Maanantai;31;27;58;30;33;63
89;09.02.2015;2015;02;20;Maanantai;24;19;43;27;27;54
89;09.02.2015;2015;02;21;Maanantai;13;18;31;18;11;29
89;09.02.2015;2015;02;22;Maanantai;6;4;10;11;5;16
89;09.02.2015;2015;02;23;Maanantai;2;6;8;6;1;7
89;10.02.2015;2015;02;00;Tiistai;2;0;2;4;1;5
89;10.02.2015;2015;02;01;Tiistai;1;0;1;2;1;3
89;10.02.2015;2015;02;02;Tiistai;2;2;4;1;1;2
89;10.02.2015;2015;02;03;Tiistai;1;1;2;1;3;4
89;10.02.2015;2015;02;04;Tiistai;2;2;4;1;0;1
89;10.02.2015;2015;02;05;Tiistai;4;5;9;3;1;4
89;10.02.2015;2015;02;06;Tiistai;17;22;39;9;9;18
89;10.02.2015;2015;02;07;Tiistai;71;63;134;39;39;78
89;10.02.2015;2015;02;08;Tiistai;73;79;152;25;42;67
89;10.02.2015;2015;02;09;Tiistai;47;35;82;40;36;76
89;10.02.2015;2015;02;10;Tiistai;32;32;64;41;37;78
89;10.02.2015;2015;02;11;Tiistai;32;43;75;47;51;98
89;10.02.2015;2015;02;12;Tiistai;31;39;70;46;57;103
89;10.02.2015;2015;02;13;Tiistai;39;24;63;52;58;110
89;10.02.2015;2015;02;14;Tiistai;46;57;103;48;52;100
89;10.02.2015;2015;02;15;Tiistai;61;70;131;48;58;106
89;10.02.2015;2015;02;16;Tiistai;71;71;142;39;61;100
89;10.02.2015;2015;02;17;Tiistai;49;51;100;39;44;83
89;10.02.2015;2015;02;18;Tiistai;22;29;51;31;40;71
89;10.02.2015;2015;02;19;Tiistai;21;19;40;24;31;55
89;10.02.2015;2015;02;20;Tiistai;14;21;35;18;25;43
89;10.02.2015;2015;02;21;Tiistai;19;12;31;10;22;32
89;10.02.2015;2015;02;22;Tiistai;1;5;6;6;5;11
89;10.02.2015;2015;02;23;Tiistai;7;4;11;1;2;3
89;11.02.2015;2015;02;00;Keskiviikko;2;2;4;2;4;6
89;11.02.2015;2015;02;01;Keskiviikko;1;2;3;0;0;0
89;11.02.2015;2015;02;02;Keskiviikko;0;0;0;1;2;3
89;11.02.2015;2015;02;03;Keskiviikko;4;3;7;2;2;4
89;11.02.2015;2015;02;04;Keskiviikko;2;5;7;1;1;2
89;11.02.2015;2015;02;05;Keskiviikko;4;3;7;2;1;3
89;11.02.2015;2015;02;06;Keskiviikko;14;13;27;12;8;20
89;11.02.2015;2015;02;07;Keskiviikko;41;54;95;35;37;72
89;11.02.2015;2015;02;08;Keskiviikko;44;48;92;33;35;68
89;11.02.2015;2015;02;09;Keskiviikko;23;37;60;35;35;70
89;11.02.2015;2015;02;10;Keskiviikko;23;28;51;24;29;53
89;11.02.2015;2015;02;11;Keskiviikko;25;24;49;42;25;67
89;11.02.2015;2015;02;12;Keskiviikko;23;22;45;32;45;77
89;11.02.2015;2015;02;13;Keskiviikko;28;17;45;25;28;53
89;11.02.2015;2015;02;14;Keskiviikko;44;40;84;41;37;78
89;11.02.2015;2015;02;15;Keskiviikko;43;40;83;43;38;81
89;11.02.2015;2015;02;16;Keskiviikko;51;69;120;46;40;86
89;11.02.2015;2015;02;17;Keskiviikko;32;35;67;20;39;59
89;11.02.2015;2015;02;18;Keskiviikko;23;23;46;15;29;44
89;11.02.2015;2015;02;19;Keskiviikko;12;21;33;30;18;48
89;11.02.2015;2015;02;20;Keskiviikko;18;9;27;14;14;28
89;11.02.2015;2015;02;21;Keskiviikko;6;7;13;9;9;18
89;11.02.2015;2015;02;22;Keskiviikko;6;9;15;5;2;7
89;11.02.2015;2015;02;23;Keskiviikko;3;0;3;5;2;7
89;12.02.2015;2015;02;00;Torstai;0;3;3;2;1;3
89;12.02.2015;2015;02;01;Torstai;2;2;4;0;3;3
89;12.02.2015;2015;02;02;Torstai;0;1;1;0;0;0
89;12.02.2015;2015;02;03;Torstai;5;3;8;3;4;7
89;12.02.2015;2015;02;04;Torstai;19;14;33;20;26;46
89;12.02.2015;2015;02;05;Torstai;2;3;5;2;1;3
89;12.02.2015;2015;02;06;Torstai;15;16;31;8;7;15
89;12.02.2015;2015;02;07;Torstai;52;47;99;32;33;65
89;12.02.2015;2015;02;08;Torstai;71;64;135;32;32;64
89;12.02.2015;2015;02;09;Torstai;37;33;70;21;28;49
89;12.02.2015;2015;02;10;Torstai;17;30;47;25;20;45
89;12.02.2015;2015;02;11;Torstai;22;21;43;21;37;58
89;12.02.2015;2015;02;12;Torstai;25;34;59;26;28;54
89;12.02.2015;2015;02;13;Torstai;36;24;60;25;34;59
89;12.02.2015;2015;02;14;Torstai;40;43;83;39;45;84
89;12.02.2015;2015;02;15;Torstai;67;66;133;37;38;75
89;12.02.2015;2015;02;16;Torstai;59;60;119;39;24;63
89;12.02.2015;2015;02;17;Torstai;49;36;85;25;23;48
89;12.02.2015;2015;02;18;Torstai;37;37;74;25;24;49
89;12.02.2015;2015;02;19;Torstai;23;21;44;17;26;43
89;12.02.2015;2015;02;20;Torstai;20;21;41;11;17;28
89;12.02.2015;2015;02;21;Torstai;9;20;29;8;10;18
89;12.02.2015;2015;02;22;Torstai;6;14;20;6;3;9
89;12.02.2015;2015;02;23;Torstai;2;3;5;0;5;5
89;13.02.2015;2015;02;00;Perjantai;3;1;4;1;3;4
89;13.02.2015;2015;02;01;Perjantai;0;1;1;0;1;1
89;13.02.2015;2015;02;02;Perjantai;0;0;0;1;0;1
89;13.02.2015;2015;02;03;Perjantai;11;9;20;11;7;18
89;13.02.2015;2015;02;04;Perjantai;4;4;8;1;1;2
89;13.02.2015;2015;02;05;Perjantai;7;0;7;1;1;2
89;13.02.2015;2015;02;06;Perjantai;24;14;38;11;9;20
89;13.02.2015;2015;02;07;Perjantai;49;54;103;32;20;52
89;13.02.2015;2015;02;08;Perjantai;61;56;117;27;27;54
89;13.02.2015;2015;02;09;Perjantai;44;33;77;17;26;43
89;13.02.2015;2015;02;10;Perjantai;25;29;54;25;23;48
89;13.02.2015;2015;02;11;Perjantai;41;47;88;26;35;61
89;13.02.2015;2015;02;12;Perjantai;38;52;90;25;23;48
89;13.02.2015;2015;02;13;Perjantai;38;32;70;41;37;78
89;13.02.2015;2015;02;14;Perjantai;54;38;92;37;30;67
89;13.02.2015;2015;02;15;Perjantai;54;62;116;34;31;65
89;13.02.2015;2015;02;16;Perjantai;65;76;141;37;34;71
89;13.02.2015;2015;02;17;Perjantai;49;41;90;16;21;37
89;13.02.2015;2015;02;18;Perjantai;32;21;53;18;18;36
89;13.02.2015;2015;02;19;Perjantai;24;15;39;19;13;32
89;13.02.2015;2015;02;20;Perjantai;17;17;34;18;15;33
89;13.02.2015;2015;02;21;Perjantai;18;12;30;11;14;25
89;13.02.2015;2015;02;22;Perjantai;9;6;15;7;5;12
89;13.02.2015;2015;02;23;Perjantai;8;5;13;11;3;14
89;14.02.2015;2015;02;00;Lauantai;10;7;17;2;3;5
89;14.02.2015;2015;02;01;Lauantai;5;1;6;4;4;8
89;14.02.2015;2015;02;02;Lauantai;5;5;10;7;7;14
89;14.02.2015;2015;02;03;Lauantai;2;3;5;2;5;7
89;14.02.2015;2015;02;04;Lauantai;6;0;6;2;3;5
89;14.02.2015;2015;02;05;Lauantai;2;2;4;0;1;1
89;14.02.2015;2015;02;06;Lauantai;3;7;10;1;2;3
89;14.02.2015;2015;02;07;Lauantai;3;6;9;9;5;14
89;14.02.2015;2015;02;08;Lauantai;4;17;21;9;8;17
89;14.02.2015;2015;02;09;Lauantai;11;15;26;15;16;31
89;14.02.2015;2015;02;10;Lauantai;15;15;30;19;36;55
89;14.02.2015;2015;02;11;Lauantai;33;20;53;44;30;74
89;14.02.2015;2015;02;12;Lauantai;23;34;57;32;40;72
89;14.02.2015;2015;02;13;Lauantai;42;26;68;40;33;73
89;14.02.2015;2015;02;14;Lauantai;23;26;49;35;46;81
89;14.02.2015;2015;02;15;Lauantai;39;27;66;26;25;51
89;14.02.2015;2015;02;16;Lauantai;26;32;58;21;27;48
89;14.02.2015;2015;02;17;Lauantai;27;18;45;27;26;53
89;14.02.2015;2015;02;18;Lauantai;14;26;40;23;30;53
89;14.02.2015;2015;02;19;Lauantai;18;17;35;13;19;32
89;14.02.2015;2015;02;20;Lauantai;13;16;29;14;5;19
89;14.02.2015;2015;02;21;Lauantai;19;15;34;11;10;21
89;14.02.2015;2015;02;22;Lauantai;15;7;22;12;6;18
89;14.02.2015;2015;02;23;Lauantai;10;11;21;7;4;11
89;15.02.2015;2015;02;00;Sunnuntai;9;13;22;5;8;13
89;15.02.2015;2015;02;01;Sunnuntai;4;5;9;5;3;8
89;15.02.2015;2015;02;02;Sunnuntai;1;8;9;3;2;5
89;15.02.2015;2015;02;03;Sunnuntai;8;3;11;3;2;5
89;15.02.2015;2015;02;04;Sunnuntai;5;1;6;3;2;5
89;15.02.2015;2015;02;05;Sunnuntai;1;1;2;0;2;2
89;15.02.2015;2015;02;06;Sunnuntai;5;5;10;2;1;3
89;15.02.2015;2015;02;07;Sunnuntai;1;3;4;0;2;2
89;15.02.2015;2015;02;08;Sunnuntai;4;2;6;3;7;10
89;15.02.2015;2015;02;09;Sunnuntai;5;5;10;7;11;18
89;15.02.2015;2015;02;10;Sunnuntai;10;4;14;27;29;56
89;15.02.2015;2015;02;11;Sunnuntai;18;21;39;22;38;60
89;15.02.2015;2015;02;12;Sunnuntai;21;19;40;60;53;113
89;15.02.2015;2015;02;13;Sunnuntai;22;26;48;61;49;110
89;15.02.2015;2015;02;14;Sunnuntai;23;23;46;51;55;106
89;15.02.2015;2015;02;15;Sunnuntai;21;30;51;45;61;106
89;15.02.2015;2015;02;16;Sunnuntai;20;20;40;29;24;53
89;15.02.2015;2015;02;17;Sunnuntai;22;18;40;25;30;55
89;15.02.2015;2015;02;18;Sunnuntai;13;13;26;18;15;33
89;15.02.2015;2015;02;19;Sunnuntai;11;12;23;13;16;29
89;15.02.2015;2015;02;20;Sunnuntai;7;6;13;7;9;16
89;15.02.2015;2015;02;21;Sunnuntai;11;9;20;8;5;13
89;15.02.2015;2015;02;22;Sunnuntai;5;6;11;3;3;6
89;15.02.2015;2015;02;23;Sunnuntai;4;8;12;5;4;9
89;16.02.2015;2015;02;00;Maanantai;2;0;2;5;2;7
89;16.02.2015;2015;02;01;Maanantai;0;2;2;0;1;1
89;16.02.2015;2015;02;02;Maanantai;0;0;0;0;0;0
89;16.02.2015;2015;02;03;Maanantai;0;0;0;1;0;1
89;16.02.2015;2015;02;04;Maanantai;1;3;4;0;0;0
89;16.02.2015;2015;02;05;Maanantai;5;3;8;2;1;3
89;16.02.2015;2015;02;06;Maanantai;31;20;51;9;12;21
89;16.02.2015;2015;02;07;Maanantai;68;74;142;24;31;55
89;16.02.2015;2015;02;08;Maanantai;72;85;157;28;31;59
89;16.02.2015;2015;02;09;Maanantai;69;58;127;41;39;80
89;16.02.2015;2015;02;10;Maanantai;40;29;69;32;25;57
89;16.02.2015;2015;02;11;Maanantai;52;48;100;47;43;90
89;16.02.2015;2015;02;12;Maanantai;40;34;74;52;43;95
89;16.02.2015;2015;02;13;Maanantai;32;48;80;41;47;88
89;16.02.2015;2015;02;14;Maanantai;64;52;116;38;42;80
89;16.02.2015;2015;02;15;Maanantai;74;81;155;47;49;96
89;16.02.2015;2015;02;16;Maanantai;85;107;192;54;43;97
89;16.02.2015;2015;02;17;Maanantai;61;61;122;26;28;54
89;16.02.2015;2015;02;18;Maanantai;51;39;90;42;30;72
89;16.02.2015;2015;02;19;Maanantai;36;24;60;22;21;43
89;16.02.2015;2015;02;20;Maanantai;26;28;54;16;16;32
89;16.02.2015;2015;02;21;Maanantai;12;20;32;8;10;18
89;16.02.2015;2015;02;22;Maanantai;8;8;16;7;5;12
89;16.02.2015;2015;02;23;Maanantai;6;7;13;2;3;5
89;17.02.2015;2015;02;00;Tiistai;0;1;1;4;5;9
89;17.02.2015;2015;02;01;Tiistai;0;0;0;0;0;0
89;17.02.2015;2015;02;02;Tiistai;0;1;1;1;1;2
89;17.02.2015;2015;02;03;Tiistai;4;2;6;1;0;1
89;17.02.2015;2015;02;04;Tiistai;1;2;3;0;1;1
89;17.02.2015;2015;02;05;Tiistai;1;5;6;4;0;4
89;17.02.2015;2015;02;06;Tiistai;16;24;40;11;8;19
89;17.02.2015;2015;02;07;Tiistai;67;74;141;28;27;55
89;17.02.2015;2015;02;08;Tiistai;80;95;175;40;35;75
89;17.02.2015;2015;02;09;Tiistai;44;50;94;29;33;62
89;17.02.2015;2015;02;10;Tiistai;42;37;79;22;27;49
89;17.02.2015;2015;02;11;Tiistai;38;40;78;33;33;66
89;17.02.2015;2015;02;12;Tiistai;54;66;120;34;48;82
89;17.02.2015;2015;02;13;Tiistai;40;41;81;42;36;78
89;17.02.2015;2015;02;14;Tiistai;50;61;111;41;39;80
89;17.02.2015;2015;02;15;Tiistai;85;67;152;35;44;79
89;17.02.2015;2015;02;16;Tiistai;90;89;179;38;47;85
89;17.02.2015;2015;02;17;Tiistai;54;76;130;26;34;60
89;17.02.2015;2015;02;18;Tiistai;38;35;73;25;34;59
89;17.02.2015;2015;02;19;Tiistai;44;50;94;28;24;52
89;17.02.2015;2015;02;20;Tiistai;17;27;44;29;15;44
89;17.02.2015;2015;02;21;Tiistai;22;25;47;9;12;21
89;17.02.2015;2015;02;22;Tiistai;8;9;17;4;5;9
89;17.02.2015;2015;02;23;Tiistai;4;9;13;0;4;4
89;18.02.2015;2015;02;00;Keskiviikko;3;4;7;3;0;3
89;18.02.2015;2015;02;01;Keskiviikko;3;3;6;3;3;6
89;18.02.2015;2015;02;02;Keskiviikko;2;3;5;2;3;5
89;18.02.2015;2015;02;03;Keskiviikko;2;3;5;1;1;2
89;18.02.2015;2015;02;04;Keskiviikko;4;4;8;0;1;1
89;18.02.2015;2015;02;05;Keskiviikko;10;6;16;1;2;3
89;18.02.2015;2015;02;06;Keskiviikko;19;25;44;10;8;18
89;18.02.2015;2015;02;07;Keskiviikko;67;92;159;34;25;59
89;18.02.2015;2015;02;08;Keskiviikko;91;83;174;32;38;70
89;18.02.2015;2015;02;09;Keskiviikko;60;47;107;34;38;72
89;18.02.2015;2015;02;10;Keskiviikko;39;37;76;36;26;62
89;18.02.2015;2015;02;11;Keskiviikko;41;59;100;41;45;86
89;18.02.2015;2015;02;12;Keskiviikko;50;42;92;41;51;92
89;18.02.2015;2015;02;13;Keskiviikko;43;52;95;53;42;95
89;18.02.2015;2015;02;14;Keskiviikko;60;54;114;65;55;120
89;18.02.2015;2015;02;15;Keskiviikko;73;83;156;41;53;94
89;18.02.2015;2015;02;16;Keskiviikko;91;87;178;69;61;130
89;18.02.2015;2015;02;17;Keskiviikko;59;58;117;36;31;67
89;18.02.2015;2015;02;18;Keskiviikko;50;32;82;35;37;72
89;18.02.2015;2015;02;19;Keskiviikko;39;40;79;33;19;52
89;18.02.2015;2015;02;20;Keskiviikko;26;22;48;19;16;35
89;18.02.2015;2015;02;21;Keskiviikko;22;17;39;8;12;20
89;18.02.2015;2015;02;22;Keskiviikko;9;7;16;9;4;13
89;18.02.2015;2015;02;23;Keskiviikko;6;5;11;8;1;9
89;19.02.2015;2015;02;00;Torstai;2;0;2;3;0;3
89;19.02.2015;2015;02;01;Torstai;1;1;2;0;0;0
89;19.02.2015;2015;02;02;Torstai;0;2;2;0;0;0
89;19.02.2015;2015;02;03;Torstai;2;3;5;2;1;3
89;19.02.2015;2015;02;04;Torstai;0;4;4;0;0;0
89;19.02.2015;2015;02;05;Torstai;3;4;7;2;2;4
89;19.02.2015;2015;02;06;Torstai;27;26;53;8;13;21
89;19.02.2015;2015;02;07;Torstai;77;65;142;19;29;48
89;19.02.2015;2015;02;08;Torstai;79;85;164;34;38;72
89;19.02.2015;2015;02;09;Torstai;54;40;94;36;34;70
89;19.02.2015;2015;02;10;Torstai;39;42;81;25;22;47
89;19.02.2015;2015;02;11;Torstai;50;52;102;34;25;59
89;19.02.2015;2015;02;12;Torstai;42;53;95;35;30;65
89;19.02.2015;2015;02;13;Torstai;54;49;103;43;44;87
89;19.02.2015;2015;02;14;Torstai;53;76;129;27;37;64
89;19.02.2015;2015;02;15;Torstai;81;79;160;38;37;75
89;19.02.2015;2015;02;16;Torstai;100;84;184;32;37;69
89;19.02.2015;2015;02;17;Torstai;45;48;93;16;20;36
89;19.02.2015;2015;02;18;Torstai;59;42;101;18;30;48
89;19.02.2015;2015;02;19;Torstai;37;30;67;26;19;45
89;19.02.2015;2015;02;20;Torstai;25;23;48;25;13;38
89;19.02.2015;2015;02;21;Torstai;13;17;30;8;7;15
89;19.02.2015;2015;02;22;Torstai;12;8;20;5;5;10
89;19.02.2015;2015;02;23;Torstai;1;4;5;1;1;2
89;20.02.2015;2015;02;00;Perjantai;3;2;5;0;2;2
89;20.02.2015;2015;02;01;Perjantai;0;0;0;0;0;0
89;20.02.2015;2015;02;02;Perjantai;1;0;1;1;0;1
89;20.02.2015;2015;02;03;Perjantai;2;2;4;1;0;1
89;20.02.2015;2015;02;04;Perjantai;1;2;3;0;1;1
89;20.02.2015;2015;02;05;Perjantai;4;4;8;4;3;7
89;20.02.2015;2015;02;06;Perjantai;19;17;36;7;7;14
89;20.02.2015;2015;02;07;Perjantai;67;46;113;22;31;53
89;20.02.2015;2015;02;08;Perjantai;59;52;111;33;40;73
89;20.02.2015;2015;02;09;Perjantai;42;42;84;33;37;70
89;20.02.2015;2015;02;10;Perjantai;30;35;65;30;16;46
89;20.02.2015;2015;02;11;Perjantai;54;35;89;29;29;58
89;20.02.2015;2015;02;12;Perjantai;36;57;93;37;27;64
89;20.02.2015;2015;02;13;Perjantai;44;34;78;33;46;79
89;20.02.2015;2015;02;14;Perjantai;50;43;93;37;35;72
89;20.02.2015;2015;02;15;Perjantai;61;68;129;29;33;62
89;20.02.2015;2015;02;16;Perjantai;49;61;110;37;35;72
89;20.02.2015;2015;02;17;Perjantai;50;40;90;21;31;52
89;20.02.2015;2015;02;18;Perjantai;35;26;61;22;23;45
89;20.02.2015;2015;02;19;Perjantai;25;17;42;16;18;34
89;20.02.2015;2015;02;20;Perjantai;15;19;34;17;15;32
89;20.02.2015;2015;02;21;Perjantai;13;11;24;10;4;14
89;20.02.2015;2015;02;22;Perjantai;9;15;24;10;8;18
89;20.02.2015;2015;02;23;Perjantai;5;10;15;6;6;12
89;21.02.2015;2015;02;00;Lauantai;12;4;16;8;2;10
89;21.02.2015;2015;02;01;Lauantai;3;4;7;9;5;14
89;21.02.2015;2015;02;02;Lauantai;1;5;6;3;4;7
89;21.02.2015;2015;02;03;Lauantai;2;0;2;4;3;7
89;21.02.2015;2015;02;04;Lauantai;1;5;6;3;6;9
89;21.02.2015;2015;02;05;Lauantai;2;1;3;2;2;4
89;21.02.2015;2015;02;06;Lauantai;2;4;6;0;6;6
89;21.02.2015;2015;02;07;Lauantai;7;6;13;2;5;7
89;21.02.2015;2015;02;08;Lauantai;16;10;26;8;10;18
89;21.02.2015;2015;02;09;Lauantai;22;27;49;19;23;42
89;21.02.2015;2015;02;10;Lauantai;22;32;54;31;22;53
89;21.02.2015;2015;02;11;Lauantai;24;33;57;28;37;65
89;21.02.2015;2015;02;12;Lauantai;28;34;62;46;39;85
89;21.02.2015;2015;02;13;Lauantai;21;25;46;37;52;89
89;21.02.2015;2015;02;14;Lauantai;23;27;50;31;34;65
89;21.02.2015;2015;02;15;Lauantai;22;32;54;32;28;60
89;21.02.2015;2015;02;16;Lauantai;28;30;58;32;25;57
89;21.02.2015;2015;02;17;Lauantai;23;23;46;25;19;44
89;21.02.2015;2015;02;18;Lauantai;32;21;53;13;18;31
89;21.02.2015;2015;02;19;Lauantai;23;14;37;24;19;43
89;21.02.2015;2015;02;20;Lauantai;17;8;25;9;8;17
89;21.02.2015;2015;02;21;Lauantai;16;13;29;10;8;18
89;21.02.2015;2015;02;22;Lauantai;11;10;21;12;7;19
89;21.02.2015;2015;02;23;Lauantai;5;12;17;8;7;15
89;22.02.2015;2015;02;00;Sunnuntai;11;11;22;6;9;15
89;22.02.2015;2015;02;01;Sunnuntai;5;2;7;3;4;7
89;22.02.2015;2015;02;02;Sunnuntai;2;8;10;5;3;8
89;22.02.2015;2015;02;03;Sunnuntai;7;5;12;2;1;3
89;22.02.2015;2015;02;04;Sunnuntai;4;2;6;8;3;11
89;22.02.2015;2015;02;05;Sunnuntai;3;1;4;1;3;4
89;22.02.2015;2015;02;06;Sunnuntai;3;1;4;0;1;1
89;22.02.2015;2015;02;07;Sunnuntai;5;2;7;3;6;9
89;22.02.2015;2015;02;08;Sunnuntai;5;1;6;9;7;16
89;22.02.2015;2015;02;09;Sunnuntai;9;3;12;18;22;40
89;22.02.2015;2015;02;10;Sunnuntai;19;14;33;25;37;62
89;22.02.2015;2015;02;11;Sunnuntai;23;24;47;57;54;111
89;22.02.2015;2015;02;12;Sunnuntai;23;29;52;51;50;101
89;22.02.2015;2015;02;13;Sunnuntai;22;32;54;52;46;98
89;22.02.2015;2015;02;14;Sunnuntai;31;29;60;39;41;80
89;22.02.2015;2015;02;15;Sunnuntai;26;20;46;25;29;54
89;22.02.2015;2015;02;16;Sunnuntai;19;25;44;33;23;56
89;22.02.2015;2015;02;17;Sunnuntai;23;19;42;33;30;63
89;22.02.2015;2015;02;18;Sunnuntai;15;19;34;16;18;34
89;22.02.2015;2015;02;19;Sunnuntai;16;15;31;12;15;27
89;22.02.2015;2015;02;20;Sunnuntai;13;11;24;11;13;24
89;22.02.2015;2015;02;21;Sunnuntai;5;4;9;12;11;23
89;22.02.2015;2015;02;22;Sunnuntai;7;5;12;8;3;11
89;22.02.2015;2015;02;23;Sunnuntai;5;2;7;5;1;6
89;23.02.2015;2015;02;00;Maanantai;1;2;3;0;2;2
89;23.02.2015;2015;02;01;Maanantai;1;1;2;1;0;1
89;23.02.2015;2015;02;02;Maanantai;0;1;1;1;1;2
89;23.02.2015;2015;02;03;Maanantai;6;9;15;4;7;11
89;23.02.2015;2015;02;04;Maanantai;1;4;5;1;1;2
89;23.02.2015;2015;02;05;Maanantai;8;4;12;2;2;4
89;23.02.2015;2015;02;06;Maanantai;17;35;52;7;11;18
89;23.02.2015;2015;02;07;Maanantai;59;82;141;20;39;59
89;23.02.2015;2015;02;08;Maanantai;76;73;149;39;33;72
89;23.02.2015;2015;02;09;Maanantai;47;72;119;28;36;64
89;23.02.2015;2015;02;10;Maanantai;44;34;78;25;35;60
89;23.02.2015;2015;02;11;Maanantai;53;51;104;42;30;72
89;23.02.2015;2015;02;12;Maanantai;52;49;101;32;44;76
89;23.02.2015;2015;02;13;Maanantai;48;27;75;40;32;72
89;23.02.2015;2015;02;14;Maanantai;64;45;109;50;35;85
89;23.02.2015;2015;02;15;Maanantai;92;63;155;51;54;105
89;23.02.2015;2015;02;16;Maanantai;105;73;178;40;45;85
89;23.02.2015;2015;02;17;Maanantai;65;45;110;29;35;64
89;23.02.2015;2015;02;18;Maanantai;51;39;90;41;32;73
89;23.02.2015;2015;02;19;Maanantai;29;31;60;36;30;66
89;23.02.2015;2015;02;20;Maanantai;36;20;56;24;26;50
89;23.02.2015;2015;02;21;Maanantai;33;17;50;17;8;25
89;23.02.2015;2015;02;22;Maanantai;8;7;15;5;8;13
89;23.02.2015;2015;02;23;Maanantai;7;3;10;0;1;1
89;24.02.2015;2015;02;00;Tiistai;3;1;4;2;2;4
89;24.02.2015;2015;02;01;Tiistai;2;1;3;0;0;0
89;24.02.2015;2015;02;02;Tiistai;2;0;2;2;0;2
89;24.02.2015;2015;02;03;Tiistai;0;3;3;2;1;3
89;24.02.2015;2015;02;04;Tiistai;2;2;4;0;0;0
89;24.02.2015;2015;02;05;Tiistai;3;2;5;1;3;4
89;24.02.2015;2015;02;06;Tiistai;24;29;53;10;11;21
89;24.02.2015;2015;02;07;Tiistai;40;89;129;26;51;77
89;24.02.2015;2015;02;08;Tiistai;59;107;166;32;50;82
89;24.02.2015;2015;02;09;Tiistai;37;53;90;18;33;51
89;24.02.2015;2015;02;10;Tiistai;22;37;59;20;31;51
89;24.02.2015;2015;02;11;Tiistai;25;39;64;30;50;80
89;24.02.2015;2015;02;12;Tiistai;38;32;70;25;42;67
89;24.02.2015;2015;02;13;Tiistai;38;33;71;63;38;101
89;24.02.2015;2015;02;14;Tiistai;79;44;123;44;28;72
89;24.02.2015;2015;02;15;Tiistai;83;54;137;50;33;83
89;24.02.2015;2015;02;16;Tiistai;137;61;198;47;27;74
89;24.02.2015;2015;02;17;Tiistai;63;46;109;51;27;78
89;24.02.2015;2015;02;18;Tiistai;43;39;82;44;37;81
89;24.02.2015;2015;02;19;Tiistai;44;21;65;30;29;59
89;24.02.2015;2015;02;20;Tiistai;27;22;49;25;26;51
89;24.02.2015;2015;02;21;Tiistai;35;17;52;17;10;27
89;24.02.2015;2015;02;22;Tiistai;10;8;18;8;2;10
89;24.02.2015;2015;02;23;Tiistai;5;3;8;3;4;7
89;25.02.2015;2015;02;00;Keskiviikko;4;0;4;3;5;8
89;25.02.2015;2015;02;01;Keskiviikko;4;2;6;1;1;2
89;25.02.2015;2015;02;02;Keskiviikko;2;0;2;0;0;0
89;25.02.2015;2015;02;03;Keskiviikko;0;2;2;1;0;1
89;25.02.2015;2015;02;04;Keskiviikko;0;1;1;1;0;1
89;25.02.2015;2015;02;05;Keskiviikko;5;5;10;2;4;6
89;25.02.2015;2015;02;06;Keskiviikko;23;30;53;9;9;18
89;25.02.2015;2015;02;07;Keskiviikko;61;91;152;20;41;61
89;25.02.2015;2015;02;08;Keskiviikko;51;116;167;20;50;70
89;25.02.2015;2015;02;09;Keskiviikko;36;64;100;16;43;59
89;25.02.2015;2015;02;10;Keskiviikko;25;53;78;27;22;49
89;25.02.2015;2015;02;11;Keskiviikko;41;43;84;35;36;71
89;25.02.2015;2015;02;12;Keskiviikko;46;58;104;48;37;85
89;25.02.2015;2015;02;13;Keskiviikko;44;38;82;36;27;63
89;25.02.2015;2015;02;14;Keskiviikko;69;53;122;56;43;99
89;25.02.2015;2015;02;15;Keskiviikko;77;57;134;40;39;79
89;25.02.2015;2015;02;16;Keskiviikko;118;78;196;44;42;86
89;25.02.2015;2015;02;17;Keskiviikko;79;50;129;46;38;84
89;25.02.2015;2015;02;18;Keskiviikko;49;42;91;30;25;55
89;25.02.2015;2015;02;19;Keskiviikko;40;20;60;26;19;45
89;25.02.2015;2015;02;20;Keskiviikko;37;29;66;27;21;48
89;25.02.2015;2015;02;21;Keskiviikko;27;15;42;14;14;28
89;25.02.2015;2015;02;22;Keskiviikko;10;7;17;6;4;10
89;25.02.2015;2015;02;23;Keskiviikko;5;0;5;2;4;6
89;26.02.2015;2015;02;00;Torstai;1;4;5;6;1;7
89;26.02.2015;2015;02;01;Torstai;0;2;2;1;1;2
89;26.02.2015;2015;02;02;Torstai;2;1;3;1;2;3
89;26.02.2015;2015;02;03;Torstai;0;0;0;3;1;4
89;26.02.2015;2015;02;04;Torstai;0;4;4;0;1;1
89;26.02.2015;2015;02;05;Torstai;4;12;16;2;0;2
89;26.02.2015;2015;02;06;Torstai;24;25;49;5;5;10
89;26.02.2015;2015;02;07;Torstai;45;95;140;18;43;61
89;26.02.2015;2015;02;08;Torstai;42;116;158;21;45;66
89;26.02.2015;2015;02;09;Torstai;27;61;88;12;29;41
89;26.02.2015;2015;02;10;Torstai;31;40;71;27;24;51
89;26.02.2015;2015;02;11;Torstai;40;37;77;23;23;46
89;26.02.2015;2015;02;12;Torstai;51;29;80;30;31;61
89;26.02.2015;2015;02;13;Torstai;43;36;79;42;27;69
89;26.02.2015;2015;02;14;Torstai;66;53;119;36;26;62
89;26.02.2015;2015;02;15;Torstai;87;75;162;44;17;61
89;26.02.2015;2015;02;16;Torstai;100;70;170;45;43;88
89;26.02.2015;2015;02;17;Torstai;74;64;138;33;20;53
89;26.02.2015;2015;02;18;Torstai;50;63;113;23;29;52
89;26.02.2015;2015;02;19;Torstai;41;28;69;27;25;52
89;26.02.2015;2015;02;20;Torstai;43;27;70;23;16;39
89;26.02.2015;2015;02;21;Torstai;27;13;40;26;9;35
89;26.02.2015;2015;02;22;Torstai;14;8;22;7;3;10
89;26.02.2015;2015;02;23;Torstai;5;7;12;5;1;6
89;27.02.2015;2015;02;00;Perjantai;7;3;10;8;1;9
89;27.02.2015;2015;02;01;Perjantai;2;0;2;0;1;1
89;27.02.2015;2015;02;02;Perjantai;0;1;1;1;0;1
89;27.02.2015;2015;02;03;Perjantai;4;1;5;0;1;1
89;27.02.2015;2015;02;04;Perjantai;2;1;3;1;1;2
89;27.02.2015;2015;02;05;Perjantai;1;4;5;4;3;7
89;27.02.2015;2015;02;06;Perjantai;8;30;38;7;10;17
89;27.02.2015;2015;02;07;Perjantai;34;119;153;7;46;53
89;27.02.2015;2015;02;08;Perjantai;29;109;138;21;49;70
89;27.02.2015;2015;02;09;Perjantai;27;59;86;15;50;65
89;27.02.2015;2015;02;10;Perjantai;21;56;77;20;31;51
89;27.02.2015;2015;02;11;Perjantai;47;62;109;41;39;80
89;27.02.2015;2015;02;12;Perjantai;45;64;109;37;39;76
89;27.02.2015;2015;02;13;Perjantai;52;50;102;51;30;81
89;27.02.2015;2015;02;14;Perjantai;86;57;143;25;30;55
89;27.02.2015;2015;02;15;Perjantai;96;49;145;53;18;71
89;27.02.2015;2015;02;16;Perjantai;78;71;149;42;25;67
89;27.02.2015;2015;02;17;Perjantai;75;43;118;24;20;44
89;27.02.2015;2015;02;18;Perjantai;53;33;86;20;22;42
89;27.02.2015;2015;02;19;Perjantai;24;20;44;28;13;41
89;27.02.2015;2015;02;20;Perjantai;19;16;35;15;3;18
89;27.02.2015;2015;02;21;Perjantai;28;16;44;12;8;20
89;27.02.2015;2015;02;22;Perjantai;9;21;30;5;9;14
89;27.02.2015;2015;02;23;Perjantai;19;3;22;5;8;13
89;28.02.2015;2015;02;00;Lauantai;9;8;17;7;5;12
89;28.02.2015;2015;02;01;Lauantai;5;14;19;5;4;9
89;28.02.2015;2015;02;02;Lauantai;4;1;5;8;3;11
89;28.02.2015;2015;02;03;Lauantai;7;6;13;23;8;31
89;28.02.2015;2015;02;04;Lauantai;5;0;5;3;1;4
89;28.02.2015;2015;02;05;Lauantai;7;6;13;1;4;5
89;28.02.2015;2015;02;06;Lauantai;1;3;4;2;4;6
89;28.02.2015;2015;02;07;Lauantai;3;9;12;5;4;9
89;28.02.2015;2015;02;08;Lauantai;8;12;20;7;15;22
89;28.02.2015;2015;02;09;Lauantai;11;32;43;29;20;49
89;28.02.2015;2015;02;10;Lauantai;16;37;53;25;32;57
89;28.02.2015;2015;02;11;Lauantai;22;48;70;30;47;77
89;28.02.2015;2015;02;12;Lauantai;38;57;95;42;25;67
89;28.02.2015;2015;02;13;Lauantai;26;34;60;35;31;66
89;28.02.2015;2015;02;14;Lauantai;40;47;87;34;28;62
89;28.02.2015;2015;02;15;Lauantai;30;40;70;24;25;49
89;28.02.2015;2015;02;16;Lauantai;52;45;97;27;35;62
89;28.02.2015;2015;02;17;Lauantai;23;25;48;34;20;54
89;28.02.2015;2015;02;18;Lauantai;25;38;63;26;19;45
89;28.02.2015;2015;02;19;Lauantai;25;19;44;18;17;35
89;28.02.2015;2015;02;20;Lauantai;16;19;35;13;10;23
89;28.02.2015;2015;02;21;Lauantai;35;11;46;9;10;19
89;28.02.2015;2015;02;22;Lauantai;24;4;28;6;10;16
89;28.02.2015;2015;02;23;Lauantai;14;13;27;2;8;10
89;01.03.2015;2015;03;00;Sunnuntai;10;15;25;4;3;7
89;01.03.2015;2015;03;01;Sunnuntai;5;6;11;9;9;18
89;01.03.2015;2015;03;02;Sunnuntai;10;5;15;4;2;6
89;01.03.2015;2015;03;03;Sunnuntai;7;4;11;4;0;4
89;01.03.2015;2015;03;04;Sunnuntai;10;0;10;6;2;8
89;01.03.2015;2015;03;05;Sunnuntai;3;3;6;1;2;3
89;01.03.2015;2015;03;06;Sunnuntai;0;5;5;2;2;4
89;01.03.2015;2015;03;07;Sunnuntai;3;5;8;3;5;8
89;01.03.2015;2015;03;08;Sunnuntai;4;5;9;11;11;22
89;01.03.2015;2015;03;09;Sunnuntai;12;16;28;24;33;57
89;01.03.2015;2015;03;10;Sunnuntai;6;28;34;42;40;82
89;01.03.2015;2015;03;11;Sunnuntai;23;31;54;50;46;96
89;01.03.2015;2015;03;12;Sunnuntai;31;52;83;40;44;84
89;01.03.2015;2015;03;13;Sunnuntai;25;17;42;50;37;87
89;01.03.2015;2015;03;14;Sunnuntai;20;34;54;42;25;67
89;01.03.2015;2015;03;15;Sunnuntai;38;29;67;43;33;76
89;01.03.2015;2015;03;16;Sunnuntai;31;19;50;38;27;65
89;01.03.2015;2015;03;17;Sunnuntai;22;41;63;37;43;80
89;01.03.2015;2015;03;18;Sunnuntai;23;20;43;26;27;53
89;01.03.2015;2015;03;19;Sunnuntai;11;14;25;20;19;39
89;01.03.2015;2015;03;20;Sunnuntai;11;9;20;14;6;20
89;01.03.2015;2015;03;21;Sunnuntai;14;6;20;6;9;15
89;01.03.2015;2015;03;22;Sunnuntai;5;5;10;2;4;6
89;01.03.2015;2015;03;23;Sunnuntai;4;3;7;4;2;6
89;02.03.2015;2015;03;00;Maanantai;4;0;4;5;3;8
89;02.03.2015;2015;03;01;Maanantai;0;3;3;1;4;5
89;02.03.2015;2015;03;02;Maanantai;2;0;2;1;0;1
89;02.03.2015;2015;03;03;Maanantai;6;0;6;1;0;1
89;02.03.2015;2015;03;04;Maanantai;2;4;6;0;0;0
89;02.03.2015;2015;03;05;Maanantai;3;6;9;2;1;3
89;02.03.2015;2015;03;06;Maanantai;10;30;40;4;7;11
89;02.03.2015;2015;03;07;Maanantai;20;86;106;4;35;39
89;02.03.2015;2015;03;08;Maanantai;19;85;104;14;42;56
89;02.03.2015;2015;03;09;Maanantai;15;46;61;9;42;51
89;02.03.2015;2015;03;10;Maanantai;27;41;68;25;26;51
89;02.03.2015;2015;03;11;Maanantai;35;47;82;36;22;58
89;02.03.2015;2015;03;12;Maanantai;38;37;75;33;30;63
89;02.03.2015;2015;03;13;Maanantai;34;43;77;30;26;56
89;02.03.2015;2015;03;14;Maanantai;44;38;82;34;28;62
89;02.03.2015;2015;03;15;Maanantai;75;61;136;54;39;93
89;02.03.2015;2015;03;16;Maanantai;82;44;126;56;18;74
89;02.03.2015;2015;03;17;Maanantai;49;31;80;30;20;50
89;02.03.2015;2015;03;18;Maanantai;37;34;71;28;23;51
89;02.03.2015;2015;03;19;Maanantai;29;12;41;32;14;46
89;02.03.2015;2015;03;20;Maanantai;21;10;31;15;7;22
89;02.03.2015;2015;03;21;Maanantai;19;12;31;7;7;14
89;02.03.2015;2015;03;22;Maanantai;8;6;14;6;3;9
89;02.03.2015;2015;03;23;Maanantai;5;0;5;3;3;6
89;03.03.2015;2015;03;00;Tiistai;1;1;2;3;1;4
89;03.03.2015;2015;03;01;Tiistai;7;1;8;1;1;2
89;03.03.2015;2015;03;02;Tiistai;2;0;2;5;2;7
89;03.03.2015;2015;03;03;Tiistai;0;2;2;5;1;6
89;03.03.2015;2015;03;04;Tiistai;3;1;4;2;0;2
89;03.03.2015;2015;03;05;Tiistai;1;9;10;3;4;7
89;03.03.2015;2015;03;06;Tiistai;9;32;41;6;6;12
89;03.03.2015;2015;03;07;Tiistai;17;87;104;8;27;35
89;03.03.2015;2015;03;08;Tiistai;14;77;91;8;50;58
89;03.03.2015;2015;03;09;Tiistai;11;32;43;28;33;61
89;03.03.2015;2015;03;10;Tiistai;23;47;70;35;50;85
89;03.03.2015;2015;03;11;Tiistai;21;51;72;29;36;65
89;03.03.2015;2015;03;12;Tiistai;37;28;65;26;30;56
89;03.03.2015;2015;03;13;Tiistai;37;42;79;30;18;48
89;03.03.2015;2015;03;14;Tiistai;56;30;86;51;26;77
89;03.03.2015;2015;03;15;Tiistai;57;50;107;40;28;68
89;03.03.2015;2015;03;16;Tiistai;78;47;125;48;17;65
89;03.03.2015;2015;03;17;Tiistai;57;39;96;23;26;49
89;03.03.2015;2015;03;18;Tiistai;42;26;68;38;36;74
89;03.03.2015;2015;03;19;Tiistai;32;20;52;28;16;44
89;03.03.2015;2015;03;20;Tiistai;25;16;41;18;13;31
89;03.03.2015;2015;03;21;Tiistai;25;18;43;14;5;19
89;03.03.2015;2015;03;22;Tiistai;5;7;12;4;9;13
89;03.03.2015;2015;03;23;Tiistai;5;5;10;1;1;2
89;04.03.2015;2015;03;00;Keskiviikko;3;2;5;3;0;3
89;04.03.2015;2015;03;01;Keskiviikko;4;1;5;1;2;3
89;04.03.2015;2015;03;02;Keskiviikko;3;1;4;1;3;4
89;04.03.2015;2015;03;03;Keskiviikko;1;3;4;3;1;4
89;04.03.2015;2015;03;04;Keskiviikko;2;2;4;1;1;2
89;04.03.2015;2015;03;05;Keskiviikko;1;9;10;2;2;4
89;04.03.2015;2015;03;06;Keskiviikko;9;26;35;4;12;16
89;04.03.2015;2015;03;07;Keskiviikko;19;73;92;8;26;34
89;04.03.2015;2015;03;08;Keskiviikko;24;69;93;8;33;41
89;04.03.2015;2015;03;09;Keskiviikko;10;38;48;18;32;50
89;04.03.2015;2015;03;10;Keskiviikko;21;32;53;21;23;44
89;04.03.2015;2015;03;11;Keskiviikko;36;50;86;18;33;51
89;04.03.2015;2015;03;12;Keskiviikko;29;34;63;39;33;72
89;04.03.2015;2015;03;13;Keskiviikko;24;34;58;24;28;52
89;04.03.2015;2015;03;14;Keskiviikko;52;27;79;31;27;58
89;04.03.2015;2015;03;15;Keskiviikko;64;51;115;37;15;52
89;04.03.2015;2015;03;16;Keskiviikko;72;37;109;47;28;75
89;04.03.2015;2015;03;17;Keskiviikko;65;48;113;40;24;64
89;04.03.2015;2015;03;18;Keskiviikko;29;25;54;34;34;68
89;04.03.2015;2015;03;19;Keskiviikko;34;26;60;18;21;39
89;04.03.2015;2015;03;20;Keskiviikko;30;27;57;33;14;47
89;04.03.2015;2015;03;21;Keskiviikko;20;15;35;4;6;10
89;04.03.2015;2015;03;22;Keskiviikko;10;4;14;5;8;13
89;04.03.2015;2015;03;23;Keskiviikko;7;1;8;4;5;9
89;05.03.2015;2015;03;00;Torstai;2;1;3;3;1;4
89;05.03.2015;2015;03;01;Torstai;2;3;5;2;1;3
89;05.03.2015;2015;03;02;Torstai;4;2;6;1;2;3
89;05.03.2015;2015;03;03;Torstai;6;2;8;4;2;6
89;05.03.2015;2015;03;04;Torstai;2;0;2;4;0;4
89;05.03.2015;2015;03;05;Torstai;3;7;10;1;3;4
89;05.03.2015;2015;03;06;Torstai;10;29;39;2;6;8
89;05.03.2015;2015;03;07;Torstai;24;97;121;7;32;39
89;05.03.2015;2015;03;08;Torstai;10;80;90;13;25;38
89;05.03.2015;2015;03;09;Torstai;17;53;70;11;36;47
89;05.03.2015;2015;03;10;Torstai;27;36;63;44;42;86
89;05.03.2015;2015;03;11;Torstai;23;37;60;23;47;70
89;05.03.2015;2015;03;12;Torstai;30;37;67;34;34;68
89;05.03.2015;2015;03;13;Torstai;33;30;63;43;28;71
89;05.03.2015;2015;03;14;Torstai;53;42;95;36;24;60
89;05.03.2015;2015;03;15;Torstai;66;41;107;35;23;58
89;05.03.2015;2015;03;16;Torstai;79;39;118;45;26;71
89;05.03.2015;2015;03;17;Torstai;42;33;75;43;29;72
89;05.03.2015;2015;03;18;Torstai;39;29;68;35;29;64
89;05.03.2015;2015;03;19;Torstai;27;11;38;29;26;55
89;05.03.2015;2015;03;20;Torstai;18;19;37;22;16;38
89;05.03.2015;2015;03;21;Torstai;25;11;36;10;11;21
89;05.03.2015;2015;03;22;Torstai;17;6;23;4;2;6
89;05.03.2015;2015;03;23;Torstai;6;5;11;7;2;9
89;06.03.2015;2015;03;00;Perjantai;3;1;4;7;2;9
89;06.03.2015;2015;03;01;Perjantai;4;3;7;4;0;4
89;06.03.2015;2015;03;02;Perjantai;3;0;3;1;2;3
89;06.03.2015;2015;03;03;Perjantai;4;1;5;0;0;0
89;06.03.2015;2015;03;04;Perjantai;2;2;4;2;2;4
89;06.03.2015;2015;03;05;Perjantai;3;3;6;2;1;3
89;06.03.2015;2015;03;06;Perjantai;10;24;34;5;9;14
89;06.03.2015;2015;03;07;Perjantai;20;69;89;7;26;33
89;06.03.2015;2015;03;08;Perjantai;16;71;87;6;34;40
89;06.03.2015;2015;03;09;Perjantai;12;45;57;15;27;42
89;06.03.2015;2015;03;10;Perjantai;15;25;40;17;17;34
89;06.03.2015;2015;03;11;Perjantai;19;49;68;16;27;43
89;06.03.2015;2015;03;12;Perjantai;21;54;75;28;40;68
89;06.03.2015;2015;03;13;Perjantai;28;52;80;34;29;63
89;06.03.2015;2015;03;14;Perjantai;45;42;87;36;27;63
89;06.03.2015;2015;03;15;Perjantai;79;45;124;54;26;80
89;06.03.2015;2015;03;16;Perjantai;78;46;124;40;50;90
89;06.03.2015;2015;03;17;Perjantai;40;32;72;38;23;61
89;06.03.2015;2015;03;18;Perjantai;40;28;68;20;27;47
89;06.03.2015;2015;03;19;Perjantai;22;25;47;22;19;41
89;06.03.2015;2015;03;20;Perjantai;38;28;66;12;7;19
89;06.03.2015;2015;03;21;Perjantai;31;15;46;14;12;26
89;06.03.2015;2015;03;22;Perjantai;11;7;18;19;9;28
89;06.03.2015;2015;03;23;Perjantai;10;18;28;7;10;17
89;07.03.2015;2015;03;00;Lauantai;11;9;20;3;6;9
89;07.03.2015;2015;03;01;Lauantai;13;0;13;6;2;8
89;07.03.2015;2015;03;02;Lauantai;9;5;14;6;7;13
89;07.03.2015;2015;03;03;Lauantai;9;2;11;9;2;11
89;07.03.2015;2015;03;04;Lauantai;7;1;8;1;0;1
89;07.03.2015;2015;03;05;Lauantai;1;0;1;0;0;0
89;07.03.2015;2015;03;06;Lauantai;3;5;8;2;1;3
89;07.03.2015;2015;03;07;Lauantai;2;9;11;4;4;8
89;07.03.2015;2015;03;08;Lauantai;7;15;22;12;9;21
89;07.03.2015;2015;03;09;Lauantai;9;29;38;14;38;52
89;07.03.2015;2015;03;10;Lauantai;8;35;43;38;48;86
89;07.03.2015;2015;03;11;Lauantai;19;30;49;33;44;77
89;07.03.2015;2015;03;12;Lauantai;24;49;73;30;35;65
89;07.03.2015;2015;03;13;Lauantai;32;21;53;28;23;51
89;07.03.2015;2015;03;14;Lauantai;22;25;47;22;11;33
89;07.03.2015;2015;03;15;Lauantai;20;25;45;20;13;33
89;07.03.2015;2015;03;16;Lauantai;28;21;49;18;13;31
89;07.03.2015;2015;03;17;Lauantai;23;14;37;12;20;32
89;07.03.2015;2015;03;18;Lauantai;30;8;38;12;6;18
89;07.03.2015;2015;03;19;Lauantai;11;7;18;11;10;21
89;07.03.2015;2015;03;20;Lauantai;9;9;18;5;4;9
89;07.03.2015;2015;03;21;Lauantai;6;18;24;6;8;14
89;07.03.2015;2015;03;22;Lauantai;3;5;8;6;3;9
89;07.03.2015;2015;03;23;Lauantai;12;9;21;6;7;13
89;08.03.2015;2015;03;00;Sunnuntai;4;4;8;4;5;9
89;08.03.2015;2015;03;01;Sunnuntai;7;1;8;5;2;7
89;08.03.2015;2015;03;02;Sunnuntai;3;2;5;8;0;8
89;08.03.2015;2015;03;03;Sunnuntai;6;0;6;7;2;9
89;08.03.2015;2015;03;04;Sunnuntai;7;1;8;8;0;8
89;08.03.2015;2015;03;05;Sunnuntai;2;0;2;1;1;2
89;08.03.2015;2015;03;06;Sunnuntai;2;6;8;1;2;3
89;08.03.2015;2015;03;07;Sunnuntai;1;5;6;2;1;3
89;08.03.2015;2015;03;08;Sunnuntai;3;7;10;7;6;13
89;08.03.2015;2015;03;09;Sunnuntai;4;13;17;12;11;23
89;08.03.2015;2015;03;10;Sunnuntai;10;20;30;24;21;45
89;08.03.2015;2015;03;11;Sunnuntai;11;21;32;55;42;97
89;08.03.2015;2015;03;12;Sunnuntai;12;26;38;34;44;78
89;08.03.2015;2015;03;13;Sunnuntai;29;36;65;65;65;130
89;08.03.2015;2015;03;14;Sunnuntai;32;32;64;47;50;97
89;08.03.2015;2015;03;15;Sunnuntai;33;37;70;62;60;122
89;08.03.2015;2015;03;16;Sunnuntai;34;28;62;41;42;83
89;08.03.2015;2015;03;17;Sunnuntai;33;31;64;38;40;78
89;08.03.2015;2015;03;18;Sunnuntai;38;16;54;44;47;91
89;08.03.2015;2015;03;19;Sunnuntai;27;11;38;29;26;55
89;08.03.2015;2015;03;20;Sunnuntai;13;10;23;22;15;37
89;08.03.2015;2015;03;21;Sunnuntai;7;7;14;15;5;20
89;08.03.2015;2015;03;22;Sunnuntai;6;5;11;3;4;7
89;08.03.2015;2015;03;23;Sunnuntai;2;1;3;2;6;8
89;09.03.2015;2015;03;00;Maanantai;5;0;5;3;1;4
89;09.03.2015;2015;03;01;Maanantai;0;0;0;0;1;1
89;09.03.2015;2015;03;02;Maanantai;0;0;0;0;0;0
89;09.03.2015;2015;03;03;Maanantai;0;2;2;0;0;0
89;09.03.2015;2015;03;04;Maanantai;0;1;1;1;0;1
89;09.03.2015;2015;03;05;Maanantai;0;7;7;3;0;3
89;09.03.2015;2015;03;06;Maanantai;11;31;42;0;7;7
89;09.03.2015;2015;03;07;Maanantai;33;150;183;6;33;39
89;09.03.2015;2015;03;08;Maanantai;42;165;207;12;55;67
89;09.03.2015;2015;03;09;Maanantai;35;87;122;21;48;69
89;09.03.2015;2015;03;10;Maanantai;31;61;92;38;25;63
89;09.03.2015;2015;03;11;Maanantai;51;49;100;39;54;93
89;09.03.2015;2015;03;12;Maanantai;62;49;111;41;37;78
89;09.03.2015;2015;03;13;Maanantai;60;62;122;41;40;81
89;09.03.2015;2015;03;14;Maanantai;107;39;146;50;28;78
89;09.03.2015;2015;03;15;Maanantai;108;74;182;49;34;83
89;09.03.2015;2015;03;16;Maanantai;145;70;215;57;27;84
89;09.03.2015;2015;03;17;Maanantai;69;53;122;44;34;78
89;09.03.2015;2015;03;18;Maanantai;56;41;97;46;31;77
89;09.03.2015;2015;03;19;Maanantai;45;23;68;33;17;50
89;09.03.2015;2015;03;20;Maanantai;41;23;64;22;19;41
89;09.03.2015;2015;03;21;Maanantai;26;14;40;16;10;26
89;09.03.2015;2015;03;22;Maanantai;9;9;18;8;2;10
89;09.03.2015;2015;03;23;Maanantai;8;2;10;2;4;6
89;10.03.2015;2015;03;00;Tiistai;2;0;2;1;1;2
89;10.03.2015;2015;03;01;Tiistai;4;2;6;0;0;0
89;10.03.2015;2015;03;02;Tiistai;1;1;2;0;0;0
89;10.03.2015;2015;03;03;Tiistai;1;2;3;0;0;0
89;10.03.2015;2015;03;04;Tiistai;2;2;4;2;0;2
89;10.03.2015;2015;03;05;Tiistai;3;8;11;3;1;4
89;10.03.2015;2015;03;06;Tiistai;14;39;53;2;10;12
89;10.03.2015;2015;03;07;Tiistai;46;137;183;11;37;48
89;10.03.2015;2015;03;08;Tiistai;50;177;227;15;55;70
89;10.03.2015;2015;03;09;Tiistai;37;83;120;14;38;52
89;10.03.2015;2015;03;10;Tiistai;29;59;88;30;31;61
89;10.03.2015;2015;03;11;Tiistai;40;52;92;30;32;62
89;10.03.2015;2015;03;12;Tiistai;46;55;101;35;29;64
89;10.03.2015;2015;03;13;Tiistai;59;29;88;32;24;56
89;10.03.2015;2015;03;14;Tiistai;70;32;102;36;22;58
89;10.03.2015;2015;03;15;Tiistai;106;62;168;39;14;53
89;10.03.2015;2015;03;16;Tiistai;123;61;184;33;18;51
89;10.03.2015;2015;03;17;Tiistai;72;58;130;34;21;55
89;10.03.2015;2015;03;18;Tiistai;60;33;93;32;25;57
89;10.03.2015;2015;03;19;Tiistai;35;26;61;23;9;32
89;10.03.2015;2015;03;20;Tiistai;44;13;57;16;15;31
89;10.03.2015;2015;03;21;Tiistai;35;6;41;10;8;18
89;10.03.2015;2015;03;22;Tiistai;13;4;17;3;3;6
89;10.03.2015;2015;03;23;Tiistai;3;4;7;4;4;8
89;11.03.2015;2015;03;00;Keskiviikko;3;4;7;0;1;1
89;11.03.2015;2015;03;01;Keskiviikko;1;0;1;2;3;5
89;11.03.2015;2015;03;02;Keskiviikko;1;0;1;1;0;1
89;11.03.2015;2015;03;03;Keskiviikko;0;2;2;0;0;0
89;11.03.2015;2015;03;04;Keskiviikko;3;1;4;1;0;1
89;11.03.2015;2015;03;05;Keskiviikko;3;10;13;4;1;5
89;11.03.2015;2015;03;06;Keskiviikko;15;35;50;5;13;18
89;11.03.2015;2015;03;07;Keskiviikko;41;142;183;5;46;51
89;11.03.2015;2015;03;08;Keskiviikko;45;170;215;18;54;72
89;11.03.2015;2015;03;09;Keskiviikko;34;67;101;17;47;64
89;11.03.2015;2015;03;10;Keskiviikko;29;50;79;30;39;69
89;11.03.2015;2015;03;11;Keskiviikko;41;65;106;35;40;75
89;11.03.2015;2015;03;12;Keskiviikko;46;61;107;41;43;84
89;11.03.2015;2015;03;13;Keskiviikko;66;50;116;38;52;90
89;11.03.2015;2015;03;14;Keskiviikko;91;65;156;55;28;83
89;11.03.2015;2015;03;15;Keskiviikko;130;73;203;41;33;74
89;11.03.2015;2015;03;16;Keskiviikko;121;85;206;66;40;106
89;11.03.2015;2015;03;17;Keskiviikko;105;84;189;50;34;84
89;11.03.2015;2015;03;18;Keskiviikko;64;32;96;35;40;75
89;11.03.2015;2015;03;19;Keskiviikko;51;26;77;27;27;54
89;11.03.2015;2015;03;20;Keskiviikko;39;20;59;24;19;43
89;11.03.2015;2015;03;21;Keskiviikko;32;11;43;5;7;12
89;11.03.2015;2015;03;22;Keskiviikko;11;10;21;8;2;10
89;11.03.2015;2015;03;23;Keskiviikko;8;6;14;2;3;5
89;12.03.2015;2015;03;00;Torstai;1;2;3;2;0;2
89;12.03.2015;2015;03;01;Torstai;2;3;5;0;0;0
89;12.03.2015;2015;03;02;Torstai;2;1;3;4;0;4
89;12.03.2015;2015;03;03;Torstai;5;0;5;1;0;1
89;12.03.2015;2015;03;04;Torstai;2;2;4;0;1;1
89;12.03.2015;2015;03;05;Torstai;0;7;7;1;0;1
89;12.03.2015;2015;03;06;Torstai;20;41;61;8;16;24
89;12.03.2015;2015;03;07;Torstai;41;144;185;15;43;58
89;12.03.2015;2015;03;08;Torstai;45;168;213;20;60;80
89;12.03.2015;2015;03;09;Torstai;33;95;128;21;40;61
89;12.03.2015;2015;03;10;Torstai;24;77;101;28;34;62
89;12.03.2015;2015;03;11;Torstai;54;56;110;34;48;82
89;12.03.2015;2015;03;12;Torstai;41;57;98;37;43;80
89;12.03.2015;2015;03;13;Torstai;62;60;122;50;36;86
89;12.03.2015;2015;03;14;Torstai;72;59;131;57;29;86
89;12.03.2015;2015;03;15;Torstai;118;74;192;61;47;108
89;12.03.2015;2015;03;16;Torstai;140;73;213;53;23;76
89;12.03.2015;2015;03;17;Torstai;88;71;159;36;34;70
89;12.03.2015;2015;03;18;Torstai;65;45;110;32;23;55
89;12.03.2015;2015;03;19;Torstai;51;53;104;28;19;47
89;12.03.2015;2015;03;20;Torstai;45;32;77;18;10;28
89;12.03.2015;2015;03;21;Torstai;32;16;48;15;6;21
89;12.03.2015;2015;03;22;Torstai;16;7;23;8;7;15
89;12.03.2015;2015;03;23;Torstai;12;5;17;4;2;6
89;13.03.2015;2015;03;00;Perjantai;5;5;10;3;1;4
89;13.03.2015;2015;03;01;Perjantai;6;1;7;2;3;5
89;13.03.2015;2015;03;02;Perjantai;4;2;6;1;0;1
89;13.03.2015;2015;03;03;Perjantai;6;1;7;5;0;5
89;13.03.2015;2015;03;04;Perjantai;3;0;3;2;0;2
89;13.03.2015;2015;03;05;Perjantai;1;9;10;2;1;3
89;13.03.2015;2015;03;06;Perjantai;14;36;50;2;13;15
89;13.03.2015;2015;03;07;Perjantai;39;127;166;9;39;48
89;13.03.2015;2015;03;08;Perjantai;42;168;210;14;57;71
89;13.03.2015;2015;03;09;Perjantai;20;85;105;20;48;68
89;13.03.2015;2015;03;10;Perjantai;27;75;102;18;32;50
89;13.03.2015;2015;03;11;Perjantai;33;62;95;33;46;79
89;13.03.2015;2015;03;12;Perjantai;54;67;121;36;40;76
89;13.03.2015;2015;03;13;Perjantai;81;50;131;52;38;90
89;13.03.2015;2015;03;14;Perjantai;89;72;161;43;34;77
89;13.03.2015;2015;03;15;Perjantai;117;71;188;60;37;97
89;13.03.2015;2015;03;16;Perjantai;113;67;180;45;32;77
89;13.03.2015;2015;03;17;Perjantai;65;63;128;39;37;76
89;13.03.2015;2015;03;18;Perjantai;55;34;89;26;39;65
89;13.03.2015;2015;03;19;Perjantai;51;30;81;34;13;47
89;13.03.2015;2015;03;20;Perjantai;29;16;45;11;16;27
89;13.03.2015;2015;03;21;Perjantai;17;18;35;6;9;15
89;13.03.2015;2015;03;22;Perjantai;21;29;50;7;12;19
89;13.03.2015;2015;03;23;Perjantai;16;19;35;9;6;15
89;14.03.2015;2015;03;00;Lauantai;10;12;22;5;3;8
89;14.03.2015;2015;03;01;Lauantai;13;4;17;7;1;8
89;14.03.2015;2015;03;02;Lauantai;12;8;20;6;2;8
89;14.03.2015;2015;03;03;Lauantai;18;3;21;5;2;7
89;14.03.2015;2015;03;04;Lauantai;8;3;11;7;2;9
89;14.03.2015;2015;03;05;Lauantai;1;1;2;1;0;1
89;14.03.2015;2015;03;06;Lauantai;7;9;16;1;2;3
89;14.03.2015;2015;03;07;Lauantai;1;7;8;4;9;13
89;14.03.2015;2015;03;08;Lauantai;9;24;33;13;12;25
89;14.03.2015;2015;03;09;Lauantai;3;45;48;22;42;64
89;14.03.2015;2015;03;10;Lauantai;22;42;64;32;41;73
89;14.03.2015;2015;03;11;Lauantai;36;46;82;39;68;107
89;14.03.2015;2015;03;12;Lauantai;41;61;102;40;86;126
89;14.03.2015;2015;03;13;Lauantai;53;43;96;58;71;129
89;14.03.2015;2015;03;14;Lauantai;63;38;101;68;50;118
89;14.03.2015;2015;03;15;Lauantai;59;48;107;57;48;105
89;14.03.2015;2015;03;16;Lauantai;50;40;90;45;39;84
89;14.03.2015;2015;03;17;Lauantai;46;40;86;38;30;68
89;14.03.2015;2015;03;18;Lauantai;31;22;53;29;20;49
89;14.03.2015;2015;03;19;Lauantai;18;32;50;16;16;32
89;14.03.2015;2015;03;20;Lauantai;24;19;43;9;8;17
89;14.03.2015;2015;03;21;Lauantai;15;10;25;11;9;20
89;14.03.2015;2015;03;22;Lauantai;14;14;28;10;7;17
89;14.03.2015;2015;03;23;Lauantai;21;7;28;8;8;16
89;15.03.2015;2015;03;00;Sunnuntai;10;7;17;2;2;4
89;15.03.2015;2015;03;01;Sunnuntai;12;3;15;7;4;11
89;15.03.2015;2015;03;02;Sunnuntai;9;2;11;5;2;7
89;15.03.2015;2015;03;03;Sunnuntai;8;0;8;7;2;9
89;15.03.2015;2015;03;04;Sunnuntai;6;2;8;6;0;6
89;15.03.2015;2015;03;05;Sunnuntai;4;0;4;0;1;1
89;15.03.2015;2015;03;06;Sunnuntai;4;4;8;3;3;6
89;15.03.2015;2015;03;07;Sunnuntai;4;10;14;3;2;5
89;15.03.2015;2015;03;08;Sunnuntai;6;4;10;12;15;27
89;15.03.2015;2015;03;09;Sunnuntai;14;18;32;25;29;54
89;15.03.2015;2015;03;10;Sunnuntai;15;25;40;37;50;87
89;15.03.2015;2015;03;11;Sunnuntai;28;64;92;57;65;122
89;15.03.2015;2015;03;12;Sunnuntai;39;64;103;74;83;157
89;15.03.2015;2015;03;13;Sunnuntai;55;65;120;74;90;164
89;15.03.2015;2015;03;14;Sunnuntai;57;60;117;63;60;123
89;15.03.2015;2015;03;15;Sunnuntai;40;56;96;75;65;140
89;15.03.2015;2015;03;16;Sunnuntai;57;37;94;63;43;106
89;15.03.2015;2015;03;17;Sunnuntai;37;28;65;41;39;80
89;15.03.2015;2015;03;18;Sunnuntai;39;14;53;36;26;62
89;15.03.2015;2015;03;19;Sunnuntai;21;16;37;19;14;33
89;15.03.2015;2015;03;20;Sunnuntai;12;7;19;15;14;29
89;15.03.2015;2015;03;21;Sunnuntai;17;8;25;14;6;20
89;15.03.2015;2015;03;22;Sunnuntai;12;3;15;5;3;8
89;15.03.2015;2015;03;23;Sunnuntai;4;2;6;2;4;6
89;16.03.2015;2015;03;00;Maanantai;2;1;3;3;0;3
89;16.03.2015;2015;03;01;Maanantai;2;1;3;0;0;0
89;16.03.2015;2015;03;02;Maanantai;0;0;0;0;0;0
89;16.03.2015;2015;03;03;Maanantai;2;1;3;0;0;0
89;16.03.2015;2015;03;04;Maanantai;1;1;2;2;0;2
89;16.03.2015;2015;03;05;Maanantai;3;9;12;4;0;4
89;16.03.2015;2015;03;06;Maanantai;15;39;54;4;10;14
89;16.03.2015;2015;03;07;Maanantai;40;144;184;7;46;53
89;16.03.2015;2015;03;08;Maanantai;32;193;225;13;60;73
89;16.03.2015;2015;03;09;Maanantai;36;107;143;21;35;56
89;16.03.2015;2015;03;10;Maanantai;30;59;89;30;35;65
89;16.03.2015;2015;03;11;Maanantai;57;57;114;39;46;85
89;16.03.2015;2015;03;12;Maanantai;36;61;97;42;47;89
89;16.03.2015;2015;03;13;Maanantai;68;53;121;46;37;83
89;16.03.2015;2015;03;14;Maanantai;100;57;157;50;49;99
89;16.03.2015;2015;03;15;Maanantai;134;62;196;58;63;121
89;16.03.2015;2015;03;16;Maanantai;148;81;229;59;38;97
89;16.03.2015;2015;03;17;Maanantai;93;51;144;53;34;87
89;16.03.2015;2015;03;18;Maanantai;63;60;123;45;40;85
89;16.03.2015;2015;03;19;Maanantai;52;24;76;32;28;60
89;16.03.2015;2015;03;20;Maanantai;46;14;60;25;12;37
89;16.03.2015;2015;03;21;Maanantai;33;10;43;14;12;26
89;16.03.2015;2015;03;22;Maanantai;7;1;8;2;4;6
89;16.03.2015;2015;03;23;Maanantai;4;7;11;7;3;10
89;17.03.2015;2015;03;00;Tiistai;3;0;3;1;0;1
89;17.03.2015;2015;03;01;Tiistai;2;0;2;0;0;0
89;17.03.2015;2015;03;02;Tiistai;3;1;4;1;0;1
89;17.03.2015;2015;03;03;Tiistai;0;1;1;0;0;0
89;17.03.2015;2015;03;04;Tiistai;1;1;2;0;0;0
89;17.03.2015;2015;03;05;Tiistai;1;9;10;3;1;4
89;17.03.2015;2015;03;06;Tiistai;19;38;57;3;11;14
89;17.03.2015;2015;03;07;Tiistai;47;154;201;10;49;59
89;17.03.2015;2015;03;08;Tiistai;43;179;222;14;53;67
89;17.03.2015;2015;03;09;Tiistai;45;99;144;29;46;75
89;17.03.2015;2015;03;10;Tiistai;34;62;96;20;31;51
89;17.03.2015;2015;03;11;Tiistai;71;72;143;41;40;81
89;17.03.2015;2015;03;12;Tiistai;74;59;133;41;40;81
89;17.03.2015;2015;03;13;Tiistai;79;59;138;47;35;82
89;17.03.2015;2015;03;14;Tiistai;103;59;162;49;40;89
89;17.03.2015;2015;03;15;Tiistai;141;87;228;51;30;81
89;17.03.2015;2015;03;16;Tiistai;141;65;206;46;21;67
89;17.03.2015;2015;03;17;Tiistai;101;68;169;38;36;74
89;17.03.2015;2015;03;18;Tiistai;67;52;119;36;33;69
89;17.03.2015;2015;03;19;Tiistai;52;31;83;32;38;70
89;17.03.2015;2015;03;20;Tiistai;46;16;62;27;19;46
89;17.03.2015;2015;03;21;Tiistai;29;24;53;7;9;16
89;17.03.2015;2015;03;22;Tiistai;16;10;26;9;3;12
89;17.03.2015;2015;03;23;Tiistai;6;9;15;3;2;5
89;18.03.2015;2015;03;00;Keskiviikko;3;1;4;4;2;6
89;18.03.2015;2015;03;01;Keskiviikko;1;1;2;1;1;2
89;18.03.2015;2015;03;02;Keskiviikko;2;0;2;4;0;4
89;18.03.2015;2015;03;03;Keskiviikko;5;4;9;2;1;3
89;18.03.2015;2015;03;04;Keskiviikko;1;2;3;1;0;1
89;18.03.2015;2015;03;05;Keskiviikko;4;10;14;4;1;5
89;18.03.2015;2015;03;06;Keskiviikko;16;38;54;4;12;16
89;18.03.2015;2015;03;07;Keskiviikko;31;175;206;10;40;50
89;18.03.2015;2015;03;08;Keskiviikko;46;180;226;15;57;72
89;18.03.2015;2015;03;09;Keskiviikko;44;94;138;23;40;63
89;18.03.2015;2015;03;10;Keskiviikko;43;52;95;20;29;49
89;18.03.2015;2015;03;11;Keskiviikko;39;61;100;35;43;78
89;18.03.2015;2015;03;12;Keskiviikko;55;54;109;42;57;99
89;18.03.2015;2015;03;13;Keskiviikko;73;52;125;49;34;83
89;18.03.2015;2015;03;14;Keskiviikko;89;58;147;49;29;78
89;18.03.2015;2015;03;15;Keskiviikko;124;65;189;32;27;59
89;18.03.2015;2015;03;16;Keskiviikko;148;73;221;53;27;80
89;18.03.2015;2015;03;17;Keskiviikko;89;82;171;38;20;58
89;18.03.2015;2015;03;18;Keskiviikko;69;48;117;49;39;88
89;18.03.2015;2015;03;19;Keskiviikko;56;24;80;27;25;52
89;18.03.2015;2015;03;20;Keskiviikko;58;19;77;32;17;49
89;18.03.2015;2015;03;21;Keskiviikko;28;11;39;9;16;25
89;18.03.2015;2015;03;22;Keskiviikko;18;10;28;9;4;13
89;18.03.2015;2015;03;23;Keskiviikko;19;6;25;11;3;14
89;19.03.2015;2015;03;00;Torstai;5;2;7;7;3;10
89;19.03.2015;2015;03;01;Torstai;3;0;3;0;2;2
89;19.03.2015;2015;03;02;Torstai;2;0;2;4;1;5
89;19.03.2015;2015;03;03;Torstai;3;2;5;0;0;0
89;19.03.2015;2015;03;04;Torstai;0;4;4;0;1;1
89;19.03.2015;2015;03;05;Torstai;2;8;10;1;1;2
89;19.03.2015;2015;03;06;Torstai;16;35;51;4;10;14
89;19.03.2015;2015;03;07;Torstai;41;139;180;15;47;62
89;19.03.2015;2015;03;08;Torstai;47;152;199;16;48;64
89;19.03.2015;2015;03;09;Torstai;25;89;114;18;40;58
89;19.03.2015;2015;03;10;Torstai;37;46;83;21;21;42
89;19.03.2015;2015;03;11;Torstai;49;63;112;28;40;68
89;19.03.2015;2015;03;12;Torstai;37;53;90;19;21;40
89;19.03.2015;2015;03;13;Torstai;53;41;94;20;11;31
89;19.03.2015;2015;03;14;Torstai;85;29;114;22;18;40
89;19.03.2015;2015;03;15;Torstai;114;58;172;40;21;61
89;19.03.2015;2015;03;16;Torstai;124;86;210;41;25;66
89;19.03.2015;2015;03;17;Torstai;75;54;129;43;21;64
89;19.03.2015;2015;03;18;Torstai;66;59;125;46;49;95
89;19.03.2015;2015;03;19;Torstai;57;32;89;32;25;57
89;19.03.2015;2015;03;20;Torstai;48;24;72;20;15;35
89;19.03.2015;2015;03;21;Torstai;38;21;59;17;6;23
89;19.03.2015;2015;03;22;Torstai;18;7;25;5;5;10
89;19.03.2015;2015;03;23;Torstai;9;6;15;0;2;2
89;20.03.2015;2015;03;00;Perjantai;7;1;8;2;1;3
89;20.03.2015;2015;03;01;Perjantai;4;0;4;2;1;3
89;20.03.2015;2015;03;02;Perjantai;1;6;7;2;1;3
89;20.03.2015;2015;03;03;Perjantai;3;3;6;1;1;2
89;20.03.2015;2015;03;04;Perjantai;5;0;5;1;0;1
89;20.03.2015;2015;03;05;Perjantai;1;10;11;2;2;4
89;20.03.2015;2015;03;06;Perjantai;12;34;46;5;13;18
89;20.03.2015;2015;03;07;Perjantai;39;135;174;8;34;42
89;20.03.2015;2015;03;08;Perjantai;35;136;171;14;47;61
89;20.03.2015;2015;03;09;Perjantai;38;65;103;19;41;60
89;20.03.2015;2015;03;10;Perjantai;33;70;103;26;49;75
89;20.03.2015;2015;03;11;Perjantai;52;82;134;33;38;71
89;20.03.2015;2015;03;12;Perjantai;78;67;145;36;41;77
89;20.03.2015;2015;03;13;Perjantai;77;50;127;41;25;66
89;20.03.2015;2015;03;14;Perjantai;96;44;140;44;38;82
89;20.03.2015;2015;03;15;Perjantai;124;77;201;39;37;76
89;20.03.2015;2015;03;16;Perjantai;117;60;177;44;28;72
89;20.03.2015;2015;03;17;Perjantai;68;63;131;32;40;72
89;20.03.2015;2015;03;18;Perjantai;47;47;94;37;22;59
89;20.03.2015;2015;03;19;Perjantai;52;41;93;22;25;47
89;20.03.2015;2015;03;20;Perjantai;41;25;66;19;18;37
89;20.03.2015;2015;03;21;Perjantai;41;11;52;9;11;20
89;20.03.2015;2015;03;22;Perjantai;17;20;37;5;8;13
89;20.03.2015;2015;03;23;Perjantai;14;13;27;12;10;22
89;21.03.2015;2015;03;00;Lauantai;10;3;13;9;1;10
89;21.03.2015;2015;03;01;Lauantai;9;6;15;5;2;7
89;21.03.2015;2015;03;02;Lauantai;17;5;22;6;0;6
89;21.03.2015;2015;03;03;Lauantai;15;4;19;9;0;9
89;21.03.2015;2015;03;04;Lauantai;10;1;11;6;1;7
89;21.03.2015;2015;03;05;Lauantai;3;2;5;0;2;2
89;21.03.2015;2015;03;06;Lauantai;2;10;12;0;2;2
89;21.03.2015;2015;03;07;Lauantai;2;16;18;6;5;11
89;21.03.2015;2015;03;08;Lauantai;6;25;31;9;15;24
89;21.03.2015;2015;03;09;Lauantai;15;37;52;22;27;49
89;21.03.2015;2015;03;10;Lauantai;15;37;52;16;41;57
89;21.03.2015;2015;03;11;Lauantai;34;55;89;38;56;94
89;21.03.2015;2015;03;12;Lauantai;36;52;88;46;56;102
89;21.03.2015;2015;03;13;Lauantai;34;47;81;45;46;91
89;21.03.2015;2015;03;14;Lauantai;50;52;102;46;36;82
89;21.03.2015;2015;03;15;Lauantai;44;49;93;52;32;84
89;21.03.2015;2015;03;16;Lauantai;48;36;84;46;38;84
89;21.03.2015;2015;03;17;Lauantai;51;31;82;33;23;56
89;21.03.2015;2015;03;18;Lauantai;47;21;68;31;19;50
89;21.03.2015;2015;03;19;Lauantai;24;27;51;22;19;41
89;21.03.2015;2015;03;20;Lauantai;20;19;39;10;8;18
89;21.03.2015;2015;03;21;Lauantai;13;18;31;9;7;16
89;21.03.2015;2015;03;22;Lauantai;15;11;26;1;5;6
89;21.03.2015;2015;03;23;Lauantai;20;9;29;3;4;7
89;22.03.2015;2015;03;00;Sunnuntai;11;15;26;9;2;11
89;22.03.2015;2015;03;01;Sunnuntai;3;6;9;2;3;5
89;22.03.2015;2015;03;02;Sunnuntai;11;3;14;4;1;5
89;22.03.2015;2015;03;03;Sunnuntai;23;2;25;12;0;12
89;22.03.2015;2015;03;04;Sunnuntai;10;0;10;6;0;6
89;22.03.2015;2015;03;05;Sunnuntai;2;0;2;1;0;1
89;22.03.2015;2015;03;06;Sunnuntai;2;6;8;0;2;2
89;22.03.2015;2015;03;07;Sunnuntai;2;13;15;7;4;11
89;22.03.2015;2015;03;08;Sunnuntai;7;6;13;12;7;19
89;22.03.2015;2015;03;09;Sunnuntai;6;15;21;19;29;48
89;22.03.2015;2015;03;10;Sunnuntai;4;18;22;27;36;63
89;22.03.2015;2015;03;11;Sunnuntai;20;32;52;33;45;78
89;22.03.2015;2015;03;12;Sunnuntai;26;35;61;38;44;82
89;22.03.2015;2015;03;13;Sunnuntai;39;38;77;32;41;73
89;22.03.2015;2015;03;14;Sunnuntai;30;33;63;31;33;64
89;22.03.2015;2015;03;15;Sunnuntai;37;41;78;25;16;41
89;22.03.2015;2015;03;16;Sunnuntai;26;23;49;19;14;33
89;22.03.2015;2015;03;17;Sunnuntai;33;22;55;19;12;31
89;22.03.2015;2015;03;18;Sunnuntai;29;11;40;14;18;32
89;22.03.2015;2015;03;19;Sunnuntai;19;10;29;20;17;37
89;22.03.2015;2015;03;20;Sunnuntai;23;8;31;21;11;32
89;22.03.2015;2015;03;21;Sunnuntai;12;18;30;12;10;22
89;22.03.2015;2015;03;22;Sunnuntai;2;7;9;0;6;6
89;22.03.2015;2015;03;23;Sunnuntai;4;2;6;5;0;5
89;23.03.2015;2015;03;00;Maanantai;3;0;3;3;0;3
89;23.03.2015;2015;03;01;Maanantai;3;2;5;0;1;1
89;23.03.2015;2015;03;02;Maanantai;4;2;6;1;0;1
89;23.03.2015;2015;03;03;Maanantai;2;3;5;1;0;1
89;23.03.2015;2015;03;04;Maanantai;2;4;6;0;0;0
89;23.03.2015;2015;03;05;Maanantai;6;9;15;2;0;2
89;23.03.2015;2015;03;06;Maanantai;7;33;40;4;7;11
89;23.03.2015;2015;03;07;Maanantai;28;119;147;8;35;43
89;23.03.2015;2015;03;08;Maanantai;37;152;189;18;59;77
89;23.03.2015;2015;03;09;Maanantai;31;103;134;19;45;64
89;23.03.2015;2015;03;10;Maanantai;29;54;83;23;28;51
89;23.03.2015;2015;03;11;Maanantai;45;53;98;31;27;58
89;23.03.2015;2015;03;12;Maanantai;55;52;107;29;35;64
89;23.03.2015;2015;03;13;Maanantai;50;50;100;32;28;60
89;23.03.2015;2015;03;14;Maanantai;88;41;129;45;23;68
89;23.03.2015;2015;03;15;Maanantai;109;54;163;55;38;93
89;23.03.2015;2015;03;16;Maanantai;154;76;230;61;25;86
89;23.03.2015;2015;03;17;Maanantai;84;44;128;22;19;41
89;23.03.2015;2015;03;18;Maanantai;50;29;79;44;25;69
89;23.03.2015;2015;03;19;Maanantai;49;27;76;19;26;45
89;23.03.2015;2015;03;20;Maanantai;37;18;55;19;15;34
89;23.03.2015;2015;03;21;Maanantai;21;14;35;13;7;20
89;23.03.2015;2015;03;22;Maanantai;17;3;20;8;4;12
89;23.03.2015;2015;03;23;Maanantai;3;2;5;3;1;4
89;24.03.2015;2015;03;00;Tiistai;2;0;2;3;0;3
89;24.03.2015;2015;03;01;Tiistai;2;0;2;0;0;0
89;24.03.2015;2015;03;02;Tiistai;4;0;4;1;0;1
89;24.03.2015;2015;03;03;Tiistai;2;1;3;0;0;0
89;24.03.2015;2015;03;04;Tiistai;3;1;4;1;0;1
89;24.03.2015;2015;03;05;Tiistai;5;13;18;2;0;2
89;24.03.2015;2015;03;06;Tiistai;18;40;58;4;10;14
89;24.03.2015;2015;03;07;Tiistai;34;130;164;13;29;42
89;24.03.2015;2015;03;08;Tiistai;43;153;196;18;59;77
89;24.03.2015;2015;03;09;Tiistai;30;74;104;17;32;49
89;24.03.2015;2015;03;10;Tiistai;32;43;75;16;31;47
89;24.03.2015;2015;03;11;Tiistai;27;38;65;27;27;54
89;24.03.2015;2015;03;12;Tiistai;53;55;108;20;30;50
89;24.03.2015;2015;03;13;Tiistai;34;27;61;31;22;53
89;24.03.2015;2015;03;14;Tiistai;72;24;96;45;24;69
89;24.03.2015;2015;03;15;Tiistai;87;54;141;41;20;61
89;24.03.2015;2015;03;16;Tiistai;113;47;160;45;19;64
89;24.03.2015;2015;03;17;Tiistai;55;54;109;26;37;63
89;24.03.2015;2015;03;18;Tiistai;44;26;70;44;31;75
89;24.03.2015;2015;03;19;Tiistai;39;26;65;36;22;58
89;24.03.2015;2015;03;20;Tiistai;33;4;37;30;20;50
89;24.03.2015;2015;03;21;Tiistai;44;13;57;17;13;30
89;24.03.2015;2015;03;22;Tiistai;6;1;7;5;4;9
89;24.03.2015;2015;03;23;Tiistai;6;2;8;0;3;3
89;25.03.2015;2015;03;00;Keskiviikko;2;4;6;2;2;4
89;25.03.2015;2015;03;01;Keskiviikko;2;2;4;2;0;2
89;25.03.2015;2015;03;02;Keskiviikko;1;0;1;0;0;0
89;25.03.2015;2015;03;03;Keskiviikko;3;3;6;0;0;0
89;25.03.2015;2015;03;04;Keskiviikko;0;3;3;4;3;7
89;25.03.2015;2015;03;05;Keskiviikko;4;11;15;4;0;4
89;25.03.2015;2015;03;06;Keskiviikko;12;45;57;7;13;20
89;25.03.2015;2015;03;07;Keskiviikko;37;127;164;11;53;64
89;25.03.2015;2015;03;08;Keskiviikko;34;140;174;18;51;69
89;25.03.2015;2015;03;09;Keskiviikko;32;87;119;18;56;74
89;25.03.2015;2015;03;10;Keskiviikko;32;54;86;28;30;58
89;25.03.2015;2015;03;11;Keskiviikko;40;61;101;37;39;76
89;25.03.2015;2015;03;12;Keskiviikko;42;47;89;41;49;90
89;25.03.2015;2015;03;13;Keskiviikko;62;58;120;45;60;105
89;25.03.2015;2015;03;14;Keskiviikko;74;67;141;63;37;100
89;25.03.2015;2015;03;15;Keskiviikko;109;71;180;66;24;90
89;25.03.2015;2015;03;16;Keskiviikko;114;76;190;61;36;97
89;25.03.2015;2015;03;17;Keskiviikko;100;77;177;58;36;94
89;25.03.2015;2015;03;18;Keskiviikko;65;34;99;53;37;90
89;25.03.2015;2015;03;19;Keskiviikko;69;31;100;38;42;80
89;25.03.2015;2015;03;20;Keskiviikko;56;11;67;19;18;37
89;25.03.2015;2015;03;21;Keskiviikko;28;15;43;12;10;22
89;25.03.2015;2015;03;22;Keskiviikko;14;10;24;6;3;9
89;25.03.2015;2015;03;23;Keskiviikko;5;2;7;3;3;6
89;26.03.2015;2015;03;00;Torstai;2;2;4;2;1;3
89;26.03.2015;2015;03;01;Torstai;4;2;6;1;0;1
89;26.03.2015;2015;03;02;Torstai;0;0;0;2;0;2
89;26.03.2015;2015;03;03;Torstai;4;2;6;1;0;1
89;26.03.2015;2015;03;04;Torstai;4;5;9;1;0;1
89;26.03.2015;2015;03;05;Torstai;2;10;12;1;2;3
89;26.03.2015;2015;03;06;Torstai;16;31;47;7;15;22
89;26.03.2015;2015;03;07;Torstai;38;115;153;12;52;64
89;26.03.2015;2015;03;08;Torstai;36;162;198;18;48;66
89;26.03.2015;2015;03;09;Torstai;29;75;104;24;45;69
89;26.03.2015;2015;03;10;Torstai;36;57;93;28;41;69
89;26.03.2015;2015;03;11;Torstai;47;64;111;32;44;76
89;26.03.2015;2015;03;12;Torstai;57;72;129;41;48;89
89;26.03.2015;2015;03;13;Torstai;70;54;124;55;42;97
89;26.03.2015;2015;03;14;Torstai;97;51;148;43;41;84
89;26.03.2015;2015;03;15;Torstai;120;92;212;52;26;78
89;26.03.2015;2015;03;16;Torstai;134;61;195;56;40;96
89;26.03.2015;2015;03;17;Torstai;87;53;140;46;36;82
89;26.03.2015;2015;03;18;Torstai;50;52;102;46;40;86
89;26.03.2015;2015;03;19;Torstai;55;36;91;25;26;51
89;26.03.2015;2015;03;20;Torstai;30;26;56;19;16;35
89;26.03.2015;2015;03;21;Torstai;40;18;58;17;7;24
89;26.03.2015;2015;03;22;Torstai;13;5;18;9;5;14
89;26.03.2015;2015;03;23;Torstai;7;7;14;2;0;2
89;27.03.2015;2015;03;00;Perjantai;1;1;2;6;3;9
89;27.03.2015;2015;03;01;Perjantai;8;0;8;1;0;1
89;27.03.2015;2015;03;02;Perjantai;3;1;4;2;0;2
89;27.03.2015;2015;03;03;Perjantai;3;3;6;0;0;0
89;27.03.2015;2015;03;04;Perjantai;4;2;6;1;1;2
89;27.03.2015;2015;03;05;Perjantai;2;13;15;1;1;2
89;27.03.2015;2015;03;06;Perjantai;18;30;48;7;17;24
89;27.03.2015;2015;03;07;Perjantai;60;91;151;13;33;46
89;27.03.2015;2015;03;08;Perjantai;69;92;161;18;37;55
89;27.03.2015;2015;03;09;Perjantai;33;45;78;24;39;63
89;27.03.2015;2015;03;10;Perjantai;33;54;87;22;27;49
89;27.03.2015;2015;03;11;Perjantai;62;63;125;34;39;73
89;27.03.2015;2015;03;12;Perjantai;62;70;132;26;56;82
89;27.03.2015;2015;03;13;Perjantai;82;57;139;36;47;83
89;27.03.2015;2015;03;14;Perjantai;91;60;151;34;37;71
89;27.03.2015;2015;03;15;Perjantai;78;87;165;36;37;73
89;27.03.2015;2015;03;16;Perjantai;106;75;181;39;37;76
89;27.03.2015;2015;03;17;Perjantai;62;52;114;31;28;59
89;27.03.2015;2015;03;18;Perjantai;41;44;85;32;26;58
89;27.03.2015;2015;03;19;Perjantai;31;40;71;17;26;43
89;27.03.2015;2015;03;20;Perjantai;30;21;51;7;16;23
89;27.03.2015;2015;03;21;Perjantai;16;20;36;10;15;25
89;27.03.2015;2015;03;22;Perjantai;12;14;26;8;7;15
89;27.03.2015;2015;03;23;Perjantai;5;18;23;6;2;8
89;28.03.2015;2015;03;00;Lauantai;8;4;12;6;4;10
89;28.03.2015;2015;03;01;Lauantai;3;5;8;6;0;6
89;28.03.2015;2015;03;02;Lauantai;4;7;11;6;2;8
89;28.03.2015;2015;03;03;Lauantai;5;1;6;4;5;9
89;28.03.2015;2015;03;04;Lauantai;5;1;6;5;4;9
89;28.03.2015;2015;03;05;Lauantai;2;3;5;4;3;7
89;28.03.2015;2015;03;06;Lauantai;9;9;18;2;4;6
89;28.03.2015;2015;03;07;Lauantai;6;10;16;8;9;17
89;28.03.2015;2015;03;08;Lauantai;9;5;14;11;10;21
89;28.03.2015;2015;03;09;Lauantai;10;21;31;27;20;47
89;28.03.2015;2015;03;10;Lauantai;26;18;44;20;11;31
89;28.03.2015;2015;03;11;Lauantai;17;29;46;14;22;36
89;28.03.2015;2015;03;12;Lauantai;19;23;42;24;13;37
89;28.03.2015;2015;03;13;Lauantai;22;21;43;20;18;38
89;28.03.2015;2015;03;14;Lauantai;27;32;59;14;14;28
89;28.03.2015;2015;03;15;Lauantai;37;28;65;14;19;33
89;28.03.2015;2015;03;16;Lauantai;24;30;54;18;16;34
89;28.03.2015;2015;03;17;Lauantai;30;29;59;19;12;31
89;28.03.2015;2015;03;18;Lauantai;35;30;65;18;10;28
89;28.03.2015;2015;03;19;Lauantai;31;15;46;10;20;30
89;28.03.2015;2015;03;20;Lauantai;18;10;28;7;6;13
89;28.03.2015;2015;03;21;Lauantai;23;25;48;4;5;9
89;28.03.2015;2015;03;22;Lauantai;11;16;27;4;6;10
89;28.03.2015;2015;03;23;Lauantai;13;18;31;9;2;11
89;29.03.2015;2015;03;00;Sunnuntai;9;9;18;2;4;6
89;29.03.2015;2015;03;01;Sunnuntai;10;10;20;6;4;10
89;29.03.2015;2015;03;02;Sunnuntai;0;0;0;0;0;0
89;29.03.2015;2015;03;03;Sunnuntai;13;8;21;9;8;17
89;29.03.2015;2015;03;04;Sunnuntai;15;17;32;3;8;11
89;29.03.2015;2015;03;05;Sunnuntai;4;3;7;0;0;0
89;29.03.2015;2015;03;06;Sunnuntai;2;6;8;6;4;10
89;29.03.2015;2015;03;07;Sunnuntai;9;4;13;5;4;9
89;29.03.2015;2015;03;08;Sunnuntai;7;8;15;9;8;17
89;29.03.2015;2015;03;09;Sunnuntai;11;12;23;19;21;40
89;29.03.2015;2015;03;10;Sunnuntai;22;4;26;32;28;60
89;29.03.2015;2015;03;11;Sunnuntai;31;21;52;36;41;77
89;29.03.2015;2015;03;12;Sunnuntai;39;48;87;36;23;59
89;29.03.2015;2015;03;13;Sunnuntai;50;46;96;48;61;109
89;29.03.2015;2015;03;14;Sunnuntai;25;36;61;47;57;104
89;29.03.2015;2015;03;15;Sunnuntai;35;29;64;37;36;73
89;29.03.2015;2015;03;16;Sunnuntai;25;40;65;44;33;77
89;29.03.2015;2015;03;17;Sunnuntai;32;40;72;41;42;83
89;29.03.2015;2015;03;18;Sunnuntai;38;27;65;59;16;75
89;29.03.2015;2015;03;19;Sunnuntai;27;21;48;22;22;44
89;29.03.2015;2015;03;20;Sunnuntai;23;15;38;14;11;25
89;29.03.2015;2015;03;21;Sunnuntai;9;7;16;15;8;23
89;29.03.2015;2015;03;22;Sunnuntai;12;21;33;5;3;8
89;29.03.2015;2015;03;23;Sunnuntai;10;2;12;3;3;6
89;30.03.2015;2015;03;00;Maanantai;1;2;3;1;1;2
89;30.03.2015;2015;03;01;Maanantai;0;1;1;0;1;1
89;30.03.2015;2015;03;02;Maanantai;0;1;1;2;2;4
89;30.03.2015;2015;03;03;Maanantai;2;2;4;1;1;2
89;30.03.2015;2015;03;04;Maanantai;2;4;6;2;0;2
89;30.03.2015;2015;03;05;Maanantai;7;19;26;16;13;29
89;30.03.2015;2015;03;06;Maanantai;17;32;49;3;7;10
89;30.03.2015;2015;03;07;Maanantai;28;126;154;9;32;41
89;30.03.2015;2015;03;08;Maanantai;26;123;149;11;40;51
89;30.03.2015;2015;03;09;Maanantai;41;104;145;7;30;37
89;30.03.2015;2015;03;10;Maanantai;36;54;90;23;21;44
89;30.03.2015;2015;03;11;Maanantai;42;51;93;24;17;41
89;30.03.2015;2015;03;12;Maanantai;51;38;89;18;19;37
89;30.03.2015;2015;03;13;Maanantai;57;44;101;17;12;29
89;30.03.2015;2015;03;14;Maanantai;95;49;144;34;21;55
89;30.03.2015;2015;03;15;Maanantai;88;58;146;46;24;70
89;30.03.2015;2015;03;16;Maanantai;109;70;179;38;33;71
89;30.03.2015;2015;03;17;Maanantai;77;43;120;32;23;55
89;30.03.2015;2015;03;18;Maanantai;56;32;88;30;19;49
89;30.03.2015;2015;03;19;Maanantai;54;27;81;32;25;57
89;30.03.2015;2015;03;20;Maanantai;32;22;54;16;17;33
89;30.03.2015;2015;03;21;Maanantai;30;14;44;11;5;16
89;30.03.2015;2015;03;22;Maanantai;8;2;10;6;6;12
89;30.03.2015;2015;03;23;Maanantai;2;1;3;1;6;7
89;31.03.2015;2015;03;00;Tiistai;3;0;3;4;2;6
89;31.03.2015;2015;03;01;Tiistai;0;0;0;1;1;2
89;31.03.2015;2015;03;02;Tiistai;0;0;0;0;0;0
89;31.03.2015;2015;03;03;Tiistai;1;1;2;2;0;2
89;31.03.2015;2015;03;04;Tiistai;1;1;2;0;0;0
89;31.03.2015;2015;03;05;Tiistai;5;4;9;2;0;2
89;31.03.2015;2015;03;06;Tiistai;17;18;35;5;13;18
89;31.03.2015;2015;03;07;Tiistai;46;85;131;20;37;57
89;31.03.2015;2015;03;08;Tiistai;78;108;186;20;24;44
89;31.03.2015;2015;03;09;Tiistai;45;56;101;12;40;52
89;31.03.2015;2015;03;10;Tiistai;33;67;100;25;23;48
89;31.03.2015;2015;03;11;Tiistai;51;48;99;27;33;60
89;31.03.2015;2015;03;12;Tiistai;51;58;109;26;34;60
89;31.03.2015;2015;03;13;Tiistai;61;51;112;22;23;45
89;31.03.2015;2015;03;14;Tiistai;66;40;106;37;25;62
89;31.03.2015;2015;03;15;Tiistai;103;49;152;37;25;62
89;31.03.2015;2015;03;16;Tiistai;104;60;164;38;27;65
89;31.03.2015;2015;03;17;Tiistai;83;48;131;36;23;59
89;31.03.2015;2015;03;18;Tiistai;51;24;75;31;31;62
89;31.03.2015;2015;03;19;Tiistai;44;31;75;30;21;51
89;31.03.2015;2015;03;20;Tiistai;38;20;58;27;18;45
89;31.03.2015;2015;03;21;Tiistai;26;12;38;20;7;27
89;31.03.2015;2015;03;22;Tiistai;15;8;23;7;5;12
89;31.03.2015;2015;03;23;Tiistai;3;5;8;4;3;7
89;01.04.2015;2015;04;00;Keskiviikko;1;1;2;0;1;1
89;01.04.2015;2015;04;01;Keskiviikko;2;0;2;0;0;0
89;01.04.2015;2015;04;02;Keskiviikko;2;0;2;1;1;2
89;01.04.2015;2015;04;03;Keskiviikko;2;2;4;1;0;1
89;01.04.2015;2015;04;04;Keskiviikko;1;4;5;0;0;0
89;01.04.2015;2015;04;05;Keskiviikko;3;7;10;1;1;2
89;01.04.2015;2015;04;06;Keskiviikko;22;37;59;4;5;9
89;01.04.2015;2015;04;07;Keskiviikko;52;115;167;9;39;48
89;01.04.2015;2015;04;08;Keskiviikko;47;161;208;9;36;45
89;01.04.2015;2015;04;09;Keskiviikko;42;73;115;16;39;55
89;01.04.2015;2015;04;10;Keskiviikko;59;76;135;26;25;51
89;01.04.2015;2015;04;11;Keskiviikko;47;68;115;27;28;55
89;01.04.2015;2015;04;12;Keskiviikko;76;51;127;28;31;59
89;01.04.2015;2015;04;13;Keskiviikko;70;49;119;35;28;63
89;01.04.2015;2015;04;14;Keskiviikko;90;42;132;35;25;60
89;01.04.2015;2015;04;15;Keskiviikko;99;54;153;34;26;60
89;01.04.2015;2015;04;16;Keskiviikko;132;67;199;53;20;73
89;01.04.2015;2015;04;17;Keskiviikko;101;44;145;43;29;72
89;01.04.2015;2015;04;18;Keskiviikko;77;50;127;31;25;56
89;01.04.2015;2015;04;19;Keskiviikko;61;37;98;44;38;82
89;01.04.2015;2015;04;20;Keskiviikko;64;24;88;32;21;53
89;01.04.2015;2015;04;21;Keskiviikko;38;21;59;8;9;17
89;01.04.2015;2015;04;22;Keskiviikko;17;19;36;5;6;11
89;01.04.2015;2015;04;23;Keskiviikko;8;3;11;5;5;10
89;02.04.2015;2015;04;00;Torstai;1;6;7;7;1;8
89;02.04.2015;2015;04;01;Torstai;7;4;11;2;5;7
89;02.04.2015;2015;04;02;Torstai;6;2;8;3;0;3
89;02.04.2015;2015;04;03;Torstai;2;2;4;2;0;2
89;02.04.2015;2015;04;04;Torstai;9;1;10;0;0;0
89;02.04.2015;2015;04;05;Torstai;2;8;10;0;1;1
89;02.04.2015;2015;04;06;Torstai;18;30;48;5;10;15
89;02.04.2015;2015;04;07;Torstai;36;109;145;8;39;47
89;02.04.2015;2015;04;08;Torstai;43;135;178;13;35;48
89;02.04.2015;2015;04;09;Torstai;37;83;120;11;30;41
89;02.04.2015;2015;04;10;Torstai;37;71;108;21;46;67
89;02.04.2015;2015;04;11;Torstai;58;52;110;20;28;48
89;02.04.2015;2015;04;12;Torstai;65;60;125;23;32;55
89;02.04.2015;2015;04;13;Torstai;81;50;131;32;30;62
89;02.04.2015;2015;04;14;Torstai;82;41;123;30;33;63
89;02.04.2015;2015;04;15;Torstai;113;61;174;43;26;69
89;02.04.2015;2015;04;16;Torstai;91;62;153;40;32;72
89;02.04.2015;2015;04;17;Torstai;71;55;126;25;30;55
89;02.04.2015;2015;04;18;Torstai;54;41;95;21;23;44
89;02.04.2015;2015;04;19;Torstai;36;23;59;14;15;29
89;02.04.2015;2015;04;20;Torstai;39;32;71;11;18;29
89;02.04.2015;2015;04;21;Torstai;13;25;38;11;7;18
89;02.04.2015;2015;04;22;Torstai;12;11;23;6;10;16
89;02.04.2015;2015;04;23;Torstai;10;14;24;5;7;12
89;03.04.2015;2015;04;00;Perjantai;7;9;16;2;5;7
89;03.04.2015;2015;04;01;Perjantai;9;6;15;7;6;13
89;03.04.2015;2015;04;02;Perjantai;7;3;10;6;2;8
89;03.04.2015;2015;04;03;Perjantai;8;4;12;5;5;10
89;03.04.2015;2015;04;04;Perjantai;5;9;14;3;0;3
89;03.04.2015;2015;04;05;Perjantai;3;3;6;0;0;0
89;03.04.2015;2015;04;06;Perjantai;4;5;9;3;4;7
89;03.04.2015;2015;04;07;Perjantai;8;4;12;4;4;8
89;03.04.2015;2015;04;08;Perjantai;9;7;16;13;11;24
89;03.04.2015;2015;04;09;Perjantai;11;9;20;16;20;36
89;03.04.2015;2015;04;10;Perjantai;12;14;26;32;22;54
89;03.04.2015;2015;04;11;Perjantai;12;22;34;32;39;71
89;03.04.2015;2015;04;12;Perjantai;33;36;69;45;59;104
89;03.04.2015;2015;04;13;Perjantai;31;31;62;42;52;94
89;03.04.2015;2015;04;14;Perjantai;38;33;71;40;47;87
89;03.04.2015;2015;04;15;Perjantai;37;16;53;32;37;69
89;03.04.2015;2015;04;16;Perjantai;45;42;87;28;28;56
89;03.04.2015;2015;04;17;Perjantai;26;41;67;44;58;102
89;03.04.2015;2015;04;18;Perjantai;28;34;62;32;13;45
89;03.04.2015;2015;04;19;Perjantai;41;22;63;30;20;50
89;03.04.2015;2015;04;20;Perjantai;17;12;29;5;26;31
89;03.04.2015;2015;04;21;Perjantai;22;24;46;8;5;13
89;03.04.2015;2015;04;22;Perjantai;15;20;35;9;3;12
89;03.04.2015;2015;04;23;Perjantai;10;11;21;3;10;13
89;04.04.2015;2015;04;00;Lauantai;8;7;15;2;9;11
89;04.04.2015;2015;04;01;Lauantai;7;9;16;4;3;7
89;04.04.2015;2015;04;02;Lauantai;5;5;10;5;4;9
89;04.04.2015;2015;04;03;Lauantai;10;8;18;4;1;5
89;04.04.2015;2015;04;04;Lauantai;13;3;16;5;1;6
89;04.04.2015;2015;04;05;Lauantai;0;6;6;1;1;2
89;04.04.2015;2015;04;06;Lauantai;3;4;7;2;6;8
89;04.04.2015;2015;04;07;Lauantai;1;10;11;10;8;18
89;04.04.2015;2015;04;08;Lauantai;6;14;20;14;7;21
89;04.04.2015;2015;04;09;Lauantai;9;29;38;5;27;32
89;04.04.2015;2015;04;10;Lauantai;9;43;52;18;27;45
89;04.04.2015;2015;04;11;Lauantai;36;58;94;28;50;78
89;04.04.2015;2015;04;12;Lauantai;45;40;85;28;28;56
89;04.04.2015;2015;04;13;Lauantai;74;51;125;36;29;65
89;04.04.2015;2015;04;14;Lauantai;59;40;99;27;41;68
89;04.04.2015;2015;04;15;Lauantai;56;27;83;32;41;73
89;04.04.2015;2015;04;16;Lauantai;46;42;88;33;28;61
89;04.04.2015;2015;04;17;Lauantai;38;37;75;28;41;69
89;04.04.2015;2015;04;18;Lauantai;45;48;93;34;47;81
89;04.04.2015;2015;04;19;Lauantai;48;44;92;40;24;64
89;04.04.2015;2015;04;20;Lauantai;32;32;64;19;24;43
89;04.04.2015;2015;04;21;Lauantai;19;21;40;11;16;27
89;04.04.2015;2015;04;22;Lauantai;11;21;32;8;11;19
89;04.04.2015;2015;04;23;Lauantai;25;20;45;6;8;14
89;05.04.2015;2015;04;00;Sunnuntai;1;8;9;5;5;10
89;05.04.2015;2015;04;01;Sunnuntai;20;6;26;4;1;5
89;05.04.2015;2015;04;02;Sunnuntai;9;3;12;8;1;9
89;05.04.2015;2015;04;03;Sunnuntai;13;4;17;8;2;10
89;05.04.2015;2015;04;04;Sunnuntai;9;0;9;2;0;2
89;05.04.2015;2015;04;05;Sunnuntai;0;0;0;0;0;0
89;05.04.2015;2015;04;06;Sunnuntai;3;9;12;2;1;3
89;05.04.2015;2015;04;07;Sunnuntai;1;5;6;4;5;9
89;05.04.2015;2015;04;08;Sunnuntai;8;11;19;13;8;21
89;05.04.2015;2015;04;09;Sunnuntai;12;15;27;21;32;53
89;05.04.2015;2015;04;10;Sunnuntai;22;16;38;47;31;78
89;05.04.2015;2015;04;11;Sunnuntai;41;41;82;52;80;132
89;05.04.2015;2015;04;12;Sunnuntai;61;47;108;76;84;160
89;05.04.2015;2015;04;13;Sunnuntai;66;57;123;83;102;185
89;05.04.2015;2015;04;14;Sunnuntai;60;60;120;62;55;117
89;05.04.2015;2015;04;15;Sunnuntai;49;54;103;55;68;123
89;05.04.2015;2015;04;16;Sunnuntai;62;45;107;41;51;92
89;05.04.2015;2015;04;17;Sunnuntai;59;53;112;45;44;89
89;05.04.2015;2015;04;18;Sunnuntai;44;51;95;47;37;84
89;05.04.2015;2015;04;19;Sunnuntai;54;31;85;25;29;54
89;05.04.2015;2015;04;20;Sunnuntai;31;20;51;24;17;41
89;05.04.2015;2015;04;21;Sunnuntai;20;17;37;3;9;12
89;05.04.2015;2015;04;22;Sunnuntai;16;11;27;7;8;15
89;05.04.2015;2015;04;23;Sunnuntai;7;13;20;4;2;6
89;06.04.2015;2015;04;00;Maanantai;4;1;5;4;4;8
89;06.04.2015;2015;04;01;Maanantai;13;4;17;5;1;6
89;06.04.2015;2015;04;02;Maanantai;5;2;7;3;3;6
89;06.04.2015;2015;04;03;Maanantai;5;1;6;24;13;37
89;06.04.2015;2015;04;04;Maanantai;7;0;7;0;1;1
89;06.04.2015;2015;04;05;Maanantai;1;1;2;0;0;0
89;06.04.2015;2015;04;06;Maanantai;3;7;10;0;2;2
89;06.04.2015;2015;04;07;Maanantai;7;9;16;4;7;11
89;06.04.2015;2015;04;08;Maanantai;5;3;8;17;12;29
89;06.04.2015;2015;04;09;Maanantai;5;13;18;31;10;41
89;06.04.2015;2015;04;10;Maanantai;15;21;36;31;33;64
89;06.04.2015;2015;04;11;Maanantai;30;30;60;54;54;108
89;06.04.2015;2015;04;12;Maanantai;32;26;58;45;35;80
89;06.04.2015;2015;04;13;Maanantai;26;25;51;25;13;38
89;06.04.2015;2015;04;14;Maanantai;15;27;42;14;18;32
89;06.04.2015;2015;04;15;Maanantai;34;29;63;27;24;51
89;06.04.2015;2015;04;16;Maanantai;24;32;56;23;20;43
89;06.04.2015;2015;04;17;Maanantai;13;24;37;29;25;54
89;06.04.2015;2015;04;18;Maanantai;28;22;50;29;29;58
89;06.04.2015;2015;04;19;Maanantai;35;20;55;26;31;57
89;06.04.2015;2015;04;20;Maanantai;28;14;42;15;17;32
89;06.04.2015;2015;04;21;Maanantai;9;8;17;8;12;20
89;06.04.2015;2015;04;22;Maanantai;7;7;14;5;3;8
89;06.04.2015;2015;04;23;Maanantai;3;3;6;4;2;6
89;07.04.2015;2015;04;00;Tiistai;3;6;9;2;0;2
89;07.04.2015;2015;04;01;Tiistai;7;6;13;0;2;2
89;07.04.2015;2015;04;02;Tiistai;2;1;3;0;0;0
89;07.04.2015;2015;04;03;Tiistai;1;2;3;0;0;0
89;07.04.2015;2015;04;04;Tiistai;2;2;4;0;0;0
89;07.04.2015;2015;04;05;Tiistai;5;5;10;1;0;1
89;07.04.2015;2015;04;06;Tiistai;21;28;49;5;7;12
89;07.04.2015;2015;04;07;Tiistai;60;114;174;18;27;45
89;07.04.2015;2015;04;08;Tiistai;95;146;241;22;31;53
89;07.04.2015;2015;04;09;Tiistai;41;59;100;12;39;51
89;07.04.2015;2015;04;10;Tiistai;38;74;112;26;26;52
89;07.04.2015;2015;04;11;Tiistai;61;56;117;21;41;62
89;07.04.2015;2015;04;12;Tiistai;66;64;130;27;34;61
89;07.04.2015;2015;04;13;Tiistai;77;48;125;37;35;72
89;07.04.2015;2015;04;14;Tiistai;109;54;163;57;41;98
89;07.04.2015;2015;04;15;Tiistai;148;73;221;48;17;65
89;07.04.2015;2015;04;16;Tiistai;173;72;245;62;34;96
89;07.04.2015;2015;04;17;Tiistai;91;62;153;54;40;94
89;07.04.2015;2015;04;18;Tiistai;79;39;118;52;37;89
89;07.04.2015;2015;04;19;Tiistai;63;39;102;40;33;73
89;07.04.2015;2015;04;20;Tiistai;59;29;88;33;27;60
89;07.04.2015;2015;04;21;Tiistai;30;20;50;17;18;35
89;07.04.2015;2015;04;22;Tiistai;14;8;22;7;5;12
89;07.04.2015;2015;04;23;Tiistai;4;0;4;3;8;11
89;08.04.2015;2015;04;00;Keskiviikko;2;2;4;7;7;14
89;08.04.2015;2015;04;01;Keskiviikko;2;3;5;2;1;3
89;08.04.2015;2015;04;02;Keskiviikko;3;2;5;1;0;1
89;08.04.2015;2015;04;03;Keskiviikko;2;4;6;0;0;0
89;08.04.2015;2015;04;04;Keskiviikko;2;3;5;1;1;2
89;08.04.2015;2015;04;05;Keskiviikko;2;9;11;1;1;2
89;08.04.2015;2015;04;06;Keskiviikko;16;46;62;8;18;26
89;08.04.2015;2015;04;07;Keskiviikko;51;176;227;12;41;53
89;08.04.2015;2015;04;08;Keskiviikko;41;193;234;11;37;48
89;08.04.2015;2015;04;09;Keskiviikko;40;99;139;25;34;59
89;08.04.2015;2015;04;10;Keskiviikko;41;71;112;24;40;64
89;08.04.2015;2015;04;11;Keskiviikko;43;79;122;35;32;67
89;08.04.2015;2015;04;12;Keskiviikko;59;70;129;33;26;59
89;08.04.2015;2015;04;13;Keskiviikko;77;64;141;35;28;63
89;08.04.2015;2015;04;14;Keskiviikko;126;67;193;47;35;82
89;08.04.2015;2015;04;15;Keskiviikko;132;68;200;50;29;79
89;08.04.2015;2015;04;16;Keskiviikko;174;87;261;49;35;84
89;08.04.2015;2015;04;17;Keskiviikko;103;78;181;36;13;49
89;08.04.2015;2015;04;18;Keskiviikko;66;42;108;37;28;65
89;08.04.2015;2015;04;19;Keskiviikko;62;37;99;51;24;75
89;08.04.2015;2015;04;20;Keskiviikko;52;35;87;35;22;57
89;08.04.2015;2015;04;21;Keskiviikko;26;21;47;14;17;31
89;08.04.2015;2015;04;22;Keskiviikko;14;13;27;6;5;11
89;08.04.2015;2015;04;23;Keskiviikko;9;6;15;2;2;4
89;09.04.2015;2015;04;00;Torstai;1;1;2;3;1;4
89;09.04.2015;2015;04;01;Torstai;2;0;2;0;2;2
89;09.04.2015;2015;04;02;Torstai;0;1;1;4;0;4
89;09.04.2015;2015;04;03;Torstai;2;0;2;0;0;0
89;09.04.2015;2015;04;04;Torstai;2;5;7;0;0;0
89;09.04.2015;2015;04;05;Torstai;5;8;13;1;0;1
89;09.04.2015;2015;04;06;Torstai;17;51;68;7;11;18
89;09.04.2015;2015;04;07;Torstai;52;170;222;7;36;43
89;09.04.2015;2015;04;08;Torstai;51;197;248;11;35;46
89;09.04.2015;2015;04;09;Torstai;42;98;140;35;37;72
89;09.04.2015;2015;04;10;Torstai;46;76;122;12;38;50
89;09.04.2015;2015;04;11;Torstai;61;77;138;23;26;49
89;09.04.2015;2015;04;12;Torstai;41;82;123;29;17;46
89;09.04.2015;2015;04;13;Torstai;79;64;143;34;52;86
89;09.04.2015;2015;04;14;Torstai;114;67;181;32;31;63
89;09.04.2015;2015;04;15;Torstai;157;90;247;52;31;83
89;09.04.2015;2015;04;16;Torstai;170;67;237;31;20;51
89;09.04.2015;2015;04;17;Torstai;93;68;161;31;20;51
89;09.04.2015;2015;04;18;Torstai;59;48;107;29;32;61
89;09.04.2015;2015;04;19;Torstai;62;35;97;40;27;67
89;09.04.2015;2015;04;20;Torstai;56;41;97;41;33;74
89;09.04.2015;2015;04;21;Torstai;42;24;66;10;17;27
89;09.04.2015;2015;04;22;Torstai;11;8;19;5;10;15
89;09.04.2015;2015;04;23;Torstai;7;4;11;6;1;7
89;10.04.2015;2015;04;00;Perjantai;9;1;10;3;6;9
89;10.04.2015;2015;04;01;Perjantai;4;4;8;1;1;2
89;10.04.2015;2015;04;02;Perjantai;5;1;6;2;0;2
89;10.04.2015;2015;04;03;Perjantai;1;2;3;1;0;1
89;10.04.2015;2015;04;04;Perjantai;2;2;4;2;0;2
89;10.04.2015;2015;04;05;Perjantai;3;12;15;0;1;1
89;10.04.2015;2015;04;06;Perjantai;19;39;58;7;3;10
89;10.04.2015;2015;04;07;Perjantai;36;166;202;9;32;41
89;10.04.2015;2015;04;08;Perjantai;30;160;190;17;50;67
89;10.04.2015;2015;04;09;Perjantai;41;112;153;19;32;51
89;10.04.2015;2015;04;10;Perjantai;49;81;130;26;24;50
89;10.04.2015;2015;04;11;Perjantai;63;90;153;26;27;53
89;10.04.2015;2015;04;12;Perjantai;63;53;116;25;22;47
89;10.04.2015;2015;04;13;Perjantai;88;36;124;38;13;51
89;10.04.2015;2015;04;14;Perjantai;78;37;115;26;16;42
89;10.04.2015;2015;04;15;Perjantai;119;69;188;25;30;55
89;10.04.2015;2015;04;16;Perjantai;107;71;178;22;10;32
89;10.04.2015;2015;04;17;Perjantai;86;63;149;25;25;50
89;10.04.2015;2015;04;18;Perjantai;60;38;98;36;15;51
89;10.04.2015;2015;04;19;Perjantai;51;34;85;38;31;69
89;10.04.2015;2015;04;20;Perjantai;45;29;74;23;18;41
89;10.04.2015;2015;04;21;Perjantai;39;22;61;12;6;18
89;10.04.2015;2015;04;22;Perjantai;22;36;58;3;5;8
89;10.04.2015;2015;04;23;Perjantai;19;20;39;2;5;7
89;11.04.2015;2015;04;00;Lauantai;16;6;22;2;5;7
89;11.04.2015;2015;04;01;Lauantai;14;13;27;6;1;7
89;11.04.2015;2015;04;02;Lauantai;6;8;14;8;3;11
89;11.04.2015;2015;04;03;Lauantai;16;6;22;4;0;4
89;11.04.2015;2015;04;04;Lauantai;15;2;17;8;1;9
89;11.04.2015;2015;04;05;Lauantai;2;5;7;1;2;3
89;11.04.2015;2015;04;06;Lauantai;2;13;15;2;2;4
89;11.04.2015;2015;04;07;Lauantai;5;9;14;9;5;14
89;11.04.2015;2015;04;08;Lauantai;17;37;54;15;16;31
89;11.04.2015;2015;04;09;Lauantai;17;72;89;23;21;44
89;11.04.2015;2015;04;10;Lauantai;25;80;105;29;33;62
89;11.04.2015;2015;04;11;Lauantai;64;106;170;43;73;116
89;11.04.2015;2015;04;12;Lauantai;78;106;184;51;61;112
89;11.04.2015;2015;04;13;Lauantai;112;110;222;75;77;152
89;11.04.2015;2015;04;14;Lauantai;115;112;227;62;51;113
89;11.04.2015;2015;04;15;Lauantai;116;92;208;70;62;132
89;11.04.2015;2015;04;16;Lauantai;123;79;202;54;35;89
89;11.04.2015;2015;04;17;Lauantai;83;66;149;47;47;94
89;11.04.2015;2015;04;18;Lauantai;75;34;109;39;30;69
89;11.04.2015;2015;04;19;Lauantai;55;41;96;25;25;50
89;11.04.2015;2015;04;20;Lauantai;40;54;94;24;18;42
89;11.04.2015;2015;04;21;Lauantai;43;39;82;15;18;33
89;11.04.2015;2015;04;22;Lauantai;19;13;32;3;9;12
89;11.04.2015;2015;04;23;Lauantai;19;23;42;7;14;21
89;12.04.2015;2015;04;00;Sunnuntai;13;21;34;5;7;12
89;12.04.2015;2015;04;01;Sunnuntai;15;8;23;5;5;10
89;12.04.2015;2015;04;02;Sunnuntai;22;7;29;10;5;15
89;12.04.2015;2015;04;03;Sunnuntai;10;1;11;5;0;5
89;12.04.2015;2015;04;04;Sunnuntai;5;1;6;7;0;7
89;12.04.2015;2015;04;05;Sunnuntai;4;1;5;0;0;0
89;12.04.2015;2015;04;06;Sunnuntai;2;7;9;3;5;8
89;12.04.2015;2015;04;07;Sunnuntai;4;6;10;8;7;15
89;12.04.2015;2015;04;08;Sunnuntai;7;8;15;14;12;26
89;12.04.2015;2015;04;09;Sunnuntai;19;40;59;19;33;52
89;12.04.2015;2015;04;10;Sunnuntai;17;61;78;57;66;123
89;12.04.2015;2015;04;11;Sunnuntai;54;97;151;69;89;158
89;12.04.2015;2015;04;12;Sunnuntai;99;128;227;83;79;162
89;12.04.2015;2015;04;13;Sunnuntai;109;103;212;87;89;176
89;12.04.2015;2015;04;14;Sunnuntai;110;98;208;65;64;129
89;12.04.2015;2015;04;15;Sunnuntai;102;96;198;67;64;131
89;12.04.2015;2015;04;16;Sunnuntai;76;76;152;56;64;120
89;12.04.2015;2015;04;17;Sunnuntai;78;68;146;56;39;95
89;12.04.2015;2015;04;18;Sunnuntai;84;59;143;41;42;83
89;12.04.2015;2015;04;19;Sunnuntai;56;34;90;38;53;91
89;12.04.2015;2015;04;20;Sunnuntai;51;33;84;33;25;58
89;12.04.2015;2015;04;21;Sunnuntai;26;16;42;15;11;26
89;12.04.2015;2015;04;22;Sunnuntai;15;10;25;7;3;10
89;12.04.2015;2015;04;23;Sunnuntai;2;6;8;6;3;9
89;13.04.2015;2015;04;00;Maanantai;2;3;5;2;2;4
89;13.04.2015;2015;04;01;Maanantai;3;0;3;0;0;0
89;13.04.2015;2015;04;02;Maanantai;3;1;4;0;0;0
89;13.04.2015;2015;04;03;Maanantai;2;2;4;0;0;0
89;13.04.2015;2015;04;04;Maanantai;4;2;6;1;0;1
89;13.04.2015;2015;04;05;Maanantai;5;23;28;2;1;3
89;13.04.2015;2015;04;06;Maanantai;17;53;70;5;9;14
89;13.04.2015;2015;04;07;Maanantai;48;217;265;10;27;37
89;13.04.2015;2015;04;08;Maanantai;59;225;284;14;41;55
89;13.04.2015;2015;04;09;Maanantai;50;122;172;15;42;57
89;13.04.2015;2015;04;10;Maanantai;45;90;135;22;29;51
89;13.04.2015;2015;04;11;Maanantai;73;93;166;34;41;75
89;13.04.2015;2015;04;12;Maanantai;72;72;144;23;27;50
89;13.04.2015;2015;04;13;Maanantai;85;63;148;43;24;67
89;13.04.2015;2015;04;14;Maanantai;107;73;180;21;26;47
89;13.04.2015;2015;04;15;Maanantai;153;77;230;35;21;56
89;13.04.2015;2015;04;16;Maanantai;176;89;265;56;27;83
89;13.04.2015;2015;04;17;Maanantai;104;72;176;33;27;60
89;13.04.2015;2015;04;18;Maanantai;74;67;141;48;32;80
89;13.04.2015;2015;04;19;Maanantai;63;44;107;40;29;69
89;13.04.2015;2015;04;20;Maanantai;66;21;87;30;22;52
89;13.04.2015;2015;04;21;Maanantai;83;21;104;20;16;36
89;13.04.2015;2015;04;22;Maanantai;10;7;17;8;13;21
89;13.04.2015;2015;04;23;Maanantai;11;4;15;3;5;8
89;14.04.2015;2015;04;00;Tiistai;3;3;6;2;0;2
89;14.04.2015;2015;04;01;Tiistai;0;3;3;0;0;0
89;14.04.2015;2015;04;02;Tiistai;1;1;2;0;1;1
89;14.04.2015;2015;04;03;Tiistai;2;1;3;3;0;3
89;14.04.2015;2015;04;04;Tiistai;3;4;7;0;0;0
89;14.04.2015;2015;04;05;Tiistai;4;17;21;1;0;1
89;14.04.2015;2015;04;06;Tiistai;16;70;86;6;14;20
89;14.04.2015;2015;04;07;Tiistai;55;216;271;12;23;35
89;14.04.2015;2015;04;08;Tiistai;52;225;277;13;60;73
89;14.04.2015;2015;04;09;Tiistai;46;117;163;21;38;59
89;14.04.2015;2015;04;10;Tiistai;51;86;137;24;39;63
89;14.04.2015;2015;04;11;Tiistai;69;93;162;41;38;79
89;14.04.2015;2015;04;12;Tiistai;87;118;205;32;24;56
89;14.04.2015;2015;04;13;Tiistai;86;97;183;31;50;81
89;14.04.2015;2015;04;14;Tiistai;126;81;207;57;43;100
89;14.04.2015;2015;04;15;Tiistai;194;117;311;47;27;74
89;14.04.2015;2015;04;16;Tiistai;222;103;325;42;18;60
89;14.04.2015;2015;04;17;Tiistai;143;109;252;33;32;65
89;14.04.2015;2015;04;18;Tiistai;82;50;132;45;43;88
89;14.04.2015;2015;04;19;Tiistai;68;45;113;53;48;101
89;14.04.2015;2015;04;20;Tiistai;75;39;114;50;31;81
89;14.04.2015;2015;04;21;Tiistai;43;26;69;35;20;55
89;14.04.2015;2015;04;22;Tiistai;10;9;19;12;7;19
89;14.04.2015;2015;04;23;Tiistai;13;6;19;4;1;5
89;15.04.2015;2015;04;00;Keskiviikko;5;1;6;2;3;5
89;15.04.2015;2015;04;01;Keskiviikko;7;1;8;2;1;3
89;15.04.2015;2015;04;02;Keskiviikko;1;0;1;0;1;1
89;15.04.2015;2015;04;03;Keskiviikko;2;1;3;1;0;1
89;15.04.2015;2015;04;04;Keskiviikko;2;4;6;2;0;2
89;15.04.2015;2015;04;05;Keskiviikko;4;12;16;2;2;4
89;15.04.2015;2015;04;06;Keskiviikko;15;61;76;5;12;17
89;15.04.2015;2015;04;07;Keskiviikko;57;188;245;11;36;47
89;15.04.2015;2015;04;08;Keskiviikko;57;211;268;15;46;61
89;15.04.2015;2015;04;09;Keskiviikko;44;115;159;28;28;56
89;15.04.2015;2015;04;10;Keskiviikko;27;64;91;16;24;40
89;15.04.2015;2015;04;11;Keskiviikko;51;61;112;26;25;51
89;15.04.2015;2015;04;12;Keskiviikko;64;58;122;29;40;69
89;15.04.2015;2015;04;13;Keskiviikko;63;74;137;42;15;57
89;15.04.2015;2015;04;14;Keskiviikko;120;58;178;25;14;39
89;15.04.2015;2015;04;15;Keskiviikko;154;95;249;47;29;76
89;15.04.2015;2015;04;16;Keskiviikko;159;110;269;38;23;61
89;15.04.2015;2015;04;17;Keskiviikko;121;81;202;30;25;55
89;15.04.2015;2015;04;18;Keskiviikko;59;60;119;31;24;55
89;15.04.2015;2015;04;19;Keskiviikko;60;26;86;21;14;35
89;15.04.2015;2015;04;20;Keskiviikko;60;19;79;19;14;33
89;15.04.2015;2015;04;21;Keskiviikko;62;20;82;23;8;31
89;15.04.2015;2015;04;22;Keskiviikko;22;11;33;4;12;16
89;15.04.2015;2015;04;23;Keskiviikko;9;4;13;5;4;9
89;16.04.2015;2015;04;00;Torstai;8;7;15;2;0;2
89;16.04.2015;2015;04;01;Torstai;3;0;3;1;0;1
89;16.04.2015;2015;04;02;Torstai;3;1;4;0;0;0
89;16.04.2015;2015;04;03;Torstai;3;1;4;0;0;0
89;16.04.2015;2015;04;04;Torstai;4;1;5;0;0;0
89;16.04.2015;2015;04;05;Torstai;2;8;10;2;0;2
89;16.04.2015;2015;04;06;Torstai;16;58;74;6;9;15
89;16.04.2015;2015;04;07;Torstai;40;182;222;9;38;47
89;16.04.2015;2015;04;08;Torstai;42;219;261;8;36;44
89;16.04.2015;2015;04;09;Torstai;46;103;149;18;44;62
89;16.04.2015;2015;04;10;Torstai;40;88;128;17;20;37
89;16.04.2015;2015;04;11;Torstai;60;79;139;24;29;53
89;16.04.2015;2015;04;12;Torstai;65;74;139;28;33;61
89;16.04.2015;2015;04;13;Torstai;86;67;153;34;38;72
89;16.04.2015;2015;04;14;Torstai;115;79;194;32;33;65
89;16.04.2015;2015;04;15;Torstai;182;106;288;38;34;72
89;16.04.2015;2015;04;16;Torstai;226;121;347;45;23;68
89;16.04.2015;2015;04;17;Torstai;122;91;213;30;27;57
89;16.04.2015;2015;04;18;Torstai;86;82;168;33;37;70
89;16.04.2015;2015;04;19;Torstai;89;54;143;34;31;65
89;16.04.2015;2015;04;20;Torstai;63;37;100;38;26;64
89;16.04.2015;2015;04;21;Torstai;50;31;81;15;14;29
89;16.04.2015;2015;04;22;Torstai;13;11;24;13;6;19
89;16.04.2015;2015;04;23;Torstai;9;8;17;3;4;7
89;17.04.2015;2015;04;00;Perjantai;9;3;12;4;1;5
89;17.04.2015;2015;04;01;Perjantai;4;3;7;3;0;3
89;17.04.2015;2015;04;02;Perjantai;6;4;10;3;1;4
89;17.04.2015;2015;04;03;Perjantai;4;1;5;3;0;3
89;17.04.2015;2015;04;04;Perjantai;4;7;11;2;4;6
89;17.04.2015;2015;04;05;Perjantai;4;13;17;0;1;1
89;17.04.2015;2015;04;06;Perjantai;15;66;81;6;6;12
89;17.04.2015;2015;04;07;Perjantai;53;164;217;10;35;45
89;17.04.2015;2015;04;08;Perjantai;51;188;239;15;48;63
89;17.04.2015;2015;04;09;Perjantai;47;132;179;20;46;66
89;17.04.2015;2015;04;10;Perjantai;45;102;147;35;28;63
89;17.04.2015;2015;04;11;Perjantai;70;92;162;30;35;65
89;17.04.2015;2015;04;12;Perjantai;84;87;171;30;39;69
89;17.04.2015;2015;04;13;Perjantai;124;94;218;45;42;87
89;17.04.2015;2015;04;14;Perjantai;152;104;256;46;48;94
89;17.04.2015;2015;04;15;Perjantai;179;99;278;44;30;74
89;17.04.2015;2015;04;16;Perjantai;171;78;249;48;25;73
89;17.04.2015;2015;04;17;Perjantai;100;81;181;46;30;76
89;17.04.2015;2015;04;18;Perjantai;80;71;151;48;39;87
89;17.04.2015;2015;04;19;Perjantai;83;52;135;34;24;58
89;17.04.2015;2015;04;20;Perjantai;59;33;92;16;17;33
89;17.04.2015;2015;04;21;Perjantai;29;29;58;23;15;38
89;17.04.2015;2015;04;22;Perjantai;20;35;55;8;11;19
89;17.04.2015;2015;04;23;Perjantai;16;16;32;2;5;7
89;18.04.2015;2015;04;00;Lauantai;22;9;31;5;8;13
89;18.04.2015;2015;04;01;Lauantai;28;15;43;10;6;16
89;18.04.2015;2015;04;02;Lauantai;16;5;21;4;0;4
89;18.04.2015;2015;04;03;Lauantai;24;2;26;11;0;11
89;18.04.2015;2015;04;04;Lauantai;20;5;25;7;1;8
89;18.04.2015;2015;04;05;Lauantai;2;2;4;2;0;2
89;18.04.2015;2015;04;06;Lauantai;4;10;14;1;0;1
89;18.04.2015;2015;04;07;Lauantai;5;22;27;13;15;28
89;18.04.2015;2015;04;08;Lauantai;14;31;45;7;11;18
89;18.04.2015;2015;04;09;Lauantai;20;65;85;15;27;42
89;18.04.2015;2015;04;10;Lauantai;32;75;107;24;50;74
89;18.04.2015;2015;04;11;Lauantai;54;116;170;34;63;97
89;18.04.2015;2015;04;12;Lauantai;52;107;159;41;57;98
89;18.04.2015;2015;04;13;Lauantai;66;114;180;55;40;95
89;18.04.2015;2015;04;14;Lauantai;133;96;229;54;52;106
89;18.04.2015;2015;04;15;Lauantai;126;98;224;58;55;113
89;18.04.2015;2015;04;16;Lauantai;84;47;131;32;38;70
89;18.04.2015;2015;04;17;Lauantai;60;57;117;26;38;64
89;18.04.2015;2015;04;18;Lauantai;62;60;122;19;31;50
89;18.04.2015;2015;04;19;Lauantai;56;46;102;42;33;75
89;18.04.2015;2015;04;20;Lauantai;43;44;87;22;22;44
89;18.04.2015;2015;04;21;Lauantai;36;27;63;17;15;32
89;18.04.2015;2015;04;22;Lauantai;27;28;55;8;11;19
89;18.04.2015;2015;04;23;Lauantai;15;22;37;5;5;10
89;19.04.2015;2015;04;00;Sunnuntai;21;21;42;5;8;13
89;19.04.2015;2015;04;01;Sunnuntai;20;16;36;3;5;8
89;19.04.2015;2015;04;02;Sunnuntai;10;4;14;4;0;4
89;19.04.2015;2015;04;03;Sunnuntai;22;4;26;7;2;9
89;19.04.2015;2015;04;04;Sunnuntai;15;0;15;10;0;10
89;19.04.2015;2015;04;05;Sunnuntai;5;1;6;0;0;0
89;19.04.2015;2015;04;06;Sunnuntai;4;9;13;1;3;4
89;19.04.2015;2015;04;07;Sunnuntai;4;11;15;8;9;17
89;19.04.2015;2015;04;08;Sunnuntai;7;11;18;10;11;21
89;19.04.2015;2015;04;09;Sunnuntai;28;28;56;29;17;46
89;19.04.2015;2015;04;10;Sunnuntai;21;76;97;40;40;80
89;19.04.2015;2015;04;11;Sunnuntai;47;82;129;49;57;106
89;19.04.2015;2015;04;12;Sunnuntai;70;92;162;66;72;138
89;19.04.2015;2015;04;13;Sunnuntai;104;88;192;65;53;118
89;19.04.2015;2015;04;14;Sunnuntai;97;78;175;51;55;106
89;19.04.2015;2015;04;15;Sunnuntai;74;66;140;36;40;76
89;19.04.2015;2015;04;16;Sunnuntai;97;52;149;45;30;75
89;19.04.2015;2015;04;17;Sunnuntai;79;75;154;39;33;72
89;19.04.2015;2015;04;18;Sunnuntai;64;55;119;45;42;87
89;19.04.2015;2015;04;19;Sunnuntai;41;37;78;32;31;63
89;19.04.2015;2015;04;20;Sunnuntai;43;24;67;14;21;35
89;19.04.2015;2015;04;21;Sunnuntai;30;22;52;10;12;22
89;19.04.2015;2015;04;22;Sunnuntai;10;7;17;4;0;4
89;19.04.2015;2015;04;23;Sunnuntai;10;5;15;5;1;6
89;20.04.2015;2015;04;00;Maanantai;6;4;10;2;0;2
89;20.04.2015;2015;04;01;Maanantai;8;3;11;0;0;0
89;20.04.2015;2015;04;02;Maanantai;1;1;2;0;2;2
89;20.04.2015;2015;04;03;Maanantai;3;0;3;0;0;0
89;20.04.2015;2015;04;04;Maanantai;2;3;5;1;2;3
89;20.04.2015;2015;04;05;Maanantai;4;12;16;4;0;4
89;20.04.2015;2015;04;06;Maanantai;17;76;93;5;8;13
89;20.04.2015;2015;04;07;Maanantai;55;198;253;6;41;47
89;20.04.2015;2015;04;08;Maanantai;52;263;315;15;40;55
89;20.04.2015;2015;04;09;Maanantai;54;160;214;17;39;56
89;20.04.2015;2015;04;10;Maanantai;45;91;136;22;29;51
89;20.04.2015;2015;04;11;Maanantai;64;122;186;33;40;73
89;20.04.2015;2015;04;12;Maanantai;89;90;179;32;22;54
89;20.04.2015;2015;04;13;Maanantai;110;89;199;33;37;70
89;20.04.2015;2015;04;14;Maanantai;128;100;228;38;42;80
89;20.04.2015;2015;04;15;Maanantai;195;117;312;48;52;100
89;20.04.2015;2015;04;16;Maanantai;227;96;323;43;29;72
89;20.04.2015;2015;04;17;Maanantai;124;87;211;44;39;83
89;20.04.2015;2015;04;18;Maanantai;98;65;163;51;44;95
89;20.04.2015;2015;04;19;Maanantai;78;54;132;34;21;55
89;20.04.2015;2015;04;20;Maanantai;68;21;89;37;22;59
89;20.04.2015;2015;04;21;Maanantai;63;19;82;11;3;14
89;20.04.2015;2015;04;22;Maanantai;28;11;39;12;2;14
89;20.04.2015;2015;04;23;Maanantai;8;5;13;3;1;4
89;21.04.2015;2015;04;00;Tiistai;4;2;6;2;3;5
89;21.04.2015;2015;04;01;Tiistai;6;1;7;0;0;0
89;21.04.2015;2015;04;02;Tiistai;1;4;5;1;0;1
89;21.04.2015;2015;04;03;Tiistai;3;3;6;0;1;1
89;21.04.2015;2015;04;04;Tiistai;1;1;2;2;0;2
89;21.04.2015;2015;04;05;Tiistai;2;13;15;0;0;0
89;21.04.2015;2015;04;06;Tiistai;15;86;101;5;6;11
89;21.04.2015;2015;04;07;Tiistai;51;218;269;9;31;40
89;21.04.2015;2015;04;08;Tiistai;56;258;314;15;32;47
89;21.04.2015;2015;04;09;Tiistai;53;118;171;19;43;62
89;21.04.2015;2015;04;10;Tiistai;46;107;153;24;42;66
89;21.04.2015;2015;04;11;Tiistai;75;104;179;45;39;84
89;21.04.2015;2015;04;12;Tiistai;76;96;172;32;27;59
89;21.04.2015;2015;04;13;Tiistai;84;97;181;40;27;67
89;21.04.2015;2015;04;14;Tiistai;119;107;226;42;27;69
89;21.04.2015;2015;04;15;Tiistai;225;94;319;33;25;58
89;21.04.2015;2015;04;16;Tiistai;227;120;347;35;29;64
89;21.04.2015;2015;04;17;Tiistai;125;83;208;39;26;65
89;21.04.2015;2015;04;18;Tiistai;108;106;214;56;54;110
89;21.04.2015;2015;04;19;Tiistai;105;71;176;73;54;127
89;21.04.2015;2015;04;20;Tiistai;75;38;113;30;34;64
89;21.04.2015;2015;04;21;Tiistai;54;26;80;18;16;34
89;21.04.2015;2015;04;22;Tiistai;38;12;50;12;10;22
89;21.04.2015;2015;04;23;Tiistai;12;3;15;7;4;11
89;22.04.2015;2015;04;00;Keskiviikko;7;3;10;3;0;3
89;22.04.2015;2015;04;01;Keskiviikko;2;4;6;1;1;2
89;22.04.2015;2015;04;02;Keskiviikko;2;4;6;0;0;0
89;22.04.2015;2015;04;03;Keskiviikko;3;4;7;1;0;1
89;22.04.2015;2015;04;04;Keskiviikko;3;5;8;0;1;1
89;22.04.2015;2015;04;05;Keskiviikko;5;16;21;1;1;2
89;22.04.2015;2015;04;06;Keskiviikko;19;70;89;5;10;15
89;22.04.2015;2015;04;07;Keskiviikko;52;230;282;7;36;43
89;22.04.2015;2015;04;08;Keskiviikko;41;237;278;15;38;53
89;22.04.2015;2015;04;09;Keskiviikko;49;128;177;24;38;62
89;22.04.2015;2015;04;10;Keskiviikko;48;85;133;22;38;60
89;22.04.2015;2015;04;11;Keskiviikko;65;105;170;17;28;45
89;22.04.2015;2015;04;12;Keskiviikko;74;104;178;23;22;45
89;22.04.2015;2015;04;13;Keskiviikko;116;66;182;26;24;50
89;22.04.2015;2015;04;14;Keskiviikko;123;86;209;42;24;66
89;22.04.2015;2015;04;15;Keskiviikko;185;107;292;40;37;77
89;22.04.2015;2015;04;16;Keskiviikko;188;133;321;44;21;65
89;22.04.2015;2015;04;17;Keskiviikko;125;119;244;27;40;67
89;22.04.2015;2015;04;18;Keskiviikko;98;95;193;48;37;85
89;22.04.2015;2015;04;19;Keskiviikko;75;51;126;38;27;65
89;22.04.2015;2015;04;20;Keskiviikko;77;28;105;19;24;43
89;22.04.2015;2015;04;21;Keskiviikko;109;54;163;20;14;34
89;22.04.2015;2015;04;22;Keskiviikko;27;16;43;10;10;20
89;22.04.2015;2015;04;23;Keskiviikko;13;21;34;5;3;8
89;23.04.2015;2015;04;00;Torstai;19;1;20;6;2;8
89;23.04.2015;2015;04;01;Torstai;13;0;13;0;1;1
89;23.04.2015;2015;04;02;Torstai;8;1;9;5;0;5
89;23.04.2015;2015;04;03;Torstai;11;5;16;1;0;1
89;23.04.2015;2015;04;04;Torstai;3;0;3;6;1;7
89;23.04.2015;2015;04;05;Torstai;4;10;14;1;0;1
89;23.04.2015;2015;04;06;Torstai;16;73;89;3;4;7
89;23.04.2015;2015;04;07;Torstai;48;192;240;10;28;38
89;23.04.2015;2015;04;08;Torstai;40;216;256;11;35;46
89;23.04.2015;2015;04;09;Torstai;36;146;182;11;32;43
89;23.04.2015;2015;04;10;Torstai;47;95;142;22;38;60
89;23.04.2015;2015;04;11;Torstai;81;94;175;37;25;62
89;23.04.2015;2015;04;12;Torstai;84;90;174;20;29;49
89;23.04.2015;2015;04;13;Torstai;116;75;191;32;23;55
89;23.04.2015;2015;04;14;Torstai;114;101;215;23;35;58
89;23.04.2015;2015;04;15;Torstai;178;105;283;33;20;53
89;23.04.2015;2015;04;16;Torstai;210;122;332;24;22;46
89;23.04.2015;2015;04;17;Torstai;110;101;211;33;40;73
89;23.04.2015;2015;04;18;Torstai;97;72;169;42;35;77
89;23.04.2015;2015;04;19;Torstai;95;54;149;37;40;77
89;23.04.2015;2015;04;20;Torstai;76;51;127;31;36;67
89;23.04.2015;2015;04;21;Torstai;61;26;87;15;14;29
89;23.04.2015;2015;04;22;Torstai;27;11;38;8;4;12
89;23.04.2015;2015;04;23;Torstai;22;5;27;5;4;9
89;24.04.2015;2015;04;00;Perjantai;10;7;17;0;0;0
89;24.04.2015;2015;04;01;Perjantai;7;3;10;1;0;1
89;24.04.2015;2015;04;02;Perjantai;3;5;8;2;0;2
89;24.04.2015;2015;04;03;Perjantai;5;0;5;0;0;0
89;24.04.2015;2015;04;04;Perjantai;1;4;5;3;0;3
89;24.04.2015;2015;04;05;Perjantai;2;19;21;4;1;5
89;24.04.2015;2015;04;06;Perjantai;13;55;68;4;9;13
89;24.04.2015;2015;04;07;Perjantai;51;165;216;4;32;36
89;24.04.2015;2015;04;08;Perjantai;43;199;242;13;37;50
89;24.04.2015;2015;04;09;Perjantai;44;114;158;16;41;57
89;24.04.2015;2015;04;10;Perjantai;47;89;136;20;32;52
89;24.04.2015;2015;04;11;Perjantai;118;124;242;28;29;57
89;24.04.2015;2015;04;12;Perjantai;160;100;260;60;46;106
89;24.04.2015;2015;04;13;Perjantai;131;145;276;29;58;87
89;24.04.2015;2015;04;14;Perjantai;171;148;319;33;41;74
89;24.04.2015;2015;04;15;Perjantai;169;183;352;24;47;71
89;24.04.2015;2015;04;16;Perjantai;163;180;343;33;39;72
89;24.04.2015;2015;04;17;Perjantai;125;135;260;27;26;53
89;24.04.2015;2015;04;18;Perjantai;92;78;170;27;27;54
89;24.04.2015;2015;04;19;Perjantai;89;39;128;30;22;52
89;24.04.2015;2015;04;20;Perjantai;50;26;76;28;21;49
89;24.04.2015;2015;04;21;Perjantai;83;43;126;14;9;23
89;24.04.2015;2015;04;22;Perjantai;45;40;85;8;9;17
89;24.04.2015;2015;04;23;Perjantai;26;30;56;5;9;14
89;25.04.2015;2015;04;00;Lauantai;19;16;35;9;12;21
89;25.04.2015;2015;04;01;Lauantai;18;30;48;6;5;11
89;25.04.2015;2015;04;02;Lauantai;17;8;25;1;4;5
89;25.04.2015;2015;04;03;Lauantai;19;4;23;9;2;11
89;25.04.2015;2015;04;04;Lauantai;15;3;18;8;1;9
89;25.04.2015;2015;04;05;Lauantai;4;7;11;2;2;4
89;25.04.2015;2015;04;06;Lauantai;9;19;28;2;2;4
89;25.04.2015;2015;04;07;Lauantai;5;22;27;7;9;16
89;25.04.2015;2015;04;08;Lauantai;11;35;46;12;21;33
89;25.04.2015;2015;04;09;Lauantai;20;76;96;23;43;66
89;25.04.2015;2015;04;10;Lauantai;26;108;134;30;32;62
89;25.04.2015;2015;04;11;Lauantai;53;108;161;21;42;63
89;25.04.2015;2015;04;12;Lauantai;68;83;151;32;42;74
89;25.04.2015;2015;04;13;Lauantai;107;76;183;25;34;59
89;25.04.2015;2015;04;14;Lauantai;108;77;185;22;30;52
89;25.04.2015;2015;04;15;Lauantai;98;86;184;35;27;62
89;25.04.2015;2015;04;16;Lauantai;93;69;162;27;32;59
89;25.04.2015;2015;04;17;Lauantai;58;77;135;33;33;66
89;25.04.2015;2015;04;18;Lauantai;46;61;107;22;24;46
89;25.04.2015;2015;04;19;Lauantai;19;29;48;13;14;27
89;25.04.2015;2015;04;20;Lauantai;26;45;71;13;23;36
89;25.04.2015;2015;04;21;Lauantai;59;90;149;8;21;29
89;25.04.2015;2015;04;22;Lauantai;43;64;107;5;19;24
89;25.04.2015;2015;04;23;Lauantai;23;48;71;12;15;27
89;26.04.2015;2015;04;00;Sunnuntai;42;29;71;11;5;16
89;26.04.2015;2015;04;01;Sunnuntai;35;6;41;5;5;10
89;26.04.2015;2015;04;02;Sunnuntai;40;2;42;8;1;9
89;26.04.2015;2015;04;03;Sunnuntai;19;1;20;11;2;13
89;26.04.2015;2015;04;04;Sunnuntai;32;4;36;9;0;9
89;26.04.2015;2015;04;05;Sunnuntai;7;2;9;1;1;2
89;26.04.2015;2015;04;06;Sunnuntai;4;18;22;2;2;4
89;26.04.2015;2015;04;07;Sunnuntai;2;11;13;5;7;12
89;26.04.2015;2015;04;08;Sunnuntai;8;14;22;11;12;23
89;26.04.2015;2015;04;09;Sunnuntai;16;31;47;14;44;58
89;26.04.2015;2015;04;10;Sunnuntai;30;45;75;32;63;95
89;26.04.2015;2015;04;11;Sunnuntai;66;85;151;47;52;99
89;26.04.2015;2015;04;12;Sunnuntai;76;109;185;40;64;104
89;26.04.2015;2015;04;13;Sunnuntai;65;122;187;53;61;114
89;26.04.2015;2015;04;14;Sunnuntai;125;103;228;39;62;101
89;26.04.2015;2015;04;15;Sunnuntai;105;69;174;44;50;94
89;26.04.2015;2015;04;16;Sunnuntai;103;69;172;33;31;64
89;26.04.2015;2015;04;17;Sunnuntai;111;82;193;46;37;83
89;26.04.2015;2015;04;18;Sunnuntai;73;64;137;34;32;66
89;26.04.2015;2015;04;19;Sunnuntai;56;36;92;28;28;56
89;26.04.2015;2015;04;20;Sunnuntai;41;23;64;21;20;41
89;26.04.2015;2015;04;21;Sunnuntai;20;33;53;13;14;27
89;26.04.2015;2015;04;22;Sunnuntai;18;27;45;3;5;8
89;26.04.2015;2015;04;23;Sunnuntai;13;7;20;3;2;5
89;27.04.2015;2015;04;00;Maanantai;1;13;14;1;4;5
89;27.04.2015;2015;04;01;Maanantai;0;4;4;0;1;1
89;27.04.2015;2015;04;02;Maanantai;3;3;6;0;0;0
89;27.04.2015;2015;04;03;Maanantai;4;1;5;0;0;0
89;27.04.2015;2015;04;04;Maanantai;3;3;6;1;0;1
89;27.04.2015;2015;04;05;Maanantai;4;16;20;0;1;1
89;27.04.2015;2015;04;06;Maanantai;13;56;69;3;10;13
89;27.04.2015;2015;04;07;Maanantai;28;152;180;4;22;26
89;27.04.2015;2015;04;08;Maanantai;40;194;234;4;37;41
89;27.04.2015;2015;04;09;Maanantai;40;134;174;15;28;43
89;27.04.2015;2015;04;10;Maanantai;48;76;124;24;28;52
89;27.04.2015;2015;04;11;Maanantai;65;76;141;23;29;52
89;27.04.2015;2015;04;12;Maanantai;91;83;174;47;53;100
89;27.04.2015;2015;04;13;Maanantai;113;63;176;23;22;45
89;27.04.2015;2015;04;14;Maanantai;109;71;180;38;15;53
89;27.04.2015;2015;04;15;Maanantai;182;96;278;24;22;46
89;27.04.2015;2015;04;16;Maanantai;186;111;297;34;24;58
89;27.04.2015;2015;04;17;Maanantai;97;83;180;25;41;66
89;27.04.2015;2015;04;18;Maanantai;94;149;243;30;53;83
89;27.04.2015;2015;04;19;Maanantai;114;59;173;46;45;91
89;27.04.2015;2015;04;20;Maanantai;127;27;154;35;34;69
89;27.04.2015;2015;04;21;Maanantai;53;18;71;21;18;39
89;27.04.2015;2015;04;22;Maanantai;13;10;23;4;7;11
89;27.04.2015;2015;04;23;Maanantai;14;15;29;2;1;3
89;28.04.2015;2015;04;00;Tiistai;4;6;10;0;3;3
89;28.04.2015;2015;04;01;Tiistai;4;0;4;1;2;3
89;28.04.2015;2015;04;02;Tiistai;4;6;10;0;3;3
89;28.04.2015;2015;04;03;Tiistai;4;0;4;1;0;1
89;28.04.2015;2015;04;04;Tiistai;2;2;4;4;0;4
89;28.04.2015;2015;04;05;Tiistai;4;19;23;2;3;5
89;28.04.2015;2015;04;06;Tiistai;16;68;84;6;11;17
89;28.04.2015;2015;04;07;Tiistai;52;211;263;7;32;39
89;28.04.2015;2015;04;08;Tiistai;49;246;295;9;42;51
89;28.04.2015;2015;04;09;Tiistai;45;138;183;13;24;37
89;28.04.2015;2015;04;10;Tiistai;56;99;155;23;30;53
89;28.04.2015;2015;04;11;Tiistai;74;124;198;34;32;66
89;28.04.2015;2015;04;12;Tiistai;86;108;194;16;32;48
89;28.04.2015;2015;04;13;Tiistai;121;89;210;27;34;61
89;28.04.2015;2015;04;14;Tiistai;136;115;251;24;34;58
89;28.04.2015;2015;04;15;Tiistai;211;113;324;34;26;60
89;28.04.2015;2015;04;16;Tiistai;234;122;356;36;17;53
89;28.04.2015;2015;04;17;Tiistai;152;100;252;32;30;62
89;28.04.2015;2015;04;18;Tiistai;121;92;213;41;36;77
89;28.04.2015;2015;04;19;Tiistai;110;65;175;41;49;90
89;28.04.2015;2015;04;20;Tiistai;87;36;123;32;36;68
89;28.04.2015;2015;04;21;Tiistai;59;34;93;21;15;36
89;28.04.2015;2015;04;22;Tiistai;19;19;38;9;10;19
89;28.04.2015;2015;04;23;Tiistai;6;15;21;2;1;3
89;29.04.2015;2015;04;00;Keskiviikko;6;4;10;2;1;3
89;29.04.2015;2015;04;01;Keskiviikko;10;2;12;0;1;1
89;29.04.2015;2015;04;02;Keskiviikko;17;3;20;2;0;2
89;29.04.2015;2015;04;03;Keskiviikko;4;5;9;0;0;0
89;29.04.2015;2015;04;04;Keskiviikko;4;2;6;2;0;2
89;29.04.2015;2015;04;05;Keskiviikko;5;21;26;1;2;3
89;29.04.2015;2015;04;06;Keskiviikko;18;67;85;1;6;7
89;29.04.2015;2015;04;07;Keskiviikko;46;223;269;9;28;37
89;29.04.2015;2015;04;08;Keskiviikko;40;217;257;8;46;54
89;29.04.2015;2015;04;09;Keskiviikko;47;128;175;13;30;43
89;29.04.2015;2015;04;10;Keskiviikko;49;71;120;24;24;48
89;29.04.2015;2015;04;11;Keskiviikko;79;105;184;16;32;48
89;29.04.2015;2015;04;12;Keskiviikko;88;112;200;21;22;43
89;29.04.2015;2015;04;13;Keskiviikko;115;82;197;25;28;53
89;29.04.2015;2015;04;14;Keskiviikko;151;83;234;28;27;55
89;29.04.2015;2015;04;15;Keskiviikko;185;106;291;17;27;44
89;29.04.2015;2015;04;16;Keskiviikko;209;112;321;34;18;52
89;29.04.2015;2015;04;17;Keskiviikko;124;95;219;26;16;42
89;29.04.2015;2015;04;18;Keskiviikko;91;69;160;29;21;50
89;29.04.2015;2015;04;19;Keskiviikko;90;47;137;17;34;51
89;29.04.2015;2015;04;20;Keskiviikko;90;32;122;28;12;40
89;29.04.2015;2015;04;21;Keskiviikko;58;28;86;10;6;16
89;29.04.2015;2015;04;22;Keskiviikko;25;25;50;8;2;10
89;29.04.2015;2015;04;23;Keskiviikko;11;19;30;4;8;12
89;30.04.2015;2015;04;00;Torstai;9;10;19;3;3;6
89;30.04.2015;2015;04;01;Torstai;8;3;11;4;0;4
89;30.04.2015;2015;04;02;Torstai;8;0;8;0;0;0
89;30.04.2015;2015;04;03;Torstai;12;1;13;0;1;1
89;30.04.2015;2015;04;04;Torstai;7;2;9;1;0;1
89;30.04.2015;2015;04;05;Torstai;4;14;18;1;1;2
89;30.04.2015;2015;04;06;Torstai;13;43;56;5;10;15
89;30.04.2015;2015;04;07;Torstai;40;167;207;7;28;35
89;30.04.2015;2015;04;08;Torstai;48;204;252;5;42;47
89;30.04.2015;2015;04;09;Torstai;38;120;158;10;42;52
89;30.04.2015;2015;04;10;Torstai;46;97;143;44;49;93
89;30.04.2015;2015;04;11;Torstai;76;136;212;31;42;73
89;30.04.2015;2015;04;12;Torstai;110;121;231;36;39;75
89;30.04.2015;2015;04;13;Torstai;96;207;303;26;41;67
89;30.04.2015;2015;04;14;Torstai;147;282;429;34;47;81
89;30.04.2015;2015;04;15;Torstai;229;169;398;44;44;88
89;30.04.2015;2015;04;16;Torstai;220;118;338;48;37;85
89;30.04.2015;2015;04;17;Torstai;147;127;274;44;44;88
89;30.04.2015;2015;04;18;Torstai;116;143;259;31;42;73
89;30.04.2015;2015;04;19;Torstai;127;133;260;55;59;114
89;30.04.2015;2015;04;20;Torstai;54;111;165;30;70;100
89;30.04.2015;2015;04;21;Torstai;69;98;167;47;77;124
89;30.04.2015;2015;04;22;Torstai;62;83;145;26;34;60
89;30.04.2015;2015;04;23;Torstai;64;43;107;21;31;52
89;01.05.2015;2015;05;00;Perjantai;78;35;113;16;11;27
89;01.05.2015;2015;05;01;Perjantai;56;21;77;23;6;29
89;01.05.2015;2015;05;02;Perjantai;66;19;85;29;10;39
89;01.05.2015;2015;05;03;Perjantai;59;16;75;23;1;24
89;01.05.2015;2015;05;04;Perjantai;44;10;54;29;3;32
89;01.05.2015;2015;05;05;Perjantai;40;9;49;3;0;3
89;01.05.2015;2015;05;06;Perjantai;13;7;20;2;3;5
89;01.05.2015;2015;05;07;Perjantai;5;15;20;3;9;12
89;01.05.2015;2015;05;08;Perjantai;7;18;25;15;10;25
89;01.05.2015;2015;05;09;Perjantai;6;46;52;10;33;43
89;01.05.2015;2015;05;10;Perjantai;46;97;143;19;52;71
89;01.05.2015;2015;05;11;Perjantai;38;196;234;21;79;100
89;01.05.2015;2015;05;12;Perjantai;83;187;270;39;88;127
89;01.05.2015;2015;05;13;Perjantai;181;180;361;68;72;140
89;01.05.2015;2015;05;14;Perjantai;181;100;281;70;56;126
89;01.05.2015;2015;05;15;Perjantai;163;33;196;58;31;89
89;01.05.2015;2015;05;16;Perjantai;88;22;110;20;19;39
89;01.05.2015;2015;05;17;Perjantai;61;30;91;16;17;33
89;01.05.2015;2015;05;18;Perjantai;27;21;48;22;11;33
89;01.05.2015;2015;05;19;Perjantai;43;31;74;17;10;27
89;01.05.2015;2015;05;20;Perjantai;35;43;78;18;21;39
89;01.05.2015;2015;05;21;Perjantai;19;21;40;13;18;31
89;01.05.2015;2015;05;22;Perjantai;17;13;30;6;8;14
89;01.05.2015;2015;05;23;Perjantai;22;26;48;5;11;16
89;02.05.2015;2015;05;00;Lauantai;20;11;31;6;11;17
89;02.05.2015;2015;05;01;Lauantai;5;8;13;3;6;9
89;02.05.2015;2015;05;02;Lauantai;11;0;11;8;1;9
89;02.05.2015;2015;05;03;Lauantai;13;2;15;9;1;10
89;02.05.2015;2015;05;04;Lauantai;17;1;18;8;0;8
89;02.05.2015;2015;05;05;Lauantai;5;2;7;2;0;2
89;02.05.2015;2015;05;06;Lauantai;6;13;19;2;5;7
89;02.05.2015;2015;05;07;Lauantai;8;18;26;3;7;10
89;02.05.2015;2015;05;08;Lauantai;12;26;38;9;18;27
89;02.05.2015;2015;05;09;Lauantai;18;61;79;13;27;40
89;02.05.2015;2015;05;10;Lauantai;60;96;156;20;37;57
89;02.05.2015;2015;05;11;Lauantai;49;98;147;20;58;78
89;02.05.2015;2015;05;12;Lauantai;88;106;194;40;58;98
89;02.05.2015;2015;05;13;Lauantai;112;94;206;35;39;74
89;02.05.2015;2015;05;14;Lauantai;104;67;171;29;34;63
89;02.05.2015;2015;05;15;Lauantai;86;81;167;36;32;68
89;02.05.2015;2015;05;16;Lauantai;71;66;137;29;33;62
89;02.05.2015;2015;05;17;Lauantai;72;57;129;31;37;68
89;02.05.2015;2015;05;18;Lauantai;57;51;108;26;20;46
89;02.05.2015;2015;05;19;Lauantai;39;47;86;17;29;46
89;02.05.2015;2015;05;20;Lauantai;31;36;67;15;12;27
89;02.05.2015;2015;05;21;Lauantai;25;12;37;4;4;8
89;02.05.2015;2015;05;22;Lauantai;18;10;28;1;12;13
89;02.05.2015;2015;05;23;Lauantai;24;18;42;3;0;3
89;03.05.2015;2015;05;00;Sunnuntai;19;12;31;2;4;6
89;03.05.2015;2015;05;01;Sunnuntai;9;4;13;1;2;3
89;03.05.2015;2015;05;02;Sunnuntai;6;4;10;4;3;7
89;03.05.2015;2015;05;03;Sunnuntai;8;1;9;1;0;1
89;03.05.2015;2015;05;04;Sunnuntai;12;1;13;3;0;3
89;03.05.2015;2015;05;05;Sunnuntai;2;2;4;1;0;1
89;03.05.2015;2015;05;06;Sunnuntai;0;4;4;1;1;2
89;03.05.2015;2015;05;07;Sunnuntai;4;6;10;2;5;7
89;03.05.2015;2015;05;08;Sunnuntai;2;9;11;9;5;14
89;03.05.2015;2015;05;09;Sunnuntai;6;10;16;5;8;13
89;03.05.2015;2015;05;10;Sunnuntai;14;20;34;13;23;36
89;03.05.2015;2015;05;11;Sunnuntai;21;45;66;33;22;55
89;03.05.2015;2015;05;12;Sunnuntai;34;39;73;25;43;68
89;03.05.2015;2015;05;13;Sunnuntai;39;62;101;35;46;81
89;03.05.2015;2015;05;14;Sunnuntai;69;56;125;31;33;64
89;03.05.2015;2015;05;15;Sunnuntai;67;53;120;22;34;56
89;03.05.2015;2015;05;16;Sunnuntai;58;45;103;31;20;51
89;03.05.2015;2015;05;17;Sunnuntai;61;34;95;30;25;55
89;03.05.2015;2015;05;18;Sunnuntai;45;20;65;22;20;42
89;03.05.2015;2015;05;19;Sunnuntai;37;23;60;24;25;49
89;03.05.2015;2015;05;20;Sunnuntai;44;16;60;13;14;27
89;03.05.2015;2015;05;21;Sunnuntai;16;19;35;6;10;16
89;03.05.2015;2015;05;22;Sunnuntai;8;7;15;3;2;5
89;03.05.2015;2015;05;23;Sunnuntai;14;5;19;4;1;5
89;04.05.2015;2015;05;00;Maanantai;1;3;4;1;2;3
89;04.05.2015;2015;05;01;Maanantai;1;3;4;0;2;2
89;04.05.2015;2015;05;02;Maanantai;0;0;0;1;1;2
89;04.05.2015;2015;05;03;Maanantai;3;1;4;2;0;2
89;04.05.2015;2015;05;04;Maanantai;1;2;3;0;0;0
89;04.05.2015;2015;05;05;Maanantai;5;16;21;0;3;3
89;04.05.2015;2015;05;06;Maanantai;16;65;81;0;4;4
89;04.05.2015;2015;05;07;Maanantai;38;212;250;4;36;40
89;04.05.2015;2015;05;08;Maanantai;56;254;310;8;39;47
89;04.05.2015;2015;05;09;Maanantai;51;134;185;14;46;60
89;04.05.2015;2015;05;10;Maanantai;52;95;147;14;21;35
89;04.05.2015;2015;05;11;Maanantai;96;107;203;21;38;59
89;04.05.2015;2015;05;12;Maanantai;92;106;198;30;36;66
89;04.05.2015;2015;05;13;Maanantai;105;91;196;35;50;85
89;04.05.2015;2015;05;14;Maanantai;145;84;229;47;31;78
89;04.05.2015;2015;05;15;Maanantai;189;101;290;40;36;76
89;04.05.2015;2015;05;16;Maanantai;263;119;382;55;26;81
89;04.05.2015;2015;05;17;Maanantai;145;87;232;27;26;53
89;04.05.2015;2015;05;18;Maanantai;126;69;195;45;59;104
89;04.05.2015;2015;05;19;Maanantai;94;73;167;41;53;94
89;04.05.2015;2015;05;20;Maanantai;74;36;110;29;29;58
89;04.05.2015;2015;05;21;Maanantai;55;19;74;14;15;29
89;04.05.2015;2015;05;22;Maanantai;7;14;21;6;7;13
89;04.05.2015;2015;05;23;Maanantai;6;5;11;4;1;5
89;05.05.2015;2015;05;00;Tiistai;6;3;9;1;1;2
89;05.05.2015;2015;05;01;Tiistai;1;3;4;2;0;2
89;05.05.2015;2015;05;02;Tiistai;5;0;5;0;2;2
89;05.05.2015;2015;05;03;Tiistai;2;1;3;0;0;0
89;05.05.2015;2015;05;04;Tiistai;2;4;6;3;0;3
89;05.05.2015;2015;05;05;Tiistai;6;14;20;2;0;2
89;05.05.2015;2015;05;06;Tiistai;19;76;95;3;11;14
89;05.05.2015;2015;05;07;Tiistai;51;221;272;9;35;44
89;05.05.2015;2015;05;08;Tiistai;55;278;333;7;29;36
89;05.05.2015;2015;05;09;Tiistai;52;144;196;18;44;62
89;05.05.2015;2015;05;10;Tiistai;55;88;143;28;21;49
89;05.05.2015;2015;05;11;Tiistai;80;104;184;24;23;47
89;05.05.2015;2015;05;12;Tiistai;84;108;192;23;24;47
89;05.05.2015;2015;05;13;Tiistai;87;81;168;24;31;55
89;05.05.2015;2015;05;14;Tiistai;163;83;246;37;48;85
89;05.05.2015;2015;05;15;Tiistai;220;105;325;33;27;60
89;05.05.2015;2015;05;16;Tiistai;264;124;388;29;19;48
89;05.05.2015;2015;05;17;Tiistai;159;103;262;30;31;61
89;05.05.2015;2015;05;18;Tiistai;111;76;187;39;48;87
89;05.05.2015;2015;05;19;Tiistai;99;51;150;33;39;72
89;05.05.2015;2015;05;20;Tiistai;72;35;107;34;32;66
89;05.05.2015;2015;05;21;Tiistai;49;24;73;16;20;36
89;05.05.2015;2015;05;22;Tiistai;19;10;29;9;8;17
89;05.05.2015;2015;05;23;Tiistai;12;3;15;10;5;15
89;06.05.2015;2015;05;00;Keskiviikko;8;1;9;0;0;0
89;06.05.2015;2015;05;01;Keskiviikko;1;0;1;0;0;0
89;06.05.2015;2015;05;02;Keskiviikko;2;0;2;0;0;0
89;06.05.2015;2015;05;03;Keskiviikko;0;1;1;1;1;2
89;06.05.2015;2015;05;04;Keskiviikko;0;6;6;3;0;3
89;06.05.2015;2015;05;05;Keskiviikko;3;18;21;3;1;4
89;06.05.2015;2015;05;06;Keskiviikko;21;81;102;8;10;18
89;06.05.2015;2015;05;07;Keskiviikko;53;250;303;14;26;40
89;06.05.2015;2015;05;08;Keskiviikko;49;244;293;9;48;57
89;06.05.2015;2015;05;09;Keskiviikko;41;129;170;22;52;74
89;06.05.2015;2015;05;10;Keskiviikko;53;89;142;17;40;57
89;06.05.2015;2015;05;11;Keskiviikko;71;87;158;27;18;45
89;06.05.2015;2015;05;12;Keskiviikko;67;103;170;34;44;78
89;06.05.2015;2015;05;13;Keskiviikko;90;89;179;23;20;43
89;06.05.2015;2015;05;14;Keskiviikko;160;88;248;33;27;60
89;06.05.2015;2015;05;15;Keskiviikko;204;113;317;25;33;58
89;06.05.2015;2015;05;16;Keskiviikko;249;100;349;45;40;85
89;06.05.2015;2015;05;17;Keskiviikko;145;92;237;35;38;73
89;06.05.2015;2015;05;18;Keskiviikko;114;52;166;28;34;62
89;06.05.2015;2015;05;19;Keskiviikko;81;58;139;35;33;68
89;06.05.2015;2015;05;20;Keskiviikko;54;36;90;17;20;37
89;06.05.2015;2015;05;21;Keskiviikko;56;19;75;10;8;18
89;06.05.2015;2015;05;22;Keskiviikko;22;10;32;6;3;9
89;06.05.2015;2015;05;23;Keskiviikko;18;1;19;7;2;9
89;07.05.2015;2015;05;00;Torstai;9;1;10;1;1;2
89;07.05.2015;2015;05;01;Torstai;2;1;3;1;0;1
89;07.05.2015;2015;05;02;Torstai;5;1;6;0;0;0
89;07.05.2015;2015;05;03;Torstai;0;3;3;0;0;0
89;07.05.2015;2015;05;04;Torstai;2;3;5;0;1;1
89;07.05.2015;2015;05;05;Torstai;3;13;16;0;2;2
89;07.05.2015;2015;05;06;Torstai;26;71;97;3;6;9
89;07.05.2015;2015;05;07;Torstai;54;221;275;7;31;38
89;07.05.2015;2015;05;08;Torstai;50;261;311;8;42;50
89;07.05.2015;2015;05;09;Torstai;55;143;198;20;46;66
89;07.05.2015;2015;05;10;Torstai;58;106;164;17;31;48
89;07.05.2015;2015;05;11;Torstai;96;95;191;59;32;91
89;07.05.2015;2015;05;12;Torstai;97;91;188;23;24;47
89;07.05.2015;2015;05;13;Torstai;118;110;228;17;23;40
89;07.05.2015;2015;05;14;Torstai;137;76;213;33;40;73
89;07.05.2015;2015;05;15;Torstai;199;112;311;30;35;65
89;07.05.2015;2015;05;16;Torstai;245;137;382;38;36;74
89;07.05.2015;2015;05;17;Torstai;136;117;253;41;46;87
89;07.05.2015;2015;05;18;Torstai;109;85;194;37;57;94
89;07.05.2015;2015;05;19;Torstai;111;64;175;31;35;66
89;07.05.2015;2015;05;20;Torstai;105;38;143;25;24;49
89;07.05.2015;2015;05;21;Torstai;66;24;90;8;14;22
89;07.05.2015;2015;05;22;Torstai;27;15;42;13;8;21
89;07.05.2015;2015;05;23;Torstai;14;8;22;5;2;7
89;08.05.2015;2015;05;00;Perjantai;2;4;6;3;3;6
89;08.05.2015;2015;05;01;Perjantai;5;4;9;2;2;4
89;08.05.2015;2015;05;02;Perjantai;5;2;7;0;1;1
89;08.05.2015;2015;05;03;Perjantai;3;3;6;0;0;0
89;08.05.2015;2015;05;04;Perjantai;1;2;3;0;0;0
89;08.05.2015;2015;05;05;Perjantai;2;9;11;1;1;2
89;08.05.2015;2015;05;06;Perjantai;18;69;87;4;12;16
89;08.05.2015;2015;05;07;Perjantai;48;212;260;6;28;34
89;08.05.2015;2015;05;08;Perjantai;48;216;264;14;44;58
89;08.05.2015;2015;05;09;Perjantai;47;95;142;15;26;41
89;08.05.2015;2015;05;10;Perjantai;30;74;104;12;16;28
89;08.05.2015;2015;05;11;Perjantai;54;65;119;13;20;33
89;08.05.2015;2015;05;12;Perjantai;76;74;150;22;18;40
89;08.05.2015;2015;05;13;Perjantai;111;111;222;22;24;46
89;08.05.2015;2015;05;14;Perjantai;145;68;213;24;17;41
89;08.05.2015;2015;05;15;Perjantai;190;92;282;25;23;48
89;08.05.2015;2015;05;16;Perjantai;164;99;263;27;19;46
89;08.05.2015;2015;05;17;Perjantai;125;120;245;29;37;66
89;08.05.2015;2015;05;18;Perjantai;91;81;172;27;36;63
89;08.05.2015;2015;05;19;Perjantai;98;63;161;27;14;41
89;08.05.2015;2015;05;20;Perjantai;51;50;101;15;15;30
89;08.05.2015;2015;05;21;Perjantai;54;26;80;10;9;19
89;08.05.2015;2015;05;22;Perjantai;20;14;34;4;3;7
89;08.05.2015;2015;05;23;Perjantai;17;12;29;4;2;6
89;09.05.2015;2015;05;00;Lauantai;15;13;28;3;8;11
89;09.05.2015;2015;05;01;Lauantai;24;8;32;0;0;0
89;09.05.2015;2015;05;02;Lauantai;10;2;12;4;3;7
89;09.05.2015;2015;05;03;Lauantai;19;5;24;3;1;4
89;09.05.2015;2015;05;04;Lauantai;9;3;12;2;0;2
89;09.05.2015;2015;05;05;Lauantai;3;4;7;2;3;5
89;09.05.2015;2015;05;06;Lauantai;5;12;17;2;3;5
89;09.05.2015;2015;05;07;Lauantai;8;27;35;7;4;11
89;09.05.2015;2015;05;08;Lauantai;15;27;42;12;17;29
89;09.05.2015;2015;05;09;Lauantai;17;63;80;16;39;55
89;09.05.2015;2015;05;10;Lauantai;41;68;109;13;23;36
89;09.05.2015;2015;05;11;Lauantai;59;76;135;17;22;39
89;09.05.2015;2015;05;12;Lauantai;56;66;122;21;26;47
89;09.05.2015;2015;05;13;Lauantai;43;24;67;13;27;40
89;09.05.2015;2015;05;14;Lauantai;41;54;95;26;18;44
89;09.05.2015;2015;05;15;Lauantai;70;53;123;11;25;36
89;09.05.2015;2015;05;16;Lauantai;55;35;90;9;8;17
89;09.05.2015;2015;05;17;Lauantai;42;23;65;9;6;15
89;09.05.2015;2015;05;18;Lauantai;33;17;50;8;8;16
89;09.05.2015;2015;05;19;Lauantai;21;19;40;10;14;24
89;09.05.2015;2015;05;20;Lauantai;19;23;42;15;13;28
89;09.05.2015;2015;05;21;Lauantai;29;32;61;11;9;20
89;09.05.2015;2015;05;22;Lauantai;19;19;38;8;6;14
89;09.05.2015;2015;05;23;Lauantai;9;9;18;4;5;9
89;10.05.2015;2015;05;00;Sunnuntai;9;21;30;3;4;7
89;10.05.2015;2015;05;01;Sunnuntai;14;15;29;3;13;16
89;10.05.2015;2015;05;02;Sunnuntai;2;8;10;6;3;9
89;10.05.2015;2015;05;03;Sunnuntai;9;3;12;7;0;7
89;10.05.2015;2015;05;04;Sunnuntai;15;4;19;5;3;8
89;10.05.2015;2015;05;05;Sunnuntai;2;7;9;1;2;3
89;10.05.2015;2015;05;06;Sunnuntai;4;10;14;0;4;4
89;10.05.2015;2015;05;07;Sunnuntai;5;12;17;7;6;13
89;10.05.2015;2015;05;08;Sunnuntai;9;16;25;15;18;33
89;10.05.2015;2015;05;09;Sunnuntai;16;42;58;20;29;49
89;10.05.2015;2015;05;10;Sunnuntai;54;51;105;50;63;113
89;10.05.2015;2015;05;11;Sunnuntai;93;114;207;55;65;120
89;10.05.2015;2015;05;12;Sunnuntai;92;110;202;44;58;102
89;10.05.2015;2015;05;13;Sunnuntai;110;119;229;40;51;91
89;10.05.2015;2015;05;14;Sunnuntai;109;86;195;30;57;87
89;10.05.2015;2015;05;15;Sunnuntai;89;103;192;41;41;82
89;10.05.2015;2015;05;16;Sunnuntai;105;69;174;47;86;133
89;10.05.2015;2015;05;17;Sunnuntai;100;81;181;55;47;102
89;10.05.2015;2015;05;18;Sunnuntai;69;78;147;29;35;64
89;10.05.2015;2015;05;19;Sunnuntai;95;57;152;37;32;69
89;10.05.2015;2015;05;20;Sunnuntai;52;36;88;26;26;52
89;10.05.2015;2015;05;21;Sunnuntai;25;21;46;21;19;40
89;10.05.2015;2015;05;22;Sunnuntai;19;6;25;7;8;15
89;10.05.2015;2015;05;23;Sunnuntai;9;3;12;2;2;4
89;11.05.2015;2015;05;00;Maanantai;6;7;13;1;2;3
89;11.05.2015;2015;05;01;Maanantai;2;1;3;0;1;1
89;11.05.2015;2015;05;02;Maanantai;2;0;2;0;0;0
89;11.05.2015;2015;05;03;Maanantai;4;2;6;0;0;0
89;11.05.2015;2015;05;04;Maanantai;2;6;8;0;0;0
89;11.05.2015;2015;05;05;Maanantai;5;14;19;0;0;0
89;11.05.2015;2015;05;06;Maanantai;15;67;82;3;4;7
89;11.05.2015;2015;05;07;Maanantai;38;189;227;3;32;35
89;11.05.2015;2015;05;08;Maanantai;62;256;318;13;35;48
89;11.05.2015;2015;05;09;Maanantai;47;146;193;12;36;48
89;11.05.2015;2015;05;10;Maanantai;46;108;154;16;27;43
89;11.05.2015;2015;05;11;Maanantai;87;96;183;24;13;37
89;11.05.2015;2015;05;12;Maanantai;106;99;205;15;32;47
89;11.05.2015;2015;05;13;Maanantai;108;83;191;38;32;70
89;11.05.2015;2015;05;14;Maanantai;153;85;238;35;37;72
89;11.05.2015;2015;05;15;Maanantai;201;124;325;30;19;49
89;11.05.2015;2015;05;16;Maanantai;269;114;383;50;40;90
89;11.05.2015;2015;05;17;Maanantai;139;105;244;38;38;76
89;11.05.2015;2015;05;18;Maanantai;110;90;200;34;30;64
89;11.05.2015;2015;05;19;Maanantai;94;64;158;33;51;84
89;11.05.2015;2015;05;20;Maanantai;107;64;171;35;32;67
89;11.05.2015;2015;05;21;Maanantai;59;36;95;18;15;33
89;11.05.2015;2015;05;22;Maanantai;21;13;34;8;8;16
89;11.05.2015;2015;05;23;Maanantai;7;5;12;4;2;6
89;12.05.2015;2015;05;00;Tiistai;4;1;5;4;0;4
89;12.05.2015;2015;05;01;Tiistai;5;2;7;0;1;1
89;12.05.2015;2015;05;02;Tiistai;1;2;3;0;1;1
89;12.05.2015;2015;05;03;Tiistai;2;2;4;1;0;1
89;12.05.2015;2015;05;04;Tiistai;0;2;2;0;0;0
89;12.05.2015;2015;05;05;Tiistai;1;11;12;2;1;3
89;12.05.2015;2015;05;06;Tiistai;22;61;83;6;9;15
89;12.05.2015;2015;05;07;Tiistai;38;184;222;4;20;24
89;12.05.2015;2015;05;08;Tiistai;49;213;262;7;25;32
89;12.05.2015;2015;05;09;Tiistai;37;81;118;8;19;27
89;12.05.2015;2015;05;10;Tiistai;41;58;99;5;13;18
89;12.05.2015;2015;05;11;Tiistai;47;64;111;10;5;15
89;12.05.2015;2015;05;12;Tiistai;53;58;111;12;18;30
89;12.05.2015;2015;05;13;Tiistai;73;63;136;13;23;36
89;12.05.2015;2015;05;14;Tiistai;104;67;171;16;19;35
89;12.05.2015;2015;05;15;Tiistai;160;64;224;24;10;34
89;12.05.2015;2015;05;16;Tiistai;169;96;265;34;13;47
89;12.05.2015;2015;05;17;Tiistai;106;69;175;22;23;45
89;12.05.2015;2015;05;18;Tiistai;89;45;134;15;36;51
89;12.05.2015;2015;05;19;Tiistai;84;47;131;34;32;66
89;12.05.2015;2015;05;20;Tiistai;62;36;98;28;18;46
89;12.05.2015;2015;05;21;Tiistai;42;22;64;12;14;26
89;12.05.2015;2015;05;22;Tiistai;11;15;26;5;3;8
89;12.05.2015;2015;05;23;Tiistai;11;9;20;1;3;4
89;13.05.2015;2015;05;00;Keskiviikko;9;6;15;5;1;6
89;13.05.2015;2015;05;01;Keskiviikko;2;1;3;2;1;3
89;13.05.2015;2015;05;02;Keskiviikko;8;3;11;0;3;3
89;13.05.2015;2015;05;03;Keskiviikko;1;4;5;3;2;5
89;13.05.2015;2015;05;04;Keskiviikko;1;2;3;1;0;1
89;13.05.2015;2015;05;05;Keskiviikko;6;17;23;2;3;5
89;13.05.2015;2015;05;06;Keskiviikko;17;75;92;2;8;10
89;13.05.2015;2015;05;07;Keskiviikko;71;172;243;15;27;42
89;13.05.2015;2015;05;08;Keskiviikko;74;183;257;6;34;40
89;13.05.2015;2015;05;09;Keskiviikko;52;183;235;13;27;40
89;13.05.2015;2015;05;10;Keskiviikko;51;116;167;24;35;59
89;13.05.2015;2015;05;11;Keskiviikko;63;59;122;26;51;77
89;13.05.2015;2015;05;12;Keskiviikko;101;55;156;14;13;27
89;13.05.2015;2015;05;13;Keskiviikko;62;39;101;12;13;25
89;13.05.2015;2015;05;14;Keskiviikko;121;40;161;13;14;27
89;13.05.2015;2015;05;15;Keskiviikko;125;50;175;11;13;24
89;13.05.2015;2015;05;16;Keskiviikko;121;55;176;18;6;24
89;13.05.2015;2015;05;17;Keskiviikko;73;43;116;13;13;26
89;13.05.2015;2015;05;18;Keskiviikko;40;26;66;11;5;16
89;13.05.2015;2015;05;19;Keskiviikko;37;30;67;18;15;33
89;13.05.2015;2015;05;20;Keskiviikko;42;29;71;22;33;55
89;13.05.2015;2015;05;21;Keskiviikko;31;24;55;6;12;18
89;13.05.2015;2015;05;22;Keskiviikko;16;9;25;12;8;20
89;13.05.2015;2015;05;23;Keskiviikko;14;21;35;3;11;14
89;14.05.2015;2015;05;00;Torstai;5;17;22;7;1;8
89;14.05.2015;2015;05;01;Torstai;10;3;13;2;2;4
89;14.05.2015;2015;05;02;Torstai;6;5;11;4;0;4
89;14.05.2015;2015;05;03;Torstai;18;1;19;5;1;6
89;14.05.2015;2015;05;04;Torstai;15;2;17;1;0;1
89;14.05.2015;2015;05;05;Torstai;6;3;9;0;1;1
89;14.05.2015;2015;05;06;Torstai;7;12;19;2;5;7
89;14.05.2015;2015;05;07;Torstai;6;13;19;5;7;12
89;14.05.2015;2015;05;08;Torstai;17;16;33;14;14;28
89;14.05.2015;2015;05;09;Torstai;8;31;39;21;30;51
89;14.05.2015;2015;05;10;Torstai;12;24;36;26;28;54
89;14.05.2015;2015;05;11;Torstai;30;42;72;28;33;61
89;14.05.2015;2015;05;12;Torstai;39;49;88;36;57;93
89;14.05.2015;2015;05;13;Torstai;38;57;95;42;48;90
89;14.05.2015;2015;05;14;Torstai;50;64;114;35;53;88
89;14.05.2015;2015;05;15;Torstai;67;63;130;45;41;86
89;14.05.2015;2015;05;16;Torstai;46;34;80;32;31;63
89;14.05.2015;2015;05;17;Torstai;31;55;86;31;38;69
89;14.05.2015;2015;05;18;Torstai;53;41;94;37;29;66
89;14.05.2015;2015;05;19;Torstai;35;24;59;20;26;46
89;14.05.2015;2015;05;20;Torstai;26;25;51;12;17;29
89;14.05.2015;2015;05;21;Torstai;19;22;41;4;12;16
89;14.05.2015;2015;05;22;Torstai;11;9;20;2;2;4
89;14.05.2015;2015;05;23;Torstai;10;9;19;2;5;7
89;15.05.2015;2015;05;00;Perjantai;6;14;20;5;2;7
89;15.05.2015;2015;05;01;Perjantai;5;0;5;2;3;5
89;15.05.2015;2015;05;02;Perjantai;0;6;6;0;0;0
89;15.05.2015;2015;05;03;Perjantai;5;1;6;1;0;1
89;15.05.2015;2015;05;04;Perjantai;3;4;7;2;1;3
89;15.05.2015;2015;05;05;Perjantai;5;12;17;0;1;1
89;15.05.2015;2015;05;06;Perjantai;10;36;46;2;3;5
89;15.05.2015;2015;05;07;Perjantai;23;84;107;4;18;22
89;15.05.2015;2015;05;08;Perjantai;36;108;144;9;24;33
89;15.05.2015;2015;05;09;Perjantai;37;76;113;14;17;31
89;15.05.2015;2015;05;10;Perjantai;35;48;83;10;22;32
89;15.05.2015;2015;05;11;Perjantai;44;61;105;16;18;34
89;15.05.2015;2015;05;12;Perjantai;47;83;130;14;25;39
89;15.05.2015;2015;05;13;Perjantai;76;56;132;16;19;35
89;15.05.2015;2015;05;14;Perjantai;67;51;118;16;20;36
89;15.05.2015;2015;05;15;Perjantai;95;73;168;19;14;33
89;15.05.2015;2015;05;16;Perjantai;105;68;173;19;13;32
89;15.05.2015;2015;05;17;Perjantai;73;58;131;27;16;43
89;15.05.2015;2015;05;18;Perjantai;62;58;120;21;20;41
89;15.05.2015;2015;05;19;Perjantai;61;53;114;31;41;72
89;15.05.2015;2015;05;20;Perjantai;46;45;91;18;37;55
89;15.05.2015;2015;05;21;Perjantai;40;36;76;18;20;38
89;15.05.2015;2015;05;22;Perjantai;13;32;45;9;10;19
89;15.05.2015;2015;05;23;Perjantai;23;27;50;6;13;19
89;16.05.2015;2015;05;00;Lauantai;14;15;29;4;10;14
89;16.05.2015;2015;05;01;Lauantai;14;15;29;2;2;4
89;16.05.2015;2015;05;02;Lauantai;31;0;31;5;2;7
89;16.05.2015;2015;05;03;Lauantai;16;0;16;12;3;15
89;16.05.2015;2015;05;04;Lauantai;10;3;13;6;0;6
89;16.05.2015;2015;05;05;Lauantai;4;7;11;1;1;2
89;16.05.2015;2015;05;06;Lauantai;3;12;15;3;6;9
89;16.05.2015;2015;05;07;Lauantai;7;24;31;6;8;14
89;16.05.2015;2015;05;08;Lauantai;17;34;51;8;22;30
89;16.05.2015;2015;05;09;Lauantai;19;80;99;11;27;38
89;16.05.2015;2015;05;10;Lauantai;53;121;174;31;54;85
89;16.05.2015;2015;05;11;Lauantai;49;157;206;35;62;97
89;16.05.2015;2015;05;12;Lauantai;97;143;240;28;59;87
89;16.05.2015;2015;05;13;Lauantai;103;146;249;31;48;79
89;16.05.2015;2015;05;14;Lauantai;137;119;256;41;51;92
89;16.05.2015;2015;05;15;Lauantai;131;87;218;51;49;100
89;16.05.2015;2015;05;16;Lauantai;117;70;187;43;55;98
89;16.05.2015;2015;05;17;Lauantai;95;60;155;31;34;65
89;16.05.2015;2015;05;18;Lauantai;81;66;147;25;32;57
89;16.05.2015;2015;05;19;Lauantai;47;55;102;33;31;64
89;16.05.2015;2015;05;20;Lauantai;51;44;95;26;39;65
89;16.05.2015;2015;05;21;Lauantai;36;37;73;12;9;21
89;16.05.2015;2015;05;22;Lauantai;20;31;51;11;18;29
89;16.05.2015;2015;05;23;Lauantai;22;44;66;9;10;19
89;17.05.2015;2015;05;00;Sunnuntai;18;27;45;4;11;15
89;17.05.2015;2015;05;01;Sunnuntai;18;6;24;8;11;19
89;17.05.2015;2015;05;02;Sunnuntai;19;4;23;6;2;8
89;17.05.2015;2015;05;03;Sunnuntai;19;1;20;9;0;9
89;17.05.2015;2015;05;04;Sunnuntai;16;4;20;5;1;6
89;17.05.2015;2015;05;05;Sunnuntai;13;4;17;6;4;10
89;17.05.2015;2015;05;06;Sunnuntai;5;12;17;0;4;4
89;17.05.2015;2015;05;07;Sunnuntai;6;5;11;5;3;8
89;17.05.2015;2015;05;08;Sunnuntai;5;9;14;6;20;26
89;17.05.2015;2015;05;09;Sunnuntai;17;27;44;14;26;40
89;17.05.2015;2015;05;10;Sunnuntai;16;65;81;31;39;70
89;17.05.2015;2015;05;11;Sunnuntai;42;94;136;41;54;95
89;17.05.2015;2015;05;12;Sunnuntai;62;93;155;63;72;135
89;17.05.2015;2015;05;13;Sunnuntai;77;88;165;63;79;142
89;17.05.2015;2015;05;14;Sunnuntai;98;105;203;43;43;86
89;17.05.2015;2015;05;15;Sunnuntai;71;35;106;17;25;42
89;17.05.2015;2015;05;16;Sunnuntai;77;46;123;16;20;36
89;17.05.2015;2015;05;17;Sunnuntai;55;44;99;40;41;81
89;17.05.2015;2015;05;18;Sunnuntai;55;66;121;32;36;68
89;17.05.2015;2015;05;19;Sunnuntai;59;50;109;31;40;71
89;17.05.2015;2015;05;20;Sunnuntai;42;41;83;29;37;66
89;17.05.2015;2015;05;21;Sunnuntai;32;19;51;12;26;38
89;17.05.2015;2015;05;22;Sunnuntai;8;7;15;4;9;13
89;17.05.2015;2015;05;23;Sunnuntai;6;3;9;6;4;10
89;18.05.2015;2015;05;00;Maanantai;8;3;11;1;3;4
89;18.05.2015;2015;05;01;Maanantai;2;5;7;0;1;1
89;18.05.2015;2015;05;02;Maanantai;2;5;7;0;1;1
89;18.05.2015;2015;05;03;Maanantai;1;2;3;0;0;0
89;18.05.2015;2015;05;04;Maanantai;3;7;10;2;0;2
89;18.05.2015;2015;05;05;Maanantai;4;13;17;0;0;0
89;18.05.2015;2015;05;06;Maanantai;17;90;107;3;8;11
89;18.05.2015;2015;05;07;Maanantai;45;232;277;2;39;41
89;18.05.2015;2015;05;08;Maanantai;45;277;322;5;32;37
89;18.05.2015;2015;05;09;Maanantai;59;131;190;28;40;68
89;18.05.2015;2015;05;10;Maanantai;69;112;181;31;30;61
89;18.05.2015;2015;05;11;Maanantai;73;90;163;17;26;43
89;18.05.2015;2015;05;12;Maanantai;101;111;212;23;31;54
89;18.05.2015;2015;05;13;Maanantai;118;85;203;27;43;70
89;18.05.2015;2015;05;14;Maanantai;176;88;264;34;25;59
89;18.05.2015;2015;05;15;Maanantai;216;105;321;33;24;57
89;18.05.2015;2015;05;16;Maanantai;236;117;353;28;27;55
89;18.05.2015;2015;05;17;Maanantai;151;76;227;27;18;45
89;18.05.2015;2015;05;18;Maanantai;108;57;165;24;33;57
89;18.05.2015;2015;05;19;Maanantai;92;58;150;25;33;58
89;18.05.2015;2015;05;20;Maanantai;72;35;107;29;25;54
89;18.05.2015;2015;05;21;Maanantai;41;25;66;12;17;29
89;18.05.2015;2015;05;22;Maanantai;17;14;31;5;2;7
89;18.05.2015;2015;05;23;Maanantai;6;1;7;0;1;1
89;19.05.2015;2015;05;00;Tiistai;4;2;6;1;1;2
89;19.05.2015;2015;05;01;Tiistai;1;0;1;2;0;2
89;19.05.2015;2015;05;02;Tiistai;3;3;6;1;1;2
89;19.05.2015;2015;05;03;Tiistai;0;3;3;0;0;0
89;19.05.2015;2015;05;04;Tiistai;0;2;2;2;1;3
89;19.05.2015;2015;05;05;Tiistai;3;13;16;2;1;3
89;19.05.2015;2015;05;06;Tiistai;14;82;96;3;6;9
89;19.05.2015;2015;05;07;Tiistai;37;212;249;6;41;47
89;19.05.2015;2015;05;08;Tiistai;48;217;265;14;32;46
89;19.05.2015;2015;05;09;Tiistai;41;105;146;45;31;76
89;19.05.2015;2015;05;10;Tiistai;41;84;125;16;54;70
89;19.05.2015;2015;05;11;Tiistai;66;69;135;27;33;60
89;19.05.2015;2015;05;12;Tiistai;58;110;168;31;26;57
89;19.05.2015;2015;05;13;Tiistai;100;78;178;8;35;43
89;19.05.2015;2015;05;14;Tiistai;119;81;200;24;20;44
89;19.05.2015;2015;05;15;Tiistai;207;97;304;42;27;69
89;19.05.2015;2015;05;16;Tiistai;237;105;342;37;24;61
89;19.05.2015;2015;05;17;Tiistai;143;64;207;27;22;49
89;19.05.2015;2015;05;18;Tiistai;96;50;146;26;29;55
89;19.05.2015;2015;05;19;Tiistai;88;53;141;28;32;60
89;19.05.2015;2015;05;20;Tiistai;64;31;95;24;33;57
89;19.05.2015;2015;05;21;Tiistai;39;18;57;8;12;20
89;19.05.2015;2015;05;22;Tiistai;16;16;32;5;2;7
89;19.05.2015;2015;05;23;Tiistai;7;7;14;1;0;1
89;20.05.2015;2015;05;00;Keskiviikko;4;4;8;1;1;2
89;20.05.2015;2015;05;01;Keskiviikko;1;0;1;0;0;0
89;20.05.2015;2015;05;02;Keskiviikko;1;1;2;1;1;2
89;20.05.2015;2015;05;03;Keskiviikko;1;1;2;2;0;2
89;20.05.2015;2015;05;04;Keskiviikko;3;6;9;2;0;2
89;20.05.2015;2015;05;05;Keskiviikko;6;20;26;1;1;2
89;20.05.2015;2015;05;06;Keskiviikko;20;82;102;4;7;11
89;20.05.2015;2015;05;07;Keskiviikko;37;197;234;4;28;32
89;20.05.2015;2015;05;08;Keskiviikko;59;240;299;15;33;48
89;20.05.2015;2015;05;09;Keskiviikko;38;142;180;12;34;46
89;20.05.2015;2015;05;10;Keskiviikko;53;80;133;18;28;46
89;20.05.2015;2015;05;11;Keskiviikko;60;81;141;29;31;60
89;20.05.2015;2015;05;12;Keskiviikko;48;45;93;14;13;27
89;20.05.2015;2015;05;13;Keskiviikko;73;41;114;15;12;27
89;20.05.2015;2015;05;14;Keskiviikko;94;79;173;22;11;33
89;20.05.2015;2015;05;15;Keskiviikko;186;64;250;14;12;26
89;20.05.2015;2015;05;16;Keskiviikko;220;92;312;22;17;39
89;20.05.2015;2015;05;17;Keskiviikko;111;71;182;20;28;48
89;20.05.2015;2015;05;18;Keskiviikko;109;54;163;25;32;57
89;20.05.2015;2015;05;19;Keskiviikko;99;45;144;39;38;77
89;20.05.2015;2015;05;20;Keskiviikko;51;43;94;29;23;52
89;20.05.2015;2015;05;21;Keskiviikko;45;32;77;27;27;54
89;20.05.2015;2015;05;22;Keskiviikko;20;19;39;11;6;17
89;20.05.2015;2015;05;23;Keskiviikko;13;9;22;5;4;9
89;21.05.2015;2015;05;00;Torstai;3;3;6;0;2;2
89;21.05.2015;2015;05;01;Torstai;6;2;8;1;0;1
89;21.05.2015;2015;05;02;Torstai;2;7;9;1;3;4
89;21.05.2015;2015;05;03;Torstai;6;0;6;0;0;0
89;21.05.2015;2015;05;04;Torstai;5;4;9;1;1;2
89;21.05.2015;2015;05;05;Torstai;2;14;16;4;3;7
89;21.05.2015;2015;05;06;Torstai;31;78;109;3;6;9
89;21.05.2015;2015;05;07;Torstai;67;202;269;3;26;29
89;21.05.2015;2015;05;08;Torstai;67;250;317;6;32;38
89;21.05.2015;2015;05;09;Torstai;41;158;199;25;57;82
89;21.05.2015;2015;05;10;Torstai;58;113;171;17;31;48
89;21.05.2015;2015;05;11;Torstai;87;96;183;34;44;78
89;21.05.2015;2015;05;12;Torstai;94;124;218;16;22;38
89;21.05.2015;2015;05;13;Torstai;120;70;190;33;18;51
89;21.05.2015;2015;05;14;Torstai;143;114;257;33;34;67
89;21.05.2015;2015;05;15;Torstai;237;139;376;38;39;77
89;21.05.2015;2015;05;16;Torstai;255;139;394;40;25;65
89;21.05.2015;2015;05;17;Torstai;156;105;261;41;44;85
89;21.05.2015;2015;05;18;Torstai;156;72;228;37;51;88
89;21.05.2015;2015;05;19;Torstai;140;80;220;47;48;95
89;21.05.2015;2015;05;20;Torstai;107;46;153;42;33;75
89;21.05.2015;2015;05;21;Torstai;48;26;74;15;19;34
89;21.05.2015;2015;05;22;Torstai;18;22;40;5;7;12
89;21.05.2015;2015;05;23;Torstai;20;4;24;4;2;6
89;22.05.2015;2015;05;00;Perjantai;13;19;32;2;1;3
89;22.05.2015;2015;05;01;Perjantai;6;1;7;0;0;0
89;22.05.2015;2015;05;02;Perjantai;11;3;14;2;0;2
89;22.05.2015;2015;05;03;Perjantai;4;1;5;3;1;4
89;22.05.2015;2015;05;04;Perjantai;4;6;10;1;0;1
89;22.05.2015;2015;05;05;Perjantai;10;13;23;2;2;4
89;22.05.2015;2015;05;06;Perjantai;24;72;96;1;10;11
89;22.05.2015;2015;05;07;Perjantai;54;194;248;9;20;29
89;22.05.2015;2015;05;08;Perjantai;60;239;299;16;41;57
89;22.05.2015;2015;05;09;Perjantai;38;146;184;37;46;83
89;22.05.2015;2015;05;10;Perjantai;57;124;181;17;49;66
89;22.05.2015;2015;05;11;Perjantai;93;124;217;48;80;128
89;22.05.2015;2015;05;12;Perjantai;139;113;252;47;52;99
89;22.05.2015;2015;05;13;Perjantai;130;72;202;28;11;39
89;22.05.2015;2015;05;14;Perjantai;154;77;231;22;15;37
89;22.05.2015;2015;05;15;Perjantai;181;98;279;8;28;36
89;22.05.2015;2015;05;16;Perjantai;215;94;309;33;31;64
89;22.05.2015;2015;05;17;Perjantai;148;99;247;27;35;62
89;22.05.2015;2015;05;18;Perjantai;130;84;214;33;31;64
89;22.05.2015;2015;05;19;Perjantai;103;79;182;65;56;121
89;22.05.2015;2015;05;20;Perjantai;97;71;168;51;42;93
89;22.05.2015;2015;05;21;Perjantai;73;63;136;43;50;93
89;22.05.2015;2015;05;22;Perjantai;47;58;105;23;41;64
89;22.05.2015;2015;05;23;Perjantai;35;61;96;30;63;93
89;23.05.2015;2015;05;00;Lauantai;16;93;109;6;58;64
89;23.05.2015;2015;05;01;Lauantai;38;31;69;9;28;37
89;23.05.2015;2015;05;02;Lauantai;32;12;44;11;9;20
89;23.05.2015;2015;05;03;Lauantai;10;0;10;11;4;15
89;23.05.2015;2015;05;04;Lauantai;18;7;25;11;2;13
89;23.05.2015;2015;05;05;Lauantai;10;6;16;0;0;0
89;23.05.2015;2015;05;06;Lauantai;4;16;20;5;2;7
89;23.05.2015;2015;05;07;Lauantai;10;14;24;7;5;12
89;23.05.2015;2015;05;08;Lauantai;13;45;58;9;17;26
89;23.05.2015;2015;05;09;Lauantai;15;54;69;6;14;20
89;23.05.2015;2015;05;10;Lauantai;31;58;89;14;30;44
89;23.05.2015;2015;05;11;Lauantai;31;44;75;11;119;130
89;23.05.2015;2015;05;12;Lauantai;22;49;71;20;432;452
89;23.05.2015;2015;05;13;Lauantai;15;66;81;45;870;915
89;23.05.2015;2015;05;14;Lauantai;30;66;96;33;505;538
89;23.05.2015;2015;05;15;Lauantai;49;66;115;42;192;234
89;23.05.2015;2015;05;16;Lauantai;48;31;79;11;107;118
89;23.05.2015;2015;05;17;Lauantai;39;16;55;14;15;29
89;23.05.2015;2015;05;18;Lauantai;30;13;43;10;11;21
89;23.05.2015;2015;05;19;Lauantai;9;10;19;4;3;7
89;23.05.2015;2015;05;20;Lauantai;26;27;53;20;19;39
89;23.05.2015;2015;05;21;Lauantai;21;24;45;10;19;29
89;23.05.2015;2015;05;22;Lauantai;22;14;36;9;5;14
89;23.05.2015;2015;05;23;Lauantai;14;23;37;3;12;15
89;24.05.2015;2015;05;00;Sunnuntai;11;13;24;3;2;5
89;24.05.2015;2015;05;01;Sunnuntai;7;4;11;2;5;7
89;24.05.2015;2015;05;02;Sunnuntai;17;15;32;3;0;3
89;24.05.2015;2015;05;03;Sunnuntai;24;4;28;6;0;6
89;24.05.2015;2015;05;04;Sunnuntai;13;0;13;5;0;5
89;24.05.2015;2015;05;05;Sunnuntai;1;6;7;2;2;4
89;24.05.2015;2015;05;06;Sunnuntai;3;18;21;3;5;8
89;24.05.2015;2015;05;07;Sunnuntai;6;9;15;8;8;16
89;24.05.2015;2015;05;08;Sunnuntai;11;15;26;9;15;24
89;24.05.2015;2015;05;09;Sunnuntai;29;42;71;22;33;55
89;24.05.2015;2015;05;10;Sunnuntai;54;88;142;40;66;106
89;24.05.2015;2015;05;11;Sunnuntai;80;144;224;39;81;120
89;24.05.2015;2015;05;12;Sunnuntai;110;132;242;77;80;157
89;24.05.2015;2015;05;13;Sunnuntai;132;165;297;53;108;161
89;24.05.2015;2015;05;14;Sunnuntai;156;132;288;64;87;151
89;24.05.2015;2015;05;15;Sunnuntai;119;127;246;38;56;94
89;24.05.2015;2015;05;16;Sunnuntai;92;67;159;28;52;80
89;24.05.2015;2015;05;17;Sunnuntai;102;74;176;41;36;77
89;24.05.2015;2015;05;18;Sunnuntai;84;74;158;35;45;80
89;24.05.2015;2015;05;19;Sunnuntai;77;61;138;35;36;71
89;24.05.2015;2015;05;20;Sunnuntai;50;38;88;33;41;74
89;24.05.2015;2015;05;21;Sunnuntai;27;35;62;8;19;27
89;24.05.2015;2015;05;22;Sunnuntai;24;19;43;5;5;10
89;24.05.2015;2015;05;23;Sunnuntai;12;14;26;1;8;9
89;25.05.2015;2015;05;00;Maanantai;10;4;14;2;1;3
89;25.05.2015;2015;05;01;Maanantai;4;4;8;1;0;1
89;25.05.2015;2015;05;02;Maanantai;5;9;14;0;0;0
89;25.05.2015;2015;05;03;Maanantai;1;3;4;0;0;0
89;25.05.2015;2015;05;04;Maanantai;2;3;5;0;0;0
89;25.05.2015;2015;05;05;Maanantai;2;21;23;2;0;2
89;25.05.2015;2015;05;06;Maanantai;20;76;96;3;7;10
89;25.05.2015;2015;05;07;Maanantai;57;215;272;4;29;33
89;25.05.2015;2015;05;08;Maanantai;66;280;346;9;40;49
89;25.05.2015;2015;05;09;Maanantai;44;168;212;10;29;39
89;25.05.2015;2015;05;10;Maanantai;56;125;181;25;24;49
89;25.05.2015;2015;05;11;Maanantai;116;118;234;18;55;73
89;25.05.2015;2015;05;12;Maanantai;132;118;250;18;31;49
89;25.05.2015;2015;05;13;Maanantai;135;110;245;25;33;58
89;25.05.2015;2015;05;14;Maanantai;168;88;256;33;19;52
89;25.05.2015;2015;05;15;Maanantai;228;109;337;40;50;90
89;25.05.2015;2015;05;16;Maanantai;285;115;400;23;26;49
89;25.05.2015;2015;05;17;Maanantai;134;93;227;35;23;58
89;25.05.2015;2015;05;18;Maanantai;125;64;189;26;29;55
89;25.05.2015;2015;05;19;Maanantai;80;60;140;28;23;51
89;25.05.2015;2015;05;20;Maanantai;101;37;138;26;27;53
89;25.05.2015;2015;05;21;Maanantai;44;21;65;12;15;27
89;25.05.2015;2015;05;22;Maanantai;30;21;51;8;7;15
89;25.05.2015;2015;05;23;Maanantai;7;11;18;3;1;4
89;26.05.2015;2015;05;00;Tiistai;10;6;16;3;2;5
89;26.05.2015;2015;05;01;Tiistai;2;3;5;1;3;4
89;26.05.2015;2015;05;02;Tiistai;1;1;2;1;0;1
89;26.05.2015;2015;05;03;Tiistai;4;1;5;1;1;2
89;26.05.2015;2015;05;04;Tiistai;2;5;7;1;0;1
89;26.05.2015;2015;05;05;Tiistai;2;16;18;1;1;2
89;26.05.2015;2015;05;06;Tiistai;23;83;106;3;8;11
89;26.05.2015;2015;05;07;Tiistai;56;201;257;5;21;26
89;26.05.2015;2015;05;08;Tiistai;51;224;275;16;43;59
89;26.05.2015;2015;05;09;Tiistai;34;113;147;6;49;55
89;26.05.2015;2015;05;10;Tiistai;53;92;145;48;37;85
89;26.05.2015;2015;05;11;Tiistai;64;100;164;24;26;50
89;26.05.2015;2015;05;12;Tiistai;88;98;186;38;44;82
89;26.05.2015;2015;05;13;Tiistai;123;86;209;28;29;57
89;26.05.2015;2015;05;14;Tiistai;142;98;240;25;30;55
89;26.05.2015;2015;05;15;Tiistai;211;122;333;30;32;62
89;26.05.2015;2015;05;16;Tiistai;247;152;399;27;24;51
89;26.05.2015;2015;05;17;Tiistai;176;99;275;39;39;78
89;26.05.2015;2015;05;18;Tiistai;110;75;185;40;37;77
89;26.05.2015;2015;05;19;Tiistai;88;68;156;35;34;69
89;26.05.2015;2015;05;20;Tiistai;77;37;114;24;24;48
89;26.05.2015;2015;05;21;Tiistai;54;30;84;18;14;32
89;26.05.2015;2015;05;22;Tiistai;40;15;55;10;7;17
89;26.05.2015;2015;05;23;Tiistai;12;11;23;4;3;7
89;27.05.2015;2015;05;00;Keskiviikko;9;10;19;0;1;1
89;27.05.2015;2015;05;01;Keskiviikko;4;2;6;0;1;1
89;27.05.2015;2015;05;02;Keskiviikko;2;1;3;0;0;0
89;27.05.2015;2015;05;03;Keskiviikko;5;1;6;0;1;1
89;27.05.2015;2015;05;04;Keskiviikko;4;6;10;2;0;2
89;27.05.2015;2015;05;05;Keskiviikko;9;18;27;0;1;1
89;27.05.2015;2015;05;06;Keskiviikko;23;71;94;5;5;10
89;27.05.2015;2015;05;07;Keskiviikko;35;172;207;4;25;29
89;27.05.2015;2015;05;08;Keskiviikko;34;231;265;5;43;48
89;27.05.2015;2015;05;09;Keskiviikko;41;107;148;20;43;63
89;27.05.2015;2015;05;10;Keskiviikko;57;136;193;45;51;96
89;27.05.2015;2015;05;11;Keskiviikko;49;56;105;21;24;45
89;27.05.2015;2015;05;12;Keskiviikko;74;53;127;16;19;35
89;27.05.2015;2015;05;13;Keskiviikko;129;61;190;34;19;53
89;27.05.2015;2015;05;14;Keskiviikko;100;44;144;30;18;48
89;27.05.2015;2015;05;15;Keskiviikko;146;83;229;16;20;36
89;27.05.2015;2015;05;16;Keskiviikko;196;108;304;35;25;60
89;27.05.2015;2015;05;17;Keskiviikko;125;113;238;36;42;78
89;27.05.2015;2015;05;18;Keskiviikko;111;71;182;43;35;78
89;27.05.2015;2015;05;19;Keskiviikko;103;75;178;48;45;93
89;27.05.2015;2015;05;20;Keskiviikko;121;57;178;23;21;44
89;27.05.2015;2015;05;21;Keskiviikko;56;34;90;19;26;45
89;27.05.2015;2015;05;22;Keskiviikko;33;20;53;13;13;26
89;27.05.2015;2015;05;23;Keskiviikko;12;14;26;7;6;13
89;28.05.2015;2015;05;00;Torstai;17;2;19;2;1;3
89;28.05.2015;2015;05;01;Torstai;6;2;8;1;1;2
89;28.05.2015;2015;05;02;Torstai;3;7;10;0;2;2
89;28.05.2015;2015;05;03;Torstai;7;5;12;2;0;2
89;28.05.2015;2015;05;04;Torstai;8;5;13;0;1;1
89;28.05.2015;2015;05;05;Torstai;4;16;20;0;1;1
89;28.05.2015;2015;05;06;Torstai;26;90;116;4;6;10
89;28.05.2015;2015;05;07;Torstai;55;183;238;8;28;36
89;28.05.2015;2015;05;08;Torstai;60;321;381;3;33;36
89;28.05.2015;2015;05;09;Torstai;42;132;174;10;40;50
89;28.05.2015;2015;05;10;Torstai;118;133;251;24;36;60
89;28.05.2015;2015;05;11;Torstai;86;133;219;32;49;81
89;28.05.2015;2015;05;12;Torstai;135;145;280;45;75;120
89;28.05.2015;2015;05;13;Torstai;139;99;238;60;33;93
89;28.05.2015;2015;05;14;Torstai;177;114;291;25;37;62
89;28.05.2015;2015;05;15;Torstai;214;121;335;25;22;47
89;28.05.2015;2015;05;16;Torstai;260;129;389;21;19;40
89;28.05.2015;2015;05;17;Torstai;170;95;265;22;32;54
89;28.05.2015;2015;05;18;Torstai;104;89;193;18;26;44
89;28.05.2015;2015;05;19;Torstai;119;71;190;33;30;63
89;28.05.2015;2015;05;20;Torstai;90;61;151;21;35;56
89;28.05.2015;2015;05;21;Torstai;55;41;96;21;17;38
89;28.05.2015;2015;05;22;Torstai;23;13;36;5;16;21
89;28.05.2015;2015;05;23;Torstai;17;14;31;2;3;5
89;29.05.2015;2015;05;00;Perjantai;8;10;18;2;1;3
89;29.05.2015;2015;05;01;Perjantai;5;1;6;2;0;2
89;29.05.2015;2015;05;02;Perjantai;2;2;4;1;2;3
89;29.05.2015;2015;05;03;Perjantai;4;4;8;3;0;3
89;29.05.2015;2015;05;04;Perjantai;6;3;9;1;2;3
89;29.05.2015;2015;05;05;Perjantai;3;15;18;0;0;0
89;29.05.2015;2015;05;06;Perjantai;28;68;96;3;6;9
89;29.05.2015;2015;05;07;Perjantai;54;151;205;10;29;39
89;29.05.2015;2015;05;08;Perjantai;70;233;303;16;42;58
89;29.05.2015;2015;05;09;Perjantai;40;107;147;5;30;35
89;29.05.2015;2015;05;10;Perjantai;61;126;187;32;69;101
89;29.05.2015;2015;05;11;Perjantai;124;142;266;37;37;74
89;29.05.2015;2015;05;12;Perjantai;139;137;276;23;41;64
89;29.05.2015;2015;05;13;Perjantai;161;139;300;36;39;75
89;29.05.2015;2015;05;14;Perjantai;180;137;317;35;45;80
89;29.05.2015;2015;05;15;Perjantai;211;127;338;36;23;59
89;29.05.2015;2015;05;16;Perjantai;182;107;289;33;25;58
89;29.05.2015;2015;05;17;Perjantai;140;107;247;34;30;64
89;29.05.2015;2015;05;18;Perjantai;91;47;138;15;25;40
89;29.05.2015;2015;05;19;Perjantai;59;65;124;18;21;39
89;29.05.2015;2015;05;20;Perjantai;50;18;68;11;12;23
89;29.05.2015;2015;05;21;Perjantai;40;18;58;3;19;22
89;29.05.2015;2015;05;22;Perjantai;24;15;39;4;16;20
89;29.05.2015;2015;05;23;Perjantai;17;8;25;4;4;8
89;30.05.2015;2015;05;00;Lauantai;15;10;25;4;7;11
89;30.05.2015;2015;05;01;Lauantai;10;7;17;4;1;5
89;30.05.2015;2015;05;02;Lauantai;16;4;20;4;2;6
89;30.05.2015;2015;05;03;Lauantai;10;10;20;10;0;10
89;30.05.2015;2015;05;04;Lauantai;4;4;8;6;2;8
89;30.05.2015;2015;05;05;Lauantai;0;9;9;2;1;3
89;30.05.2015;2015;05;06;Lauantai;6;11;17;3;5;8
89;30.05.2015;2015;05;07;Lauantai;7;33;40;8;8;16
89;30.05.2015;2015;05;08;Lauantai;24;52;76;9;21;30
89;30.05.2015;2015;05;09;Lauantai;23;78;101;12;33;45
89;30.05.2015;2015;05;10;Lauantai;67;114;181;21;45;66
89;30.05.2015;2015;05;11;Lauantai;79;118;197;36;42;78
89;30.05.2015;2015;05;12;Lauantai;87;126;213;32;56;88
89;30.05.2015;2015;05;13;Lauantai;90;112;202;20;31;51
89;30.05.2015;2015;05;14;Lauantai;116;125;241;48;59;107
89;30.05.2015;2015;05;15;Lauantai;101;137;238;33;51;84
89;30.05.2015;2015;05;16;Lauantai;103;127;230;31;36;67
89;30.05.2015;2015;05;17;Lauantai;113;132;245;30;35;65
89;30.05.2015;2015;05;18;Lauantai;111;142;253;35;47;82
89;30.05.2015;2015;05;19;Lauantai;136;122;258;41;40;81
89;30.05.2015;2015;05;20;Lauantai;104;146;250;23;47;70
89;30.05.2015;2015;05;21;Lauantai;68;112;180;23;37;60
89;30.05.2015;2015;05;22;Lauantai;100;83;183;33;23;56
89;30.05.2015;2015;05;23;Lauantai;54;45;99;6;24;30
89;31.05.2015;2015;05;00;Sunnuntai;58;30;88;17;16;33
89;31.05.2015;2015;05;01;Sunnuntai;53;25;78;10;4;14
89;31.05.2015;2015;05;02;Sunnuntai;48;12;60;9;3;12
89;31.05.2015;2015;05;03;Sunnuntai;51;5;56;13;0;13
89;31.05.2015;2015;05;04;Sunnuntai;26;5;31;12;1;13
89;31.05.2015;2015;05;05;Sunnuntai;10;2;12;2;2;4
89;31.05.2015;2015;05;06;Sunnuntai;2;14;16;3;1;4
89;31.05.2015;2015;05;07;Sunnuntai;5;10;15;3;12;15
89;31.05.2015;2015;05;08;Sunnuntai;19;20;39;11;8;19
89;31.05.2015;2015;05;09;Sunnuntai;20;64;84;20;25;45
89;31.05.2015;2015;05;10;Sunnuntai;47;55;102;37;27;64
89;31.05.2015;2015;05;11;Sunnuntai;42;54;96;22;23;45
89;31.05.2015;2015;05;12;Sunnuntai;40;34;74;11;15;26
89;31.05.2015;2015;05;13;Sunnuntai;29;15;44;14;17;31
89;31.05.2015;2015;05;14;Sunnuntai;63;47;110;11;17;28
89;31.05.2015;2015;05;15;Sunnuntai;38;36;74;15;20;35
89;31.05.2015;2015;05;16;Sunnuntai;50;31;81;16;15;31
89;31.05.2015;2015;05;17;Sunnuntai;47;33;80;16;28;44
89;31.05.2015;2015;05;18;Sunnuntai;49;45;94;20;27;47
89;31.05.2015;2015;05;19;Sunnuntai;38;27;65;13;30;43
89;31.05.2015;2015;05;20;Sunnuntai;35;22;57;7;15;22
89;31.05.2015;2015;05;21;Sunnuntai;31;22;53;9;8;17
89;31.05.2015;2015;05;22;Sunnuntai;21;13;34;2;3;5
89;31.05.2015;2015;05;23;Sunnuntai;6;5;11;3;2;5
89;01.06.2015;2015;06;00;Maanantai;5;4;9;3;2;5
89;01.06.2015;2015;06;01;Maanantai;1;5;6;1;3;4
89;01.06.2015;2015;06;02;Maanantai;2;2;4;4;1;5
89;01.06.2015;2015;06;03;Maanantai;5;7;12;0;0;0
89;01.06.2015;2015;06;04;Maanantai;3;4;7;1;2;3
89;01.06.2015;2015;06;05;Maanantai;11;14;25;2;3;5
89;01.06.2015;2015;06;06;Maanantai;23;77;100;0;8;8
89;01.06.2015;2015;06;07;Maanantai;49;184;233;6;22;28
89;01.06.2015;2015;06;08;Maanantai;43;213;256;3;30;33
89;01.06.2015;2015;06;09;Maanantai;43;102;145;13;20;33
89;01.06.2015;2015;06;10;Maanantai;46;66;112;12;22;34
89;01.06.2015;2015;06;11;Maanantai;55;83;138;14;22;36
89;01.06.2015;2015;06;12;Maanantai;64;79;143;17;29;46
89;01.06.2015;2015;06;13;Maanantai;83;77;160;23;34;57
89;01.06.2015;2015;06;14;Maanantai;117;88;205;24;23;47
89;01.06.2015;2015;06;15;Maanantai;216;92;308;31;38;69
89;01.06.2015;2015;06;16;Maanantai;228;90;318;21;12;33
89;01.06.2015;2015;06;17;Maanantai;101;41;142;19;3;22
89;01.06.2015;2015;06;18;Maanantai;79;33;112;13;13;26
89;01.06.2015;2015;06;19;Maanantai;45;33;78;19;13;32
89;01.06.2015;2015;06;20;Maanantai;38;19;57;12;10;22
89;01.06.2015;2015;06;21;Maanantai;34;7;41;20;17;37
89;01.06.2015;2015;06;22;Maanantai;13;13;26;8;7;15
89;01.06.2015;2015;06;23;Maanantai;5;10;15;2;2;4
89;02.06.2015;2015;06;00;Tiistai;9;2;11;5;2;7
89;02.06.2015;2015;06;01;Tiistai;6;5;11;1;2;3
89;02.06.2015;2015;06;02;Tiistai;3;2;5;2;1;3
89;02.06.2015;2015;06;03;Tiistai;4;1;5;1;0;1
89;02.06.2015;2015;06;04;Tiistai;2;8;10;1;0;1
89;02.06.2015;2015;06;05;Tiistai;9;10;19;1;3;4
89;02.06.2015;2015;06;06;Tiistai;20;86;106;4;6;10
89;02.06.2015;2015;06;07;Tiistai;63;190;253;5;24;29
89;02.06.2015;2015;06;08;Tiistai;58;209;267;4;41;45
89;02.06.2015;2015;06;09;Tiistai;38;120;158;14;66;80
89;02.06.2015;2015;06;10;Tiistai;51;103;154;24;33;57
89;02.06.2015;2015;06;11;Tiistai;59;133;192;47;47;94
89;02.06.2015;2015;06;12;Tiistai;89;121;210;40;50;90
89;02.06.2015;2015;06;13;Tiistai;118;121;239;34;52;86
89;02.06.2015;2015;06;14;Tiistai;150;100;250;58;60;118
89;02.06.2015;2015;06;15;Tiistai;213;141;354;49;50;99
89;02.06.2015;2015;06;16;Tiistai;250;150;400;55;64;119
89;02.06.2015;2015;06;17;Tiistai;164;142;306;30;58;88
89;02.06.2015;2015;06;18;Tiistai;150;93;243;61;50;111
89;02.06.2015;2015;06;19;Tiistai;157;69;226;57;56;113
89;02.06.2015;2015;06;20;Tiistai;105;43;148;46;45;91
89;02.06.2015;2015;06;21;Tiistai;54;30;84;11;20;31
89;02.06.2015;2015;06;22;Tiistai;40;17;57;15;12;27
89;02.06.2015;2015;06;23;Tiistai;13;14;27;5;3;8
89;03.06.2015;2015;06;00;Keskiviikko;8;3;11;2;4;6
89;03.06.2015;2015;06;01;Keskiviikko;6;1;7;1;1;2
89;03.06.2015;2015;06;02;Keskiviikko;2;0;2;1;0;1
89;03.06.2015;2015;06;03;Keskiviikko;3;3;6;1;0;1
89;03.06.2015;2015;06;04;Keskiviikko;3;7;10;2;1;3
89;03.06.2015;2015;06;05;Keskiviikko;5;13;18;1;2;3
89;03.06.2015;2015;06;06;Keskiviikko;14;63;77;4;7;11
89;03.06.2015;2015;06;07;Keskiviikko;29;134;163;4;14;18
89;03.06.2015;2015;06;08;Keskiviikko;32;124;156;3;28;31
89;03.06.2015;2015;06;09;Keskiviikko;21;59;80;3;14;17
89;03.06.2015;2015;06;10;Keskiviikko;24;37;61;5;14;19
89;03.06.2015;2015;06;11;Keskiviikko;26;31;57;7;6;13
89;03.06.2015;2015;06;12;Keskiviikko;36;55;91;4;21;25
89;03.06.2015;2015;06;13;Keskiviikko;57;73;130;15;16;31
89;03.06.2015;2015;06;14;Keskiviikko;74;54;128;11;18;29
89;03.06.2015;2015;06;15;Keskiviikko;123;76;199;23;20;43
89;03.06.2015;2015;06;16;Keskiviikko;153;79;232;25;20;45
89;03.06.2015;2015;06;17;Keskiviikko;104;91;195;26;23;49
89;03.06.2015;2015;06;18;Keskiviikko;86;69;155;34;34;68
89;03.06.2015;2015;06;19;Keskiviikko;79;50;129;29;29;58
89;03.06.2015;2015;06;20;Keskiviikko;75;33;108;26;23;49
89;03.06.2015;2015;06;21;Keskiviikko;42;26;68;15;19;34
89;03.06.2015;2015;06;22;Keskiviikko;21;16;37;3;14;17
89;03.06.2015;2015;06;23;Keskiviikko;14;7;21;1;8;9
89;04.06.2015;2015;06;00;Torstai;11;10;21;4;1;5
89;04.06.2015;2015;06;01;Torstai;9;4;13;5;2;7
89;04.06.2015;2015;06;02;Torstai;5;1;6;3;0;3
89;04.06.2015;2015;06;03;Torstai;6;4;10;2;0;2
89;04.06.2015;2015;06;04;Torstai;4;3;7;1;3;4
89;04.06.2015;2015;06;05;Torstai;6;18;24;0;3;3
89;04.06.2015;2015;06;06;Torstai;18;94;112;4;10;14
89;04.06.2015;2015;06;07;Torstai;40;143;183;6;12;18
89;04.06.2015;2015;06;08;Torstai;48;193;241;6;30;36
89;04.06.2015;2015;06;09;Torstai;57;151;208;8;20;28
89;04.06.2015;2015;06;10;Torstai;58;145;203;20;46;66
89;04.06.2015;2015;06;11;Torstai;79;193;272;33;68;101
89;04.06.2015;2015;06;12;Torstai;118;215;333;24;72;96
89;04.06.2015;2015;06;13;Torstai;178;146;324;35;46;81
89;04.06.2015;2015;06;14;Torstai;223;120;343;59;38;97
89;04.06.2015;2015;06;15;Torstai;239;122;361;55;26;81
89;04.06.2015;2015;06;16;Torstai;251;117;368;36;29;65
89;04.06.2015;2015;06;17;Torstai;191;113;304;33;27;60
89;04.06.2015;2015;06;18;Torstai;109;92;201;23;29;52
89;04.06.2015;2015;06;19;Torstai;122;84;206;23;36;59
89;04.06.2015;2015;06;20;Torstai;102;53;155;23;18;41
89;04.06.2015;2015;06;21;Torstai;55;27;82;16;15;31
89;04.06.2015;2015;06;22;Torstai;39;17;56;11;7;18
89;04.06.2015;2015;06;23;Torstai;18;4;22;4;5;9
89;05.06.2015;2015;06;00;Perjantai;11;9;20;3;2;5
89;05.06.2015;2015;06;01;Perjantai;11;9;20;2;2;4
89;05.06.2015;2015;06;02;Perjantai;4;5;9;0;0;0
89;05.06.2015;2015;06;03;Perjantai;8;4;12;3;0;3
89;05.06.2015;2015;06;04;Perjantai;5;5;10;2;0;2
89;05.06.2015;2015;06;05;Perjantai;4;13;17;1;3;4
89;05.06.2015;2015;06;06;Perjantai;21;86;107;5;4;9
89;05.06.2015;2015;06;07;Perjantai;39;176;215;6;18;24
89;05.06.2015;2015;06;08;Perjantai;54;166;220;4;25;29
89;05.06.2015;2015;06;09;Perjantai;36;98;134;7;30;37
89;05.06.2015;2015;06;10;Perjantai;49;118;167;17;52;69
89;05.06.2015;2015;06;11;Perjantai;70;125;195;25;28;53
89;05.06.2015;2015;06;12;Perjantai;91;126;217;33;53;86
89;05.06.2015;2015;06;13;Perjantai;123;121;244;25;41;66
89;05.06.2015;2015;06;14;Perjantai;156;96;252;31;29;60
89;05.06.2015;2015;06;15;Perjantai;203;111;314;40;36;76
89;05.06.2015;2015;06;16;Perjantai;190;107;297;44;24;68
89;05.06.2015;2015;06;17;Perjantai;134;110;244;29;52;81
89;05.06.2015;2015;06;18;Perjantai;119;108;227;27;33;60
89;05.06.2015;2015;06;19;Perjantai;90;68;158;29;25;54
89;05.06.2015;2015;06;20;Perjantai;87;78;165;26;31;57
89;05.06.2015;2015;06;21;Perjantai;66;53;119;25;24;49
89;05.06.2015;2015;06;22;Perjantai;51;43;94;9;19;28
89;05.06.2015;2015;06;23;Perjantai;34;31;65;4;11;15
89;06.06.2015;2015;06;00;Lauantai;30;20;50;8;7;15
89;06.06.2015;2015;06;01;Lauantai;25;18;43;8;1;9
89;06.06.2015;2015;06;02;Lauantai;21;12;33;4;0;4
89;06.06.2015;2015;06;03;Lauantai;37;7;44;9;0;9
89;06.06.2015;2015;06;04;Lauantai;21;6;27;6;1;7
89;06.06.2015;2015;06;05;Lauantai;5;9;14;1;3;4
89;06.06.2015;2015;06;06;Lauantai;9;20;29;4;4;8
89;06.06.2015;2015;06;07;Lauantai;13;19;32;11;7;18
89;06.06.2015;2015;06;08;Lauantai;15;24;39;5;11;16
89;06.06.2015;2015;06;09;Lauantai;24;97;121;13;32;45
89;06.06.2015;2015;06;10;Lauantai;45;127;172;16;38;54
89;06.06.2015;2015;06;11;Lauantai;80;147;227;21;33;54
89;06.06.2015;2015;06;12;Lauantai;84;105;189;25;46;71
89;06.06.2015;2015;06;13;Lauantai;103;73;176;35;24;59
89;06.06.2015;2015;06;14;Lauantai;89;79;168;29;28;57
89;06.06.2015;2015;06;15;Lauantai;93;62;155;25;30;55
89;06.06.2015;2015;06;16;Lauantai;85;46;131;22;17;39
89;06.06.2015;2015;06;17;Lauantai;48;29;77;23;16;39
89;06.06.2015;2015;06;18;Lauantai;52;19;71;12;11;23
89;06.06.2015;2015;06;19;Lauantai;27;13;40;10;10;20
89;06.06.2015;2015;06;20;Lauantai;16;11;27;8;7;15
89;06.06.2015;2015;06;21;Lauantai;21;13;34;4;3;7
89;06.06.2015;2015;06;22;Lauantai;11;14;25;2;6;8
89;06.06.2015;2015;06;23;Lauantai;17;5;22;2;4;6
89;07.06.2015;2015;06;00;Sunnuntai;12;16;28;7;1;8
89;07.06.2015;2015;06;01;Sunnuntai;10;8;18;3;3;6
89;07.06.2015;2015;06;02;Sunnuntai;5;2;7;5;1;6
89;07.06.2015;2015;06;03;Sunnuntai;24;3;27;6;0;6
89;07.06.2015;2015;06;04;Sunnuntai;5;4;9;1;0;1
89;07.06.2015;2015;06;05;Sunnuntai;1;4;5;0;1;1
89;07.06.2015;2015;06;06;Sunnuntai;2;8;10;1;1;2
89;07.06.2015;2015;06;07;Sunnuntai;2;7;9;2;2;4
89;07.06.2015;2015;06;08;Sunnuntai;7;9;16;6;5;11
89;07.06.2015;2015;06;09;Sunnuntai;3;16;19;7;17;24
89;07.06.2015;2015;06;10;Sunnuntai;5;15;20;5;11;16
89;07.06.2015;2015;06;11;Sunnuntai;9;15;24;6;14;20
89;07.06.2015;2015;06;12;Sunnuntai;10;17;27;7;11;18
89;07.06.2015;2015;06;13;Sunnuntai;11;11;22;12;5;17
89;07.06.2015;2015;06;14;Sunnuntai;20;14;34;6;10;16
89;07.06.2015;2015;06;15;Sunnuntai;17;12;29;4;6;10
89;07.06.2015;2015;06;16;Sunnuntai;21;7;28;7;9;16
89;07.06.2015;2015;06;17;Sunnuntai;20;20;40;11;12;23
89;07.06.2015;2015;06;18;Sunnuntai;19;11;30;6;10;16
89;07.06.2015;2015;06;19;Sunnuntai;16;8;24;13;12;25
89;07.06.2015;2015;06;20;Sunnuntai;18;10;28;13;13;26
89;07.06.2015;2015;06;21;Sunnuntai;25;8;33;6;5;11
89;07.06.2015;2015;06;22;Sunnuntai;11;10;21;10;8;18
89;07.06.2015;2015;06;23;Sunnuntai;5;5;10;2;7;9
89;08.06.2015;2015;06;00;Maanantai;3;2;5;2;2;4
89;08.06.2015;2015;06;01;Maanantai;1;1;2;0;3;3
89;08.06.2015;2015;06;02;Maanantai;3;2;5;3;0;3
89;08.06.2015;2015;06;03;Maanantai;6;5;11;1;0;1
89;08.06.2015;2015;06;04;Maanantai;2;8;10;0;2;2
89;08.06.2015;2015;06;05;Maanantai;8;9;17;2;0;2
89;08.06.2015;2015;06;06;Maanantai;14;88;102;5;10;15
89;08.06.2015;2015;06;07;Maanantai;47;176;223;5;24;29
89;08.06.2015;2015;06;08;Maanantai;53;190;243;12;36;48
89;08.06.2015;2015;06;09;Maanantai;27;114;141;15;33;48
89;08.06.2015;2015;06;10;Maanantai;55;91;146;25;32;57
89;08.06.2015;2015;06;11;Maanantai;63;107;170;36;42;78
89;08.06.2015;2015;06;12;Maanantai;83;125;208;23;34;57
89;08.06.2015;2015;06;13;Maanantai;105;89;194;23;41;64
89;08.06.2015;2015;06;14;Maanantai;116;117;233;29;45;74
89;08.06.2015;2015;06;15;Maanantai;226;114;340;39;32;71
89;08.06.2015;2015;06;16;Maanantai;232;120;352;52;32;84
89;08.06.2015;2015;06;17;Maanantai;166;97;263;36;42;78
89;08.06.2015;2015;06;18;Maanantai;123;64;187;44;62;106
89;08.06.2015;2015;06;19;Maanantai;100;63;163;50;48;98
89;08.06.2015;2015;06;20;Maanantai;81;39;120;36;41;77
89;08.06.2015;2015;06;21;Maanantai;68;41;109;12;17;29
89;08.06.2015;2015;06;22;Maanantai;42;13;55;14;11;25
89;08.06.2015;2015;06;23;Maanantai;10;9;19;9;6;15
89;09.06.2015;2015;06;00;Tiistai;5;8;13;3;5;8
89;09.06.2015;2015;06;01;Tiistai;5;0;5;4;1;5
89;09.06.2015;2015;06;02;Tiistai;7;0;7;0;2;2
89;09.06.2015;2015;06;03;Tiistai;2;5;7;1;0;1
89;09.06.2015;2015;06;04;Tiistai;3;10;13;4;0;4
89;09.06.2015;2015;06;05;Tiistai;6;15;21;2;4;6
89;09.06.2015;2015;06;06;Tiistai;18;94;112;3;7;10
89;09.06.2015;2015;06;07;Tiistai;61;219;280;7;20;27
89;09.06.2015;2015;06;08;Tiistai;57;214;271;33;36;69
89;09.06.2015;2015;06;09;Tiistai;51;122;173;19;57;76
89;09.06.2015;2015;06;10;Tiistai;60;122;182;34;56;90
89;09.06.2015;2015;06;11;Tiistai;83;125;208;30;52;82
89;09.06.2015;2015;06;12;Tiistai;85;117;202;41;39;80
89;09.06.2015;2015;06;13;Tiistai;132;117;249;34;45;79
89;09.06.2015;2015;06;14;Tiistai;120;111;231;37;29;66
89;09.06.2015;2015;06;15;Tiistai;195;134;329;24;40;64
89;09.06.2015;2015;06;16;Tiistai;247;132;379;43;36;79
89;09.06.2015;2015;06;17;Tiistai;178;115;293;41;52;93
89;09.06.2015;2015;06;18;Tiistai;117;96;213;35;57;92
89;09.06.2015;2015;06;19;Tiistai;100;55;155;33;28;61
89;09.06.2015;2015;06;20;Tiistai;82;42;124;25;32;57
89;09.06.2015;2015;06;21;Tiistai;56;25;81;21;24;45
89;09.06.2015;2015;06;22;Tiistai;24;14;38;6;7;13
89;09.06.2015;2015;06;23;Tiistai;22;13;35;15;5;20
89;10.06.2015;2015;06;00;Keskiviikko;8;8;16;7;3;10
89;10.06.2015;2015;06;01;Keskiviikko;1;1;2;3;3;6
89;10.06.2015;2015;06;02;Keskiviikko;8;3;11;2;1;3
89;10.06.2015;2015;06;03;Keskiviikko;4;4;8;0;0;0
89;10.06.2015;2015;06;04;Keskiviikko;3;5;8;1;1;2
89;10.06.2015;2015;06;05;Keskiviikko;7;16;23;3;1;4
89;10.06.2015;2015;06;06;Keskiviikko;23;90;113;2;9;11
89;10.06.2015;2015;06;07;Keskiviikko;42;189;231;4;18;22
89;10.06.2015;2015;06;08;Keskiviikko;47;167;214;18;26;44
89;10.06.2015;2015;06;09;Keskiviikko;28;55;83;4;27;31
89;10.06.2015;2015;06;10;Keskiviikko;24;50;74;32;28;60
89;10.06.2015;2015;06;11;Keskiviikko;29;60;89;16;25;41
89;10.06.2015;2015;06;12;Keskiviikko;43;54;97;9;20;29
89;10.06.2015;2015;06;13;Keskiviikko;69;70;139;14;20;34
89;10.06.2015;2015;06;14;Keskiviikko;86;60;146;21;21;42
89;10.06.2015;2015;06;15;Keskiviikko;190;82;272;25;33;58
89;10.06.2015;2015;06;16;Keskiviikko;213;131;344;26;47;73
89;10.06.2015;2015;06;17;Keskiviikko;123;113;236;27;47;74
89;10.06.2015;2015;06;18;Keskiviikko;105;81;186;31;26;57
89;10.06.2015;2015;06;19;Keskiviikko;128;71;199;34;30;64
89;10.06.2015;2015;06;20;Keskiviikko;89;61;150;20;24;44
89;10.06.2015;2015;06;21;Keskiviikko;69;26;95;16;12;28
89;10.06.2015;2015;06;22;Keskiviikko;38;18;56;7;5;12
89;10.06.2015;2015;06;23;Keskiviikko;15;10;25;4;4;8
89;11.06.2015;2015;06;00;Torstai;18;12;30;2;2;4
89;11.06.2015;2015;06;01;Torstai;5;1;6;2;5;7
89;11.06.2015;2015;06;02;Torstai;7;8;15;2;4;6
89;11.06.2015;2015;06;03;Torstai;8;4;12;1;0;1
89;11.06.2015;2015;06;04;Torstai;4;8;12;1;0;1
89;11.06.2015;2015;06;05;Torstai;7;16;23;0;0;0
89;11.06.2015;2015;06;06;Torstai;21;99;120;6;3;9
89;11.06.2015;2015;06;07;Torstai;43;185;228;3;24;27
89;11.06.2015;2015;06;08;Torstai;53;176;229;13;32;45
89;11.06.2015;2015;06;09;Torstai;41;122;163;16;39;55
89;11.06.2015;2015;06;10;Torstai;52;100;152;35;46;81
89;11.06.2015;2015;06;11;Torstai;74;91;165;35;52;87
89;11.06.2015;2015;06;12;Torstai;84;125;209;47;58;105
89;11.06.2015;2015;06;13;Torstai;129;115;244;34;59;93
89;11.06.2015;2015;06;14;Torstai;133;97;230;50;58;108
89;11.06.2015;2015;06;15;Torstai;227;114;341;36;17;53
89;11.06.2015;2015;06;16;Torstai;227;125;352;29;25;54
89;11.06.2015;2015;06;17;Torstai;139;114;253;26;36;62
89;11.06.2015;2015;06;18;Torstai;132;91;223;33;26;59
89;11.06.2015;2015;06;19;Torstai;102;44;146;31;30;61
89;11.06.2015;2015;06;20;Torstai;63;55;118;20;29;49
89;11.06.2015;2015;06;21;Torstai;64;24;88;17;14;31
89;11.06.2015;2015;06;22;Torstai;34;21;55;7;14;21
89;11.06.2015;2015;06;23;Torstai;15;14;29;8;1;9
89;12.06.2015;2015;06;00;Perjantai;14;5;19;3;2;5
89;12.06.2015;2015;06;01;Perjantai;7;1;8;0;1;1
89;12.06.2015;2015;06;02;Perjantai;3;1;4;2;1;3
89;12.06.2015;2015;06;03;Perjantai;3;2;5;0;0;0
89;12.06.2015;2015;06;04;Perjantai;3;8;11;0;0;0
89;12.06.2015;2015;06;05;Perjantai;5;16;21;2;1;3
89;12.06.2015;2015;06;06;Perjantai;18;94;112;4;3;7
89;12.06.2015;2015;06;07;Perjantai;50;175;225;4;14;18
89;12.06.2015;2015;06;08;Perjantai;43;181;224;6;28;34
89;12.06.2015;2015;06;09;Perjantai;42;124;166;11;27;38
89;12.06.2015;2015;06;10;Perjantai;50;108;158;14;38;52
89;12.06.2015;2015;06;11;Perjantai;71;101;172;26;29;55
89;12.06.2015;2015;06;12;Perjantai;86;138;224;29;37;66
89;12.06.2015;2015;06;13;Perjantai;127;146;273;27;44;71
89;12.06.2015;2015;06;14;Perjantai;161;110;271;29;41;70
89;12.06.2015;2015;06;15;Perjantai;192;119;311;36;30;66
89;12.06.2015;2015;06;16;Perjantai;193;112;305;25;26;51
89;12.06.2015;2015;06;17;Perjantai;127;78;205;38;21;59
89;12.06.2015;2015;06;18;Perjantai;85;102;187;21;31;52
89;12.06.2015;2015;06;19;Perjantai;109;47;156;25;25;50
89;12.06.2015;2015;06;20;Perjantai;65;76;141;21;24;45
89;12.06.2015;2015;06;21;Perjantai;55;48;103;9;19;28
89;12.06.2015;2015;06;22;Perjantai;40;37;77;8;14;22
89;12.06.2015;2015;06;23;Perjantai;28;34;62;5;9;14
89;13.06.2015;2015;06;00;Lauantai;32;34;66;6;11;17
89;13.06.2015;2015;06;01;Lauantai;24;21;45;5;6;11
89;13.06.2015;2015;06;02;Lauantai;21;3;24;8;1;9
89;13.06.2015;2015;06;03;Lauantai;24;2;26;5;0;5
89;13.06.2015;2015;06;04;Lauantai;11;4;15;5;1;6
89;13.06.2015;2015;06;05;Lauantai;2;3;5;3;2;5
89;13.06.2015;2015;06;06;Lauantai;6;13;19;2;2;4
89;13.06.2015;2015;06;07;Lauantai;15;16;31;6;5;11
89;13.06.2015;2015;06;08;Lauantai;14;32;46;6;15;21
89;13.06.2015;2015;06;09;Lauantai;9;57;66;8;17;25
89;13.06.2015;2015;06;10;Lauantai;27;50;77;7;10;17
89;13.06.2015;2015;06;11;Lauantai;33;66;99;12;27;39
89;13.06.2015;2015;06;12;Lauantai;35;90;125;11;27;38
89;13.06.2015;2015;06;13;Lauantai;77;117;194;19;29;48
89;13.06.2015;2015;06;14;Lauantai;99;108;207;19;43;62
89;13.06.2015;2015;06;15;Lauantai;117;112;229;44;52;96
89;13.06.2015;2015;06;16;Lauantai;118;75;193;20;22;42
89;13.06.2015;2015;06;17;Lauantai;127;67;194;23;22;45
89;13.06.2015;2015;06;18;Lauantai;85;84;169;17;31;48
89;13.06.2015;2015;06;19;Lauantai;77;78;155;33;30;63
89;13.06.2015;2015;06;20;Lauantai;52;82;134;14;28;42
89;13.06.2015;2015;06;21;Lauantai;61;55;116;19;25;44
89;13.06.2015;2015;06;22;Lauantai;26;45;71;6;18;24
89;13.06.2015;2015;06;23;Lauantai;45;95;140;9;10;19
89;14.06.2015;2015;06;00;Sunnuntai;28;71;99;1;15;16
89;14.06.2015;2015;06;01;Sunnuntai;40;15;55;6;4;10
89;14.06.2015;2015;06;02;Sunnuntai;31;7;38;7;1;8
89;14.06.2015;2015;06;03;Sunnuntai;26;9;35;8;0;8
89;14.06.2015;2015;06;04;Sunnuntai;13;5;18;5;0;5
89;14.06.2015;2015;06;05;Sunnuntai;12;6;18;1;0;1
89;14.06.2015;2015;06;06;Sunnuntai;4;19;23;2;0;2
89;14.06.2015;2015;06;07;Sunnuntai;10;8;18;2;2;4
89;14.06.2015;2015;06;08;Sunnuntai;9;19;28;9;5;14
89;14.06.2015;2015;06;09;Sunnuntai;27;45;72;12;23;35
89;14.06.2015;2015;06;10;Sunnuntai;70;59;129;31;48;79
89;14.06.2015;2015;06;11;Sunnuntai;61;130;191;27;71;98
89;14.06.2015;2015;06;12;Sunnuntai;86;153;239;27;83;110
89;14.06.2015;2015;06;13;Sunnuntai;122;156;278;62;74;136
89;14.06.2015;2015;06;14;Sunnuntai;147;148;295;52;58;110
89;14.06.2015;2015;06;15;Sunnuntai;126;146;272;49;58;107
89;14.06.2015;2015;06;16;Sunnuntai;171;110;281;62;58;120
89;14.06.2015;2015;06;17;Sunnuntai;149;69;218;56;41;97
89;14.06.2015;2015;06;18;Sunnuntai;94;103;197;25;46;71
89;14.06.2015;2015;06;19;Sunnuntai;65;54;119;28;36;64
89;14.06.2015;2015;06;20;Sunnuntai;67;33;100;15;19;34
89;14.06.2015;2015;06;21;Sunnuntai;46;22;68;10;13;23
89;14.06.2015;2015;06;22;Sunnuntai;21;9;30;6;7;13
89;14.06.2015;2015;06;23;Sunnuntai;13;3;16;3;6;9
89;15.06.2015;2015;06;00;Maanantai;3;4;7;2;1;3
89;15.06.2015;2015;06;01;Maanantai;1;3;4;0;0;0
89;15.06.2015;2015;06;02;Maanantai;3;1;4;0;0;0
89;15.06.2015;2015;06;03;Maanantai;3;3;6;1;0;1
89;15.06.2015;2015;06;04;Maanantai;1;4;5;1;0;1
89;15.06.2015;2015;06;05;Maanantai;3;12;15;0;1;1
89;15.06.2015;2015;06;06;Maanantai;6;53;59;1;4;5
89;15.06.2015;2015;06;07;Maanantai;27;81;108;4;9;13
89;15.06.2015;2015;06;08;Maanantai;13;103;116;3;17;20
89;15.06.2015;2015;06;09;Maanantai;16;52;68;1;12;13
89;15.06.2015;2015;06;10;Maanantai;21;38;59;4;15;19
89;15.06.2015;2015;06;11;Maanantai;30;37;67;7;17;24
89;15.06.2015;2015;06;12;Maanantai;29;40;69;10;13;23
89;15.06.2015;2015;06;13;Maanantai;52;43;95;9;21;30
89;15.06.2015;2015;06;14;Maanantai;50;40;90;14;17;31
89;15.06.2015;2015;06;15;Maanantai;97;57;154;17;9;26
89;15.06.2015;2015;06;16;Maanantai;109;57;166;23;7;30
89;15.06.2015;2015;06;17;Maanantai;53;26;79;16;6;22
89;15.06.2015;2015;06;18;Maanantai;60;14;74;6;4;10
89;15.06.2015;2015;06;19;Maanantai;30;23;53;15;15;30
89;15.06.2015;2015;06;20;Maanantai;36;16;52;13;5;18
89;15.06.2015;2015;06;21;Maanantai;27;7;34;8;8;16
89;15.06.2015;2015;06;22;Maanantai;13;7;20;7;1;8
89;15.06.2015;2015;06;23;Maanantai;3;2;5;1;0;1
89;16.06.2015;2015;06;00;Tiistai;3;1;4;0;0;0
89;16.06.2015;2015;06;01;Tiistai;0;2;2;1;1;2
89;16.06.2015;2015;06;02;Tiistai;1;2;3;2;0;2
89;16.06.2015;2015;06;03;Tiistai;4;4;8;0;0;0
89;16.06.2015;2015;06;04;Tiistai;1;4;5;0;0;0
89;16.06.2015;2015;06;05;Tiistai;2;6;8;1;1;2
89;16.06.2015;2015;06;06;Tiistai;12;73;85;2;11;13
89;16.06.2015;2015;06;07;Tiistai;32;135;167;2;12;14
89;16.06.2015;2015;06;08;Tiistai;35;132;167;6;34;40
89;16.06.2015;2015;06;09;Tiistai;23;65;88;4;17;21
89;16.06.2015;2015;06;10;Tiistai;25;71;96;12;21;33
89;16.06.2015;2015;06;11;Tiistai;45;65;110;21;26;47
89;16.06.2015;2015;06;12;Tiistai;62;94;156;29;33;62
89;16.06.2015;2015;06;13;Tiistai;51;35;86;16;9;25
89;16.06.2015;2015;06;14;Tiistai;87;45;132;18;7;25
89;16.06.2015;2015;06;15;Tiistai;127;66;193;13;12;25
89;16.06.2015;2015;06;16;Tiistai;136;76;212;27;10;37
89;16.06.2015;2015;06;17;Tiistai;87;40;127;21;17;38
89;16.06.2015;2015;06;18;Tiistai;59;40;99;19;14;33
89;16.06.2015;2015;06;19;Tiistai;56;30;86;12;20;32
89;16.06.2015;2015;06;20;Tiistai;57;24;81;26;15;41
89;16.06.2015;2015;06;21;Tiistai;33;26;59;13;12;25
89;16.06.2015;2015;06;22;Tiistai;29;14;43;1;6;7
89;16.06.2015;2015;06;23;Tiistai;8;5;13;3;4;7
89;17.06.2015;2015;06;00;Keskiviikko;11;2;13;3;1;4
89;17.06.2015;2015;06;01;Keskiviikko;4;5;9;0;1;1
89;17.06.2015;2015;06;02;Keskiviikko;3;3;6;1;2;3
89;17.06.2015;2015;06;03;Keskiviikko;1;1;2;1;0;1
89;17.06.2015;2015;06;04;Keskiviikko;3;9;12;0;0;0
89;17.06.2015;2015;06;05;Keskiviikko;4;11;15;0;0;0
89;17.06.2015;2015;06;06;Keskiviikko;19;86;105;1;4;5
89;17.06.2015;2015;06;07;Keskiviikko;56;171;227;3;17;20
89;17.06.2015;2015;06;08;Keskiviikko;59;200;259;7;33;40
89;17.06.2015;2015;06;09;Keskiviikko;49;133;182;17;26;43
89;17.06.2015;2015;06;10;Keskiviikko;56;107;163;22;29;51
89;17.06.2015;2015;06;11;Keskiviikko;99;124;223;24;30;54
89;17.06.2015;2015;06;12;Keskiviikko;111;122;233;22;30;52
89;17.06.2015;2015;06;13;Keskiviikko;107;134;241;21;30;51
89;17.06.2015;2015;06;14;Keskiviikko;134;151;285;27;27;54
89;17.06.2015;2015;06;15;Keskiviikko;242;192;434;25;36;61
89;17.06.2015;2015;06;16;Keskiviikko;238;153;391;27;44;71
89;17.06.2015;2015;06;17;Keskiviikko;173;165;338;33;36;69
89;17.06.2015;2015;06;18;Keskiviikko;154;95;249;34;40;74
89;17.06.2015;2015;06;19;Keskiviikko;151;89;240;32;32;64
89;17.06.2015;2015;06;20;Keskiviikko;105;70;175;32;26;58
89;17.06.2015;2015;06;21;Keskiviikko;103;49;152;14;28;42
89;17.06.2015;2015;06;22;Keskiviikko;55;33;88;7;7;14
89;17.06.2015;2015;06;23;Keskiviikko;24;21;45;9;3;12
89;18.06.2015;2015;06;00;Torstai;6;6;12;1;2;3
89;18.06.2015;2015;06;01;Torstai;8;5;13;0;2;2
89;18.06.2015;2015;06;02;Torstai;7;0;7;1;0;1
89;18.06.2015;2015;06;03;Torstai;5;4;9;1;0;1
89;18.06.2015;2015;06;04;Torstai;6;7;13;2;0;2
89;18.06.2015;2015;06;05;Torstai;8;23;31;0;0;0
89;18.06.2015;2015;06;06;Torstai;29;106;135;3;6;9
89;18.06.2015;2015;06;07;Torstai;57;191;248;3;21;24
89;18.06.2015;2015;06;08;Torstai;54;187;241;9;19;28
89;18.06.2015;2015;06;09;Torstai;62;156;218;10;32;42
89;18.06.2015;2015;06;10;Torstai;71;124;195;21;32;53
89;18.06.2015;2015;06;11;Torstai;88;121;209;21;39;60
89;18.06.2015;2015;06;12;Torstai;101;124;225;20;26;46
89;18.06.2015;2015;06;13;Torstai;124;120;244;24;26;50
89;18.06.2015;2015;06;14;Torstai;207;109;316;29;28;57
89;18.06.2015;2015;06;15;Torstai;216;116;332;22;25;47
89;18.06.2015;2015;06;16;Torstai;153;114;267;16;20;36
89;18.06.2015;2015;06;17;Torstai;120;91;211;19;21;40
89;18.06.2015;2015;06;18;Torstai;111;109;220;21;21;42
89;18.06.2015;2015;06;19;Torstai;73;83;156;21;14;35
89;18.06.2015;2015;06;20;Torstai;78;49;127;15;9;24
89;18.06.2015;2015;06;21;Torstai;40;35;75;3;8;11
89;18.06.2015;2015;06;22;Torstai;44;40;84;7;7;14
89;18.06.2015;2015;06;23;Torstai;29;20;49;8;9;17
89;19.06.2015;2015;06;00;Perjantai;21;7;28;3;5;8
89;19.06.2015;2015;06;01;Perjantai;13;5;18;5;5;10
89;19.06.2015;2015;06;02;Perjantai;13;5;18;1;4;5
89;19.06.2015;2015;06;03;Perjantai;7;8;15;5;0;5
89;19.06.2015;2015;06;04;Perjantai;10;6;16;0;2;2
89;19.06.2015;2015;06;05;Perjantai;4;6;10;1;1;2
89;19.06.2015;2015;06;06;Perjantai;4;22;26;1;5;6
89;19.06.2015;2015;06;07;Perjantai;18;39;57;2;5;7
89;19.06.2015;2015;06;08;Perjantai;11;47;58;7;15;22
89;19.06.2015;2015;06;09;Perjantai;37;74;111;10;21;31
89;19.06.2015;2015;06;10;Perjantai;68;117;185;16;24;40
89;19.06.2015;2015;06;11;Perjantai;79;78;157;19;30;49
89;19.06.2015;2015;06;12;Perjantai;91;57;148;20;30;50
89;19.06.2015;2015;06;13;Perjantai;67;69;136;25;33;58
89;19.06.2015;2015;06;14;Perjantai;99;73;172;26;31;57
89;19.06.2015;2015;06;15;Perjantai;64;84;148;19;26;45
89;19.06.2015;2015;06;16;Perjantai;88;71;159;22;26;48
89;19.06.2015;2015;06;17;Perjantai;78;77;155;15;28;43
89;19.06.2015;2015;06;18;Perjantai;54;107;161;22;51;73
89;19.06.2015;2015;06;19;Perjantai;60;59;119;9;27;36
89;19.06.2015;2015;06;20;Perjantai;75;47;122;24;13;37
89;19.06.2015;2015;06;21;Perjantai;60;72;132;11;25;36
89;19.06.2015;2015;06;22;Perjantai;36;47;83;13;28;41
89;19.06.2015;2015;06;23;Perjantai;32;34;66;7;13;20
89;20.06.2015;2015;06;00;Lauantai;27;28;55;3;10;13
89;20.06.2015;2015;06;01;Lauantai;26;20;46;3;5;8
89;20.06.2015;2015;06;02;Lauantai;27;12;39;8;0;8
89;20.06.2015;2015;06;03;Lauantai;17;14;31;3;0;3
89;20.06.2015;2015;06;04;Lauantai;16;6;22;9;1;10
89;20.06.2015;2015;06;05;Lauantai;17;9;26;1;1;2
89;20.06.2015;2015;06;06;Lauantai;9;11;20;3;3;6
89;20.06.2015;2015;06;07;Lauantai;11;8;19;1;5;6
89;20.06.2015;2015;06;08;Lauantai;3;11;14;7;8;15
89;20.06.2015;2015;06;09;Lauantai;14;23;37;10;19;29
89;20.06.2015;2015;06;10;Lauantai;34;46;80;14;24;38
89;20.06.2015;2015;06;11;Lauantai;54;76;130;23;38;61
89;20.06.2015;2015;06;12;Lauantai;66;113;179;28;30;58
89;20.06.2015;2015;06;13;Lauantai;100;120;220;38;52;90
89;20.06.2015;2015;06;14;Lauantai;99;133;232;23;40;63
89;20.06.2015;2015;06;15;Lauantai;80;145;225;27;38;65
89;20.06.2015;2015;06;16;Lauantai;92;110;202;37;57;94
89;20.06.2015;2015;06;17;Lauantai;91;111;202;47;44;91
89;20.06.2015;2015;06;18;Lauantai;80;114;194;25;46;71
89;20.06.2015;2015;06;19;Lauantai;102;109;211;30;43;73
89;20.06.2015;2015;06;20;Lauantai;78;81;159;16;28;44
89;20.06.2015;2015;06;21;Lauantai;70;65;135;23;18;41
89;20.06.2015;2015;06;22;Lauantai;60;68;128;11;10;21
89;20.06.2015;2015;06;23;Lauantai;44;55;99;24;18;42
89;21.06.2015;2015;06;00;Sunnuntai;13;25;38;5;3;8
89;21.06.2015;2015;06;01;Sunnuntai;16;14;30;7;6;13
89;21.06.2015;2015;06;02;Sunnuntai;18;6;24;4;1;5
89;21.06.2015;2015;06;03;Sunnuntai;17;4;21;4;0;4
89;21.06.2015;2015;06;04;Sunnuntai;16;1;17;0;0;0
89;21.06.2015;2015;06;05;Sunnuntai;4;3;7;1;1;2
89;21.06.2015;2015;06;06;Sunnuntai;6;16;22;0;3;3
89;21.06.2015;2015;06;07;Sunnuntai;8;2;10;1;3;4
89;21.06.2015;2015;06;08;Sunnuntai;2;10;12;4;7;11
89;21.06.2015;2015;06;09;Sunnuntai;10;14;24;11;13;24
89;21.06.2015;2015;06;10;Sunnuntai;8;14;22;11;11;22
89;21.06.2015;2015;06;11;Sunnuntai;22;39;61;14;15;29
89;21.06.2015;2015;06;12;Sunnuntai;26;44;70;13;14;27
89;21.06.2015;2015;06;13;Sunnuntai;38;70;108;15;23;38
89;21.06.2015;2015;06;14;Sunnuntai;39;67;106;22;22;44
89;21.06.2015;2015;06;15;Sunnuntai;46;71;117;23;28;51
89;21.06.2015;2015;06;16;Sunnuntai;76;87;163;21;27;48
89;21.06.2015;2015;06;17;Sunnuntai;80;76;156;22;37;59
89;21.06.2015;2015;06;18;Sunnuntai;92;87;179;30;45;75
89;21.06.2015;2015;06;19;Sunnuntai;91;106;197;32;54;86
89;21.06.2015;2015;06;20;Sunnuntai;93;49;142;18;15;33
89;21.06.2015;2015;06;21;Sunnuntai;46;36;82;11;23;34
89;21.06.2015;2015;06;22;Sunnuntai;25;21;46;15;9;24
89;21.06.2015;2015;06;23;Sunnuntai;19;13;32;6;6;12
89;22.06.2015;2015;06;00;Maanantai;10;11;21;2;0;2
89;22.06.2015;2015;06;01;Maanantai;8;5;13;1;0;1
89;22.06.2015;2015;06;02;Maanantai;0;2;2;1;2;3
89;22.06.2015;2015;06;03;Maanantai;3;2;5;0;0;0
89;22.06.2015;2015;06;04;Maanantai;2;6;8;0;1;1
89;22.06.2015;2015;06;05;Maanantai;11;21;32;1;3;4
89;22.06.2015;2015;06;06;Maanantai;24;96;120;3;6;9
89;22.06.2015;2015;06;07;Maanantai;63;207;270;3;20;23
89;22.06.2015;2015;06;08;Maanantai;60;185;245;16;22;38
89;22.06.2015;2015;06;09;Maanantai;55;160;215;6;30;36
89;22.06.2015;2015;06;10;Maanantai;87;164;251;16;45;61
89;22.06.2015;2015;06;11;Maanantai;112;170;282;31;46;77
89;22.06.2015;2015;06;12;Maanantai;152;193;345;28;54;82
89;22.06.2015;2015;06;13;Maanantai;183;170;353;33;40;73
89;22.06.2015;2015;06;14;Maanantai;199;149;348;35;34;69
89;22.06.2015;2015;06;15;Maanantai;258;165;423;34;35;69
89;22.06.2015;2015;06;16;Maanantai;254;170;424;28;25;53
89;22.06.2015;2015;06;17;Maanantai;189;159;348;32;37;69
89;22.06.2015;2015;06;18;Maanantai;154;152;306;41;40;81
89;22.06.2015;2015;06;19;Maanantai;146;92;238;29;54;83
89;22.06.2015;2015;06;20;Maanantai;126;79;205;32;23;55
89;22.06.2015;2015;06;21;Maanantai;53;22;75;12;5;17
89;22.06.2015;2015;06;22;Maanantai;23;19;42;7;9;16
89;22.06.2015;2015;06;23;Maanantai;13;17;30;7;4;11
89;23.06.2015;2015;06;00;Tiistai;6;3;9;2;0;2
89;23.06.2015;2015;06;01;Tiistai;8;3;11;0;0;0
89;23.06.2015;2015;06;02;Tiistai;8;1;9;0;0;0
89;23.06.2015;2015;06;03;Tiistai;1;3;4;2;1;3
89;23.06.2015;2015;06;04;Tiistai;5;6;11;3;1;4
89;23.06.2015;2015;06;05;Tiistai;11;17;28;3;2;5
89;23.06.2015;2015;06;06;Tiistai;21;68;89;1;2;3
89;23.06.2015;2015;06;07;Tiistai;49;139;188;0;14;14
89;23.06.2015;2015;06;08;Tiistai;43;145;188;8;33;41
89;23.06.2015;2015;06;09;Tiistai;31;61;92;6;16;22
89;23.06.2015;2015;06;10;Tiistai;27;66;93;11;20;31
89;23.06.2015;2015;06;11;Tiistai;44;38;82;15;16;31
89;23.06.2015;2015;06;12;Tiistai;49;29;78;7;10;17
89;23.06.2015;2015;06;13;Tiistai;39;31;70;5;12;17
89;23.06.2015;2015;06;14;Tiistai;63;43;106;3;6;9
89;23.06.2015;2015;06;15;Tiistai;119;59;178;10;14;24
89;23.06.2015;2015;06;16;Tiistai;124;71;195;14;12;26
89;23.06.2015;2015;06;17;Tiistai;64;41;105;20;10;30
89;23.06.2015;2015;06;18;Tiistai;63;31;94;17;7;24
89;23.06.2015;2015;06;19;Tiistai;37;22;59;7;17;24
89;23.06.2015;2015;06;20;Tiistai;44;22;66;10;14;24
89;23.06.2015;2015;06;21;Tiistai;28;15;43;11;11;22
89;23.06.2015;2015;06;22;Tiistai;15;12;27;5;7;12
89;23.06.2015;2015;06;23;Tiistai;7;11;18;5;4;9
89;24.06.2015;2015;06;00;Keskiviikko;6;2;8;1;3;4
89;24.06.2015;2015;06;01;Keskiviikko;5;3;8;2;0;2
89;24.06.2015;2015;06;02;Keskiviikko;0;1;1;0;1;1
89;24.06.2015;2015;06;03;Keskiviikko;2;3;5;0;0;0
89;24.06.2015;2015;06;04;Keskiviikko;3;6;9;2;1;3
89;24.06.2015;2015;06;05;Keskiviikko;5;18;23;0;2;2
89;24.06.2015;2015;06;06;Keskiviikko;26;81;107;3;7;10
89;24.06.2015;2015;06;07;Keskiviikko;53;151;204;6;18;24
89;24.06.2015;2015;06;08;Keskiviikko;47;151;198;3;29;32
89;24.06.2015;2015;06;09;Keskiviikko;39;129;168;20;26;46
89;24.06.2015;2015;06;10;Keskiviikko;58;136;194;20;38;58
89;24.06.2015;2015;06;11;Keskiviikko;103;103;206;20;45;65
89;24.06.2015;2015;06;12;Keskiviikko;73;82;155;18;20;38
89;24.06.2015;2015;06;13;Keskiviikko;80;62;142;21;16;37
89;24.06.2015;2015;06;14;Keskiviikko;67;59;126;11;12;23
89;24.06.2015;2015;06;15;Keskiviikko;139;77;216;17;20;37
89;24.06.2015;2015;06;16;Keskiviikko;154;66;220;23;10;33
89;24.06.2015;2015;06;17;Keskiviikko;88;50;138;21;13;34
89;24.06.2015;2015;06;18;Keskiviikko;57;49;106;21;29;50
89;24.06.2015;2015;06;19;Keskiviikko;66;44;110;24;21;45
89;24.06.2015;2015;06;20;Keskiviikko;73;49;122;30;35;65
89;24.06.2015;2015;06;21;Keskiviikko;43;33;76;23;24;47
89;24.06.2015;2015;06;22;Keskiviikko;24;24;48;7;14;21
89;24.06.2015;2015;06;23;Keskiviikko;13;10;23;3;7;10
89;25.06.2015;2015;06;00;Torstai;7;4;11;3;3;6
89;25.06.2015;2015;06;01;Torstai;15;5;20;6;3;9
89;25.06.2015;2015;06;02;Torstai;3;3;6;1;0;1
89;25.06.2015;2015;06;03;Torstai;9;4;13;1;0;1
89;25.06.2015;2015;06;04;Torstai;6;7;13;1;1;2
89;25.06.2015;2015;06;05;Torstai;9;17;26;0;2;2
89;25.06.2015;2015;06;06;Torstai;25;74;99;1;3;4
89;25.06.2015;2015;06;07;Torstai;45;111;156;2;9;11
89;25.06.2015;2015;06;08;Torstai;26;106;132;5;24;29
89;25.06.2015;2015;06;09;Torstai;25;60;85;8;8;16
89;25.06.2015;2015;06;10;Torstai;35;39;74;7;10;17
89;25.06.2015;2015;06;11;Torstai;22;45;67;5;11;16
89;25.06.2015;2015;06;12;Torstai;38;47;85;8;16;24
89;25.06.2015;2015;06;13;Torstai;48;52;100;4;12;16
89;25.06.2015;2015;06;14;Torstai;74;54;128;17;12;29
89;25.06.2015;2015;06;15;Torstai;100;61;161;5;13;18
89;25.06.2015;2015;06;16;Torstai;124;75;199;13;22;35
89;25.06.2015;2015;06;17;Torstai;76;67;143;27;12;39
89;25.06.2015;2015;06;18;Torstai;96;61;157;24;23;47
89;25.06.2015;2015;06;19;Torstai;72;64;136;34;23;57
89;25.06.2015;2015;06;20;Torstai;54;37;91;28;32;60
89;25.06.2015;2015;06;21;Torstai;51;41;92;18;20;38
89;25.06.2015;2015;06;22;Torstai;23;18;41;7;11;18
89;25.06.2015;2015;06;23;Torstai;16;11;27;2;1;3
89;26.06.2015;2015;06;00;Perjantai;12;5;17;3;2;5
89;26.06.2015;2015;06;01;Perjantai;4;2;6;0;1;1
89;26.06.2015;2015;06;02;Perjantai;5;3;8;0;2;2
89;26.06.2015;2015;06;03;Perjantai;4;2;6;1;0;1
89;26.06.2015;2015;06;04;Perjantai;2;8;10;0;1;1
89;26.06.2015;2015;06;05;Perjantai;6;21;27;0;3;3
89;26.06.2015;2015;06;06;Perjantai;26;82;108;5;6;11
89;26.06.2015;2015;06;07;Perjantai;45;145;190;3;21;24
89;26.06.2015;2015;06;08;Perjantai;38;136;174;6;22;28
89;26.06.2015;2015;06;09;Perjantai;42;94;136;16;22;38
89;26.06.2015;2015;06;10;Perjantai;44;100;144;20;36;56
89;26.06.2015;2015;06;11;Perjantai;69;108;177;20;37;57
89;26.06.2015;2015;06;12;Perjantai;75;96;171;15;36;51
89;26.06.2015;2015;06;13;Perjantai;100;104;204;20;32;52
89;26.06.2015;2015;06;14;Perjantai;143;101;244;31;28;59
89;26.06.2015;2015;06;15;Perjantai;181;138;319;28;26;54
89;26.06.2015;2015;06;16;Perjantai;152;102;254;25;33;58
89;26.06.2015;2015;06;17;Perjantai;125;117;242;18;15;33
89;26.06.2015;2015;06;18;Perjantai;120;75;195;9;18;27
89;26.06.2015;2015;06;19;Perjantai;88;81;169;13;30;43
89;26.06.2015;2015;06;20;Perjantai;77;78;155;19;16;35
89;26.06.2015;2015;06;21;Perjantai;63;54;117;18;21;39
89;26.06.2015;2015;06;22;Perjantai;45;30;75;11;9;20
89;26.06.2015;2015;06;23;Perjantai;44;29;73;0;10;10
89;27.06.2015;2015;06;00;Lauantai;29;33;62;4;5;9
89;27.06.2015;2015;06;01;Lauantai;17;15;32;1;3;4
89;27.06.2015;2015;06;02;Lauantai;12;8;20;8;2;10
89;27.06.2015;2015;06;03;Lauantai;25;7;32;8;2;10
89;27.06.2015;2015;06;04;Lauantai;19;8;27;10;0;10
89;27.06.2015;2015;06;05;Lauantai;8;9;17;2;0;2
89;27.06.2015;2015;06;06;Lauantai;5;19;24;1;3;4
89;27.06.2015;2015;06;07;Lauantai;2;25;27;6;6;12
89;27.06.2015;2015;06;08;Lauantai;25;31;56;9;13;22
89;27.06.2015;2015;06;09;Lauantai;24;65;89;16;22;38
89;27.06.2015;2015;06;10;Lauantai;42;104;146;10;31;41
89;27.06.2015;2015;06;11;Lauantai;72;129;201;19;49;68
89;27.06.2015;2015;06;12;Lauantai;75;137;212;28;41;69
89;27.06.2015;2015;06;13;Lauantai;129;147;276;30;51;81
89;27.06.2015;2015;06;14;Lauantai;100;115;215;30;39;69
89;27.06.2015;2015;06;15;Lauantai;113;105;218;41;31;72
89;27.06.2015;2015;06;16;Lauantai;103;94;197;36;29;65
89;27.06.2015;2015;06;17;Lauantai;98;91;189;25;36;61
89;27.06.2015;2015;06;18;Lauantai;71;69;140;16;22;38
89;27.06.2015;2015;06;19;Lauantai;65;62;127;18;30;48
89;27.06.2015;2015;06;20;Lauantai;50;37;87;15;16;31
89;27.06.2015;2015;06;21;Lauantai;41;54;95;9;14;23
89;27.06.2015;2015;06;22;Lauantai;31;55;86;11;10;21
89;27.06.2015;2015;06;23;Lauantai;35;51;86;12;17;29
89;28.06.2015;2015;06;00;Sunnuntai;27;48;75;4;6;10
89;28.06.2015;2015;06;01;Sunnuntai;40;20;60;4;1;5
89;28.06.2015;2015;06;02;Sunnuntai;28;16;44;7;1;8
89;28.06.2015;2015;06;03;Sunnuntai;41;7;48;7;0;7
89;28.06.2015;2015;06;04;Sunnuntai;31;5;36;3;1;4
89;28.06.2015;2015;06;05;Sunnuntai;11;5;16;4;2;6
89;28.06.2015;2015;06;06;Sunnuntai;6;16;22;1;4;5
89;28.06.2015;2015;06;07;Sunnuntai;12;10;22;3;6;9
89;28.06.2015;2015;06;08;Sunnuntai;12;19;31;7;9;16
89;28.06.2015;2015;06;09;Sunnuntai;17;43;60;17;18;35
89;28.06.2015;2015;06;10;Sunnuntai;47;94;141;30;41;71
89;28.06.2015;2015;06;11;Sunnuntai;65;147;212;44;56;100
89;28.06.2015;2015;06;12;Sunnuntai;133;183;316;33;38;71
89;28.06.2015;2015;06;13;Sunnuntai;102;169;271;38;53;91
89;28.06.2015;2015;06;14;Sunnuntai;121;151;272;35;60;95
89;28.06.2015;2015;06;15;Sunnuntai;192;170;362;32;46;78
89;28.06.2015;2015;06;16;Sunnuntai;169;146;315;46;53;99
89;28.06.2015;2015;06;17;Sunnuntai;161;136;297;44;44;88
89;28.06.2015;2015;06;18;Sunnuntai;157;154;311;53;64;117
89;28.06.2015;2015;06;19;Sunnuntai;153;104;257;50;56;106
89;28.06.2015;2015;06;20;Sunnuntai;98;101;199;37;26;63
89;28.06.2015;2015;06;21;Sunnuntai;51;45;96;16;19;35
89;28.06.2015;2015;06;22;Sunnuntai;40;34;74;12;10;22
89;28.06.2015;2015;06;23;Sunnuntai;26;11;37;8;8;16
89;29.06.2015;2015;06;00;Maanantai;16;12;28;1;1;2
89;29.06.2015;2015;06;01;Maanantai;4;1;5;1;3;4
89;29.06.2015;2015;06;02;Maanantai;3;6;9;0;1;1
89;29.06.2015;2015;06;03;Maanantai;12;9;21;1;2;3
89;29.06.2015;2015;06;04;Maanantai;1;6;7;1;5;6
89;29.06.2015;2015;06;05;Maanantai;12;27;39;2;0;2
89;29.06.2015;2015;06;06;Maanantai;22;92;114;1;4;5
89;29.06.2015;2015;06;07;Maanantai;58;187;245;4;14;18
89;29.06.2015;2015;06;08;Maanantai;47;176;223;8;35;43
89;29.06.2015;2015;06;09;Maanantai;57;157;214;13;31;44
89;29.06.2015;2015;06;10;Maanantai;84;151;235;29;46;75
89;29.06.2015;2015;06;11;Maanantai;84;200;284;34;80;114
89;29.06.2015;2015;06;12;Maanantai;140;204;344;37;72;109
89;29.06.2015;2015;06;13;Maanantai;161;185;346;52;75;127
89;29.06.2015;2015;06;14;Maanantai;173;165;338;34;76;110
89;29.06.2015;2015;06;15;Maanantai;249;170;419;42;41;83
89;29.06.2015;2015;06;16;Maanantai;303;214;517;32;39;71
89;29.06.2015;2015;06;17;Maanantai;218;190;408;48;48;96
89;29.06.2015;2015;06;18;Maanantai;194;156;350;49;52;101
89;29.06.2015;2015;06;19;Maanantai;167;90;257;45;37;82
89;29.06.2015;2015;06;20;Maanantai;103;59;162;29;31;60
89;29.06.2015;2015;06;21;Maanantai;61;36;97;15;12;27
89;29.06.2015;2015;06;22;Maanantai;33;20;53;6;13;19
89;29.06.2015;2015;06;23;Maanantai;22;14;36;15;24;39
89;30.06.2015;2015;06;00;Tiistai;9;11;20;3;2;5
89;30.06.2015;2015;06;01;Tiistai;9;2;11;3;3;6
89;30.06.2015;2015;06;02;Tiistai;2;5;7;5;0;5
89;30.06.2015;2015;06;03;Tiistai;8;3;11;1;0;1
89;30.06.2015;2015;06;04;Tiistai;0;7;7;0;0;0
89;30.06.2015;2015;06;05;Tiistai;14;24;38;0;2;2
89;30.06.2015;2015;06;06;Tiistai;20;95;115;3;7;10
89;30.06.2015;2015;06;07;Tiistai;50;148;198;1;21;22
89;30.06.2015;2015;06;08;Tiistai;45;156;201;7;13;20
89;30.06.2015;2015;06;09;Tiistai;33;102;135;6;26;32
89;30.06.2015;2015;06;10;Tiistai;60;105;165;17;27;44
89;30.06.2015;2015;06;11;Tiistai;67;99;166;11;31;42
89;30.06.2015;2015;06;12;Tiistai;76;115;191;26;35;61
89;30.06.2015;2015;06;13;Tiistai;106;118;224;22;43;65
89;30.06.2015;2015;06;14;Tiistai;133;149;282;23;47;70
89;30.06.2015;2015;06;15;Tiistai;207;149;356;29;37;66
89;30.06.2015;2015;06;16;Tiistai;202;142;344;29;30;59
89;30.06.2015;2015;06;17;Tiistai;154;133;287;37;35;72
89;30.06.2015;2015;06;18;Tiistai;134;113;247;30;57;87
89;30.06.2015;2015;06;19;Tiistai;134;97;231;40;48;88
89;30.06.2015;2015;06;20;Tiistai;103;88;191;35;43;78
89;30.06.2015;2015;06;21;Tiistai;71;53;124;25;34;59
89;30.06.2015;2015;06;22;Tiistai;33;40;73;14;15;29
89;30.06.2015;2015;06;23;Tiistai;26;25;51;35;45;80
89;01.07.2015;2015;07;00;Keskiviikko;13;13;26;2;3;5
89;01.07.2015;2015;07;01;Keskiviikko;11;8;19;1;0;1
89;01.07.2015;2015;07;02;Keskiviikko;8;6;14;1;1;2
89;01.07.2015;2015;07;03;Keskiviikko;10;1;11;5;0;5
89;01.07.2015;2015;07;04;Keskiviikko;6;7;13;0;4;4
89;01.07.2015;2015;07;05;Keskiviikko;11;25;36;0;2;2
89;01.07.2015;2015;07;06;Keskiviikko;21;95;116;2;7;9
89;01.07.2015;2015;07;07;Keskiviikko;60;173;233;5;19;24
89;01.07.2015;2015;07;08;Keskiviikko;53;180;233;10;44;54
89;01.07.2015;2015;07;09;Keskiviikko;50;161;211;23;39;62
89;01.07.2015;2015;07;10;Keskiviikko;77;157;234;27;49;76
89;01.07.2015;2015;07;11;Keskiviikko;107;206;313;40;75;115
89;01.07.2015;2015;07;12;Keskiviikko;155;237;392;39;59;98
89;01.07.2015;2015;07;13;Keskiviikko;198;211;409;40;67;107
89;01.07.2015;2015;07;14;Keskiviikko;213;247;460;47;75;122
89;01.07.2015;2015;07;15;Keskiviikko;312;250;562;54;83;137
89;01.07.2015;2015;07;16;Keskiviikko;269;264;533;51;61;112
89;01.07.2015;2015;07;17;Keskiviikko;267;261;528;54;89;143
89;01.07.2015;2015;07;18;Keskiviikko;259;245;504;78;62;140
89;01.07.2015;2015;07;19;Keskiviikko;209;187;396;58;123;181
89;01.07.2015;2015;07;20;Keskiviikko;188;152;340;55;64;119
89;01.07.2015;2015;07;21;Keskiviikko;116;111;227;15;33;48
89;01.07.2015;2015;07;22;Keskiviikko;76;43;119;14;17;31
89;01.07.2015;2015;07;23;Keskiviikko;51;34;85;6;7;13
89;02.07.2015;2015;07;00;Torstai;37;15;52;6;11;17
89;02.07.2015;2015;07;01;Torstai;19;14;33;2;2;4
89;02.07.2015;2015;07;02;Torstai;17;11;28;1;4;5
89;02.07.2015;2015;07;03;Torstai;13;3;16;3;0;3
89;02.07.2015;2015;07;04;Torstai;10;3;13;3;1;4
89;02.07.2015;2015;07;05;Torstai;11;18;29;2;1;3
89;02.07.2015;2015;07;06;Torstai;18;88;106;2;9;11
89;02.07.2015;2015;07;07;Torstai;59;163;222;3;12;15
89;02.07.2015;2015;07;08;Torstai;38;190;228;5;30;35
89;02.07.2015;2015;07;09;Torstai;51;120;171;13;25;38
89;02.07.2015;2015;07;10;Torstai;65;164;229;15;53;68
89;02.07.2015;2015;07;11;Torstai;87;163;250;43;56;99
89;02.07.2015;2015;07;12;Torstai;123;187;310;28;42;70
89;02.07.2015;2015;07;13;Torstai;157;167;324;34;48;82
89;02.07.2015;2015;07;14;Torstai;147;142;289;35;39;74
89;02.07.2015;2015;07;15;Torstai;220;168;388;35;66;101
89;02.07.2015;2015;07;16;Torstai;252;124;376;40;37;77
89;02.07.2015;2015;07;17;Torstai;189;97;286;28;25;53
89;02.07.2015;2015;07;18;Torstai;106;79;185;26;43;69
89;02.07.2015;2015;07;19;Torstai;79;50;129;13;19;32
89;02.07.2015;2015;07;20;Torstai;73;23;96;14;11;25
89;02.07.2015;2015;07;21;Torstai;58;28;86;8;8;16
89;02.07.2015;2015;07;22;Torstai;28;23;51;7;5;12
89;02.07.2015;2015;07;23;Torstai;28;8;36;2;2;4
89;03.07.2015;2015;07;00;Perjantai;13;10;23;4;3;7
89;03.07.2015;2015;07;01;Perjantai;6;6;12;8;0;8
89;03.07.2015;2015;07;02;Perjantai;4;4;8;1;0;1
89;03.07.2015;2015;07;03;Perjantai;6;5;11;2;1;3
89;03.07.2015;2015;07;04;Perjantai;2;6;8;0;1;1
89;03.07.2015;2015;07;05;Perjantai;11;18;29;1;4;5
89;03.07.2015;2015;07;06;Perjantai;24;91;115;3;5;8
89;03.07.2015;2015;07;07;Perjantai;40;140;180;1;13;14
89;03.07.2015;2015;07;08;Perjantai;33;129;162;7;33;40
89;03.07.2015;2015;07;09;Perjantai;43;144;187;11;23;34
89;03.07.2015;2015;07;10;Perjantai;97;176;273;22;50;72
89;03.07.2015;2015;07;11;Perjantai;132;178;310;37;46;83
89;03.07.2015;2015;07;12;Perjantai;166;219;385;21;54;75
89;03.07.2015;2015;07;13;Perjantai;166;214;380;48;58;106
89;03.07.2015;2015;07;14;Perjantai;222;193;415;45;54;99
89;03.07.2015;2015;07;15;Perjantai;250;229;479;43;46;89
89;03.07.2015;2015;07;16;Perjantai;207;218;425;47;64;111
89;03.07.2015;2015;07;17;Perjantai;224;192;416;38;37;75
89;03.07.2015;2015;07;18;Perjantai;204;136;340;39;30;69
89;03.07.2015;2015;07;19;Perjantai;118;100;218;21;47;68
89;03.07.2015;2015;07;20;Perjantai;72;48;120;18;15;33
89;03.07.2015;2015;07;21;Perjantai;43;33;76;6;12;18
89;03.07.2015;2015;07;22;Perjantai;20;18;38;2;6;8
89;03.07.2015;2015;07;23;Perjantai;21;34;55;4;9;13
89;04.07.2015;2015;07;00;Lauantai;28;50;78;23;36;59
89;04.07.2015;2015;07;01;Lauantai;21;22;43;5;9;14
89;04.07.2015;2015;07;02;Lauantai;16;14;30;9;4;13
89;04.07.2015;2015;07;03;Lauantai;18;2;20;3;4;7
89;04.07.2015;2015;07;04;Lauantai;22;3;25;4;0;4
89;04.07.2015;2015;07;05;Lauantai;11;5;16;1;1;2
89;04.07.2015;2015;07;06;Lauantai;8;18;26;1;2;3
89;04.07.2015;2015;07;07;Lauantai;4;15;19;3;4;7
89;04.07.2015;2015;07;08;Lauantai;7;19;26;5;12;17
89;04.07.2015;2015;07;09;Lauantai;20;27;47;9;10;19
89;04.07.2015;2015;07;10;Lauantai;14;36;50;18;22;40
89;04.07.2015;2015;07;11;Lauantai;35;62;97;15;36;51
89;04.07.2015;2015;07;12;Lauantai;38;68;106;8;20;28
89;04.07.2015;2015;07;13;Lauantai;43;51;94;17;18;35
89;04.07.2015;2015;07;14;Lauantai;50;75;125;21;26;47
89;04.07.2015;2015;07;15;Lauantai;74;116;190;34;43;77
89;04.07.2015;2015;07;16;Lauantai;89;101;190;51;52;103
89;04.07.2015;2015;07;17;Lauantai;124;125;249;39;44;83
89;04.07.2015;2015;07;18;Lauantai;104;89;193;38;41;79
89;04.07.2015;2015;07;19;Lauantai;80;69;149;20;39;59
89;04.07.2015;2015;07;20;Lauantai;72;71;143;19;20;39
89;04.07.2015;2015;07;21;Lauantai;36;50;86;12;17;29
89;04.07.2015;2015;07;22;Lauantai;48;44;92;7;17;24
89;04.07.2015;2015;07;23;Lauantai;27;46;73;5;15;20
89;05.07.2015;2015;07;00;Sunnuntai;12;73;85;3;27;30
89;05.07.2015;2015;07;01;Sunnuntai;24;44;68;5;10;15
89;05.07.2015;2015;07;02;Sunnuntai;32;29;61;10;14;24
89;05.07.2015;2015;07;03;Sunnuntai;46;3;49;9;4;13
89;05.07.2015;2015;07;04;Sunnuntai;29;9;38;18;1;19
89;05.07.2015;2015;07;05;Sunnuntai;8;7;15;3;2;5
89;05.07.2015;2015;07;06;Sunnuntai;7;17;24;2;4;6
89;05.07.2015;2015;07;07;Sunnuntai;18;6;24;4;10;14
89;05.07.2015;2015;07;08;Sunnuntai;17;10;27;12;21;33
89;05.07.2015;2015;07;09;Sunnuntai;21;53;74;21;21;42
89;05.07.2015;2015;07;10;Sunnuntai;33;75;108;26;60;86
89;05.07.2015;2015;07;11;Sunnuntai;68;137;205;43;80;123
89;05.07.2015;2015;07;12;Sunnuntai;89;164;253;43;71;114
89;05.07.2015;2015;07;13;Sunnuntai;110;154;264;37;75;112
89;05.07.2015;2015;07;14;Sunnuntai;133;156;289;46;45;91
89;05.07.2015;2015;07;15;Sunnuntai;130;138;268;40;50;90
89;05.07.2015;2015;07;16;Sunnuntai;118;133;251;46;62;108
89;05.07.2015;2015;07;17;Sunnuntai;127;104;231;38;56;94
89;05.07.2015;2015;07;18;Sunnuntai;127;116;243;28;41;69
89;05.07.2015;2015;07;19;Sunnuntai;103;81;184;33;54;87
89;05.07.2015;2015;07;20;Sunnuntai;74;67;141;24;39;63
89;05.07.2015;2015;07;21;Sunnuntai;46;49;95;14;15;29
89;05.07.2015;2015;07;22;Sunnuntai;30;21;51;9;13;22
89;05.07.2015;2015;07;23;Sunnuntai;16;13;29;2;5;7
89;06.07.2015;2015;07;00;Maanantai;12;7;19;7;2;9
89;06.07.2015;2015;07;01;Maanantai;7;9;16;0;4;4
89;06.07.2015;2015;07;02;Maanantai;8;3;11;2;1;3
89;06.07.2015;2015;07;03;Maanantai;6;3;9;0;6;6
89;06.07.2015;2015;07;04;Maanantai;6;6;12;1;1;2
89;06.07.2015;2015;07;05;Maanantai;5;28;33;0;4;4
89;06.07.2015;2015;07;06;Maanantai;24;96;120;2;9;11
89;06.07.2015;2015;07;07;Maanantai;40;156;196;4;12;16
89;06.07.2015;2015;07;08;Maanantai;23;149;172;5;24;29
89;06.07.2015;2015;07;09;Maanantai;45;112;157;12;28;40
89;06.07.2015;2015;07;10;Maanantai;49;155;204;16;35;51
89;06.07.2015;2015;07;11;Maanantai;89;145;234;38;46;84
89;06.07.2015;2015;07;12;Maanantai;105;205;310;33;61;94
89;06.07.2015;2015;07;13;Maanantai;124;191;315;49;53;102
89;06.07.2015;2015;07;14;Maanantai;161;161;322;43;68;111
89;06.07.2015;2015;07;15;Maanantai;264;174;438;44;47;91
89;06.07.2015;2015;07;16;Maanantai;223;170;393;49;34;83
89;06.07.2015;2015;07;17;Maanantai;170;167;337;41;47;88
89;06.07.2015;2015;07;18;Maanantai;172;130;302;41;48;89
89;06.07.2015;2015;07;19;Maanantai;142;134;276;62;56;118
89;06.07.2015;2015;07;20;Maanantai;137;94;231;39;37;76
89;06.07.2015;2015;07;21;Maanantai;104;53;157;23;22;45
89;06.07.2015;2015;07;22;Maanantai;59;29;88;10;15;25
89;06.07.2015;2015;07;23;Maanantai;17;24;41;5;3;8
89;07.07.2015;2015;07;00;Tiistai;16;13;29;3;4;7
89;07.07.2015;2015;07;01;Tiistai;8;14;22;2;1;3
89;07.07.2015;2015;07;02;Tiistai;12;6;18;2;0;2
89;07.07.2015;2015;07;03;Tiistai;7;3;10;0;0;0
89;07.07.2015;2015;07;04;Tiistai;2;4;6;0;1;1
89;07.07.2015;2015;07;05;Tiistai;6;19;25;3;1;4
89;07.07.2015;2015;07;06;Tiistai;24;98;122;1;9;10
89;07.07.2015;2015;07;07;Tiistai;54;143;197;2;16;18
89;07.07.2015;2015;07;08;Tiistai;29;147;176;9;30;39
89;07.07.2015;2015;07;09;Tiistai;43;114;157;12;27;39
89;07.07.2015;2015;07;10;Tiistai;57;136;193;24;30;54
89;07.07.2015;2015;07;11;Tiistai;85;144;229;32;34;66
89;07.07.2015;2015;07;12;Tiistai;99;144;243;28;47;75
89;07.07.2015;2015;07;13;Tiistai;107;151;258;20;51;71
89;07.07.2015;2015;07;14;Tiistai;133;143;276;21;37;58
89;07.07.2015;2015;07;15;Tiistai;215;144;359;19;26;45
89;07.07.2015;2015;07;16;Tiistai;243;145;388;31;17;48
89;07.07.2015;2015;07;17;Tiistai;165;126;291;29;25;54
89;07.07.2015;2015;07;18;Tiistai;130;102;232;31;40;71
89;07.07.2015;2015;07;19;Tiistai;113;71;184;31;37;68
89;07.07.2015;2015;07;20;Tiistai;112;68;180;35;33;68
89;07.07.2015;2015;07;21;Tiistai;60;50;110;23;18;41
89;07.07.2015;2015;07;22;Tiistai;40;20;60;11;7;18
89;07.07.2015;2015;07;23;Tiistai;31;9;40;3;4;7
89;08.07.2015;2015;07;00;Keskiviikko;16;11;27;2;2;4
89;08.07.2015;2015;07;01;Keskiviikko;12;5;17;0;3;3
89;08.07.2015;2015;07;02;Keskiviikko;5;4;9;5;1;6
89;08.07.2015;2015;07;03;Keskiviikko;1;5;6;0;0;0
89;08.07.2015;2015;07;04;Keskiviikko;5;7;12;1;1;2
89;08.07.2015;2015;07;05;Keskiviikko;12;21;33;1;1;2
89;08.07.2015;2015;07;06;Keskiviikko;17;92;109;2;5;7
89;08.07.2015;2015;07;07;Keskiviikko;45;133;178;3;11;14
89;08.07.2015;2015;07;08;Keskiviikko;31;148;179;7;25;32
89;08.07.2015;2015;07;09;Keskiviikko;42;105;147;10;19;29
89;08.07.2015;2015;07;10;Keskiviikko;49;94;143;17;36;53
89;08.07.2015;2015;07;11;Keskiviikko;82;119;201;23;36;59
89;08.07.2015;2015;07;12;Keskiviikko;73;143;216;20;29;49
89;08.07.2015;2015;07;13;Keskiviikko;100;127;227;26;39;65
89;08.07.2015;2015;07;14;Keskiviikko;127;125;252;29;38;67
89;08.07.2015;2015;07;15;Keskiviikko;192;140;332;23;29;52
89;08.07.2015;2015;07;16;Keskiviikko;218;150;368;24;42;66
89;08.07.2015;2015;07;17;Keskiviikko;147;151;298;28;38;66
89;08.07.2015;2015;07;18;Keskiviikko;129;128;257;33;52;85
89;08.07.2015;2015;07;19;Keskiviikko;105;116;221;32;45;77
89;08.07.2015;2015;07;20;Keskiviikko;115;89;204;38;31;69
89;08.07.2015;2015;07;21;Keskiviikko;68;49;117;12;26;38
89;08.07.2015;2015;07;22;Keskiviikko;43;34;77;13;12;25
89;08.07.2015;2015;07;23;Keskiviikko;32;27;59;8;10;18
89;09.07.2015;2015;07;00;Torstai;30;25;55;5;2;7
89;09.07.2015;2015;07;01;Torstai;14;4;18;3;1;4
89;09.07.2015;2015;07;02;Torstai;14;4;18;3;1;4
89;09.07.2015;2015;07;03;Torstai;14;3;17;2;0;2
89;09.07.2015;2015;07;04;Torstai;7;9;16;4;1;5
89;09.07.2015;2015;07;05;Torstai;8;14;22;2;1;3
89;09.07.2015;2015;07;06;Torstai;21;60;81;0;5;5
89;09.07.2015;2015;07;07;Torstai;29;103;132;5;16;21
89;09.07.2015;2015;07;08;Torstai;18;104;122;1;21;22
89;09.07.2015;2015;07;09;Torstai;22;64;86;9;21;30
89;09.07.2015;2015;07;10;Torstai;32;65;97;17;22;39
89;09.07.2015;2015;07;11;Torstai;36;50;86;17;20;37
89;09.07.2015;2015;07;12;Torstai;41;47;88;10;9;19
89;09.07.2015;2015;07;13;Torstai;49;40;89;10;15;25
89;09.07.2015;2015;07;14;Torstai;50;56;106;10;10;20
89;09.07.2015;2015;07;15;Torstai;102;68;170;22;19;41
89;09.07.2015;2015;07;16;Torstai;111;52;163;20;22;42
89;09.07.2015;2015;07;17;Torstai;81;68;149;9;16;25
89;09.07.2015;2015;07;18;Torstai;77;60;137;14;32;46
89;09.07.2015;2015;07;19;Torstai;57;64;121;21;36;57
89;09.07.2015;2015;07;20;Torstai;46;50;96;23;35;58
89;09.07.2015;2015;07;21;Torstai;45;41;86;12;16;28
89;09.07.2015;2015;07;22;Torstai;36;15;51;12;12;24
89;09.07.2015;2015;07;23;Torstai;12;12;24;7;2;9
89;10.07.2015;2015;07;00;Perjantai;33;9;42;5;1;6
89;10.07.2015;2015;07;01;Perjantai;17;1;18;2;1;3
89;10.07.2015;2015;07;02;Perjantai;8;2;10;0;0;0
89;10.07.2015;2015;07;03;Perjantai;7;6;13;0;0;0
89;10.07.2015;2015;07;04;Perjantai;8;2;10;1;1;2
89;10.07.2015;2015;07;05;Perjantai;3;10;13;0;0;0
89;10.07.2015;2015;07;06;Perjantai;14;55;69;1;7;8
89;10.07.2015;2015;07;07;Perjantai;30;87;117;1;10;11
89;10.07.2015;2015;07;08;Perjantai;23;123;146;4;21;25
89;10.07.2015;2015;07;09;Perjantai;33;81;114;4;21;25
89;10.07.2015;2015;07;10;Perjantai;23;85;108;9;33;42
89;10.07.2015;2015;07;11;Perjantai;65;89;154;23;42;65
89;10.07.2015;2015;07;12;Perjantai;87;124;211;41;46;87
89;10.07.2015;2015;07;13;Perjantai;92;126;218;50;64;114
89;10.07.2015;2015;07;14;Perjantai;123;101;224;26;23;49
89;10.07.2015;2015;07;15;Perjantai;168;109;277;31;31;62
89;10.07.2015;2015;07;16;Perjantai;149;141;290;28;72;100
89;10.07.2015;2015;07;17;Perjantai;119;128;247;37;34;71
89;10.07.2015;2015;07;18;Perjantai;107;120;227;46;45;91
89;10.07.2015;2015;07;19;Perjantai;85;131;216;39;68;107
89;10.07.2015;2015;07;20;Perjantai;93;95;188;30;57;87
89;10.07.2015;2015;07;21;Perjantai;64;72;136;17;28;45
89;10.07.2015;2015;07;22;Perjantai;39;74;113;8;16;24
89;10.07.2015;2015;07;23;Perjantai;51;38;89;9;7;16
89;11.07.2015;2015;07;00;Lauantai;60;46;106;17;9;26
89;11.07.2015;2015;07;01;Lauantai;55;31;86;15;7;22
89;11.07.2015;2015;07;02;Lauantai;35;12;47;10;2;12
89;11.07.2015;2015;07;03;Lauantai;35;8;43;7;2;9
89;11.07.2015;2015;07;04;Lauantai;34;3;37;7;1;8
89;11.07.2015;2015;07;05;Lauantai;11;10;21;2;4;6
89;11.07.2015;2015;07;06;Lauantai;9;18;27;1;4;5
89;11.07.2015;2015;07;07;Lauantai;14;24;38;10;5;15
89;11.07.2015;2015;07;08;Lauantai;16;40;56;9;14;23
89;11.07.2015;2015;07;09;Lauantai;38;81;119;11;33;44
89;11.07.2015;2015;07;10;Lauantai;44;119;163;16;39;55
89;11.07.2015;2015;07;11;Lauantai;78;139;217;25;55;80
89;11.07.2015;2015;07;12;Lauantai;88;153;241;36;52;88
89;11.07.2015;2015;07;13;Lauantai;107;172;279;46;72;118
89;11.07.2015;2015;07;14;Lauantai;137;170;307;62;78;140
89;11.07.2015;2015;07;15;Lauantai;141;155;296;47;54;101
89;11.07.2015;2015;07;16;Lauantai;152;128;280;50;68;118
89;11.07.2015;2015;07;17;Lauantai;112;116;228;44;69;113
89;11.07.2015;2015;07;18;Lauantai;98;100;198;23;31;54
89;11.07.2015;2015;07;19;Lauantai;83;99;182;26;39;65
89;11.07.2015;2015;07;20;Lauantai;54;101;155;13;24;37
89;11.07.2015;2015;07;21;Lauantai;42;66;108;14;11;25
89;11.07.2015;2015;07;22;Lauantai;44;55;99;10;21;31
89;11.07.2015;2015;07;23;Lauantai;32;35;67;3;14;17
89;12.07.2015;2015;07;00;Sunnuntai;49;10;59;1;5;6
89;12.07.2015;2015;07;01;Sunnuntai;42;21;63;5;3;8
89;12.07.2015;2015;07;02;Sunnuntai;34;12;46;1;2;3
89;12.07.2015;2015;07;03;Sunnuntai;40;7;47;11;2;13
89;12.07.2015;2015;07;04;Sunnuntai;25;4;29;6;0;6
89;12.07.2015;2015;07;05;Sunnuntai;6;4;10;1;2;3
89;12.07.2015;2015;07;06;Sunnuntai;6;14;20;1;2;3
89;12.07.2015;2015;07;07;Sunnuntai;11;9;20;1;3;4
89;12.07.2015;2015;07;08;Sunnuntai;3;23;26;7;6;13
89;12.07.2015;2015;07;09;Sunnuntai;31;47;78;26;30;56
89;12.07.2015;2015;07;10;Sunnuntai;29;56;85;19;64;83
89;12.07.2015;2015;07;11;Sunnuntai;52;86;138;39;58;97
89;12.07.2015;2015;07;12;Sunnuntai;75;154;229;48;62;110
89;12.07.2015;2015;07;13;Sunnuntai;116;194;310;50;94;144
89;12.07.2015;2015;07;14;Sunnuntai;132;196;328;49;104;153
89;12.07.2015;2015;07;15;Sunnuntai;178;148;326;70;79;149
89;12.07.2015;2015;07;16;Sunnuntai;130;144;274;50;74;124
89;12.07.2015;2015;07;17;Sunnuntai;116;121;237;103;132;235
89;12.07.2015;2015;07;18;Sunnuntai;115;110;225;34;86;120
89;12.07.2015;2015;07;19;Sunnuntai;93;78;171;51;60;111
89;12.07.2015;2015;07;20;Sunnuntai;86;72;158;27;51;78
89;12.07.2015;2015;07;21;Sunnuntai;50;34;84;16;24;40
89;12.07.2015;2015;07;22;Sunnuntai;31;16;47;6;8;14
89;12.07.2015;2015;07;23;Sunnuntai;23;20;43;2;7;9
89;13.07.2015;2015;07;00;Maanantai;15;10;25;1;3;4
89;13.07.2015;2015;07;01;Maanantai;14;6;20;3;3;6
89;13.07.2015;2015;07;02;Maanantai;3;4;7;0;1;1
89;13.07.2015;2015;07;03;Maanantai;9;5;14;2;0;2
89;13.07.2015;2015;07;04;Maanantai;9;4;13;4;1;5
89;13.07.2015;2015;07;05;Maanantai;12;19;31;0;1;1
89;13.07.2015;2015;07;06;Maanantai;19;83;102;3;5;8
89;13.07.2015;2015;07;07;Maanantai;28;133;161;4;11;15
89;13.07.2015;2015;07;08;Maanantai;33;133;166;7;21;28
89;13.07.2015;2015;07;09;Maanantai;31;118;149;18;22;40
89;13.07.2015;2015;07;10;Maanantai;62;102;164;18;24;42
89;13.07.2015;2015;07;11;Maanantai;92;124;216;25;43;68
89;13.07.2015;2015;07;12;Maanantai;81;158;239;25;42;67
89;13.07.2015;2015;07;13;Maanantai;119;132;251;27;64;91
89;13.07.2015;2015;07;14;Maanantai;163;144;307;33;42;75
89;13.07.2015;2015;07;15;Maanantai;223;140;363;19;27;46
89;13.07.2015;2015;07;16;Maanantai;205;148;353;30;29;59
89;13.07.2015;2015;07;17;Maanantai;191;113;304;29;58;87
89;13.07.2015;2015;07;18;Maanantai;143;132;275;42;44;86
89;13.07.2015;2015;07;19;Maanantai;152;93;245;41;50;91
89;13.07.2015;2015;07;20;Maanantai;124;84;208;36;55;91
89;13.07.2015;2015;07;21;Maanantai;78;47;125;20;21;41
89;13.07.2015;2015;07;22;Maanantai;38;28;66;4;14;18
89;13.07.2015;2015;07;23;Maanantai;16;19;35;1;9;10
89;14.07.2015;2015;07;00;Tiistai;18;16;34;3;6;9
89;14.07.2015;2015;07;01;Tiistai;8;4;12;3;1;4
89;14.07.2015;2015;07;02;Tiistai;9;1;10;0;2;2
89;14.07.2015;2015;07;03;Tiistai;5;4;9;0;0;0
89;14.07.2015;2015;07;04;Tiistai;4;4;8;1;1;2
89;14.07.2015;2015;07;05;Tiistai;11;14;25;0;1;1
89;14.07.2015;2015;07;06;Tiistai;26;104;130;4;4;8
89;14.07.2015;2015;07;07;Tiistai;37;136;173;3;6;9
89;14.07.2015;2015;07;08;Tiistai;39;114;153;8;22;30
89;14.07.2015;2015;07;09;Tiistai;28;115;143;7;34;41
89;14.07.2015;2015;07;10;Tiistai;63;101;164;23;29;52
89;14.07.2015;2015;07;11;Tiistai;81;139;220;21;28;49
89;14.07.2015;2015;07;12;Tiistai;91;151;242;27;46;73
89;14.07.2015;2015;07;13;Tiistai;96;158;254;21;40;61
89;14.07.2015;2015;07;14;Tiistai;133;114;247;29;39;68
89;14.07.2015;2015;07;15;Tiistai;229;134;363;31;51;82
89;14.07.2015;2015;07;16;Tiistai;230;131;361;38;28;66
89;14.07.2015;2015;07;17;Tiistai;150;152;302;44;58;102
89;14.07.2015;2015;07;18;Tiistai;127;153;280;46;40;86
89;14.07.2015;2015;07;19;Tiistai;139;79;218;20;47;67
89;14.07.2015;2015;07;20;Tiistai;109;70;179;46;35;81
89;14.07.2015;2015;07;21;Tiistai;63;39;102;17;15;32
89;14.07.2015;2015;07;22;Tiistai;31;15;46;7;13;20
89;14.07.2015;2015;07;23;Tiistai;18;17;35;1;9;10
89;15.07.2015;2015;07;00;Keskiviikko;12;8;20;6;4;10
89;15.07.2015;2015;07;01;Keskiviikko;9;3;12;2;0;2
89;15.07.2015;2015;07;02;Keskiviikko;4;0;4;3;0;3
89;15.07.2015;2015;07;03;Keskiviikko;4;3;7;2;0;2
89;15.07.2015;2015;07;04;Keskiviikko;1;5;6;1;2;3
89;15.07.2015;2015;07;05;Keskiviikko;14;18;32;0;0;0
89;15.07.2015;2015;07;06;Keskiviikko;23;98;121;2;4;6
89;15.07.2015;2015;07;07;Keskiviikko;31;147;178;6;6;12
89;15.07.2015;2015;07;08;Keskiviikko;31;121;152;6;19;25
89;15.07.2015;2015;07;09;Keskiviikko;35;127;162;11;17;28
89;15.07.2015;2015;07;10;Keskiviikko;59;105;164;16;28;44
89;15.07.2015;2015;07;11;Keskiviikko;85;148;233;13;37;50
89;15.07.2015;2015;07;12;Keskiviikko;75;154;229;37;40;77
89;15.07.2015;2015;07;13;Keskiviikko;125;141;266;29;29;58
89;15.07.2015;2015;07;14;Keskiviikko;151;129;280;30;50;80
89;15.07.2015;2015;07;15;Keskiviikko;220;149;369;38;38;76
89;15.07.2015;2015;07;16;Keskiviikko;202;156;358;30;34;64
89;15.07.2015;2015;07;17;Keskiviikko;163;178;341;35;53;88
89;15.07.2015;2015;07;18;Keskiviikko;156;170;326;39;90;129
89;15.07.2015;2015;07;19;Keskiviikko;128;116;244;52;51;103
89;15.07.2015;2015;07;20;Keskiviikko;160;115;275;51;66;117
89;15.07.2015;2015;07;21;Keskiviikko;94;81;175;27;26;53
89;15.07.2015;2015;07;22;Keskiviikko;38;32;70;9;11;20
89;15.07.2015;2015;07;23;Keskiviikko;33;38;71;10;7;17
89;16.07.2015;2015;07;00;Torstai;15;19;34;2;6;8
89;16.07.2015;2015;07;01;Torstai;17;8;25;2;2;4
89;16.07.2015;2015;07;02;Torstai;15;6;21;3;3;6
89;16.07.2015;2015;07;03;Torstai;13;4;17;1;1;2
89;16.07.2015;2015;07;04;Torstai;7;9;16;1;1;2
89;16.07.2015;2015;07;05;Torstai;15;11;26;0;1;1
89;16.07.2015;2015;07;06;Torstai;18;82;100;3;5;8
89;16.07.2015;2015;07;07;Torstai;24;99;123;3;7;10
89;16.07.2015;2015;07;08;Torstai;32;83;115;7;18;25
89;16.07.2015;2015;07;09;Torstai;40;91;131;6;17;23
89;16.07.2015;2015;07;10;Torstai;48;93;141;8;28;36
89;16.07.2015;2015;07;11;Torstai;59;86;145;14;31;45
89;16.07.2015;2015;07;12;Torstai;75;105;180;21;36;57
89;16.07.2015;2015;07;13;Torstai;94;146;240;21;45;66
89;16.07.2015;2015;07;14;Torstai;100;122;222;34;52;86
89;16.07.2015;2015;07;15;Torstai;191;160;351;52;72;124
89;16.07.2015;2015;07;16;Torstai;186;156;342;48;49;97
89;16.07.2015;2015;07;17;Torstai;176;131;307;47;48;95
89;16.07.2015;2015;07;18;Torstai;120;132;252;53;77;130
89;16.07.2015;2015;07;19;Torstai;106;105;211;30;64;94
89;16.07.2015;2015;07;20;Torstai;142;103;245;44;72;116
89;16.07.2015;2015;07;21;Torstai;76;62;138;13;35;48
89;16.07.2015;2015;07;22;Torstai;64;62;126;55;43;98
89;16.07.2015;2015;07;23;Torstai;43;28;71;19;17;36
89;17.07.2015;2015;07;00;Perjantai;24;12;36;1;3;4
89;17.07.2015;2015;07;01;Perjantai;13;9;22;0;1;1
89;17.07.2015;2015;07;02;Perjantai;4;3;7;1;4;5
89;17.07.2015;2015;07;03;Perjantai;4;5;9;2;0;2
89;17.07.2015;2015;07;04;Perjantai;7;7;14;1;1;2
89;17.07.2015;2015;07;05;Perjantai;11;14;25;0;0;0
89;17.07.2015;2015;07;06;Perjantai;22;95;117;3;6;9
89;17.07.2015;2015;07;07;Perjantai;31;102;133;8;7;15
89;17.07.2015;2015;07;08;Perjantai;38;111;149;6;12;18
89;17.07.2015;2015;07;09;Perjantai;35;127;162;6;20;26
89;17.07.2015;2015;07;10;Perjantai;58;149;207;13;39;52
89;17.07.2015;2015;07;11;Perjantai;104;184;288;21;64;85
89;17.07.2015;2015;07;12;Perjantai;109;182;291;28;57;85
89;17.07.2015;2015;07;13;Perjantai;178;145;323;26;43;69
89;17.07.2015;2015;07;14;Perjantai;202;162;364;33;63;96
89;17.07.2015;2015;07;15;Perjantai;211;187;398;36;55;91
89;17.07.2015;2015;07;16;Perjantai;220;161;381;45;49;94
89;17.07.2015;2015;07;17;Perjantai;172;178;350;37;50;87
89;17.07.2015;2015;07;18;Perjantai;181;163;344;34;57;91
89;17.07.2015;2015;07;19;Perjantai;147;131;278;47;66;113
89;17.07.2015;2015;07;20;Perjantai;115;151;266;47;38;85
89;17.07.2015;2015;07;21;Perjantai;95;112;207;22;54;76
89;17.07.2015;2015;07;22;Perjantai;63;86;149;10;18;28
89;17.07.2015;2015;07;23;Perjantai;41;73;114;6;30;36
89;18.07.2015;2015;07;00;Lauantai;27;57;84;7;18;25
89;18.07.2015;2015;07;01;Lauantai;26;39;65;8;18;26
89;18.07.2015;2015;07;02;Lauantai;43;16;59;6;6;12
89;18.07.2015;2015;07;03;Lauantai;36;12;48;9;2;11
89;18.07.2015;2015;07;04;Lauantai;27;12;39;5;1;6
89;18.07.2015;2015;07;05;Lauantai;14;12;26;4;1;5
89;18.07.2015;2015;07;06;Lauantai;8;28;36;0;3;3
89;18.07.2015;2015;07;07;Lauantai;15;19;34;3;6;9
89;18.07.2015;2015;07;08;Lauantai;17;44;61;8;18;26
89;18.07.2015;2015;07;09;Lauantai;37;74;111;18;29;47
89;18.07.2015;2015;07;10;Lauantai;62;186;248;18;36;54
89;18.07.2015;2015;07;11;Lauantai;80;191;271;33;48;81
89;18.07.2015;2015;07;12;Lauantai;128;225;353;42;72;114
89;18.07.2015;2015;07;13;Lauantai;203;204;407;49;60;109
89;18.07.2015;2015;07;14;Lauantai;215;206;421;56;68;124
89;18.07.2015;2015;07;15;Lauantai;201;234;435;42;58;100
89;18.07.2015;2015;07;16;Lauantai;167;183;350;44;47;91
89;18.07.2015;2015;07;17;Lauantai;157;145;302;45;74;119
89;18.07.2015;2015;07;18;Lauantai;167;149;316;53;68;121
89;18.07.2015;2015;07;19;Lauantai;190;144;334;51;59;110
89;18.07.2015;2015;07;20;Lauantai;111;122;233;22;46;68
89;18.07.2015;2015;07;21;Lauantai;74;77;151;17;24;41
89;18.07.2015;2015;07;22;Lauantai;62;61;123;8;14;22
89;18.07.2015;2015;07;23;Lauantai;26;44;70;6;15;21
89;19.07.2015;2015;07;00;Sunnuntai;28;69;97;3;21;24
89;19.07.2015;2015;07;01;Sunnuntai;33;24;57;4;10;14
89;19.07.2015;2015;07;02;Sunnuntai;33;18;51;3;1;4
89;19.07.2015;2015;07;03;Sunnuntai;37;7;44;7;1;8
89;19.07.2015;2015;07;04;Sunnuntai;26;8;34;6;1;7
89;19.07.2015;2015;07;05;Sunnuntai;7;11;18;3;3;6
89;19.07.2015;2015;07;06;Sunnuntai;11;13;24;2;2;4
89;19.07.2015;2015;07;07;Sunnuntai;9;6;15;3;4;7
89;19.07.2015;2015;07;08;Sunnuntai;12;21;33;10;13;23
89;19.07.2015;2015;07;09;Sunnuntai;17;26;43;24;18;42
89;19.07.2015;2015;07;10;Sunnuntai;21;39;60;20;32;52
89;19.07.2015;2015;07;11;Sunnuntai;44;39;83;17;21;38
89;19.07.2015;2015;07;12;Sunnuntai;32;66;98;15;18;33
89;19.07.2015;2015;07;13;Sunnuntai;43;84;127;16;23;39
89;19.07.2015;2015;07;14;Sunnuntai;76;75;151;24;40;64
89;19.07.2015;2015;07;15;Sunnuntai;73;53;126;21;27;48
89;19.07.2015;2015;07;16;Sunnuntai;65;81;146;21;23;44
89;19.07.2015;2015;07;17;Sunnuntai;71;101;172;23;55;78
89;19.07.2015;2015;07;18;Sunnuntai;100;85;185;25;45;70
89;19.07.2015;2015;07;19;Sunnuntai;113;90;203;33;63;96
89;19.07.2015;2015;07;20;Sunnuntai;98;76;174;47;37;84
89;19.07.2015;2015;07;21;Sunnuntai;62;64;126;22;28;50
89;19.07.2015;2015;07;22;Sunnuntai;40;31;71;11;11;22
89;19.07.2015;2015;07;23;Sunnuntai;16;13;29;6;8;14
89;20.07.2015;2015;07;00;Maanantai;12;16;28;2;1;3
89;20.07.2015;2015;07;01;Maanantai;9;4;13;2;1;3
89;20.07.2015;2015;07;02;Maanantai;2;5;7;1;0;1
89;20.07.2015;2015;07;03;Maanantai;3;3;6;1;0;1
89;20.07.2015;2015;07;04;Maanantai;9;5;14;7;2;9
89;20.07.2015;2015;07;05;Maanantai;13;19;32;1;0;1
89;20.07.2015;2015;07;06;Maanantai;21;97;118;4;10;14
89;20.07.2015;2015;07;07;Maanantai;40;139;179;2;6;8
89;20.07.2015;2015;07;08;Maanantai;32;129;161;6;19;25
89;20.07.2015;2015;07;09;Maanantai;40;129;169;13;38;51
89;20.07.2015;2015;07;10;Maanantai;76;154;230;26;41;67
89;20.07.2015;2015;07;11;Maanantai;112;196;308;30;36;66
89;20.07.2015;2015;07;12;Maanantai;157;190;347;27;37;64
89;20.07.2015;2015;07;13;Maanantai;185;253;438;28;61;89
89;20.07.2015;2015;07;14;Maanantai;187;194;381;47;73;120
89;20.07.2015;2015;07;15;Maanantai;239;205;444;50;49;99
89;20.07.2015;2015;07;16;Maanantai;258;194;452;42;39;81
89;20.07.2015;2015;07;17;Maanantai;223;170;393;49;39;88
89;20.07.2015;2015;07;18;Maanantai;177;139;316;47;47;94
89;20.07.2015;2015;07;19;Maanantai;162;105;267;33;52;85
89;20.07.2015;2015;07;20;Maanantai;146;85;231;21;24;45
89;20.07.2015;2015;07;21;Maanantai;82;47;129;20;12;32
89;20.07.2015;2015;07;22;Maanantai;49;40;89;6;8;14
89;20.07.2015;2015;07;23;Maanantai;21;20;41;1;3;4
89;21.07.2015;2015;07;00;Tiistai;8;8;16;6;11;17
89;21.07.2015;2015;07;01;Tiistai;5;4;9;4;6;10
89;21.07.2015;2015;07;02;Tiistai;13;3;16;3;0;3
89;21.07.2015;2015;07;03;Tiistai;8;3;11;2;1;3
89;21.07.2015;2015;07;04;Tiistai;5;6;11;1;3;4
89;21.07.2015;2015;07;05;Tiistai;10;14;24;1;0;1
89;21.07.2015;2015;07;06;Tiistai;22;92;114;2;7;9
89;21.07.2015;2015;07;07;Tiistai;37;121;158;3;12;15
89;21.07.2015;2015;07;08;Tiistai;25;121;146;7;30;37
89;21.07.2015;2015;07;09;Tiistai;28;85;113;9;18;27
89;21.07.2015;2015;07;10;Tiistai;48;109;157;18;44;62
89;21.07.2015;2015;07;11;Tiistai;77;108;185;24;28;52
89;21.07.2015;2015;07;12;Tiistai;89;149;238;19;45;64
89;21.07.2015;2015;07;13;Tiistai;117;149;266;14;33;47
89;21.07.2015;2015;07;14;Tiistai;137;171;308;35;41;76
89;21.07.2015;2015;07;15;Tiistai;223;143;366;35;37;72
89;21.07.2015;2015;07;16;Tiistai;221;160;381;35;22;57
89;21.07.2015;2015;07;17;Tiistai;173;102;275;25;33;58
89;21.07.2015;2015;07;18;Tiistai;133;132;265;29;47;76
89;21.07.2015;2015;07;19;Tiistai;133;147;280;40;38;78
89;21.07.2015;2015;07;20;Tiistai;135;111;246;35;31;66
89;21.07.2015;2015;07;21;Tiistai;73;65;138;18;27;45
89;21.07.2015;2015;07;22;Tiistai;33;38;71;10;11;21
89;21.07.2015;2015;07;23;Tiistai;23;12;35;7;0;7
89;22.07.2015;2015;07;00;Keskiviikko;13;4;17;2;2;4
89;22.07.2015;2015;07;01;Keskiviikko;14;8;22;1;2;3
89;22.07.2015;2015;07;02;Keskiviikko;6;3;9;2;2;4
89;22.07.2015;2015;07;03;Keskiviikko;4;4;8;1;1;2
89;22.07.2015;2015;07;04;Keskiviikko;7;4;11;2;1;3
89;22.07.2015;2015;07;05;Keskiviikko;13;20;33;1;3;4
89;22.07.2015;2015;07;06;Keskiviikko;18;96;114;4;8;12
89;22.07.2015;2015;07;07;Keskiviikko;42;135;177;4;12;16
89;22.07.2015;2015;07;08;Keskiviikko;42;135;177;5;21;26
89;22.07.2015;2015;07;09;Keskiviikko;48;118;166;14;19;33
89;22.07.2015;2015;07;10;Keskiviikko;45;136;181;16;28;44
89;22.07.2015;2015;07;11;Keskiviikko;99;145;244;26;37;63
89;22.07.2015;2015;07;12;Keskiviikko;126;196;322;28;44;72
89;22.07.2015;2015;07;13;Keskiviikko;142;177;319;50;47;97
89;22.07.2015;2015;07;14;Keskiviikko;196;157;353;43;47;90
89;22.07.2015;2015;07;15;Keskiviikko;222;219;441;32;61;93
89;22.07.2015;2015;07;16;Keskiviikko;233;178;411;55;63;118
89;22.07.2015;2015;07;17;Keskiviikko;208;204;412;36;45;81
89;22.07.2015;2015;07;18;Keskiviikko;216;212;428;41;52;93
89;22.07.2015;2015;07;19;Keskiviikko;143;123;266;42;43;85
89;22.07.2015;2015;07;20;Keskiviikko;199;108;307;50;37;87
89;22.07.2015;2015;07;21;Keskiviikko;102;83;185;23;39;62
89;22.07.2015;2015;07;22;Keskiviikko;69;69;138;17;21;38
89;22.07.2015;2015;07;23;Keskiviikko;42;15;57;3;8;11
89;23.07.2015;2015;07;00;Torstai;29;23;52;2;2;4
89;23.07.2015;2015;07;01;Torstai;13;8;21;3;2;5
89;23.07.2015;2015;07;02;Torstai;7;8;15;3;1;4
89;23.07.2015;2015;07;03;Torstai;12;6;18;1;0;1
89;23.07.2015;2015;07;04;Torstai;10;5;15;1;2;3
89;23.07.2015;2015;07;05;Torstai;12;19;31;2;0;2
89;23.07.2015;2015;07;06;Torstai;18;96;114;2;7;9
89;23.07.2015;2015;07;07;Torstai;43;135;178;5;11;16
89;23.07.2015;2015;07;08;Torstai;39;120;159;11;30;41
89;23.07.2015;2015;07;09;Torstai;45;135;180;12;40;52
89;23.07.2015;2015;07;10;Torstai;76;163;239;12;40;52
89;23.07.2015;2015;07;11;Torstai;107;192;299;31;53;84
89;23.07.2015;2015;07;12;Torstai;143;222;365;26;44;70
89;23.07.2015;2015;07;13;Torstai;199;242;441;41;40;81
89;23.07.2015;2015;07;14;Torstai;167;154;321;19;44;63
89;23.07.2015;2015;07;15;Torstai;222;170;392;31;46;77
89;23.07.2015;2015;07;16;Torstai;289;200;489;51;55;106
89;23.07.2015;2015;07;17;Torstai;232;157;389;38;52;90
89;23.07.2015;2015;07;18;Torstai;136;109;245;29;46;75
89;23.07.2015;2015;07;19;Torstai;77;78;155;24;24;48
89;23.07.2015;2015;07;20;Torstai;110;69;179;25;19;44
89;23.07.2015;2015;07;21;Torstai;76;64;140;20;15;35
89;23.07.2015;2015;07;22;Torstai;49;22;71;12;16;28
89;23.07.2015;2015;07;23;Torstai;34;18;52;6;8;14
89;24.07.2015;2015;07;00;Perjantai;26;12;38;8;4;12
89;24.07.2015;2015;07;01;Perjantai;12;5;17;1;1;2
89;24.07.2015;2015;07;02;Perjantai;7;2;9;0;3;3
89;24.07.2015;2015;07;03;Perjantai;5;4;9;1;1;2
89;24.07.2015;2015;07;04;Perjantai;7;6;13;0;2;2
89;24.07.2015;2015;07;05;Perjantai;14;17;31;0;2;2
89;24.07.2015;2015;07;06;Perjantai;14;85;99;5;3;8
89;24.07.2015;2015;07;07;Perjantai;36;114;150;4;5;9
89;24.07.2015;2015;07;08;Perjantai;28;106;134;9;18;27
89;24.07.2015;2015;07;09;Perjantai;31;75;106;7;23;30
89;24.07.2015;2015;07;10;Perjantai;51;74;125;22;21;43
89;24.07.2015;2015;07;11;Perjantai;63;89;152;16;27;43
89;24.07.2015;2015;07;12;Perjantai;42;83;125;14;24;38
89;24.07.2015;2015;07;13;Perjantai;92;65;157;13;18;31
89;24.07.2015;2015;07;14;Perjantai;90;86;176;14;17;31
89;24.07.2015;2015;07;15;Perjantai;134;173;307;13;35;48
89;24.07.2015;2015;07;16;Perjantai;136;201;337;20;29;49
89;24.07.2015;2015;07;17;Perjantai;114;150;264;20;44;64
89;24.07.2015;2015;07;18;Perjantai;134;138;272;22;41;63
89;24.07.2015;2015;07;19;Perjantai;80;122;202;28;29;57
89;24.07.2015;2015;07;20;Perjantai;93;137;230;17;27;44
89;24.07.2015;2015;07;21;Perjantai;65;113;178;20;23;43
89;24.07.2015;2015;07;22;Perjantai;47;42;89;12;13;25
89;24.07.2015;2015;07;23;Perjantai;86;57;143;11;15;26
89;25.07.2015;2015;07;00;Lauantai;86;32;118;15;9;24
89;25.07.2015;2015;07;01;Lauantai;84;22;106;24;7;31
89;25.07.2015;2015;07;02;Lauantai;49;14;63;30;2;32
89;25.07.2015;2015;07;03;Lauantai;50;5;55;16;2;18
89;25.07.2015;2015;07;04;Lauantai;34;6;40;12;1;13
89;25.07.2015;2015;07;05;Lauantai;13;7;20;4;4;8
89;25.07.2015;2015;07;06;Lauantai;8;27;35;4;2;6
89;25.07.2015;2015;07;07;Lauantai;13;23;36;3;5;8
89;25.07.2015;2015;07;08;Lauantai;20;41;61;7;12;19
89;25.07.2015;2015;07;09;Lauantai;26;57;83;10;22;32
89;25.07.2015;2015;07;10;Lauantai;37;67;104;16;30;46
89;25.07.2015;2015;07;11;Lauantai;58;64;122;17;22;39
89;25.07.2015;2015;07;12;Lauantai;87;177;264;20;57;77
89;25.07.2015;2015;07;13;Lauantai;91;228;319;25;58;83
89;25.07.2015;2015;07;14;Lauantai;134;295;429;31;70;101
89;25.07.2015;2015;07;15;Lauantai;180;188;368;40;52;92
89;25.07.2015;2015;07;16;Lauantai;143;194;337;41;41;82
89;25.07.2015;2015;07;17;Lauantai;180;206;386;46;57;103
89;25.07.2015;2015;07;18;Lauantai;152;182;334;42;54;96
89;25.07.2015;2015;07;19;Lauantai;143;173;316;25;44;69
89;25.07.2015;2015;07;20;Lauantai;84;157;241;19;36;55
89;25.07.2015;2015;07;21;Lauantai;75;137;212;24;35;59
89;25.07.2015;2015;07;22;Lauantai;69;96;165;6;17;23
89;25.07.2015;2015;07;23;Lauantai;79;43;122;8;15;23
89;26.07.2015;2015;07;00;Sunnuntai;140;44;184;16;11;27
89;26.07.2015;2015;07;01;Sunnuntai;128;32;160;22;9;31
89;26.07.2015;2015;07;02;Sunnuntai;96;5;101;36;4;40
89;26.07.2015;2015;07;03;Sunnuntai;72;9;81;29;4;33
89;26.07.2015;2015;07;04;Sunnuntai;46;3;49;18;1;19
89;26.07.2015;2015;07;05;Sunnuntai;18;7;25;9;0;9
89;26.07.2015;2015;07;06;Sunnuntai;6;13;19;5;2;7
89;26.07.2015;2015;07;07;Sunnuntai;10;9;19;4;8;12
89;26.07.2015;2015;07;08;Sunnuntai;13;25;38;11;8;19
89;26.07.2015;2015;07;09;Sunnuntai;32;36;68;12;25;37
89;26.07.2015;2015;07;10;Sunnuntai;34;77;111;16;30;46
89;26.07.2015;2015;07;11;Sunnuntai;57;92;149;34;55;89
89;26.07.2015;2015;07;12;Sunnuntai;60;99;159;26;55;81
89;26.07.2015;2015;07;13;Sunnuntai;88;104;192;46;58;104
89;26.07.2015;2015;07;14;Sunnuntai;74;89;163;19;46;65
89;26.07.2015;2015;07;15;Sunnuntai;112;87;199;39;59;98
89;26.07.2015;2015;07;16;Sunnuntai;78;80;158;30;59;89
89;26.07.2015;2015;07;17;Sunnuntai;73;79;152;24;40;64
89;26.07.2015;2015;07;18;Sunnuntai;82;75;157;32;49;81
89;26.07.2015;2015;07;19;Sunnuntai;63;58;121;20;36;56
89;26.07.2015;2015;07;20;Sunnuntai;45;37;82;23;18;41
89;26.07.2015;2015;07;21;Sunnuntai;33;9;42;7;6;13
89;26.07.2015;2015;07;22;Sunnuntai;25;7;32;3;3;6
89;26.07.2015;2015;07;23;Sunnuntai;4;7;11;3;1;4
89;27.07.2015;2015;07;00;Maanantai;10;2;12;1;1;2
89;27.07.2015;2015;07;01;Maanantai;2;0;2;0;1;1
89;27.07.2015;2015;07;02;Maanantai;1;1;2;0;0;0
89;27.07.2015;2015;07;03;Maanantai;0;5;5;0;0;0
89;27.07.2015;2015;07;04;Maanantai;5;5;10;1;2;3
89;27.07.2015;2015;07;05;Maanantai;8;17;25;0;0;0
89;27.07.2015;2015;07;06;Maanantai;17;72;89;0;9;9
89;27.07.2015;2015;07;07;Maanantai;29;100;129;4;9;13
89;27.07.2015;2015;07;08;Maanantai;20;124;144;5;17;22
89;27.07.2015;2015;07;09;Maanantai;35;81;116;4;32;36
89;27.07.2015;2015;07;10;Maanantai;41;64;105;18;29;47
89;27.07.2015;2015;07;11;Maanantai;55;79;134;22;31;53
89;27.07.2015;2015;07;12;Maanantai;72;105;177;16;27;43
89;27.07.2015;2015;07;13;Maanantai;90;97;187;22;26;48
89;27.07.2015;2015;07;14;Maanantai;105;104;209;18;27;45
89;27.07.2015;2015;07;15;Maanantai;197;133;330;17;20;37
89;27.07.2015;2015;07;16;Maanantai;167;129;296;38;38;76
89;27.07.2015;2015;07;17;Maanantai;143;100;243;38;31;69
89;27.07.2015;2015;07;18;Maanantai;121;86;207;36;41;77
89;27.07.2015;2015;07;19;Maanantai;91;76;167;28;34;62
89;27.07.2015;2015;07;20;Maanantai;77;60;137;22;29;51
89;27.07.2015;2015;07;21;Maanantai;58;32;90;12;21;33
89;27.07.2015;2015;07;22;Maanantai;30;15;45;7;7;14
89;27.07.2015;2015;07;23;Maanantai;26;18;44;6;7;13
89;28.07.2015;2015;07;00;Tiistai;5;4;9;4;4;8
89;28.07.2015;2015;07;01;Tiistai;3;6;9;0;2;2
89;28.07.2015;2015;07;02;Tiistai;4;3;7;3;1;4
89;28.07.2015;2015;07;03;Tiistai;5;1;6;3;1;4
89;28.07.2015;2015;07;04;Tiistai;6;5;11;1;2;3
89;28.07.2015;2015;07;05;Tiistai;9;26;35;1;2;3
89;28.07.2015;2015;07;06;Tiistai;26;89;115;2;10;12
89;28.07.2015;2015;07;07;Tiistai;37;157;194;7;15;22
89;28.07.2015;2015;07;08;Tiistai;34;144;178;4;23;27
89;28.07.2015;2015;07;09;Tiistai;31;107;138;14;26;40
89;28.07.2015;2015;07;10;Tiistai;55;143;198;20;39;59
89;28.07.2015;2015;07;11;Tiistai;69;140;209;30;49;79
89;28.07.2015;2015;07;12;Tiistai;102;153;255;30;55;85
89;28.07.2015;2015;07;13;Tiistai;128;162;290;23;37;60
89;28.07.2015;2015;07;14;Tiistai;149;140;289;29;49;78
89;28.07.2015;2015;07;15;Tiistai;224;181;405;36;42;78
89;28.07.2015;2015;07;16;Tiistai;224;205;429;28;51;79
89;28.07.2015;2015;07;17;Tiistai;193;141;334;58;55;113
89;28.07.2015;2015;07;18;Tiistai;170;109;279;28;52;80
89;28.07.2015;2015;07;19;Tiistai;162;109;271;33;66;99
89;28.07.2015;2015;07;20;Tiistai;120;68;188;28;51;79
89;28.07.2015;2015;07;21;Tiistai;77;48;125;30;20;50
89;28.07.2015;2015;07;22;Tiistai;72;32;104;14;12;26
89;28.07.2015;2015;07;23;Tiistai;23;20;43;5;6;11
89;29.07.2015;2015;07;00;Keskiviikko;14;7;21;1;2;3
89;29.07.2015;2015;07;01;Keskiviikko;6;8;14;4;6;10
89;29.07.2015;2015;07;02;Keskiviikko;6;1;7;2;2;4
89;29.07.2015;2015;07;03;Keskiviikko;7;2;9;1;0;1
89;29.07.2015;2015;07;04;Keskiviikko;2;4;6;2;2;4
89;29.07.2015;2015;07;05;Keskiviikko;6;23;29;0;3;3
89;29.07.2015;2015;07;06;Keskiviikko;28;103;131;4;8;12
89;29.07.2015;2015;07;07;Keskiviikko;41;172;213;4;22;26
89;29.07.2015;2015;07;08;Keskiviikko;38;141;179;6;22;28
89;29.07.2015;2015;07;09;Keskiviikko;37;107;144;9;18;27
89;29.07.2015;2015;07;10;Keskiviikko;71;149;220;13;41;54
89;29.07.2015;2015;07;11;Keskiviikko;139;167;306;23;43;66
89;29.07.2015;2015;07;12;Keskiviikko;122;168;290;27;40;67
89;29.07.2015;2015;07;13;Keskiviikko;171;166;337;33;44;77
89;29.07.2015;2015;07;14;Keskiviikko;167;131;298;24;36;60
89;29.07.2015;2015;07;15;Keskiviikko;234;138;372;29;42;71
89;29.07.2015;2015;07;16;Keskiviikko;213;147;360;31;33;64
89;29.07.2015;2015;07;17;Keskiviikko;140;92;232;17;20;37
89;29.07.2015;2015;07;18;Keskiviikko;112;60;172;18;9;27
89;29.07.2015;2015;07;19;Keskiviikko;74;47;121;21;22;43
89;29.07.2015;2015;07;20;Keskiviikko;53;39;92;12;19;31
89;29.07.2015;2015;07;21;Keskiviikko;28;41;69;8;8;16
89;29.07.2015;2015;07;22;Keskiviikko;46;12;58;5;2;7
89;29.07.2015;2015;07;23;Keskiviikko;19;8;27;5;5;10
89;30.07.2015;2015;07;00;Torstai;15;7;22;1;1;2
89;30.07.2015;2015;07;01;Torstai;5;0;5;0;1;1
89;30.07.2015;2015;07;02;Torstai;3;2;5;1;2;3
89;30.07.2015;2015;07;03;Torstai;5;4;9;3;1;4
89;30.07.2015;2015;07;04;Torstai;7;3;10;3;2;5
89;30.07.2015;2015;07;05;Torstai;6;23;29;1;1;2
89;30.07.2015;2015;07;06;Torstai;23;88;111;2;11;13
89;30.07.2015;2015;07;07;Torstai;33;111;144;4;15;19
89;30.07.2015;2015;07;08;Torstai;37;151;188;6;19;25
89;30.07.2015;2015;07;09;Torstai;32;101;133;10;18;28
89;30.07.2015;2015;07;10;Torstai;59;108;167;11;25;36
89;30.07.2015;2015;07;11;Torstai;89;155;244;28;30;58
89;30.07.2015;2015;07;12;Torstai;126;160;286;29;48;77
89;30.07.2015;2015;07;13;Torstai;149;195;344;28;44;72
89;30.07.2015;2015;07;14;Torstai;147;157;304;35;46;81
89;30.07.2015;2015;07;15;Torstai;238;187;425;45;59;104
89;30.07.2015;2015;07;16;Torstai;250;185;435;31;46;77
89;30.07.2015;2015;07;17;Torstai;205;166;371;43;34;77
89;30.07.2015;2015;07;18;Torstai;192;176;368;49;57;106
89;30.07.2015;2015;07;19;Torstai;181;171;352;39;62;101
89;30.07.2015;2015;07;20;Torstai;130;109;239;35;27;62
89;30.07.2015;2015;07;21;Torstai;90;87;177;19;40;59
89;30.07.2015;2015;07;22;Torstai;95;47;142;14;19;33
89;30.07.2015;2015;07;23;Torstai;56;27;83;18;15;33
89;31.07.2015;2015;07;00;Perjantai;25;10;35;5;10;15
89;31.07.2015;2015;07;01;Perjantai;14;6;20;10;6;16
89;31.07.2015;2015;07;02;Perjantai;9;5;14;3;4;7
89;31.07.2015;2015;07;03;Perjantai;8;5;13;2;2;4
89;31.07.2015;2015;07;04;Perjantai;18;3;21;0;1;1
89;31.07.2015;2015;07;05;Perjantai;5;26;31;0;2;2
89;31.07.2015;2015;07;06;Perjantai;23;84;107;3;7;10
89;31.07.2015;2015;07;07;Perjantai;30;123;153;7;13;20
89;31.07.2015;2015;07;08;Perjantai;50;129;179;9;19;28
89;31.07.2015;2015;07;09;Perjantai;58;123;181;14;38;52
89;31.07.2015;2015;07;10;Perjantai;45;160;205;14;35;49
89;31.07.2015;2015;07;11;Perjantai;98;168;266;11;36;47
89;31.07.2015;2015;07;12;Perjantai;139;133;272;34;32;66
89;31.07.2015;2015;07;13;Perjantai;126;131;257;23;30;53
89;31.07.2015;2015;07;14;Perjantai;154;107;261;30;44;74
89;31.07.2015;2015;07;15;Perjantai;176;139;315;16;49;65
89;31.07.2015;2015;07;16;Perjantai;170;142;312;29;37;66
89;31.07.2015;2015;07;17;Perjantai;164;163;327;35;38;73
89;31.07.2015;2015;07;18;Perjantai;140;129;269;28;37;65
89;31.07.2015;2015;07;19;Perjantai;122;114;236;38;38;76
89;31.07.2015;2015;07;20;Perjantai;109;105;214;28;27;55
89;31.07.2015;2015;07;21;Perjantai;92;65;157;14;20;34
89;31.07.2015;2015;07;22;Perjantai;53;50;103;8;14;22
89;31.07.2015;2015;07;23;Perjantai;62;46;108;14;17;31
89;01.08.2015;2015;08;00;Lauantai;27;34;61;9;5;14
89;01.08.2015;2015;08;01;Lauantai;38;11;49;7;4;11
89;01.08.2015;2015;08;02;Lauantai;27;14;41;6;4;10
89;01.08.2015;2015;08;03;Lauantai;43;0;43;8;0;8
89;01.08.2015;2015;08;04;Lauantai;22;12;34;5;0;5
89;01.08.2015;2015;08;05;Lauantai;6;9;15;0;2;2
89;01.08.2015;2015;08;06;Lauantai;10;18;28;0;4;4
89;01.08.2015;2015;08;07;Lauantai;10;14;24;2;3;5
89;01.08.2015;2015;08;08;Lauantai;17;25;42;10;11;21
89;01.08.2015;2015;08;09;Lauantai;18;44;62;8;25;33
89;01.08.2015;2015;08;10;Lauantai;32;69;101;10;17;27
89;01.08.2015;2015;08;11;Lauantai;36;52;88;17;25;42
89;01.08.2015;2015;08;12;Lauantai;46;92;138;10;18;28
89;01.08.2015;2015;08;13;Lauantai;54;76;130;21;38;59
89;01.08.2015;2015;08;14;Lauantai;55;55;110;26;39;65
89;01.08.2015;2015;08;15;Lauantai;81;53;134;20;23;43
89;01.08.2015;2015;08;16;Lauantai;75;46;121;22;36;58
89;01.08.2015;2015;08;17;Lauantai;48;68;116;14;13;27
89;01.08.2015;2015;08;18;Lauantai;56;37;93;16;20;36
89;01.08.2015;2015;08;19;Lauantai;42;42;84;16;23;39
89;01.08.2015;2015;08;20;Lauantai;37;35;72;15;13;28
89;01.08.2015;2015;08;21;Lauantai;34;34;68;5;14;19
89;01.08.2015;2015;08;22;Lauantai;16;50;66;10;13;23
89;01.08.2015;2015;08;23;Lauantai;34;40;74;7;14;21
89;02.08.2015;2015;08;00;Sunnuntai;19;36;55;4;11;15
89;02.08.2015;2015;08;01;Sunnuntai;17;29;46;1;11;12
89;02.08.2015;2015;08;02;Sunnuntai;25;7;32;3;0;3
89;02.08.2015;2015;08;03;Sunnuntai;37;1;38;10;0;10
89;02.08.2015;2015;08;04;Sunnuntai;24;5;29;9;1;10
89;02.08.2015;2015;08;05;Sunnuntai;5;6;11;5;4;9
89;02.08.2015;2015;08;06;Sunnuntai;8;11;19;0;1;1
89;02.08.2015;2015;08;07;Sunnuntai;4;7;11;1;4;5
89;02.08.2015;2015;08;08;Sunnuntai;4;12;16;5;5;10
89;02.08.2015;2015;08;09;Sunnuntai;26;37;63;16;16;32
89;02.08.2015;2015;08;10;Sunnuntai;31;54;85;25;54;79
89;02.08.2015;2015;08;11;Sunnuntai;38;76;114;37;34;71
89;02.08.2015;2015;08;12;Sunnuntai;56;90;146;37;51;88
89;02.08.2015;2015;08;13;Sunnuntai;103;135;238;40;60;100
89;02.08.2015;2015;08;14;Sunnuntai;124;124;248;32;66;98
89;02.08.2015;2015;08;15;Sunnuntai;96;115;211;50;69;119
89;02.08.2015;2015;08;16;Sunnuntai;117;99;216;45;43;88
89;02.08.2015;2015;08;17;Sunnuntai;122;59;181;30;35;65
89;02.08.2015;2015;08;18;Sunnuntai;91;82;173;41;38;79
89;02.08.2015;2015;08;19;Sunnuntai;51;39;90;13;21;34
89;02.08.2015;2015;08;20;Sunnuntai;42;40;82;17;13;30
89;02.08.2015;2015;08;21;Sunnuntai;43;31;74;15;10;25
89;02.08.2015;2015;08;22;Sunnuntai;25;17;42;4;6;10
89;02.08.2015;2015;08;23;Sunnuntai;13;9;22;2;3;5
89;03.08.2015;2015;08;00;Maanantai;7;4;11;8;7;15
89;03.08.2015;2015;08;01;Maanantai;8;3;11;2;3;5
89;03.08.2015;2015;08;02;Maanantai;3;3;6;4;1;5
89;03.08.2015;2015;08;03;Maanantai;4;3;7;1;0;1
89;03.08.2015;2015;08;04;Maanantai;11;2;13;2;1;3
89;03.08.2015;2015;08;05;Maanantai;9;17;26;1;0;1
89;03.08.2015;2015;08;06;Maanantai;25;59;84;2;6;8
89;03.08.2015;2015;08;07;Maanantai;47;128;175;6;20;26
89;03.08.2015;2015;08;08;Maanantai;44;152;196;7;19;26
89;03.08.2015;2015;08;09;Maanantai;31;70;101;8;17;25
89;03.08.2015;2015;08;10;Maanantai;44;76;120;14;24;38
89;03.08.2015;2015;08;11;Maanantai;54;107;161;19;22;41
89;03.08.2015;2015;08;12;Maanantai;72;126;198;16;29;45
89;03.08.2015;2015;08;13;Maanantai;102;149;251;52;38;90
89;03.08.2015;2015;08;14;Maanantai;149;147;296;27;56;83
89;03.08.2015;2015;08;15;Maanantai;220;199;419;39;49;88
89;03.08.2015;2015;08;16;Maanantai;238;172;410;59;62;121
89;03.08.2015;2015;08;17;Maanantai;174;135;309;54;45;99
89;03.08.2015;2015;08;18;Maanantai;166;127;293;51;61;112
89;03.08.2015;2015;08;19;Maanantai;147;96;243;36;44;80
89;03.08.2015;2015;08;20;Maanantai;104;66;170;42;31;73
89;03.08.2015;2015;08;21;Maanantai;80;58;138;22;14;36
89;03.08.2015;2015;08;22;Maanantai;26;17;43;9;12;21
89;03.08.2015;2015;08;23;Maanantai;22;12;34;3;9;12
89;04.08.2015;2015;08;00;Tiistai;5;8;13;3;3;6
89;04.08.2015;2015;08;01;Tiistai;2;4;6;1;1;2
89;04.08.2015;2015;08;02;Tiistai;7;3;10;0;0;0
89;04.08.2015;2015;08;03;Tiistai;5;7;12;2;0;2
89;04.08.2015;2015;08;04;Tiistai;5;4;9;1;2;3
89;04.08.2015;2015;08;05;Tiistai;10;25;35;1;3;4
89;04.08.2015;2015;08;06;Tiistai;26;88;114;3;8;11
89;04.08.2015;2015;08;07;Tiistai;51;171;222;2;21;23
89;04.08.2015;2015;08;08;Tiistai;50;200;250;8;35;43
89;04.08.2015;2015;08;09;Tiistai;47;136;183;13;30;43
89;04.08.2015;2015;08;10;Tiistai;53;120;173;17;38;55
89;04.08.2015;2015;08;11;Tiistai;95;136;231;22;44;66
89;04.08.2015;2015;08;12;Tiistai;130;165;295;33;43;76
89;04.08.2015;2015;08;13;Tiistai;175;144;319;50;53;103
89;04.08.2015;2015;08;14;Tiistai;180;192;372;54;75;129
89;04.08.2015;2015;08;15;Tiistai;280;208;488;53;83;136
89;04.08.2015;2015;08;16;Tiistai;268;179;447;61;58;119
89;04.08.2015;2015;08;17;Tiistai;199;197;396;51;60;111
89;04.08.2015;2015;08;18;Tiistai;173;136;309;64;90;154
89;04.08.2015;2015;08;19;Tiistai;197;148;345;60;77;137
89;04.08.2015;2015;08;20;Tiistai;124;104;228;34;48;82
89;04.08.2015;2015;08;21;Tiistai;102;54;156;39;28;67
89;04.08.2015;2015;08;22;Tiistai;46;31;77;22;17;39
89;04.08.2015;2015;08;23;Tiistai;36;16;52;10;14;24
89;05.08.2015;2015;08;00;Keskiviikko;17;10;27;3;1;4
89;05.08.2015;2015;08;01;Keskiviikko;9;6;15;1;0;1
89;05.08.2015;2015;08;02;Keskiviikko;8;9;17;3;1;4
89;05.08.2015;2015;08;03;Keskiviikko;11;2;13;1;2;3
89;05.08.2015;2015;08;04;Keskiviikko;9;5;14;0;1;1
89;05.08.2015;2015;08;05;Keskiviikko;6;21;27;0;0;0
89;05.08.2015;2015;08;06;Keskiviikko;28;76;104;2;6;8
89;05.08.2015;2015;08;07;Keskiviikko;47;171;218;9;19;28
89;05.08.2015;2015;08;08;Keskiviikko;53;214;267;11;32;43
89;05.08.2015;2015;08;09;Keskiviikko;53;125;178;31;48;79
89;05.08.2015;2015;08;10;Keskiviikko;55;139;194;20;42;62
89;05.08.2015;2015;08;11;Keskiviikko;102;189;291;37;60;97
89;05.08.2015;2015;08;12;Keskiviikko;153;206;359;44;65;109
89;05.08.2015;2015;08;13;Keskiviikko;181;217;398;52;82;134
89;05.08.2015;2015;08;14;Keskiviikko;216;180;396;49;59;108
89;05.08.2015;2015;08;15;Keskiviikko;315;227;542;58;58;116
89;05.08.2015;2015;08;16;Keskiviikko;297;231;528;56;55;111
89;05.08.2015;2015;08;17;Keskiviikko;231;273;504;79;96;175
89;05.08.2015;2015;08;18;Keskiviikko;264;208;472;71;90;161
89;05.08.2015;2015;08;19;Keskiviikko;264;188;452;40;53;93
89;05.08.2015;2015;08;20;Keskiviikko;169;137;306;37;55;92
89;05.08.2015;2015;08;21;Keskiviikko;111;90;201;22;32;54
89;05.08.2015;2015;08;22;Keskiviikko;62;46;108;11;16;27
89;05.08.2015;2015;08;23;Keskiviikko;27;19;46;2;3;5
89;06.08.2015;2015;08;00;Torstai;19;6;25;4;2;6
89;06.08.2015;2015;08;01;Torstai;10;11;21;1;2;3
89;06.08.2015;2015;08;02;Torstai;12;0;12;1;0;1
89;06.08.2015;2015;08;03;Torstai;4;3;7;3;1;4
89;06.08.2015;2015;08;04;Torstai;13;11;24;6;1;7
89;06.08.2015;2015;08;05;Torstai;6;15;21;0;2;2
89;06.08.2015;2015;08;06;Torstai;20;83;103;3;8;11
89;06.08.2015;2015;08;07;Torstai;56;153;209;6;18;24
89;06.08.2015;2015;08;08;Torstai;28;182;210;6;37;43
89;06.08.2015;2015;08;09;Torstai;52;85;137;9;15;24
89;06.08.2015;2015;08;10;Torstai;35;69;104;10;23;33
89;06.08.2015;2015;08;11;Torstai;45;86;131;20;30;50
89;06.08.2015;2015;08;12;Torstai;62;96;158;20;17;37
89;06.08.2015;2015;08;13;Torstai;75;98;173;21;22;43
89;06.08.2015;2015;08;14;Torstai;116;95;211;15;18;33
89;06.08.2015;2015;08;15;Torstai;188;73;261;13;15;28
89;06.08.2015;2015;08;16;Torstai;174;92;266;17;17;34
89;06.08.2015;2015;08;17;Torstai;111;58;169;19;18;37
89;06.08.2015;2015;08;18;Torstai;92;68;160;21;26;47
89;06.08.2015;2015;08;19;Torstai;63;34;97;23;25;48
89;06.08.2015;2015;08;20;Torstai;44;28;72;16;16;32
89;06.08.2015;2015;08;21;Torstai;43;24;67;7;17;24
89;06.08.2015;2015;08;22;Torstai;30;29;59;6;6;12
89;06.08.2015;2015;08;23;Torstai;11;6;17;5;2;7
89;07.08.2015;2015;08;00;Perjantai;7;3;10;1;2;3
89;07.08.2015;2015;08;01;Perjantai;3;1;4;1;2;3
89;07.08.2015;2015;08;02;Perjantai;12;4;16;2;1;3
89;07.08.2015;2015;08;03;Perjantai;5;5;10;3;1;4
89;07.08.2015;2015;08;04;Perjantai;2;2;4;3;3;6
89;07.08.2015;2015;08;05;Perjantai;2;16;18;1;0;1
89;07.08.2015;2015;08;06;Perjantai;16;73;89;1;6;7
89;07.08.2015;2015;08;07;Perjantai;35;142;177;4;9;13
89;07.08.2015;2015;08;08;Perjantai;31;140;171;9;20;29
89;07.08.2015;2015;08;09;Perjantai;35;92;127;13;18;31
89;07.08.2015;2015;08;10;Perjantai;32;70;102;17;26;43
89;07.08.2015;2015;08;11;Perjantai;50;76;126;12;23;35
89;07.08.2015;2015;08;12;Perjantai;55;90;145;20;39;59
89;07.08.2015;2015;08;13;Perjantai;100;116;216;26;28;54
89;07.08.2015;2015;08;14;Perjantai;138;88;226;25;26;51
89;07.08.2015;2015;08;15;Perjantai;150;116;266;9;19;28
89;07.08.2015;2015;08;16;Perjantai;168;124;292;27;29;56
89;07.08.2015;2015;08;17;Perjantai;130;126;256;39;47;86
89;07.08.2015;2015;08;18;Perjantai;116;119;235;33;52;85
89;07.08.2015;2015;08;19;Perjantai;122;144;266;33;68;101
89;07.08.2015;2015;08;20;Perjantai;99;100;199;38;66;104
89;07.08.2015;2015;08;21;Perjantai;59;86;145;27;28;55
89;07.08.2015;2015;08;22;Perjantai;54;64;118;14;13;27
89;07.08.2015;2015;08;23;Perjantai;57;42;99;12;17;29
89;08.08.2015;2015;08;00;Lauantai;38;30;68;8;14;22
89;08.08.2015;2015;08;01;Lauantai;31;17;48;6;2;8
89;08.08.2015;2015;08;02;Lauantai;29;8;37;10;3;13
89;08.08.2015;2015;08;03;Lauantai;25;13;38;7;2;9
89;08.08.2015;2015;08;04;Lauantai;27;8;35;6;1;7
89;08.08.2015;2015;08;05;Lauantai;6;6;12;0;2;2
89;08.08.2015;2015;08;06;Lauantai;8;14;22;3;1;4
89;08.08.2015;2015;08;07;Lauantai;6;19;25;7;7;14
89;08.08.2015;2015;08;08;Lauantai;23;40;63;12;12;24
89;08.08.2015;2015;08;09;Lauantai;21;69;90;16;23;39
89;08.08.2015;2015;08;10;Lauantai;46;105;151;7;28;35
89;08.08.2015;2015;08;11;Lauantai;52;86;138;18;33;51
89;08.08.2015;2015;08;12;Lauantai;76;82;158;22;29;51
89;08.08.2015;2015;08;13;Lauantai;68;76;144;22;29;51
89;08.08.2015;2015;08;14;Lauantai;81;92;173;23;38;61
89;08.08.2015;2015;08;15;Lauantai;81;84;165;37;30;67
89;08.08.2015;2015;08;16;Lauantai;86;62;148;19;33;52
89;08.08.2015;2015;08;17;Lauantai;75;57;132;22;31;53
89;08.08.2015;2015;08;18;Lauantai;79;91;170;23;22;45
89;08.08.2015;2015;08;19;Lauantai;64;79;143;23;35;58
89;08.08.2015;2015;08;20;Lauantai;81;71;152;30;42;72
89;08.08.2015;2015;08;21;Lauantai;55;73;128;19;22;41
89;08.08.2015;2015;08;22;Lauantai;29;51;80;14;28;42
89;08.08.2015;2015;08;23;Lauantai;30;61;91;7;12;19
89;09.08.2015;2015;08;00;Sunnuntai;30;24;54;6;6;12
89;09.08.2015;2015;08;01;Sunnuntai;33;17;50;4;7;11
89;09.08.2015;2015;08;02;Sunnuntai;16;6;22;6;6;12
89;09.08.2015;2015;08;03;Sunnuntai;26;4;30;5;2;7
89;09.08.2015;2015;08;04;Sunnuntai;35;9;44;3;1;4
89;09.08.2015;2015;08;05;Sunnuntai;5;1;6;5;1;6
89;09.08.2015;2015;08;06;Sunnuntai;6;7;13;0;4;4
89;09.08.2015;2015;08;07;Sunnuntai;4;13;17;3;1;4
89;09.08.2015;2015;08;08;Sunnuntai;6;10;16;5;4;9
89;09.08.2015;2015;08;09;Sunnuntai;19;36;55;22;22;44
89;09.08.2015;2015;08;10;Sunnuntai;21;51;72;32;36;68
89;09.08.2015;2015;08;11;Sunnuntai;59;96;155;46;40;86
89;09.08.2015;2015;08;12;Sunnuntai;80;126;206;30;45;75
89;09.08.2015;2015;08;13;Sunnuntai;98;157;255;39;58;97
89;09.08.2015;2015;08;14;Sunnuntai;130;125;255;37;42;79
89;09.08.2015;2015;08;15;Sunnuntai;142;137;279;51;78;129
89;09.08.2015;2015;08;16;Sunnuntai;141;133;274;53;64;117
89;09.08.2015;2015;08;17;Sunnuntai;146;130;276;36;62;98
89;09.08.2015;2015;08;18;Sunnuntai;136;95;231;37;37;74
89;09.08.2015;2015;08;19;Sunnuntai;78;60;138;41;40;81
89;09.08.2015;2015;08;20;Sunnuntai;70;71;141;25;32;57
89;09.08.2015;2015;08;21;Sunnuntai;36;44;80;13;9;22
89;09.08.2015;2015;08;22;Sunnuntai;27;10;37;7;2;9
89;09.08.2015;2015;08;23;Sunnuntai;11;6;17;5;5;10
89;10.08.2015;2015;08;00;Maanantai;8;2;10;1;4;5
89;10.08.2015;2015;08;01;Maanantai;4;3;7;0;1;1
89;10.08.2015;2015;08;02;Maanantai;4;1;5;0;3;3
89;10.08.2015;2015;08;03;Maanantai;2;4;6;2;0;2
89;10.08.2015;2015;08;04;Maanantai;4;5;9;3;0;3
89;10.08.2015;2015;08;05;Maanantai;3;12;15;0;0;0
89;10.08.2015;2015;08;06;Maanantai;27;87;114;0;10;10
89;10.08.2015;2015;08;07;Maanantai;47;226;273;4;24;28
89;10.08.2015;2015;08;08;Maanantai;51;194;245;5;27;32
89;10.08.2015;2015;08;09;Maanantai;52;134;186;11;38;49
89;10.08.2015;2015;08;10;Maanantai;59;112;171;17;30;47
89;10.08.2015;2015;08;11;Maanantai;83;141;224;21;36;57
89;10.08.2015;2015;08;12;Maanantai;101;165;266;25;36;61
89;10.08.2015;2015;08;13;Maanantai;138;169;307;42;46;88
89;10.08.2015;2015;08;14;Maanantai;191;166;357;38;55;93
89;10.08.2015;2015;08;15;Maanantai;319;167;486;41;38;79
89;10.08.2015;2015;08;16;Maanantai;301;159;460;32;30;62
89;10.08.2015;2015;08;17;Maanantai;198;164;362;33;59;92
89;10.08.2015;2015;08;18;Maanantai;202;130;332;47;50;97
89;10.08.2015;2015;08;19;Maanantai;160;116;276;38;61;99
89;10.08.2015;2015;08;20;Maanantai;113;93;206;25;36;61
89;10.08.2015;2015;08;21;Maanantai;85;67;152;18;36;54
89;10.08.2015;2015;08;22;Maanantai;38;31;69;4;9;13
89;10.08.2015;2015;08;23;Maanantai;25;13;38;9;3;12
89;11.08.2015;2015;08;00;Tiistai;15;6;21;1;7;8
89;11.08.2015;2015;08;01;Tiistai;4;3;7;1;3;4
89;11.08.2015;2015;08;02;Tiistai;2;2;4;2;3;5
89;11.08.2015;2015;08;03;Tiistai;3;6;9;1;2;3
89;11.08.2015;2015;08;04;Tiistai;1;6;7;1;0;1
89;11.08.2015;2015;08;05;Tiistai;10;16;26;1;1;2
89;11.08.2015;2015;08;06;Tiistai;25;102;127;3;6;9
89;11.08.2015;2015;08;07;Tiistai;52;209;261;9;27;36
89;11.08.2015;2015;08;08;Tiistai;48;248;296;9;38;47
89;11.08.2015;2015;08;09;Tiistai;47;148;195;17;33;50
89;11.08.2015;2015;08;10;Tiistai;59;137;196;21;35;56
89;11.08.2015;2015;08;11;Tiistai;123;196;319;20;37;57
89;11.08.2015;2015;08;12;Tiistai;160;207;367;31;43;74
89;11.08.2015;2015;08;13;Tiistai;181;201;382;49;73;122
89;11.08.2015;2015;08;14;Tiistai;207;184;391;35;52;87
89;11.08.2015;2015;08;15;Tiistai;308;184;492;35;40;75
89;11.08.2015;2015;08;16;Tiistai;345;167;512;26;14;40
89;11.08.2015;2015;08;17;Tiistai;168;129;297;30;28;58
89;11.08.2015;2015;08;18;Tiistai;131;96;227;33;33;66
89;11.08.2015;2015;08;19;Tiistai;116;70;186;28;31;59
89;11.08.2015;2015;08;20;Tiistai;97;54;151;18;28;46
89;11.08.2015;2015;08;21;Tiistai;62;43;105;14;18;32
89;11.08.2015;2015;08;22;Tiistai;29;17;46;7;5;12
89;11.08.2015;2015;08;23;Tiistai;11;8;19;2;3;5
89;12.08.2015;2015;08;00;Keskiviikko;6;1;7;0;0;0
89;12.08.2015;2015;08;01;Keskiviikko;5;2;7;1;1;2
89;12.08.2015;2015;08;02;Keskiviikko;0;1;1;0;3;3
89;12.08.2015;2015;08;03;Keskiviikko;2;2;4;1;1;2
89;12.08.2015;2015;08;04;Keskiviikko;2;6;8;0;1;1
89;12.08.2015;2015;08;05;Keskiviikko;13;19;32;1;1;2
89;12.08.2015;2015;08;06;Keskiviikko;20;79;99;5;5;10
89;12.08.2015;2015;08;07;Keskiviikko;41;191;232;8;19;27
89;12.08.2015;2015;08;08;Keskiviikko;36;306;342;4;31;35
89;12.08.2015;2015;08;09;Keskiviikko;67;193;260;11;40;51
89;12.08.2015;2015;08;10;Keskiviikko;49;101;150;20;22;42
89;12.08.2015;2015;08;11;Keskiviikko;92;108;200;25;33;58
89;12.08.2015;2015;08;12;Keskiviikko;115;97;212;17;24;41
89;12.08.2015;2015;08;13;Keskiviikko;116;101;217;36;31;67
89;12.08.2015;2015;08;14;Keskiviikko;180;126;306;30;34;64
89;12.08.2015;2015;08;15;Keskiviikko;239;145;384;30;22;52
89;12.08.2015;2015;08;16;Keskiviikko;267;139;406;32;25;57
89;12.08.2015;2015;08;17;Keskiviikko;163;190;353;38;55;93
89;12.08.2015;2015;08;18;Keskiviikko;169;155;324;44;64;108
89;12.08.2015;2015;08;19;Keskiviikko;180;139;319;55;59;114
89;12.08.2015;2015;08;20;Keskiviikko;147;75;222;36;45;81
89;12.08.2015;2015;08;21;Keskiviikko;71;49;120;21;18;39
89;12.08.2015;2015;08;22;Keskiviikko;37;36;73;5;10;15
89;12.08.2015;2015;08;23;Keskiviikko;15;13;28;8;7;15
89;13.08.2015;2015;08;00;Torstai;19;4;23;2;2;4
89;13.08.2015;2015;08;01;Torstai;2;5;7;1;4;5
89;13.08.2015;2015;08;02;Torstai;4;3;7;1;0;1
89;13.08.2015;2015;08;03;Torstai;7;2;9;1;1;2
89;13.08.2015;2015;08;04;Torstai;2;7;9;1;0;1
89;13.08.2015;2015;08;05;Torstai;10;17;27;2;1;3
89;13.08.2015;2015;08;06;Torstai;21;84;105;0;7;7
89;13.08.2015;2015;08;07;Torstai;48;252;300;5;13;18
89;13.08.2015;2015;08;08;Torstai;49;362;411;5;49;54
89;13.08.2015;2015;08;09;Torstai;58;145;203;10;29;39
89;13.08.2015;2015;08;10;Torstai;72;127;199;30;39;69
89;13.08.2015;2015;08;11;Torstai;82;134;216;24;40;64
89;13.08.2015;2015;08;12;Torstai;152;130;282;34;40;74
89;13.08.2015;2015;08;13;Torstai;162;129;291;28;25;53
89;13.08.2015;2015;08;14;Torstai;172;154;326;41;52;93
89;13.08.2015;2015;08;15;Torstai;283;163;446;44;48;92
89;13.08.2015;2015;08;16;Torstai;310;160;470;48;25;73
89;13.08.2015;2015;08;17;Torstai;188;164;352;33;31;64
89;13.08.2015;2015;08;18;Torstai;164;116;280;44;49;93
89;13.08.2015;2015;08;19;Torstai;167;83;250;43;44;87
89;13.08.2015;2015;08;20;Torstai;104;64;168;34;27;61
89;13.08.2015;2015;08;21;Torstai;62;39;101;11;20;31
89;13.08.2015;2015;08;22;Torstai;37;55;92;10;22;32
89;13.08.2015;2015;08;23;Torstai;9;15;24;0;6;6
89;14.08.2015;2015;08;00;Perjantai;11;6;17;4;1;5
89;14.08.2015;2015;08;01;Perjantai;11;3;14;3;0;3
89;14.08.2015;2015;08;02;Perjantai;12;3;15;3;2;5
89;14.08.2015;2015;08;03;Perjantai;7;1;8;0;0;0
89;14.08.2015;2015;08;04;Perjantai;5;11;16;3;0;3
89;14.08.2015;2015;08;05;Perjantai;9;19;28;0;1;1
89;14.08.2015;2015;08;06;Perjantai;17;68;85;1;3;4
89;14.08.2015;2015;08;07;Perjantai;52;203;255;2;13;15
89;14.08.2015;2015;08;08;Perjantai;48;281;329;15;35;50
89;14.08.2015;2015;08;09;Perjantai;61;172;233;8;25;33
89;14.08.2015;2015;08;10;Perjantai;40;99;139;33;37;70
89;14.08.2015;2015;08;11;Perjantai;69;110;179;18;19;37
89;14.08.2015;2015;08;12;Perjantai;122;117;239;28;43;71
89;14.08.2015;2015;08;13;Perjantai;142;139;281;27;44;71
89;14.08.2015;2015;08;14;Perjantai;189;139;328;54;42;96
89;14.08.2015;2015;08;15;Perjantai;248;158;406;34;24;58
89;14.08.2015;2015;08;16;Perjantai;215;116;331;35;19;54
89;14.08.2015;2015;08;17;Perjantai;177;123;300;38;30;68
89;14.08.2015;2015;08;18;Perjantai;107;120;227;21;29;50
89;14.08.2015;2015;08;19;Perjantai;128;97;225;25;48;73
89;14.08.2015;2015;08;20;Perjantai;93;68;161;28;39;67
89;14.08.2015;2015;08;21;Perjantai;55;66;121;16;28;44
89;14.08.2015;2015;08;22;Perjantai;33;37;70;8;9;17
89;14.08.2015;2015;08;23;Perjantai;40;28;68;3;10;13
89;15.08.2015;2015;08;00;Lauantai;34;27;61;3;10;13
89;15.08.2015;2015;08;01;Lauantai;33;10;43;3;4;7
89;15.08.2015;2015;08;02;Lauantai;24;10;34;7;3;10
89;15.08.2015;2015;08;03;Lauantai;31;6;37;5;2;7
89;15.08.2015;2015;08;04;Lauantai;16;6;22;8;3;11
89;15.08.2015;2015;08;05;Lauantai;7;5;12;2;3;5
89;15.08.2015;2015;08;06;Lauantai;7;7;14;0;2;2
89;15.08.2015;2015;08;07;Lauantai;10;16;26;4;3;7
89;15.08.2015;2015;08;08;Lauantai;6;42;48;5;12;17
89;15.08.2015;2015;08;09;Lauantai;22;79;101;16;27;43
89;15.08.2015;2015;08;10;Lauantai;53;91;144;23;35;58
89;15.08.2015;2015;08;11;Lauantai;70;164;234;20;42;62
89;15.08.2015;2015;08;12;Lauantai;89;198;287;16;52;68
89;15.08.2015;2015;08;13;Lauantai;133;167;300;25;54;79
89;15.08.2015;2015;08;14;Lauantai;139;140;279;32;48;80
89;15.08.2015;2015;08;15;Lauantai;174;112;286;43;55;98
89;15.08.2015;2015;08;16;Lauantai;131;126;257;29;42;71
89;15.08.2015;2015;08;17;Lauantai;115;131;246;24;40;64
89;15.08.2015;2015;08;18;Lauantai;110;97;207;36;21;57
89;15.08.2015;2015;08;19;Lauantai;96;105;201;24;52;76
89;15.08.2015;2015;08;20;Lauantai;59;90;149;25;35;60
89;15.08.2015;2015;08;21;Lauantai;59;57;116;16;26;42
89;15.08.2015;2015;08;22;Lauantai;50;50;100;6;21;27
89;15.08.2015;2015;08;23;Lauantai;36;38;74;4;9;13
89;16.08.2015;2015;08;00;Sunnuntai;26;35;61;3;6;9
89;16.08.2015;2015;08;01;Sunnuntai;27;24;51;3;4;7
89;16.08.2015;2015;08;02;Sunnuntai;23;1;24;9;0;9
89;16.08.2015;2015;08;03;Sunnuntai;45;1;46;10;1;11
89;16.08.2015;2015;08;04;Sunnuntai;23;3;26;4;1;5
89;16.08.2015;2015;08;05;Sunnuntai;9;3;12;4;0;4
89;16.08.2015;2015;08;06;Sunnuntai;4;10;14;1;5;6
89;16.08.2015;2015;08;07;Sunnuntai;9;9;18;4;3;7
89;16.08.2015;2015;08;08;Sunnuntai;6;13;19;3;4;7
89;16.08.2015;2015;08;09;Sunnuntai;21;42;63;6;23;29
89;16.08.2015;2015;08;10;Sunnuntai;29;82;111;19;30;49
89;16.08.2015;2015;08;11;Sunnuntai;69;133;202;46;66;112
89;16.08.2015;2015;08;12;Sunnuntai;91;173;264;24;48;72
89;16.08.2015;2015;08;13;Sunnuntai;135;223;358;29;84;113
89;16.08.2015;2015;08;14;Sunnuntai;179;177;356;53;71;124
89;16.08.2015;2015;08;15;Sunnuntai;214;179;393;49;79;128
89;16.08.2015;2015;08;16;Sunnuntai;190;148;338;71;50;121
89;16.08.2015;2015;08;17;Sunnuntai;190;151;341;39;41;80
89;16.08.2015;2015;08;18;Sunnuntai;162;83;245;34;46;80
89;16.08.2015;2015;08;19;Sunnuntai;96;98;194;24;43;67
89;16.08.2015;2015;08;20;Sunnuntai;81;84;165;21;35;56
89;16.08.2015;2015;08;21;Sunnuntai;47;35;82;12;23;35
89;16.08.2015;2015;08;22;Sunnuntai;28;11;39;7;5;12
89;16.08.2015;2015;08;23;Sunnuntai;7;4;11;2;2;4
89;17.08.2015;2015;08;00;Maanantai;8;3;11;1;1;2
89;17.08.2015;2015;08;01;Maanantai;4;3;7;0;0;0
89;17.08.2015;2015;08;02;Maanantai;1;0;1;0;0;0
89;17.08.2015;2015;08;03;Maanantai;1;4;5;0;0;0
89;17.08.2015;2015;08;04;Maanantai;1;4;5;1;0;1
89;17.08.2015;2015;08;05;Maanantai;6;21;27;0;1;1
89;17.08.2015;2015;08;06;Maanantai;27;81;108;2;6;8
89;17.08.2015;2015;08;07;Maanantai;61;267;328;7;20;27
89;17.08.2015;2015;08;08;Maanantai;54;322;376;9;50;59
89;17.08.2015;2015;08;09;Maanantai;67;173;240;11;31;42
89;17.08.2015;2015;08;10;Maanantai;73;134;207;14;35;49
89;17.08.2015;2015;08;11;Maanantai;105;145;250;22;42;64
89;17.08.2015;2015;08;12;Maanantai;133;144;277;29;33;62
89;17.08.2015;2015;08;13;Maanantai;146;150;296;33;41;74
89;17.08.2015;2015;08;14;Maanantai;218;148;366;28;35;63
89;17.08.2015;2015;08;15;Maanantai;317;168;485;32;14;46
89;17.08.2015;2015;08;16;Maanantai;324;185;509;39;36;75
89;17.08.2015;2015;08;17;Maanantai;227;204;431;42;36;78
89;17.08.2015;2015;08;18;Maanantai;217;150;367;52;51;103
89;17.08.2015;2015;08;19;Maanantai;210;129;339;37;53;90
89;17.08.2015;2015;08;20;Maanantai;150;104;254;33;32;65
89;17.08.2015;2015;08;21;Maanantai;116;87;203;35;32;67
89;17.08.2015;2015;08;22;Maanantai;27;24;51;15;9;24
89;17.08.2015;2015;08;23;Maanantai;8;13;21;2;2;4
89;18.08.2015;2015;08;00;Tiistai;1;4;5;1;6;7
89;18.08.2015;2015;08;01;Tiistai;3;5;8;3;2;5
89;18.08.2015;2015;08;02;Tiistai;2;0;2;0;0;0
89;18.08.2015;2015;08;03;Tiistai;2;1;3;0;0;0
89;18.08.2015;2015;08;04;Tiistai;4;5;9;2;0;2
89;18.08.2015;2015;08;05;Tiistai;8;20;28;1;3;4
89;18.08.2015;2015;08;06;Tiistai;23;100;123;2;8;10
89;18.08.2015;2015;08;07;Tiistai;61;295;356;6;17;23
89;18.08.2015;2015;08;08;Tiistai;76;338;414;10;38;48
89;18.08.2015;2015;08;09;Tiistai;52;153;205;9;28;37
89;18.08.2015;2015;08;10;Tiistai;75;125;200;30;50;80
89;18.08.2015;2015;08;11;Tiistai;93;163;256;26;53;79
89;18.08.2015;2015;08;12;Tiistai;145;158;303;27;36;63
89;18.08.2015;2015;08;13;Tiistai;175;151;326;31;50;81
89;18.08.2015;2015;08;14;Tiistai;228;150;378;43;33;76
89;18.08.2015;2015;08;15;Tiistai;314;170;484;50;51;101
89;18.08.2015;2015;08;16;Tiistai;373;221;594;35;48;83
89;18.08.2015;2015;08;17;Tiistai;253;231;484;39;53;92
89;18.08.2015;2015;08;18;Tiistai;194;161;355;63;71;134
89;18.08.2015;2015;08;19;Tiistai;193;165;358;62;79;141
89;18.08.2015;2015;08;20;Tiistai;173;82;255;36;38;74
89;18.08.2015;2015;08;21;Tiistai;107;57;164;20;20;40
89;18.08.2015;2015;08;22;Tiistai;36;20;56;10;7;17
89;18.08.2015;2015;08;23;Tiistai;10;12;22;1;0;1
89;19.08.2015;2015;08;00;Keskiviikko;12;5;17;1;0;1
89;19.08.2015;2015;08;01;Keskiviikko;5;1;6;1;1;2
89;19.08.2015;2015;08;02;Keskiviikko;3;0;3;1;0;1
89;19.08.2015;2015;08;03;Keskiviikko;1;2;3;0;0;0
89;19.08.2015;2015;08;04;Keskiviikko;5;6;11;0;0;0
89;19.08.2015;2015;08;05;Keskiviikko;8;25;33;0;0;0
89;19.08.2015;2015;08;06;Keskiviikko;23;92;115;4;6;10
89;19.08.2015;2015;08;07;Keskiviikko;61;260;321;5;26;31
89;19.08.2015;2015;08;08;Keskiviikko;60;353;413;17;53;70
89;19.08.2015;2015;08;09;Keskiviikko;63;168;231;15;40;55
89;19.08.2015;2015;08;10;Keskiviikko;72;140;212;31;44;75
89;19.08.2015;2015;08;11;Keskiviikko;122;148;270;33;38;71
89;19.08.2015;2015;08;12;Keskiviikko;137;172;309;31;35;66
89;19.08.2015;2015;08;13;Keskiviikko;182;144;326;45;69;114
89;19.08.2015;2015;08;14;Keskiviikko;254;156;410;35;34;69
89;19.08.2015;2015;08;15;Keskiviikko;312;181;493;39;36;75
89;19.08.2015;2015;08;16;Keskiviikko;364;248;612;48;40;88
89;19.08.2015;2015;08;17;Keskiviikko;241;298;539;44;50;94
89;19.08.2015;2015;08;18;Keskiviikko;191;194;385;45;59;104
89;19.08.2015;2015;08;19;Keskiviikko;203;136;339;46;55;101
89;19.08.2015;2015;08;20;Keskiviikko;154;89;243;37;29;66
89;19.08.2015;2015;08;21;Keskiviikko;80;39;119;21;17;38
89;19.08.2015;2015;08;22;Keskiviikko;39;36;75;7;15;22
89;19.08.2015;2015;08;23;Keskiviikko;21;17;38;2;2;4
89;20.08.2015;2015;08;00;Torstai;19;7;26;0;0;0
89;20.08.2015;2015;08;01;Torstai;5;2;7;4;1;5
89;20.08.2015;2015;08;02;Torstai;11;1;12;1;2;3
89;20.08.2015;2015;08;03;Torstai;7;1;8;0;0;0
89;20.08.2015;2015;08;04;Torstai;1;6;7;4;0;4
89;20.08.2015;2015;08;05;Torstai;8;22;30;1;1;2
89;20.08.2015;2015;08;06;Torstai;16;80;96;2;4;6
89;20.08.2015;2015;08;07;Torstai;64;252;316;9;35;44
89;20.08.2015;2015;08;08;Torstai;54;340;394;11;42;53
89;20.08.2015;2015;08;09;Torstai;51;175;226;18;46;64
89;20.08.2015;2015;08;10;Torstai;67;125;192;32;40;72
89;20.08.2015;2015;08;11;Torstai;73;185;258;18;43;61
89;20.08.2015;2015;08;12;Torstai;134;141;275;29;32;61
89;20.08.2015;2015;08;13;Torstai;152;137;289;33;58;91
89;20.08.2015;2015;08;14;Torstai;210;191;401;40;42;82
89;20.08.2015;2015;08;15;Torstai;302;184;486;32;36;68
89;20.08.2015;2015;08;16;Torstai;332;264;596;31;32;63
89;20.08.2015;2015;08;17;Torstai;207;296;503;37;60;97
89;20.08.2015;2015;08;18;Torstai;188;327;515;45;63;108
89;20.08.2015;2015;08;19;Torstai;235;270;505;40;58;98
89;20.08.2015;2015;08;20;Torstai;216;164;380;31;43;74
89;20.08.2015;2015;08;21;Torstai;220;92;312;30;11;41
89;20.08.2015;2015;08;22;Torstai;185;25;210;21;12;33
89;20.08.2015;2015;08;23;Torstai;64;11;75;8;6;14
89;21.08.2015;2015;08;00;Perjantai;41;7;48;1;3;4
89;21.08.2015;2015;08;01;Perjantai;22;4;26;3;1;4
89;21.08.2015;2015;08;02;Perjantai;25;3;28;3;0;3
89;21.08.2015;2015;08;03;Perjantai;9;8;17;1;0;1
89;21.08.2015;2015;08;04;Perjantai;12;10;22;2;0;2
89;21.08.2015;2015;08;05;Perjantai;9;18;27;0;0;0
89;21.08.2015;2015;08;06;Perjantai;18;87;105;4;5;9
89;21.08.2015;2015;08;07;Perjantai;51;219;270;4;24;28
89;21.08.2015;2015;08;08;Perjantai;55;281;336;16;41;57
89;21.08.2015;2015;08;09;Perjantai;45;157;202;10;27;37
89;21.08.2015;2015;08;10;Perjantai;53;113;166;22;25;47
89;21.08.2015;2015;08;11;Perjantai;90;103;193;22;18;40
89;21.08.2015;2015;08;12;Perjantai;110;131;241;10;24;34
89;21.08.2015;2015;08;13;Perjantai;172;131;303;21;28;49
89;21.08.2015;2015;08;14;Perjantai;279;143;422;28;34;62
89;21.08.2015;2015;08;15;Perjantai;285;178;463;42;32;74
89;21.08.2015;2015;08;16;Perjantai;253;157;410;30;30;60
89;21.08.2015;2015;08;17;Perjantai;180;178;358;34;40;74
89;21.08.2015;2015;08;18;Perjantai;169;181;350;30;34;64
89;21.08.2015;2015;08;19;Perjantai;137;158;295;31;47;78
89;21.08.2015;2015;08;20;Perjantai;125;122;247;30;28;58
89;21.08.2015;2015;08;21;Perjantai;88;74;162;17;40;57
89;21.08.2015;2015;08;22;Perjantai;63;70;133;15;26;41
89;21.08.2015;2015;08;23;Perjantai;25;43;68;8;9;17
89;22.08.2015;2015;08;00;Lauantai;26;61;87;5;17;22
89;22.08.2015;2015;08;01;Lauantai;30;24;54;5;8;13
89;22.08.2015;2015;08;02;Lauantai;37;5;42;5;2;7
89;22.08.2015;2015;08;03;Lauantai;29;2;31;8;4;12
89;22.08.2015;2015;08;04;Lauantai;19;1;20;3;2;5
89;22.08.2015;2015;08;05;Lauantai;3;3;6;1;1;2
89;22.08.2015;2015;08;06;Lauantai;7;15;22;2;2;4
89;22.08.2015;2015;08;07;Lauantai;3;19;22;2;5;7
89;22.08.2015;2015;08;08;Lauantai;12;29;41;6;10;16
89;22.08.2015;2015;08;09;Lauantai;26;63;89;19;27;46
89;22.08.2015;2015;08;10;Lauantai;35;94;129;12;28;40
89;22.08.2015;2015;08;11;Lauantai;69;128;197;8;38;46
89;22.08.2015;2015;08;12;Lauantai;99;147;246;21;49;70
89;22.08.2015;2015;08;13;Lauantai;133;177;310;43;52;95
89;22.08.2015;2015;08;14;Lauantai;179;160;339;47;63;110
89;22.08.2015;2015;08;15;Lauantai;190;166;356;31;45;76
89;22.08.2015;2015;08;16;Lauantai;217;179;396;47;44;91
89;22.08.2015;2015;08;17;Lauantai;181;207;388;55;48;103
89;22.08.2015;2015;08;18;Lauantai;153;115;268;30;53;83
89;22.08.2015;2015;08;19;Lauantai;112;154;266;30;42;72
89;22.08.2015;2015;08;20;Lauantai;103;122;225;26;30;56
89;22.08.2015;2015;08;21;Lauantai;72;88;160;18;21;39
89;22.08.2015;2015;08;22;Lauantai;38;69;107;26;39;65
89;22.08.2015;2015;08;23;Lauantai;18;66;84;4;13;17
89;23.08.2015;2015;08;00;Sunnuntai;26;44;70;1;15;16
89;23.08.2015;2015;08;01;Sunnuntai;29;28;57;2;8;10
89;23.08.2015;2015;08;02;Sunnuntai;33;7;40;8;4;12
89;23.08.2015;2015;08;03;Sunnuntai;33;7;40;7;0;7
89;23.08.2015;2015;08;04;Sunnuntai;30;3;33;9;0;9
89;23.08.2015;2015;08;05;Sunnuntai;4;0;4;4;0;4
89;23.08.2015;2015;08;06;Sunnuntai;3;14;17;2;1;3
89;23.08.2015;2015;08;07;Sunnuntai;5;13;18;3;7;10
89;23.08.2015;2015;08;08;Sunnuntai;8;21;29;6;6;12
89;23.08.2015;2015;08;09;Sunnuntai;22;42;64;10;24;34
89;23.08.2015;2015;08;10;Sunnuntai;42;79;121;18;26;44
89;23.08.2015;2015;08;11;Sunnuntai;83;129;212;33;48;81
89;23.08.2015;2015;08;12;Sunnuntai;120;160;280;44;43;87
89;23.08.2015;2015;08;13;Sunnuntai;153;183;336;40;60;100
89;23.08.2015;2015;08;14;Sunnuntai;179;165;344;37;46;83
89;23.08.2015;2015;08;15;Sunnuntai;196;149;345;35;60;95
89;23.08.2015;2015;08;16;Sunnuntai;197;174;371;30;50;80
89;23.08.2015;2015;08;17;Sunnuntai;177;174;351;26;56;82
89;23.08.2015;2015;08;18;Sunnuntai;199;129;328;43;46;89
89;23.08.2015;2015;08;19;Sunnuntai;147;93;240;34;68;102
89;23.08.2015;2015;08;20;Sunnuntai;78;79;157;39;58;97
89;23.08.2015;2015;08;21;Sunnuntai;47;31;78;14;14;28
89;23.08.2015;2015;08;22;Sunnuntai;14;20;34;4;5;9
89;23.08.2015;2015;08;23;Sunnuntai;3;8;11;4;2;6
89;24.08.2015;2015;08;00;Maanantai;12;3;15;3;0;3
89;24.08.2015;2015;08;01;Maanantai;8;1;9;0;0;0
89;24.08.2015;2015;08;02;Maanantai;1;4;5;1;2;3
89;24.08.2015;2015;08;03;Maanantai;0;2;2;2;1;3
89;24.08.2015;2015;08;04;Maanantai;4;1;5;0;0;0
89;24.08.2015;2015;08;05;Maanantai;8;21;29;0;1;1
89;24.08.2015;2015;08;06;Maanantai;26;88;114;2;5;7
89;24.08.2015;2015;08;07;Maanantai;65;239;304;2;17;19
89;24.08.2015;2015;08;08;Maanantai;63;366;429;8;40;48
89;24.08.2015;2015;08;09;Maanantai;83;194;277;11;31;42
89;24.08.2015;2015;08;10;Maanantai;77;127;204;27;17;44
89;24.08.2015;2015;08;11;Maanantai;100;139;239;14;34;48
89;24.08.2015;2015;08;12;Maanantai;125;149;274;18;33;51
89;24.08.2015;2015;08;13;Maanantai;154;143;297;34;57;91
89;24.08.2015;2015;08;14;Maanantai;221;131;352;29;31;60
89;24.08.2015;2015;08;15;Maanantai;276;164;440;32;21;53
89;24.08.2015;2015;08;16;Maanantai;357;153;510;36;40;76
89;24.08.2015;2015;08;17;Maanantai;199;164;363;39;28;67
89;24.08.2015;2015;08;18;Maanantai;167;110;277;42;43;85
89;24.08.2015;2015;08;19;Maanantai;130;118;248;50;36;86
89;24.08.2015;2015;08;20;Maanantai;116;73;189;36;55;91
89;24.08.2015;2015;08;21;Maanantai;77;33;110;18;12;30
89;24.08.2015;2015;08;22;Maanantai;25;18;43;9;7;16
89;24.08.2015;2015;08;23;Maanantai;5;6;11;3;4;7
89;25.08.2015;2015;08;00;Tiistai;9;9;18;0;0;0
89;25.08.2015;2015;08;01;Tiistai;3;0;3;0;0;0
89;25.08.2015;2015;08;02;Tiistai;1;4;5;1;1;2
89;25.08.2015;2015;08;03;Tiistai;2;2;4;1;0;1
89;25.08.2015;2015;08;04;Tiistai;1;4;5;0;1;1
89;25.08.2015;2015;08;05;Tiistai;5;15;20;0;0;0
89;25.08.2015;2015;08;06;Tiistai;16;93;109;7;4;11
89;25.08.2015;2015;08;07;Tiistai;69;277;346;7;30;37
89;25.08.2015;2015;08;08;Tiistai;79;352;431;10;45;55
89;25.08.2015;2015;08;09;Tiistai;63;183;246;18;27;45
89;25.08.2015;2015;08;10;Tiistai;89;138;227;24;52;76
89;25.08.2015;2015;08;11;Tiistai;104;157;261;22;31;53
89;25.08.2015;2015;08;12;Tiistai;134;133;267;20;30;50
89;25.08.2015;2015;08;13;Tiistai;156;151;307;24;45;69
89;25.08.2015;2015;08;14;Tiistai;210;140;350;53;30;83
89;25.08.2015;2015;08;15;Tiistai;321;162;483;18;27;45
89;25.08.2015;2015;08;16;Tiistai;399;228;627;58;27;85
89;25.08.2015;2015;08;17;Tiistai;237;206;443;36;48;84
89;25.08.2015;2015;08;18;Tiistai;224;152;376;57;57;114
89;25.08.2015;2015;08;19;Tiistai;208;135;343;51;50;101
89;25.08.2015;2015;08;20;Tiistai;149;99;248;33;32;65
89;25.08.2015;2015;08;21;Tiistai;86;51;137;12;26;38
89;25.08.2015;2015;08;22;Tiistai;38;15;53;7;8;15
89;25.08.2015;2015;08;23;Tiistai;12;11;23;4;0;4
89;26.08.2015;2015;08;00;Keskiviikko;9;3;12;1;0;1
89;26.08.2015;2015;08;01;Keskiviikko;7;2;9;0;1;1
89;26.08.2015;2015;08;02;Keskiviikko;6;0;6;4;0;4
89;26.08.2015;2015;08;03;Keskiviikko;3;2;5;0;2;2
89;26.08.2015;2015;08;04;Keskiviikko;5;5;10;0;0;0
89;26.08.2015;2015;08;05;Keskiviikko;6;16;22;0;0;0
89;26.08.2015;2015;08;06;Keskiviikko;19;90;109;4;3;7
89;26.08.2015;2015;08;07;Keskiviikko;60;263;323;7;24;31
89;26.08.2015;2015;08;08;Keskiviikko;85;346;431;8;48;56
89;26.08.2015;2015;08;09;Keskiviikko;56;194;250;13;36;49
89;26.08.2015;2015;08;10;Keskiviikko;88;113;201;14;36;50
89;26.08.2015;2015;08;11;Keskiviikko;83;144;227;19;33;52
89;26.08.2015;2015;08;12;Keskiviikko;150;118;268;20;25;45
89;26.08.2015;2015;08;13;Keskiviikko;147;133;280;26;28;54
89;26.08.2015;2015;08;14;Keskiviikko;229;140;369;24;28;52
89;26.08.2015;2015;08;15;Keskiviikko;271;162;433;22;28;50
89;26.08.2015;2015;08;16;Keskiviikko;415;203;618;46;47;93
89;26.08.2015;2015;08;17;Keskiviikko;252;155;407;40;54;94
89;26.08.2015;2015;08;18;Keskiviikko;184;114;298;36;33;69
89;26.08.2015;2015;08;19;Keskiviikko;180;117;297;33;55;88
89;26.08.2015;2015;08;20;Keskiviikko;135;94;229;33;37;70
89;26.08.2015;2015;08;21;Keskiviikko;92;53;145;15;14;29
89;26.08.2015;2015;08;22;Keskiviikko;43;29;72;8;10;18
89;26.08.2015;2015;08;23;Keskiviikko;12;13;25;5;4;9
89;27.08.2015;2015;08;00;Torstai;11;5;16;3;1;4
89;27.08.2015;2015;08;01;Torstai;8;2;10;3;3;6
89;27.08.2015;2015;08;02;Torstai;3;1;4;0;0;0
89;27.08.2015;2015;08;03;Torstai;9;1;10;4;0;4
89;27.08.2015;2015;08;04;Torstai;2;2;4;1;0;1
89;27.08.2015;2015;08;05;Torstai;4;16;20;0;0;0
89;27.08.2015;2015;08;06;Torstai;18;84;102;2;7;9
89;27.08.2015;2015;08;07;Torstai;48;232;280;4;24;28
89;27.08.2015;2015;08;08;Torstai;75;292;367;15;30;45
89;27.08.2015;2015;08;09;Torstai;52;148;200;13;25;38
89;27.08.2015;2015;08;10;Torstai;51;118;169;12;32;44
89;27.08.2015;2015;08;11;Torstai;89;111;200;12;18;30
89;27.08.2015;2015;08;12;Torstai;94;118;212;23;26;49
89;27.08.2015;2015;08;13;Torstai;109;130;239;23;50;73
89;27.08.2015;2015;08;14;Torstai;183;109;292;43;26;69
89;27.08.2015;2015;08;15;Torstai;250;132;382;28;21;49
89;27.08.2015;2015;08;16;Torstai;250;125;375;29;16;45
89;27.08.2015;2015;08;17;Torstai;162;94;256;15;15;30
89;27.08.2015;2015;08;18;Torstai;119;78;197;21;29;50
89;27.08.2015;2015;08;19;Torstai;88;74;162;21;47;68
89;27.08.2015;2015;08;20;Torstai;108;58;166;31;25;56
89;27.08.2015;2015;08;21;Torstai;63;41;104;19;15;34
89;27.08.2015;2015;08;22;Torstai;28;25;53;5;10;15
89;27.08.2015;2015;08;23;Torstai;14;8;22;2;4;6
89;28.08.2015;2015;08;00;Perjantai;10;6;16;1;2;3
89;28.08.2015;2015;08;01;Perjantai;9;3;12;4;0;4
89;28.08.2015;2015;08;02;Perjantai;1;1;2;5;10;15
89;28.08.2015;2015;08;03;Perjantai;5;3;8;3;0;3
89;28.08.2015;2015;08;04;Perjantai;3;6;9;0;0;0
89;28.08.2015;2015;08;05;Perjantai;3;13;16;0;0;0
89;28.08.2015;2015;08;06;Perjantai;14;63;77;2;4;6
89;28.08.2015;2015;08;07;Perjantai;35;168;203;1;21;22
89;28.08.2015;2015;08;08;Perjantai;41;175;216;9;24;33
89;28.08.2015;2015;08;09;Perjantai;33;95;128;14;54;68
89;28.08.2015;2015;08;10;Perjantai;32;63;95;23;16;39
89;28.08.2015;2015;08;11;Perjantai;60;56;116;8;14;22
89;28.08.2015;2015;08;12;Perjantai;59;37;96;9;7;16
89;28.08.2015;2015;08;13;Perjantai;85;38;123;11;7;18
89;28.08.2015;2015;08;14;Perjantai;104;44;148;7;14;21
89;28.08.2015;2015;08;15;Perjantai;135;54;189;15;20;35
89;28.08.2015;2015;08;16;Perjantai;106;72;178;13;13;26
89;28.08.2015;2015;08;17;Perjantai;69;32;101;15;12;27
89;28.08.2015;2015;08;18;Perjantai;33;19;52;6;4;10
89;28.08.2015;2015;08;19;Perjantai;33;23;56;8;4;12
89;28.08.2015;2015;08;20;Perjantai;33;34;67;1;5;6
89;28.08.2015;2015;08;21;Perjantai;32;22;54;6;7;13
89;28.08.2015;2015;08;22;Perjantai;15;16;31;5;2;7
89;28.08.2015;2015;08;23;Perjantai;22;15;37;6;6;12
89;29.08.2015;2015;08;00;Lauantai;7;6;13;16;25;41
89;29.08.2015;2015;08;01;Lauantai;8;6;14;8;4;12
89;29.08.2015;2015;08;02;Lauantai;14;6;20;6;1;7
89;29.08.2015;2015;08;03;Lauantai;17;2;19;4;0;4
89;29.08.2015;2015;08;04;Lauantai;19;3;22;6;0;6
89;29.08.2015;2015;08;05;Lauantai;3;5;8;0;2;2
89;29.08.2015;2015;08;06;Lauantai;7;5;12;1;2;3
89;29.08.2015;2015;08;07;Lauantai;14;19;33;2;1;3
89;29.08.2015;2015;08;08;Lauantai;13;31;44;7;10;17
89;29.08.2015;2015;08;09;Lauantai;15;71;86;15;29;44
89;29.08.2015;2015;08;10;Lauantai;46;117;163;14;42;56
89;29.08.2015;2015;08;11;Lauantai;58;150;208;33;157;190
89;29.08.2015;2015;08;12;Lauantai;98;187;285;35;134;169
89;29.08.2015;2015;08;13;Lauantai;138;182;320;54;58;112
89;29.08.2015;2015;08;14;Lauantai;181;119;300;59;56;115
89;29.08.2015;2015;08;15;Lauantai;185;144;329;45;64;109
89;29.08.2015;2015;08;16;Lauantai;137;97;234;33;43;76
89;29.08.2015;2015;08;17;Lauantai;118;97;215;45;49;94
89;29.08.2015;2015;08;18;Lauantai;123;101;224;16;28;44
89;29.08.2015;2015;08;19;Lauantai;72;88;160;23;25;48
89;29.08.2015;2015;08;20;Lauantai;82;114;196;25;23;48
89;29.08.2015;2015;08;21;Lauantai;51;58;109;7;19;26
89;29.08.2015;2015;08;22;Lauantai;29;60;89;3;17;20
89;29.08.2015;2015;08;23;Lauantai;19;44;63;3;10;13
89;30.08.2015;2015;08;00;Sunnuntai;38;22;60;5;9;14
89;30.08.2015;2015;08;01;Sunnuntai;30;15;45;6;2;8
89;30.08.2015;2015;08;02;Sunnuntai;32;4;36;6;1;7
89;30.08.2015;2015;08;03;Sunnuntai;56;7;63;5;0;5
89;30.08.2015;2015;08;04;Sunnuntai;21;5;26;6;0;6
89;30.08.2015;2015;08;05;Sunnuntai;16;3;19;1;0;1
89;30.08.2015;2015;08;06;Sunnuntai;5;6;11;1;2;3
89;30.08.2015;2015;08;07;Sunnuntai;7;8;15;1;4;5
89;30.08.2015;2015;08;08;Sunnuntai;11;16;27;5;9;14
89;30.08.2015;2015;08;09;Sunnuntai;21;33;54;14;29;43
89;30.08.2015;2015;08;10;Sunnuntai;37;66;103;32;28;60
89;30.08.2015;2015;08;11;Sunnuntai;53;110;163;39;44;83
89;30.08.2015;2015;08;12;Sunnuntai;93;120;213;43;47;90
89;30.08.2015;2015;08;13;Sunnuntai;87;112;199;59;66;125
89;30.08.2015;2015;08;14;Sunnuntai;140;105;245;36;51;87
89;30.08.2015;2015;08;15;Sunnuntai;109;114;223;38;43;81
89;30.08.2015;2015;08;16;Sunnuntai;129;133;262;28;38;66
89;30.08.2015;2015;08;17;Sunnuntai;120;110;230;30;34;64
89;30.08.2015;2015;08;18;Sunnuntai;137;78;215;47;47;94
89;30.08.2015;2015;08;19;Sunnuntai;83;71;154;29;32;61
89;30.08.2015;2015;08;20;Sunnuntai;63;50;113;17;26;43
89;30.08.2015;2015;08;21;Sunnuntai;31;40;71;11;16;27
89;30.08.2015;2015;08;22;Sunnuntai;25;16;41;7;5;12
89;30.08.2015;2015;08;23;Sunnuntai;13;12;25;3;1;4
89;31.08.2015;2015;08;00;Maanantai;4;4;8;1;1;2
89;31.08.2015;2015;08;01;Maanantai;5;4;9;1;0;1
89;31.08.2015;2015;08;02;Maanantai;1;7;8;1;0;1
89;31.08.2015;2015;08;03;Maanantai;2;0;2;2;0;2
89;31.08.2015;2015;08;04;Maanantai;1;3;4;1;0;1
89;31.08.2015;2015;08;05;Maanantai;6;28;34;0;0;0
89;31.08.2015;2015;08;06;Maanantai;18;77;95;2;5;7
89;31.08.2015;2015;08;07;Maanantai;53;249;302;6;16;22
89;31.08.2015;2015;08;08;Maanantai;60;312;372;7;33;40
89;31.08.2015;2015;08;09;Maanantai;61;207;268;10;34;44
89;31.08.2015;2015;08;10;Maanantai;75;205;280;18;33;51
89;31.08.2015;2015;08;11;Maanantai;115;146;261;28;30;58
89;31.08.2015;2015;08;12;Maanantai;140;135;275;26;26;52
89;31.08.2015;2015;08;13;Maanantai;155;129;284;24;25;49
89;31.08.2015;2015;08;14;Maanantai;248;140;388;25;27;52
89;31.08.2015;2015;08;15;Maanantai;287;154;441;36;22;58
89;31.08.2015;2015;08;16;Maanantai;304;139;443;42;23;65
89;31.08.2015;2015;08;17;Maanantai;194;137;331;27;32;59
89;31.08.2015;2015;08;18;Maanantai;165;101;266;32;45;77
89;31.08.2015;2015;08;19;Maanantai;136;75;211;36;31;67
89;31.08.2015;2015;08;20;Maanantai;82;56;138;24;28;52
89;31.08.2015;2015;08;21;Maanantai;61;39;100;13;18;31
89;31.08.2015;2015;08;22;Maanantai;22;26;48;3;5;8
89;31.08.2015;2015;08;23;Maanantai;7;4;11;0;4;4
89;01.09.2015;2015;09;00;Tiistai;3;4;7;3;0;3
89;01.09.2015;2015;09;01;Tiistai;1;0;1;1;0;1
89;01.09.2015;2015;09;02;Tiistai;1;1;2;0;1;1
89;01.09.2015;2015;09;03;Tiistai;1;2;3;0;0;0
89;01.09.2015;2015;09;04;Tiistai;1;3;4;2;0;2
89;01.09.2015;2015;09;05;Tiistai;3;24;27;1;0;1
89;01.09.2015;2015;09;06;Tiistai;24;73;97;6;7;13
89;01.09.2015;2015;09;07;Tiistai;53;194;247;0;14;14
89;01.09.2015;2015;09;08;Tiistai;71;305;376;10;37;47
89;01.09.2015;2015;09;09;Tiistai;76;158;234;20;29;49
89;01.09.2015;2015;09;10;Tiistai;69;144;213;23;30;53
89;01.09.2015;2015;09;11;Tiistai;109;95;204;41;30;71
89;01.09.2015;2015;09;12;Tiistai;97;125;222;17;27;44
89;01.09.2015;2015;09;13;Tiistai;113;114;227;17;23;40
89;01.09.2015;2015;09;14;Tiistai;197;127;324;28;18;46
89;01.09.2015;2015;09;15;Tiistai;235;156;391;25;16;41
89;01.09.2015;2015;09;16;Tiistai;306;169;475;37;23;60
89;01.09.2015;2015;09;17;Tiistai;183;112;295;44;34;78
89;01.09.2015;2015;09;18;Tiistai;161;109;270;29;29;58
89;01.09.2015;2015;09;19;Tiistai;145;84;229;30;44;74
89;01.09.2015;2015;09;20;Tiistai;108;56;164;30;26;56
89;01.09.2015;2015;09;21;Tiistai;61;30;91;8;21;29
89;01.09.2015;2015;09;22;Tiistai;17;10;27;4;4;8
89;01.09.2015;2015;09;23;Tiistai;8;23;31;2;5;7
89;02.09.2015;2015;09;00;Keskiviikko;7;3;10;0;1;1
89;02.09.2015;2015;09;01;Keskiviikko;9;3;12;1;0;1
89;02.09.2015;2015;09;02;Keskiviikko;4;0;4;1;2;3
89;02.09.2015;2015;09;03;Keskiviikko;3;2;5;2;0;2
89;02.09.2015;2015;09;04;Keskiviikko;4;6;10;0;0;0
89;02.09.2015;2015;09;05;Keskiviikko;7;19;26;1;0;1
89;02.09.2015;2015;09;06;Keskiviikko;17;67;84;7;8;15
89;02.09.2015;2015;09;07;Keskiviikko;57;249;306;6;26;32
89;02.09.2015;2015;09;08;Keskiviikko;66;323;389;18;44;62
89;02.09.2015;2015;09;09;Keskiviikko;48;186;234;16;22;38
89;02.09.2015;2015;09;10;Keskiviikko;55;106;161;14;20;34
89;02.09.2015;2015;09;11;Keskiviikko;94;121;215;9;20;29
89;02.09.2015;2015;09;12;Keskiviikko;99;101;200;27;18;45
89;02.09.2015;2015;09;13;Keskiviikko;167;116;283;16;23;39
89;02.09.2015;2015;09;14;Keskiviikko;181;134;315;27;29;56
89;02.09.2015;2015;09;15;Keskiviikko;209;118;327;19;21;40
89;02.09.2015;2015;09;16;Keskiviikko;330;160;490;25;8;33
89;02.09.2015;2015;09;17;Keskiviikko;176;136;312;29;30;59
89;02.09.2015;2015;09;18;Keskiviikko;144;90;234;22;29;51
89;02.09.2015;2015;09;19;Keskiviikko;112;54;166;42;49;91
89;02.09.2015;2015;09;20;Keskiviikko;81;50;131;25;28;53
89;02.09.2015;2015;09;21;Keskiviikko;58;43;101;15;10;25
89;02.09.2015;2015;09;22;Keskiviikko;26;37;63;5;4;9
89;02.09.2015;2015;09;23;Keskiviikko;5;15;20;1;3;4
89;03.09.2015;2015;09;00;Torstai;6;4;10;2;0;2
89;03.09.2015;2015;09;01;Torstai;19;11;30;1;0;1
89;03.09.2015;2015;09;02;Torstai;7;3;10;0;1;1
89;03.09.2015;2015;09;03;Torstai;6;1;7;1;1;2
89;03.09.2015;2015;09;04;Torstai;3;5;8;1;1;2
89;03.09.2015;2015;09;05;Torstai;4;18;22;0;1;1
89;03.09.2015;2015;09;06;Torstai;24;71;95;6;7;13
89;03.09.2015;2015;09;07;Torstai;52;250;302;3;17;20
89;03.09.2015;2015;09;08;Torstai;73;339;412;15;45;60
89;03.09.2015;2015;09;09;Torstai;47;167;214;13;27;40
89;03.09.2015;2015;09;10;Torstai;65;117;182;21;26;47
89;03.09.2015;2015;09;11;Torstai;98;96;194;18;30;48
89;03.09.2015;2015;09;12;Torstai;89;97;186;22;20;42
89;03.09.2015;2015;09;13;Torstai;119;127;246;20;27;47
89;03.09.2015;2015;09;14;Torstai;194;122;316;27;28;55
89;03.09.2015;2015;09;15;Torstai;247;144;391;33;16;49
89;03.09.2015;2015;09;16;Torstai;303;161;464;26;25;51
89;03.09.2015;2015;09;17;Torstai;155;122;277;18;13;31
89;03.09.2015;2015;09;18;Torstai;157;75;232;27;29;56
89;03.09.2015;2015;09;19;Torstai;135;87;222;27;29;56
89;03.09.2015;2015;09;20;Torstai;79;43;122;18;30;48
89;03.09.2015;2015;09;21;Torstai;62;38;100;10;13;23
89;03.09.2015;2015;09;22;Torstai;19;26;45;3;2;5
89;03.09.2015;2015;09;23;Torstai;13;23;36;1;4;5
89;04.09.2015;2015;09;00;Perjantai;11;4;15;3;0;3
89;04.09.2015;2015;09;01;Perjantai;12;5;17;1;0;1
89;04.09.2015;2015;09;02;Perjantai;20;3;23;0;0;0
89;04.09.2015;2015;09;03;Perjantai;7;1;8;1;0;1
89;04.09.2015;2015;09;04;Perjantai;11;5;16;0;0;0
89;04.09.2015;2015;09;05;Perjantai;7;17;24;0;0;0
89;04.09.2015;2015;09;06;Perjantai;18;54;72;4;3;7
89;04.09.2015;2015;09;07;Perjantai;58;193;251;3;18;21
89;04.09.2015;2015;09;08;Perjantai;53;259;312;7;31;38
89;04.09.2015;2015;09;09;Perjantai;64;161;225;13;25;38
89;04.09.2015;2015;09;10;Perjantai;47;107;154;24;27;51
89;04.09.2015;2015;09;11;Perjantai;80;117;197;23;38;61
89;04.09.2015;2015;09;12;Perjantai;82;120;202;16;15;31
89;04.09.2015;2015;09;13;Perjantai;136;183;319;26;31;57
89;04.09.2015;2015;09;14;Perjantai;242;144;386;30;26;56
89;04.09.2015;2015;09;15;Perjantai;272;137;409;29;22;51
89;04.09.2015;2015;09;16;Perjantai;233;104;337;22;15;37
89;04.09.2015;2015;09;17;Perjantai;129;124;253;24;22;46
89;04.09.2015;2015;09;18;Perjantai;104;78;182;21;18;39
89;04.09.2015;2015;09;19;Perjantai;84;75;159;20;32;52
89;04.09.2015;2015;09;20;Perjantai;78;71;149;19;22;41
89;04.09.2015;2015;09;21;Perjantai;45;49;94;5;20;25
89;04.09.2015;2015;09;22;Perjantai;33;25;58;6;8;14
89;04.09.2015;2015;09;23;Perjantai;22;10;32;2;8;10
89;05.09.2015;2015;09;00;Lauantai;17;36;53;1;4;5
89;05.09.2015;2015;09;01;Lauantai;21;10;31;4;1;5
89;05.09.2015;2015;09;02;Lauantai;25;19;44;9;2;11
89;05.09.2015;2015;09;03;Lauantai;21;3;24;10;0;10
89;05.09.2015;2015;09;04;Lauantai;15;2;17;5;0;5
89;05.09.2015;2015;09;05;Lauantai;5;4;9;2;1;3
89;05.09.2015;2015;09;06;Lauantai;6;8;14;0;2;2
89;05.09.2015;2015;09;07;Lauantai;9;19;28;2;2;4
89;05.09.2015;2015;09;08;Lauantai;21;40;61;11;16;27
89;05.09.2015;2015;09;09;Lauantai;20;58;78;39;23;62
89;05.09.2015;2015;09;10;Lauantai;21;96;117;21;40;61
89;05.09.2015;2015;09;11;Lauantai;59;124;183;13;33;46
89;05.09.2015;2015;09;12;Lauantai;87;125;212;30;38;68
89;05.09.2015;2015;09;13;Lauantai;89;107;196;20;38;58
89;05.09.2015;2015;09;14;Lauantai;79;88;167;19;23;42
89;05.09.2015;2015;09;15;Lauantai;110;67;177;17;25;42
89;05.09.2015;2015;09;16;Lauantai;99;60;159;28;21;49
89;05.09.2015;2015;09;17;Lauantai;74;47;121;18;17;35
89;05.09.2015;2015;09;18;Lauantai;77;64;141;23;25;48
89;05.09.2015;2015;09;19;Lauantai;64;57;121;15;26;41
89;05.09.2015;2015;09;20;Lauantai;53;56;109;16;29;45
89;05.09.2015;2015;09;21;Lauantai;38;46;84;6;11;17
89;05.09.2015;2015;09;22;Lauantai;13;32;45;5;7;12
89;05.09.2015;2015;09;23;Lauantai;19;29;48;2;11;13
89;06.09.2015;2015;09;00;Sunnuntai;18;16;34;6;8;14
89;06.09.2015;2015;09;01;Sunnuntai;22;17;39;4;4;8
89;06.09.2015;2015;09;02;Sunnuntai;23;5;28;4;2;6
89;06.09.2015;2015;09;03;Sunnuntai;26;3;29;7;4;11
89;06.09.2015;2015;09;04;Sunnuntai;21;2;23;4;1;5
89;06.09.2015;2015;09;05;Sunnuntai;2;6;8;3;1;4
89;06.09.2015;2015;09;06;Sunnuntai;3;8;11;1;2;3
89;06.09.2015;2015;09;07;Sunnuntai;5;7;12;2;3;5
89;06.09.2015;2015;09;08;Sunnuntai;5;9;14;13;6;19
89;06.09.2015;2015;09;09;Sunnuntai;11;25;36;9;17;26
89;06.09.2015;2015;09;10;Sunnuntai;15;16;31;15;19;34
89;06.09.2015;2015;09;11;Sunnuntai;8;24;32;8;9;17
89;06.09.2015;2015;09;12;Sunnuntai;28;35;63;21;15;36
89;06.09.2015;2015;09;13;Sunnuntai;35;43;78;27;28;55
89;06.09.2015;2015;09;14;Sunnuntai;37;40;77;13;11;24
89;06.09.2015;2015;09;15;Sunnuntai;50;25;75;20;11;31
89;06.09.2015;2015;09;16;Sunnuntai;36;52;88;22;25;47
89;06.09.2015;2015;09;17;Sunnuntai;59;47;106;26;28;54
89;06.09.2015;2015;09;18;Sunnuntai;57;44;101;28;22;50
89;06.09.2015;2015;09;19;Sunnuntai;35;36;71;14;26;40
89;06.09.2015;2015;09;20;Sunnuntai;31;17;48;14;21;35
89;06.09.2015;2015;09;21;Sunnuntai;31;14;45;14;10;24
89;06.09.2015;2015;09;22;Sunnuntai;9;5;14;4;1;5
89;06.09.2015;2015;09;23;Sunnuntai;6;3;9;5;0;5
89;07.09.2015;2015;09;00;Maanantai;5;2;7;1;0;1
89;07.09.2015;2015;09;01;Maanantai;8;1;9;1;1;2
89;07.09.2015;2015;09;02;Maanantai;2;0;2;0;1;1
89;07.09.2015;2015;09;03;Maanantai;2;3;5;0;1;1
89;07.09.2015;2015;09;04;Maanantai;1;5;6;0;0;0
89;07.09.2015;2015;09;05;Maanantai;3;20;23;0;1;1
89;07.09.2015;2015;09;06;Maanantai;18;59;77;2;6;8
89;07.09.2015;2015;09;07;Maanantai;51;206;257;2;16;18
89;07.09.2015;2015;09;08;Maanantai;49;298;347;9;35;44
89;07.09.2015;2015;09;09;Maanantai;56;189;245;12;38;50
89;07.09.2015;2015;09;10;Maanantai;55;100;155;22;25;47
89;07.09.2015;2015;09;11;Maanantai;79;91;170;20;29;49
89;07.09.2015;2015;09;12;Maanantai;79;91;170;13;21;34
89;07.09.2015;2015;09;13;Maanantai;118;100;218;24;24;48
89;07.09.2015;2015;09;14;Maanantai;175;92;267;25;23;48
89;07.09.2015;2015;09;15;Maanantai;202;111;313;36;31;67
89;07.09.2015;2015;09;16;Maanantai;290;137;427;27;19;46
89;07.09.2015;2015;09;17;Maanantai;139;95;234;33;22;55
89;07.09.2015;2015;09;18;Maanantai;127;81;208;22;33;55
89;07.09.2015;2015;09;19;Maanantai;100;58;158;30;28;58
89;07.09.2015;2015;09;20;Maanantai;69;43;112;24;27;51
89;07.09.2015;2015;09;21;Maanantai;46;30;76;11;12;23
89;07.09.2015;2015;09;22;Maanantai;21;14;35;4;4;8
89;07.09.2015;2015;09;23;Maanantai;4;10;14;1;1;2
89;08.09.2015;2015;09;00;Tiistai;2;7;9;2;3;5
89;08.09.2015;2015;09;01;Tiistai;2;0;2;2;1;3
89;08.09.2015;2015;09;02;Tiistai;1;1;2;0;0;0
89;08.09.2015;2015;09;03;Tiistai;0;3;3;0;0;0
89;08.09.2015;2015;09;04;Tiistai;1;5;6;0;1;1
89;08.09.2015;2015;09;05;Tiistai;4;7;11;0;1;1
89;08.09.2015;2015;09;06;Tiistai;28;68;96;6;10;16
89;08.09.2015;2015;09;07;Tiistai;55;248;303;8;24;32
89;08.09.2015;2015;09;08;Tiistai;65;286;351;6;36;42
89;08.09.2015;2015;09;09;Tiistai;48;199;247;6;38;44
89;08.09.2015;2015;09;10;Tiistai;66;115;181;32;14;46
89;08.09.2015;2015;09;11;Tiistai;70;88;158;19;17;36
89;08.09.2015;2015;09;12;Tiistai;87;94;181;7;19;26
89;08.09.2015;2015;09;13;Tiistai;111;123;234;11;36;47
89;08.09.2015;2015;09;14;Tiistai;182;101;283;18;17;35
89;08.09.2015;2015;09;15;Tiistai;245;122;367;29;22;51
89;08.09.2015;2015;09;16;Tiistai;309;149;458;34;19;53
89;08.09.2015;2015;09;17;Tiistai;141;106;247;32;30;62
89;08.09.2015;2015;09;18;Tiistai;144;98;242;30;43;73
89;08.09.2015;2015;09;19;Tiistai;111;77;188;40;45;85
89;08.09.2015;2015;09;20;Tiistai;95;53;148;21;32;53
89;08.09.2015;2015;09;21;Tiistai;33;26;59;13;10;23
89;08.09.2015;2015;09;22;Tiistai;25;12;37;8;6;14
89;08.09.2015;2015;09;23;Tiistai;11;7;18;0;1;1
89;09.09.2015;2015;09;00;Keskiviikko;6;2;8;0;0;0
89;09.09.2015;2015;09;01;Keskiviikko;5;2;7;0;2;2
89;09.09.2015;2015;09;02;Keskiviikko;2;1;3;0;0;0
89;09.09.2015;2015;09;03;Keskiviikko;2;3;5;0;0;0
89;09.09.2015;2015;09;04;Keskiviikko;6;6;12;1;0;1
89;09.09.2015;2015;09;05;Keskiviikko;1;13;14;0;1;1
89;09.09.2015;2015;09;06;Keskiviikko;23;69;92;1;10;11
89;09.09.2015;2015;09;07;Keskiviikko;58;233;291;6;23;29
89;09.09.2015;2015;09;08;Keskiviikko;61;336;397;9;37;46
89;09.09.2015;2015;09;09;Keskiviikko;65;194;259;16;31;47
89;09.09.2015;2015;09;10;Keskiviikko;62;117;179;13;26;39
89;09.09.2015;2015;09;11;Keskiviikko;105;110;215;24;23;47
89;09.09.2015;2015;09;12;Keskiviikko;99;110;209;26;15;41
89;09.09.2015;2015;09;13;Keskiviikko;132;97;229;11;30;41
89;09.09.2015;2015;09;14;Keskiviikko;186;136;322;25;28;53
89;09.09.2015;2015;09;15;Keskiviikko;221;121;342;19;21;40
89;09.09.2015;2015;09;16;Keskiviikko;299;162;461;32;20;52
89;09.09.2015;2015;09;17;Keskiviikko;141;152;293;34;32;66
89;09.09.2015;2015;09;18;Keskiviikko;162;160;322;34;31;65
89;09.09.2015;2015;09;19;Keskiviikko;128;120;248;28;38;66
89;09.09.2015;2015;09;20;Keskiviikko;86;76;162;28;14;42
89;09.09.2015;2015;09;21;Keskiviikko;72;64;136;12;11;23
89;09.09.2015;2015;09;22;Keskiviikko;41;34;75;6;0;6
89;09.09.2015;2015;09;23;Keskiviikko;40;13;53;1;4;5
89;10.09.2015;2015;09;00;Torstai;70;11;81;2;1;3
89;10.09.2015;2015;09;01;Torstai;35;6;41;9;1;10
89;10.09.2015;2015;09;02;Torstai;24;1;25;0;2;2
89;10.09.2015;2015;09;03;Torstai;21;2;23;1;0;1
89;10.09.2015;2015;09;04;Torstai;10;5;15;3;0;3
89;10.09.2015;2015;09;05;Torstai;8;15;23;1;3;4
89;10.09.2015;2015;09;06;Torstai;19;61;80;3;9;12
89;10.09.2015;2015;09;07;Torstai;50;242;292;9;18;27
89;10.09.2015;2015;09;08;Torstai;65;355;420;10;37;47
89;10.09.2015;2015;09;09;Torstai;65;153;218;18;46;64
89;10.09.2015;2015;09;10;Torstai;58;111;169;30;31;61
89;10.09.2015;2015;09;11;Torstai;73;119;192;25;36;61
89;10.09.2015;2015;09;12;Torstai;119;126;245;24;25;49
89;10.09.2015;2015;09;13;Torstai;166;108;274;23;29;52
89;10.09.2015;2015;09;14;Torstai;226;130;356;28;39;67
89;10.09.2015;2015;09;15;Torstai;216;158;374;41;25;66
89;10.09.2015;2015;09;16;Torstai;273;158;431;27;22;49
89;10.09.2015;2015;09;17;Torstai;164;114;278;34;21;55
89;10.09.2015;2015;09;18;Torstai;148;123;271;32;29;61
89;10.09.2015;2015;09;19;Torstai;109;73;182;34;40;74
89;10.09.2015;2015;09;20;Torstai;96;52;148;23;21;44
89;10.09.2015;2015;09;21;Torstai;65;33;98;9;16;25
89;10.09.2015;2015;09;22;Torstai;37;14;51;5;2;7
89;10.09.2015;2015;09;23;Torstai;11;9;20;2;1;3
89;11.09.2015;2015;09;00;Perjantai;9;2;11;1;5;6
89;11.09.2015;2015;09;01;Perjantai;12;0;12;1;1;2
89;11.09.2015;2015;09;02;Perjantai;5;2;7;2;1;3
89;11.09.2015;2015;09;03;Perjantai;0;2;2;0;0;0
89;11.09.2015;2015;09;04;Perjantai;4;8;12;0;2;2
89;11.09.2015;2015;09;05;Perjantai;6;12;18;0;1;1
89;11.09.2015;2015;09;06;Perjantai;15;56;71;1;8;9
89;11.09.2015;2015;09;07;Perjantai;58;192;250;5;21;26
89;11.09.2015;2015;09;08;Perjantai;48;292;340;8;27;35
89;11.09.2015;2015;09;09;Perjantai;53;172;225;26;46;72
89;11.09.2015;2015;09;10;Perjantai;56;124;180;9;26;35
89;11.09.2015;2015;09;11;Perjantai;93;125;218;16;40;56
89;11.09.2015;2015;09;12;Perjantai;107;119;226;21;27;48
89;11.09.2015;2015;09;13;Perjantai;149;136;285;25;20;45
89;11.09.2015;2015;09;14;Perjantai;207;130;337;36;37;73
89;11.09.2015;2015;09;15;Perjantai;242;133;375;20;21;41
89;11.09.2015;2015;09;16;Perjantai;232;149;381;20;13;33
89;11.09.2015;2015;09;17;Perjantai;144;127;271;31;39;70
89;11.09.2015;2015;09;18;Perjantai;98;112;210;31;68;99
89;11.09.2015;2015;09;19;Perjantai;100;77;177;27;28;55
89;11.09.2015;2015;09;20;Perjantai;59;81;140;24;27;51
89;11.09.2015;2015;09;21;Perjantai;69;39;108;17;17;34
89;11.09.2015;2015;09;22;Perjantai;41;35;76;6;6;12
89;11.09.2015;2015;09;23;Perjantai;25;31;56;3;2;5
89;12.09.2015;2015;09;00;Lauantai;17;8;25;1;1;2
89;12.09.2015;2015;09;01;Lauantai;9;7;16;9;4;13
89;12.09.2015;2015;09;02;Lauantai;23;2;25;3;0;3
89;12.09.2015;2015;09;03;Lauantai;19;0;19;2;1;3
89;12.09.2015;2015;09;04;Lauantai;18;6;24;2;0;2
89;12.09.2015;2015;09;05;Lauantai;5;2;7;3;1;4
89;12.09.2015;2015;09;06;Lauantai;3;17;20;0;2;2
89;12.09.2015;2015;09;07;Lauantai;6;25;31;4;8;12
89;12.09.2015;2015;09;08;Lauantai;8;44;52;7;17;24
89;12.09.2015;2015;09;09;Lauantai;25;78;103;15;26;41
89;12.09.2015;2015;09;10;Lauantai;30;82;112;13;40;53
89;12.09.2015;2015;09;11;Lauantai;54;114;168;30;44;74
89;12.09.2015;2015;09;12;Lauantai;91;128;219;29;39;68
89;12.09.2015;2015;09;13;Lauantai;106;131;237;31;31;62
89;12.09.2015;2015;09;14;Lauantai;144;146;290;27;54;81
89;12.09.2015;2015;09;15;Lauantai;134;130;264;32;36;68
89;12.09.2015;2015;09;16;Lauantai;116;128;244;44;52;96
89;12.09.2015;2015;09;17;Lauantai;106;70;176;29;30;59
89;12.09.2015;2015;09;18;Lauantai;78;93;171;30;27;57
89;12.09.2015;2015;09;19;Lauantai;78;53;131;20;23;43
89;12.09.2015;2015;09;20;Lauantai;66;54;120;12;19;31
89;12.09.2015;2015;09;21;Lauantai;42;38;80;9;9;18
89;12.09.2015;2015;09;22;Lauantai;36;41;77;3;9;12
89;12.09.2015;2015;09;23;Lauantai;25;46;71;1;5;6
89;13.09.2015;2015;09;00;Sunnuntai;37;21;58;5;11;16
89;13.09.2015;2015;09;01;Sunnuntai;27;16;43;3;4;7
89;13.09.2015;2015;09;02;Sunnuntai;14;16;30;6;1;7
89;13.09.2015;2015;09;03;Sunnuntai;21;0;21;5;1;6
89;13.09.2015;2015;09;04;Sunnuntai;33;4;37;7;4;11
89;13.09.2015;2015;09;05;Sunnuntai;5;6;11;0;0;0
89;13.09.2015;2015;09;06;Sunnuntai;6;7;13;2;4;6
89;13.09.2015;2015;09;07;Sunnuntai;3;8;11;4;0;4
89;13.09.2015;2015;09;08;Sunnuntai;9;3;12;8;13;21
89;13.09.2015;2015;09;09;Sunnuntai;18;47;65;23;27;50
89;13.09.2015;2015;09;10;Sunnuntai;30;50;80;17;29;46
89;13.09.2015;2015;09;11;Sunnuntai;50;107;157;42;38;80
89;13.09.2015;2015;09;12;Sunnuntai;76;141;217;68;50;118
89;13.09.2015;2015;09;13;Sunnuntai;102;140;242;30;65;95
89;13.09.2015;2015;09;14;Sunnuntai;118;111;229;25;56;81
89;13.09.2015;2015;09;15;Sunnuntai;112;105;217;35;23;58
89;13.09.2015;2015;09;16;Sunnuntai;95;93;188;30;46;76
89;13.09.2015;2015;09;17;Sunnuntai;101;113;214;26;37;63
89;13.09.2015;2015;09;18;Sunnuntai;115;81;196;50;53;103
89;13.09.2015;2015;09;19;Sunnuntai;88;58;146;21;37;58
89;13.09.2015;2015;09;20;Sunnuntai;68;21;89;16;30;46
89;13.09.2015;2015;09;21;Sunnuntai;31;17;48;9;6;15
89;13.09.2015;2015;09;22;Sunnuntai;16;16;32;7;3;10
89;13.09.2015;2015;09;23;Sunnuntai;8;5;13;2;1;3
89;14.09.2015;2015;09;00;Maanantai;7;1;8;1;3;4
89;14.09.2015;2015;09;01;Maanantai;0;1;1;0;2;2
89;14.09.2015;2015;09;02;Maanantai;3;0;3;0;0;0
89;14.09.2015;2015;09;03;Maanantai;1;0;1;0;0;0
89;14.09.2015;2015;09;04;Maanantai;4;3;7;0;1;1
89;14.09.2015;2015;09;05;Maanantai;7;17;24;0;0;0
89;14.09.2015;2015;09;06;Maanantai;16;64;80;3;10;13
89;14.09.2015;2015;09;07;Maanantai;57;230;287;4;16;20
89;14.09.2015;2015;09;08;Maanantai;53;347;400;11;33;44
89;14.09.2015;2015;09;09;Maanantai;61;202;263;6;41;47
89;14.09.2015;2015;09;10;Maanantai;69;130;199;20;34;54
89;14.09.2015;2015;09;11;Maanantai;94;157;251;28;39;67
89;14.09.2015;2015;09;12;Maanantai;130;142;272;13;28;41
89;14.09.2015;2015;09;13;Maanantai;150;108;258;16;36;52
89;14.09.2015;2015;09;14;Maanantai;201;109;310;25;27;52
89;14.09.2015;2015;09;15;Maanantai;281;144;425;27;26;53
89;14.09.2015;2015;09;16;Maanantai;313;171;484;27;23;50
89;14.09.2015;2015;09;17;Maanantai;201;135;336;28;21;49
89;14.09.2015;2015;09;18;Maanantai;146;109;255;35;32;67
89;14.09.2015;2015;09;19;Maanantai;143;78;221;37;30;67
89;14.09.2015;2015;09;20;Maanantai;91;43;134;14;21;35
89;14.09.2015;2015;09;21;Maanantai;59;33;92;10;11;21
89;14.09.2015;2015;09;22;Maanantai;17;11;28;7;7;14
89;14.09.2015;2015;09;23;Maanantai;10;6;16;1;1;2
89;15.09.2015;2015;09;00;Tiistai;3;3;6;2;0;2
89;15.09.2015;2015;09;01;Tiistai;3;4;7;1;1;2
89;15.09.2015;2015;09;02;Tiistai;3;2;5;1;0;1
89;15.09.2015;2015;09;03;Tiistai;5;1;6;0;0;0
89;15.09.2015;2015;09;04;Tiistai;2;6;8;0;0;0
89;15.09.2015;2015;09;05;Tiistai;4;20;24;0;1;1
89;15.09.2015;2015;09;06;Tiistai;21;59;80;1;5;6
89;15.09.2015;2015;09;07;Tiistai;65;250;315;2;13;15
89;15.09.2015;2015;09;08;Tiistai;76;351;427;8;42;50
89;15.09.2015;2015;09;09;Tiistai;57;166;223;13;39;52
89;15.09.2015;2015;09;10;Tiistai;62;131;193;23;21;44
89;15.09.2015;2015;09;11;Tiistai;86;110;196;33;43;76
89;15.09.2015;2015;09;12;Tiistai;129;154;283;13;19;32
89;15.09.2015;2015;09;13;Tiistai;146;117;263;27;31;58
89;15.09.2015;2015;09;14;Tiistai;191;116;307;21;29;50
89;15.09.2015;2015;09;15;Tiistai;280;145;425;25;21;46
89;15.09.2015;2015;09;16;Tiistai;322;181;503;29;23;52
89;15.09.2015;2015;09;17;Tiistai;191;139;330;34;20;54
89;15.09.2015;2015;09;18;Tiistai;149;99;248;44;26;70
89;15.09.2015;2015;09;19;Tiistai;120;70;190;37;34;71
89;15.09.2015;2015;09;20;Tiistai;86;35;121;21;31;52
89;15.09.2015;2015;09;21;Tiistai;69;25;94;9;5;14
89;15.09.2015;2015;09;22;Tiistai;27;18;45;11;5;16
89;15.09.2015;2015;09;23;Tiistai;10;8;18;2;2;4
89;16.09.2015;2015;09;00;Keskiviikko;10;4;14;1;4;5
89;16.09.2015;2015;09;01;Keskiviikko;11;2;13;1;0;1
89;16.09.2015;2015;09;02;Keskiviikko;5;1;6;1;0;1
89;16.09.2015;2015;09;03;Keskiviikko;5;1;6;1;0;1
89;16.09.2015;2015;09;04;Keskiviikko;3;7;10;0;0;0
89;16.09.2015;2015;09;05;Keskiviikko;4;17;21;1;0;1
89;16.09.2015;2015;09;06;Keskiviikko;18;64;82;2;10;12
89;16.09.2015;2015;09;07;Keskiviikko;48;194;242;7;24;31
89;16.09.2015;2015;09;08;Keskiviikko;45;285;330;17;41;58
89;16.09.2015;2015;09;09;Keskiviikko;47;121;168;8;29;37
89;16.09.2015;2015;09;10;Keskiviikko;45;84;129;16;24;40
89;16.09.2015;2015;09;11;Keskiviikko;65;85;150;28;18;46
89;16.09.2015;2015;09;12;Keskiviikko;78;80;158;7;20;27
89;16.09.2015;2015;09;13;Keskiviikko;73;70;143;18;14;32
89;16.09.2015;2015;09;14;Keskiviikko;167;96;263;17;20;37
89;16.09.2015;2015;09;15;Keskiviikko;201;114;315;22;27;49
89;16.09.2015;2015;09;16;Keskiviikko;246;126;372;33;22;55
89;16.09.2015;2015;09;17;Keskiviikko;138;134;272;26;28;54
89;16.09.2015;2015;09;18;Keskiviikko;94;73;167;24;24;48
89;16.09.2015;2015;09;19;Keskiviikko;108;58;166;33;30;63
89;16.09.2015;2015;09;20;Keskiviikko;65;42;107;15;24;39
89;16.09.2015;2015;09;21;Keskiviikko;39;18;57;10;5;15
89;16.09.2015;2015;09;22;Keskiviikko;18;20;38;5;2;7
89;16.09.2015;2015;09;23;Keskiviikko;13;4;17;0;2;2
89;17.09.2015;2015;09;00;Torstai;13;8;21;4;2;6
89;17.09.2015;2015;09;01;Torstai;7;0;7;0;0;0
89;17.09.2015;2015;09;02;Torstai;6;1;7;0;1;1
89;17.09.2015;2015;09;03;Torstai;4;0;4;0;0;0
89;17.09.2015;2015;09;04;Torstai;4;5;9;0;1;1
89;17.09.2015;2015;09;05;Torstai;6;11;17;2;1;3
89;17.09.2015;2015;09;06;Torstai;18;66;84;1;5;6
89;17.09.2015;2015;09;07;Torstai;62;198;260;3;21;24
89;17.09.2015;2015;09;08;Torstai;71;315;386;10;36;46
89;17.09.2015;2015;09;09;Torstai;93;107;200;15;15;30
89;17.09.2015;2015;09;10;Torstai;71;69;140;20;20;40
89;17.09.2015;2015;09;11;Torstai;75;73;148;22;22;44
89;17.09.2015;2015;09;12;Torstai;92;91;183;24;24;48
89;17.09.2015;2015;09;13;Torstai;93;90;183;20;20;40
89;17.09.2015;2015;09;14;Torstai;113;111;224;18;18;36
89;17.09.2015;2015;09;15;Torstai;157;156;313;24;24;48
89;17.09.2015;2015;09;16;Torstai;186;183;369;30;30;60
89;17.09.2015;2015;09;17;Torstai;128;126;254;25;25;50
89;17.09.2015;2015;09;18;Torstai;118;117;235;20;20;40
89;17.09.2015;2015;09;19;Torstai;74;72;146;15;15;30
89;17.09.2015;2015;09;20;Torstai;55;53;108;10;10;20
89;17.09.2015;2015;09;21;Torstai;45;43;88;7;7;14
89;17.09.2015;2015;09;22;Torstai;21;11;32;4;2;6
89;17.09.2015;2015;09;23;Torstai;11;3;14;2;1;3
89;18.09.2015;2015;09;00;Perjantai;14;7;21;3;2;5
89;18.09.2015;2015;09;01;Perjantai;11;0;11;0;0;0
89;18.09.2015;2015;09;02;Perjantai;13;2;15;2;0;2
89;18.09.2015;2015;09;03;Perjantai;6;0;6;2;0;2
89;18.09.2015;2015;09;04;Perjantai;6;3;9;2;0;2
89;18.09.2015;2015;09;05;Perjantai;4;7;11;1;0;1
89;18.09.2015;2015;09;06;Perjantai;14;41;55;0;5;5
89;18.09.2015;2015;09;07;Perjantai;42;130;172;3;8;11
89;18.09.2015;2015;09;08;Perjantai;33;220;253;5;24;29
89;18.09.2015;2015;09;09;Perjantai;35;49;84;5;14;19
89;18.09.2015;2015;09;10;Perjantai;38;31;69;5;13;18
89;18.09.2015;2015;09;11;Perjantai;55;43;98;5;13;18
89;18.09.2015;2015;09;12;Perjantai;52;37;89;9;8;17
89;18.09.2015;2015;09;13;Perjantai;58;26;84;7;6;13
89;18.09.2015;2015;09;14;Perjantai;101;48;149;9;6;15
89;18.09.2015;2015;09;15;Perjantai;103;60;163;12;6;18
89;18.09.2015;2015;09;16;Perjantai;90;53;143;12;14;26
89;18.09.2015;2015;09;17;Perjantai;53;47;100;13;8;21
89;18.09.2015;2015;09;18;Perjantai;41;36;77;13;12;25
89;18.09.2015;2015;09;19;Perjantai;48;26;74;14;11;25
89;18.09.2015;2015;09;20;Perjantai;36;32;68;14;16;30
89;18.09.2015;2015;09;21;Perjantai;27;31;58;10;5;15
89;18.09.2015;2015;09;22;Perjantai;20;27;47;3;4;7
89;18.09.2015;2015;09;23;Perjantai;9;13;22;2;8;10
89;19.09.2015;2015;09;00;Lauantai;13;21;34;2;9;11
89;19.09.2015;2015;09;01;Lauantai;9;7;16;5;2;7
89;19.09.2015;2015;09;02;Lauantai;6;4;10;3;0;3
89;19.09.2015;2015;09;03;Lauantai;9;3;12;4;0;4
89;19.09.2015;2015;09;04;Lauantai;7;0;7;2;1;3
89;19.09.2015;2015;09;05;Lauantai;1;6;7;1;0;1
89;19.09.2015;2015;09;06;Lauantai;3;6;9;0;4;4
89;19.09.2015;2015;09;07;Lauantai;5;10;15;1;0;1
89;19.09.2015;2015;09;08;Lauantai;5;11;16;6;11;17
89;19.09.2015;2015;09;09;Lauantai;12;45;57;14;35;49
89;19.09.2015;2015;09;10;Lauantai;15;72;87;18;34;52
89;19.09.2015;2015;09;11;Lauantai;39;78;117;24;31;55
89;19.09.2015;2015;09;12;Lauantai;58;97;155;19;31;50
89;19.09.2015;2015;09;13;Lauantai;68;68;136;19;32;51
89;19.09.2015;2015;09;14;Lauantai;73;77;150;23;20;43
89;19.09.2015;2015;09;15;Lauantai;81;57;138;24;24;48
89;19.09.2015;2015;09;16;Lauantai;76;55;131;28;22;50
89;19.09.2015;2015;09;17;Lauantai;62;43;105;13;18;31
89;19.09.2015;2015;09;18;Lauantai;50;41;91;11;17;28
89;19.09.2015;2015;09;19;Lauantai;39;24;63;10;16;26
89;19.09.2015;2015;09;20;Lauantai;47;33;80;8;18;26
89;19.09.2015;2015;09;21;Lauantai;14;18;32;7;10;17
89;19.09.2015;2015;09;22;Lauantai;15;32;47;3;4;7
89;19.09.2015;2015;09;23;Lauantai;22;25;47;3;5;8
89;20.09.2015;2015;09;00;Sunnuntai;11;41;52;4;7;11
89;20.09.2015;2015;09;01;Sunnuntai;9;5;14;10;2;12
89;20.09.2015;2015;09;02;Sunnuntai;24;8;32;0;0;0
89;20.09.2015;2015;09;03;Sunnuntai;19;4;23;3;2;5
89;20.09.2015;2015;09;04;Sunnuntai;21;4;25;3;0;3
89;20.09.2015;2015;09;05;Sunnuntai;6;0;6;2;1;3
89;20.09.2015;2015;09;06;Sunnuntai;6;9;15;0;2;2
89;20.09.2015;2015;09;07;Sunnuntai;8;7;15;2;4;6
89;20.09.2015;2015;09;08;Sunnuntai;7;9;16;11;10;21
89;20.09.2015;2015;09;09;Sunnuntai;9;23;32;19;29;48
89;20.09.2015;2015;09;10;Sunnuntai;29;49;78;37;36;73
89;20.09.2015;2015;09;11;Sunnuntai;39;54;93;30;41;71
89;20.09.2015;2015;09;12;Sunnuntai;60;98;158;35;33;68
89;20.09.2015;2015;09;13;Sunnuntai;83;103;186;35;45;80
89;20.09.2015;2015;09;14;Sunnuntai;103;85;188;36;30;66
89;20.09.2015;2015;09;15;Sunnuntai;89;84;173;24;34;58
89;20.09.2015;2015;09;16;Sunnuntai;71;51;122;15;18;33
89;20.09.2015;2015;09;17;Sunnuntai;47;26;73;11;11;22
89;20.09.2015;2015;09;18;Sunnuntai;46;42;88;11;8;19
89;20.09.2015;2015;09;19;Sunnuntai;35;33;68;30;28;58
89;20.09.2015;2015;09;20;Sunnuntai;23;29;52;18;20;38
89;20.09.2015;2015;09;21;Sunnuntai;26;7;33;7;6;13
89;20.09.2015;2015;09;22;Sunnuntai;11;8;19;3;4;7
89;20.09.2015;2015;09;23;Sunnuntai;2;2;4;1;3;4
89;21.09.2015;2015;09;00;Maanantai;5;1;6;6;2;8
89;21.09.2015;2015;09;01;Maanantai;3;0;3;0;1;1
89;21.09.2015;2015;09;02;Maanantai;0;0;0;0;0;0
89;21.09.2015;2015;09;03;Maanantai;0;2;2;0;0;0
89;21.09.2015;2015;09;04;Maanantai;0;5;5;0;0;0
89;21.09.2015;2015;09;05;Maanantai;2;14;16;0;0;0
89;21.09.2015;2015;09;06;Maanantai;16;57;73;0;6;6
89;21.09.2015;2015;09;07;Maanantai;50;196;246;1;20;21
89;21.09.2015;2015;09;08;Maanantai;70;304;374;6;42;48
89;21.09.2015;2015;09;09;Maanantai;70;185;255;14;27;41
89;21.09.2015;2015;09;10;Maanantai;58;108;166;22;30;52
89;21.09.2015;2015;09;11;Maanantai;69;84;153;23;25;48
89;21.09.2015;2015;09;12;Maanantai;85;104;189;19;26;45
89;21.09.2015;2015;09;13;Maanantai;104;94;198;19;22;41
89;21.09.2015;2015;09;14;Maanantai;168;77;245;37;51;88
89;21.09.2015;2015;09;15;Maanantai;235;127;362;34;21;55
89;21.09.2015;2015;09;16;Maanantai;285;138;423;23;22;45
89;21.09.2015;2015;09;17;Maanantai;137;103;240;33;30;63
89;21.09.2015;2015;09;18;Maanantai;142;89;231;38;41;79
89;21.09.2015;2015;09;19;Maanantai;87;64;151;36;47;83
89;21.09.2015;2015;09;20;Maanantai;72;38;110;38;26;64
89;21.09.2015;2015;09;21;Maanantai;63;21;84;11;17;28
89;21.09.2015;2015;09;22;Maanantai;23;10;33;6;5;11
89;21.09.2015;2015;09;23;Maanantai;5;8;13;2;3;5
89;22.09.2015;2015;09;00;Tiistai;4;5;9;0;0;0
89;22.09.2015;2015;09;01;Tiistai;1;5;6;0;0;0
89;22.09.2015;2015;09;02;Tiistai;2;1;3;0;0;0
89;22.09.2015;2015;09;03;Tiistai;0;0;0;0;0;0
89;22.09.2015;2015;09;04;Tiistai;8;5;13;0;0;0
89;22.09.2015;2015;09;05;Tiistai;3;7;10;0;1;1
89;22.09.2015;2015;09;06;Tiistai;13;55;68;6;9;15
89;22.09.2015;2015;09;07;Tiistai;37;198;235;2;21;23
89;22.09.2015;2015;09;08;Tiistai;60;248;308;11;65;76
89;22.09.2015;2015;09;09;Tiistai;34;100;134;19;20;39
89;22.09.2015;2015;09;10;Tiistai;35;59;94;16;15;31
89;22.09.2015;2015;09;11;Tiistai;44;35;79;12;16;28
89;22.09.2015;2015;09;12;Tiistai;36;71;107;12;36;48
89;22.09.2015;2015;09;13;Tiistai;74;67;141;40;16;56
89;22.09.2015;2015;09;14;Tiistai;105;85;190;17;18;35
89;22.09.2015;2015;09;15;Tiistai;201;93;294;30;20;50
89;22.09.2015;2015;09;16;Tiistai;220;96;316;22;20;42
89;22.09.2015;2015;09;17;Tiistai;125;60;185;31;14;45
89;22.09.2015;2015;09;18;Tiistai;84;56;140;15;16;31
89;22.09.2015;2015;09;19;Tiistai;74;27;101;8;6;14
89;22.09.2015;2015;09;20;Tiistai;45;22;67;7;15;22
89;22.09.2015;2015;09;21;Tiistai;29;16;45;8;9;17
89;22.09.2015;2015;09;22;Tiistai;19;11;30;2;1;3
89;22.09.2015;2015;09;23;Tiistai;2;7;9;2;1;3
89;23.09.2015;2015;09;00;Keskiviikko;11;2;13;1;2;3
89;23.09.2015;2015;09;01;Keskiviikko;4;1;5;3;1;4
89;23.09.2015;2015;09;02;Keskiviikko;1;1;2;0;0;0
89;23.09.2015;2015;09;03;Keskiviikko;1;1;2;0;0;0
89;23.09.2015;2015;09;04;Keskiviikko;3;2;5;2;0;2
89;23.09.2015;2015;09;05;Keskiviikko;1;15;16;1;0;1
89;23.09.2015;2015;09;06;Keskiviikko;15;56;71;4;3;7
89;23.09.2015;2015;09;07;Keskiviikko;44;166;210;2;25;27
89;23.09.2015;2015;09;08;Keskiviikko;49;301;350;7;65;72
89;23.09.2015;2015;09;09;Keskiviikko;59;152;211;30;40;70
89;23.09.2015;2015;09;10;Keskiviikko;66;97;163;26;37;63
89;23.09.2015;2015;09;11;Keskiviikko;63;91;154;20;16;36
89;23.09.2015;2015;09;12;Keskiviikko;89;76;165;26;41;67
89;23.09.2015;2015;09;13;Keskiviikko;116;72;188;38;17;55
89;23.09.2015;2015;09;14;Keskiviikko;124;76;200;22;12;34
89;23.09.2015;2015;09;15;Keskiviikko;183;68;251;20;15;35
89;23.09.2015;2015;09;16;Keskiviikko;221;98;319;30;15;45
89;23.09.2015;2015;09;17;Keskiviikko;115;87;202;21;23;44
89;23.09.2015;2015;09;18;Keskiviikko;82;62;144;13;25;38
89;23.09.2015;2015;09;19;Keskiviikko;73;52;125;24;19;43
89;23.09.2015;2015;09;20;Keskiviikko;56;40;96;24;23;47
89;23.09.2015;2015;09;21;Keskiviikko;42;21;63;6;6;12
89;23.09.2015;2015;09;22;Keskiviikko;15;4;19;2;2;4
89;23.09.2015;2015;09;23;Keskiviikko;8;9;17;0;1;1
89;24.09.2015;2015;09;00;Torstai;6;3;9;0;1;1
89;24.09.2015;2015;09;01;Torstai;3;2;5;2;2;4
89;24.09.2015;2015;09;02;Torstai;1;1;2;1;1;2
89;24.09.2015;2015;09;03;Torstai;1;0;1;0;0;0
89;24.09.2015;2015;09;04;Torstai;5;3;8;1;0;1
89;24.09.2015;2015;09;05;Torstai;2;14;16;0;0;0
89;24.09.2015;2015;09;06;Torstai;12;51;63;0;6;6
89;24.09.2015;2015;09;07;Torstai;53;204;257;7;16;23
89;24.09.2015;2015;09;08;Torstai;61;283;344;10;34;44
89;24.09.2015;2015;09;09;Torstai;56;134;190;13;28;41
89;24.09.2015;2015;09;10;Torstai;65;85;150;10;21;31
89;24.09.2015;2015;09;11;Torstai;64;79;143;13;22;35
89;24.09.2015;2015;09;12;Torstai;92;96;188;13;21;34
89;24.09.2015;2015;09;13;Torstai;104;90;194;14;18;32
89;24.09.2015;2015;09;14;Torstai;148;93;241;16;33;49
89;24.09.2015;2015;09;15;Torstai;201;98;299;20;28;48
89;24.09.2015;2015;09;16;Torstai;251;119;370;27;18;45
89;24.09.2015;2015;09;17;Torstai;151;116;267;24;16;40
89;24.09.2015;2015;09;18;Torstai;108;87;195;28;31;59
89;24.09.2015;2015;09;19;Torstai;100;68;168;33;34;67
89;24.09.2015;2015;09;20;Torstai;68;47;115;19;29;48
89;24.09.2015;2015;09;21;Torstai;50;31;81;11;12;23
89;24.09.2015;2015;09;22;Torstai;36;21;57;7;2;9
89;24.09.2015;2015;09;23;Torstai;10;17;27;3;1;4
89;25.09.2015;2015;09;00;Perjantai;8;3;11;1;0;1
89;25.09.2015;2015;09;01;Perjantai;3;2;5;0;0;0
89;25.09.2015;2015;09;02;Perjantai;3;2;5;0;1;1
89;25.09.2015;2015;09;03;Perjantai;1;5;6;3;4;7
89;25.09.2015;2015;09;04;Perjantai;6;3;9;0;0;0
89;25.09.2015;2015;09;05;Perjantai;4;12;16;0;1;1
89;25.09.2015;2015;09;06;Perjantai;16;44;60;0;8;8
89;25.09.2015;2015;09;07;Perjantai;42;169;211;5;25;30
89;25.09.2015;2015;09;08;Perjantai;49;247;296;11;34;45
89;25.09.2015;2015;09;09;Perjantai;50;122;172;19;19;38
89;25.09.2015;2015;09;10;Perjantai;48;116;164;19;34;53
89;25.09.2015;2015;09;11;Perjantai;76;89;165;17;16;33
89;25.09.2015;2015;09;12;Perjantai;95;107;202;17;15;32
89;25.09.2015;2015;09;13;Perjantai;144;89;233;31;21;52
89;25.09.2015;2015;09;14;Perjantai;166;91;257;18;25;43
89;25.09.2015;2015;09;15;Perjantai;185;113;298;25;25;50
89;25.09.2015;2015;09;16;Perjantai;162;108;270;25;23;48
89;25.09.2015;2015;09;17;Perjantai;124;79;203;25;20;45
89;25.09.2015;2015;09;18;Perjantai;66;56;122;18;22;40
89;25.09.2015;2015;09;19;Perjantai;76;38;114;24;22;46
89;25.09.2015;2015;09;20;Perjantai;43;34;77;14;11;25
89;25.09.2015;2015;09;21;Perjantai;47;20;67;9;4;13
89;25.09.2015;2015;09;22;Perjantai;39;32;71;9;10;19
89;25.09.2015;2015;09;23;Perjantai;17;26;43;5;5;10
89;26.09.2015;2015;09;00;Lauantai;11;24;35;3;6;9
89;26.09.2015;2015;09;01;Lauantai;19;15;34;6;3;9
89;26.09.2015;2015;09;02;Lauantai;17;10;27;3;4;7
89;26.09.2015;2015;09;03;Lauantai;10;8;18;4;1;5
89;26.09.2015;2015;09;04;Lauantai;13;4;17;4;2;6
89;26.09.2015;2015;09;05;Lauantai;3;4;7;2;2;4
89;26.09.2015;2015;09;06;Lauantai;8;13;21;0;2;2
89;26.09.2015;2015;09;07;Lauantai;4;17;21;4;2;6
89;26.09.2015;2015;09;08;Lauantai;8;32;40;5;7;12
89;26.09.2015;2015;09;09;Lauantai;13;53;66;12;26;38
89;26.09.2015;2015;09;10;Lauantai;27;79;106;22;32;54
89;26.09.2015;2015;09;11;Lauantai;69;90;159;28;36;64
89;26.09.2015;2015;09;12;Lauantai;67;91;158;26;35;61
89;26.09.2015;2015;09;13;Lauantai;66;101;167;32;35;67
89;26.09.2015;2015;09;14;Lauantai;66;79;145;22;37;59
89;26.09.2015;2015;09;15;Lauantai;91;82;173;30;40;70
89;26.09.2015;2015;09;16;Lauantai;88;72;160;40;30;70
89;26.09.2015;2015;09;17;Lauantai;104;99;203;25;41;66
89;26.09.2015;2015;09;18;Lauantai;91;86;177;13;31;44
89;26.09.2015;2015;09;19;Lauantai;59;60;119;18;22;40
89;26.09.2015;2015;09;20;Lauantai;35;31;66;7;15;22
89;26.09.2015;2015;09;21;Lauantai;34;35;69;12;7;19
89;26.09.2015;2015;09;22;Lauantai;25;27;52;6;6;12
89;26.09.2015;2015;09;23;Lauantai;17;22;39;1;9;10
89;27.09.2015;2015;09;00;Sunnuntai;18;24;42;4;2;6
89;27.09.2015;2015;09;01;Sunnuntai;24;18;42;6;5;11
89;27.09.2015;2015;09;02;Sunnuntai;14;6;20;5;1;6
89;27.09.2015;2015;09;03;Sunnuntai;35;7;42;13;1;14
89;27.09.2015;2015;09;04;Sunnuntai;20;6;26;5;2;7
89;27.09.2015;2015;09;05;Sunnuntai;5;2;7;1;1;2
89;27.09.2015;2015;09;06;Sunnuntai;2;8;10;0;3;3
89;27.09.2015;2015;09;07;Sunnuntai;3;4;7;3;3;6
89;27.09.2015;2015;09;08;Sunnuntai;5;11;16;7;11;18
89;27.09.2015;2015;09;09;Sunnuntai;16;27;43;8;19;27
89;27.09.2015;2015;09;10;Sunnuntai;14;30;44;14;26;40
89;27.09.2015;2015;09;11;Sunnuntai;29;49;78;30;36;66
89;27.09.2015;2015;09;12;Sunnuntai;41;58;99;43;35;78
89;27.09.2015;2015;09;13;Sunnuntai;53;63;116;23;38;61
89;27.09.2015;2015;09;14;Sunnuntai;68;64;132;33;31;64
89;27.09.2015;2015;09;15;Sunnuntai;67;55;122;26;30;56
89;27.09.2015;2015;09;16;Sunnuntai;81;66;147;19;42;61
89;27.09.2015;2015;09;17;Sunnuntai;72;57;129;25;41;66
89;27.09.2015;2015;09;18;Sunnuntai;63;48;111;33;32;65
89;27.09.2015;2015;09;19;Sunnuntai;43;30;73;30;28;58
89;27.09.2015;2015;09;20;Sunnuntai;35;26;61;15;17;32
89;27.09.2015;2015;09;21;Sunnuntai;14;22;36;7;7;14
89;27.09.2015;2015;09;22;Sunnuntai;15;8;23;5;2;7
89;27.09.2015;2015;09;23;Sunnuntai;5;3;8;1;0;1
89;28.09.2015;2015;09;00;Maanantai;7;1;8;0;0;0
89;28.09.2015;2015;09;01;Maanantai;2;0;2;0;0;0
89;28.09.2015;2015;09;02;Maanantai;1;0;1;0;0;0
89;28.09.2015;2015;09;03;Maanantai;3;3;6;0;1;1
89;28.09.2015;2015;09;04;Maanantai;5;7;12;1;0;1
89;28.09.2015;2015;09;05;Maanantai;8;16;24;0;4;4
89;28.09.2015;2015;09;06;Maanantai;16;58;74;2;4;6
89;28.09.2015;2015;09;07;Maanantai;52;188;240;2;20;22
89;28.09.2015;2015;09;08;Maanantai;65;298;363;10;38;48
89;28.09.2015;2015;09;09;Maanantai;49;196;245;12;28;40
89;28.09.2015;2015;09;10;Maanantai;66;104;170;28;31;59
89;28.09.2015;2015;09;11;Maanantai;81;100;181;19;21;40
89;28.09.2015;2015;09;12;Maanantai;112;107;219;17;30;47
89;28.09.2015;2015;09;13;Maanantai;118;105;223;35;38;73
89;28.09.2015;2015;09;14;Maanantai;166;84;250;26;22;48
89;28.09.2015;2015;09;15;Maanantai;221;121;342;17;34;51
89;28.09.2015;2015;09;16;Maanantai;241;121;362;25;18;43
89;28.09.2015;2015;09;17;Maanantai;135;122;257;32;21;53
89;28.09.2015;2015;09;18;Maanantai;117;66;183;44;37;81
89;28.09.2015;2015;09;19;Maanantai;88;52;140;32;31;63
89;28.09.2015;2015;09;20;Maanantai;65;39;104;22;21;43
89;28.09.2015;2015;09;21;Maanantai;49;24;73;12;9;21
89;28.09.2015;2015;09;22;Maanantai;17;12;29;3;3;6
89;28.09.2015;2015;09;23;Maanantai;7;2;9;1;0;1
89;29.09.2015;2015;09;00;Tiistai;4;3;7;1;1;2
89;29.09.2015;2015;09;01;Tiistai;2;4;6;0;0;0
89;29.09.2015;2015;09;02;Tiistai;0;4;4;0;0;0
89;29.09.2015;2015;09;03;Tiistai;3;1;4;0;0;0
89;29.09.2015;2015;09;04;Tiistai;1;4;5;0;0;0
89;29.09.2015;2015;09;05;Tiistai;3;13;16;0;0;0
89;29.09.2015;2015;09;06;Tiistai;17;62;79;2;5;7
89;29.09.2015;2015;09;07;Tiistai;51;205;256;7;15;22
89;29.09.2015;2015;09;08;Tiistai;54;320;374;6;40;46
89;29.09.2015;2015;09;09;Tiistai;42;131;173;10;29;39
89;29.09.2015;2015;09;10;Tiistai;53;105;158;14;24;38
89;29.09.2015;2015;09;11;Tiistai;85;70;155;25;31;56
89;29.09.2015;2015;09;12;Tiistai;87;120;207;25;20;45
89;29.09.2015;2015;09;13;Tiistai;120;98;218;14;27;41
89;29.09.2015;2015;09;14;Tiistai;147;90;237;27;12;39
89;29.09.2015;2015;09;15;Tiistai;196;91;287;32;25;57
89;29.09.2015;2015;09;16;Tiistai;224;118;342;29;20;49
89;29.09.2015;2015;09;17;Tiistai;162;102;264;25;25;50
89;29.09.2015;2015;09;18;Tiistai;113;88;201;29;36;65
89;29.09.2015;2015;09;19;Tiistai;87;59;146;31;32;63
89;29.09.2015;2015;09;20;Tiistai;68;49;117;20;27;47
89;29.09.2015;2015;09;21;Tiistai;48;16;64;12;9;21
89;29.09.2015;2015;09;22;Tiistai;17;5;22;6;1;7
89;29.09.2015;2015;09;23;Tiistai;7;4;11;2;3;5
89;30.09.2015;2015;09;00;Keskiviikko;4;1;5;1;2;3
89;30.09.2015;2015;09;01;Keskiviikko;2;3;5;0;0;0
89;30.09.2015;2015;09;02;Keskiviikko;1;0;1;1;1;2
89;30.09.2015;2015;09;03;Keskiviikko;2;4;6;0;2;2
89;30.09.2015;2015;09;04;Keskiviikko;2;5;7;0;0;0
89;30.09.2015;2015;09;05;Keskiviikko;8;16;24;0;1;1
89;30.09.2015;2015;09;06;Keskiviikko;13;48;61;1;8;9
89;30.09.2015;2015;09;07;Keskiviikko;64;193;257;5;19;24
89;30.09.2015;2015;09;08;Keskiviikko;49;288;337;12;36;48
89;30.09.2015;2015;09;09;Keskiviikko;46;150;196;4;33;37
89;30.09.2015;2015;09;10;Keskiviikko;56;97;153;18;33;51
89;30.09.2015;2015;09;11;Keskiviikko;75;106;181;21;33;54
89;30.09.2015;2015;09;12;Keskiviikko;111;116;227;27;29;56
89;30.09.2015;2015;09;13;Keskiviikko;118;83;201;24;21;45
89;30.09.2015;2015;09;14;Keskiviikko;172;105;277;32;35;67
89;30.09.2015;2015;09;15;Keskiviikko;189;108;297;31;23;54
89;30.09.2015;2015;09;16;Keskiviikko;261;146;407;33;20;53
89;30.09.2015;2015;09;17;Keskiviikko;161;146;307;25;30;55
89;30.09.2015;2015;09;18;Keskiviikko;102;82;184;28;41;69
89;30.09.2015;2015;09;19;Keskiviikko;116;95;211;29;24;53
89;30.09.2015;2015;09;20;Keskiviikko;85;50;135;27;16;43
89;30.09.2015;2015;09;21;Keskiviikko;58;25;83;5;4;9
89;30.09.2015;2015;09;22;Keskiviikko;21;12;33;5;5;10
89;30.09.2015;2015;09;23;Keskiviikko;18;16;34;2;4;6
89;01.10.2015;2015;10;00;Torstai;15;6;21;2;2;4
89;01.10.2015;2015;10;01;Torstai;13;1;14;3;0;3
89;01.10.2015;2015;10;02;Torstai;10;18;28;3;1;4
89;01.10.2015;2015;10;03;Torstai;7;5;12;0;0;0
89;01.10.2015;2015;10;04;Torstai;3;8;11;0;0;0
89;01.10.2015;2015;10;05;Torstai;5;8;13;0;3;3
89;01.10.2015;2015;10;06;Torstai;19;51;70;1;7;8
89;01.10.2015;2015;10;07;Torstai;60;177;237;5;21;26
89;01.10.2015;2015;10;08;Torstai;51;315;366;12;43;55
89;01.10.2015;2015;10;09;Torstai;55;144;199;17;39;56
89;01.10.2015;2015;10;10;Torstai;64;90;154;18;13;31
89;01.10.2015;2015;10;11;Torstai;86;113;199;29;25;54
89;01.10.2015;2015;10;12;Torstai;81;106;187;19;36;55
89;01.10.2015;2015;10;13;Torstai;122;87;209;20;18;38
89;01.10.2015;2015;10;14;Torstai;144;102;246;34;21;55
89;01.10.2015;2015;10;15;Torstai;201;101;302;18;21;39
89;01.10.2015;2015;10;16;Torstai;222;124;346;19;21;40
89;01.10.2015;2015;10;17;Torstai;125;108;233;26;30;56
89;01.10.2015;2015;10;18;Torstai;98;105;203;32;23;55
89;01.10.2015;2015;10;19;Torstai;92;49;141;30;29;59
89;01.10.2015;2015;10;20;Torstai;71;40;111;19;19;38
89;01.10.2015;2015;10;21;Torstai;61;28;89;10;13;23
89;01.10.2015;2015;10;22;Torstai;14;13;27;10;3;13
89;01.10.2015;2015;10;23;Torstai;13;9;22;2;1;3
89;02.10.2015;2015;10;00;Perjantai;13;4;17;4;4;8
89;02.10.2015;2015;10;01;Perjantai;1;2;3;0;1;1
89;02.10.2015;2015;10;02;Perjantai;5;3;8;1;0;1
89;02.10.2015;2015;10;03;Perjantai;6;3;9;0;1;1
89;02.10.2015;2015;10;04;Perjantai;8;4;12;3;0;3
89;02.10.2015;2015;10;05;Perjantai;7;9;16;0;0;0
89;02.10.2015;2015;10;06;Perjantai;13;36;49;2;6;8
89;02.10.2015;2015;10;07;Perjantai;40;110;150;3;19;22
89;02.10.2015;2015;10;08;Perjantai;38;194;232;9;24;33
89;02.10.2015;2015;10;09;Perjantai;31;77;108;13;17;30
89;02.10.2015;2015;10;10;Perjantai;31;51;82;8;12;20
89;02.10.2015;2015;10;11;Perjantai;47;56;103;17;17;34
89;02.10.2015;2015;10;12;Perjantai;48;64;112;18;22;40
89;02.10.2015;2015;10;13;Perjantai;88;58;146;13;11;24
89;02.10.2015;2015;10;14;Perjantai;98;60;158;12;12;24
89;02.10.2015;2015;10;15;Perjantai;118;53;171;20;16;36
89;02.10.2015;2015;10;16;Perjantai;111;51;162;14;16;30
89;02.10.2015;2015;10;17;Perjantai;68;44;112;4;15;19
89;02.10.2015;2015;10;18;Perjantai;49;31;80;12;11;23
89;02.10.2015;2015;10;19;Perjantai;30;23;53;5;6;11
89;02.10.2015;2015;10;20;Perjantai;25;24;49;3;3;6
89;02.10.2015;2015;10;21;Perjantai;23;19;42;8;7;15
89;02.10.2015;2015;10;22;Perjantai;13;12;25;3;2;5
89;02.10.2015;2015;10;23;Perjantai;13;10;23;2;5;7
89;03.10.2015;2015;10;00;Lauantai;15;15;30;2;3;5
89;03.10.2015;2015;10;01;Lauantai;9;13;22;4;2;6
89;03.10.2015;2015;10;02;Lauantai;11;9;20;2;2;4
89;03.10.2015;2015;10;03;Lauantai;6;2;8;6;1;7
89;03.10.2015;2015;10;04;Lauantai;15;0;15;4;1;5
89;03.10.2015;2015;10;05;Lauantai;2;6;8;0;0;0
89;03.10.2015;2015;10;06;Lauantai;3;5;8;0;2;2
89;03.10.2015;2015;10;07;Lauantai;5;12;17;2;3;5
89;03.10.2015;2015;10;08;Lauantai;1;23;24;10;12;22
89;03.10.2015;2015;10;09;Lauantai;18;59;77;15;19;34
89;03.10.2015;2015;10;10;Lauantai;29;73;102;12;27;39
89;03.10.2015;2015;10;11;Lauantai;50;101;151;21;41;62
89;03.10.2015;2015;10;12;Lauantai;66;82;148;22;39;61
89;03.10.2015;2015;10;13;Lauantai;87;100;187;39;43;82
89;03.10.2015;2015;10;14;Lauantai;80;77;157;18;29;47
89;03.10.2015;2015;10;15;Lauantai;79;70;149;19;37;56
89;03.10.2015;2015;10;16;Lauantai;103;95;198;28;39;67
89;03.10.2015;2015;10;17;Lauantai;68;58;126;29;29;58
89;03.10.2015;2015;10;18;Lauantai;65;63;128;24;27;51
89;03.10.2015;2015;10;19;Lauantai;60;24;84;15;11;26
89;03.10.2015;2015;10;20;Lauantai;31;49;80;5;14;19
89;03.10.2015;2015;10;21;Lauantai;36;44;80;10;10;20
89;03.10.2015;2015;10;22;Lauantai;30;32;62;2;7;9
89;03.10.2015;2015;10;23;Lauantai;21;32;53;1;7;8
89;04.10.2015;2015;10;00;Sunnuntai;20;23;43;5;5;10
89;04.10.2015;2015;10;01;Sunnuntai;38;11;49;7;8;15
89;04.10.2015;2015;10;02;Sunnuntai;23;7;30;6;1;7
89;04.10.2015;2015;10;03;Sunnuntai;32;1;33;5;0;5
89;04.10.2015;2015;10;04;Sunnuntai;20;1;21;5;0;5
89;04.10.2015;2015;10;05;Sunnuntai;5;1;6;1;1;2
89;04.10.2015;2015;10;06;Sunnuntai;0;9;9;0;1;1
89;04.10.2015;2015;10;07;Sunnuntai;4;6;10;2;5;7
89;04.10.2015;2015;10;08;Sunnuntai;4;14;18;9;3;12
89;04.10.2015;2015;10;09;Sunnuntai;16;32;48;11;18;29
89;04.10.2015;2015;10;10;Sunnuntai;17;45;62;32;33;65
89;04.10.2015;2015;10;11;Sunnuntai;35;61;96;34;35;69
89;04.10.2015;2015;10;12;Sunnuntai;34;72;106;21;45;66
89;04.10.2015;2015;10;13;Sunnuntai;64;73;137;37;55;92
89;04.10.2015;2015;10;14;Sunnuntai;73;72;145;27;26;53
89;04.10.2015;2015;10;15;Sunnuntai;58;34;92;18;28;46
89;04.10.2015;2015;10;16;Sunnuntai;75;61;136;20;29;49
89;04.10.2015;2015;10;17;Sunnuntai;54;46;100;28;22;50
89;04.10.2015;2015;10;18;Sunnuntai;38;49;87;26;27;53
89;04.10.2015;2015;10;19;Sunnuntai;30;33;63;14;21;35
89;04.10.2015;2015;10;20;Sunnuntai;35;24;59;14;12;26
89;04.10.2015;2015;10;21;Sunnuntai;18;9;27;4;6;10
89;04.10.2015;2015;10;22;Sunnuntai;8;6;14;1;1;2
89;04.10.2015;2015;10;23;Sunnuntai;6;2;8;2;3;5
89;05.10.2015;2015;10;00;Maanantai;4;1;5;0;0;0
89;05.10.2015;2015;10;01;Maanantai;1;0;1;0;0;0
89;05.10.2015;2015;10;02;Maanantai;2;0;2;2;0;2
89;05.10.2015;2015;10;03;Maanantai;0;2;2;0;0;0
89;05.10.2015;2015;10;04;Maanantai;3;4;7;0;0;0
89;05.10.2015;2015;10;05;Maanantai;4;10;14;0;0;0
89;05.10.2015;2015;10;06;Maanantai;10;46;56;0;6;6
89;05.10.2015;2015;10;07;Maanantai;53;196;249;5;20;25
89;05.10.2015;2015;10;08;Maanantai;64;295;359;11;49;60
89;05.10.2015;2015;10;09;Maanantai;43;169;212;10;40;50
89;05.10.2015;2015;10;10;Maanantai;57;79;136;12;29;41
89;05.10.2015;2015;10;11;Maanantai;67;76;143;23;37;60
89;05.10.2015;2015;10;12;Maanantai;70;109;179;21;33;54
89;05.10.2015;2015;10;13;Maanantai;126;76;202;24;25;49
89;05.10.2015;2015;10;14;Maanantai;127;89;216;30;27;57
89;05.10.2015;2015;10;15;Maanantai;217;103;320;34;31;65
89;05.10.2015;2015;10;16;Maanantai;242;106;348;35;19;54
89;05.10.2015;2015;10;17;Maanantai;123;68;191;30;21;51
89;05.10.2015;2015;10;18;Maanantai;98;54;152;32;43;75
89;05.10.2015;2015;10;19;Maanantai;65;44;109;28;24;52
89;05.10.2015;2015;10;20;Maanantai;44;28;72;18;21;39
89;05.10.2015;2015;10;21;Maanantai;46;9;55;10;6;16
89;05.10.2015;2015;10;22;Maanantai;17;7;24;4;2;6
89;05.10.2015;2015;10;23;Maanantai;7;3;10;1;1;2
89;06.10.2015;2015;10;00;Tiistai;1;0;1;0;0;0
89;06.10.2015;2015;10;01;Tiistai;2;1;3;0;0;0
89;06.10.2015;2015;10;02;Tiistai;1;0;1;0;1;1
89;06.10.2015;2015;10;03;Tiistai;5;0;5;0;1;1
89;06.10.2015;2015;10;04;Tiistai;1;7;8;0;0;0
89;06.10.2015;2015;10;05;Tiistai;2;13;15;0;0;0
89;06.10.2015;2015;10;06;Tiistai;15;45;60;3;6;9
89;06.10.2015;2015;10;07;Tiistai;54;192;246;9;20;29
89;06.10.2015;2015;10;08;Tiistai;62;307;369;3;39;42
89;06.10.2015;2015;10;09;Tiistai;47;123;170;9;43;52
89;06.10.2015;2015;10;10;Tiistai;41;66;107;15;23;38
89;06.10.2015;2015;10;11;Tiistai;63;95;158;27;27;54
89;06.10.2015;2015;10;12;Tiistai;76;94;170;18;28;46
89;06.10.2015;2015;10;13;Tiistai;95;80;175;23;26;49
89;06.10.2015;2015;10;14;Tiistai;159;73;232;25;17;42
89;06.10.2015;2015;10;15;Tiistai;196;119;315;31;18;49
89;06.10.2015;2015;10;16;Tiistai;239;134;373;36;27;63
89;06.10.2015;2015;10;17;Tiistai;129;102;231;35;39;74
89;06.10.2015;2015;10;18;Tiistai;110;83;193;41;39;80
89;06.10.2015;2015;10;19;Tiistai;84;47;131;31;31;62
89;06.10.2015;2015;10;20;Tiistai;87;33;120;16;13;29
89;06.10.2015;2015;10;21;Tiistai;34;10;44;7;6;13
89;06.10.2015;2015;10;22;Tiistai;23;8;31;4;0;4
89;06.10.2015;2015;10;23;Tiistai;13;4;17;2;0;2
89;07.10.2015;2015;10;00;Keskiviikko;5;8;13;1;0;1
89;07.10.2015;2015;10;01;Keskiviikko;2;0;2;1;0;1
89;07.10.2015;2015;10;02;Keskiviikko;0;2;2;1;0;1
89;07.10.2015;2015;10;03;Keskiviikko;2;2;4;0;0;0
89;07.10.2015;2015;10;04;Keskiviikko;2;2;4;1;0;1
89;07.10.2015;2015;10;05;Keskiviikko;3;14;17;1;0;1
89;07.10.2015;2015;10;06;Keskiviikko;17;58;75;5;12;17
89;07.10.2015;2015;10;07;Keskiviikko;37;183;220;7;26;33
89;07.10.2015;2015;10;08;Keskiviikko;62;302;364;3;40;43
89;07.10.2015;2015;10;09;Keskiviikko;49;157;206;16;34;50
89;07.10.2015;2015;10;10;Keskiviikko;35;111;146;28;35;63
89;07.10.2015;2015;10;11;Keskiviikko;75;96;171;25;34;59
89;07.10.2015;2015;10;12;Keskiviikko;84;107;191;32;34;66
89;07.10.2015;2015;10;13;Keskiviikko;91;73;164;24;40;64
89;07.10.2015;2015;10;14;Keskiviikko;169;95;264;24;19;43
89;07.10.2015;2015;10;15;Keskiviikko;183;96;279;30;16;46
89;07.10.2015;2015;10;16;Keskiviikko;274;116;390;41;23;64
89;07.10.2015;2015;10;17;Keskiviikko;158;101;259;26;38;64
89;07.10.2015;2015;10;18;Keskiviikko;116;56;172;19;36;55
89;07.10.2015;2015;10;19;Keskiviikko;100;41;141;30;25;55
89;07.10.2015;2015;10;20;Keskiviikko;63;43;106;25;16;41
89;07.10.2015;2015;10;21;Keskiviikko;39;25;64;4;5;9
89;07.10.2015;2015;10;22;Keskiviikko;19;13;32;2;5;7
89;07.10.2015;2015;10;23;Keskiviikko;11;13;24;2;3;5
89;08.10.2015;2015;10;00;Torstai;6;1;7;0;0;0
89;08.10.2015;2015;10;01;Torstai;5;4;9;1;0;1
89;08.10.2015;2015;10;02;Torstai;3;0;3;1;0;1
89;08.10.2015;2015;10;03;Torstai;2;1;3;2;0;2
89;08.10.2015;2015;10;04;Torstai;3;4;7;0;0;0
89;08.10.2015;2015;10;05;Torstai;1;13;14;2;1;3
89;08.10.2015;2015;10;06;Torstai;14;48;62;1;9;10
89;08.10.2015;2015;10;07;Torstai;53;167;220;5;17;22
89;08.10.2015;2015;10;08;Torstai;62;262;324;12;44;56
89;08.10.2015;2015;10;09;Torstai;53;142;195;9;42;51
89;08.10.2015;2015;10;10;Torstai;47;82;129;18;30;48
89;08.10.2015;2015;10;11;Torstai;61;98;159;23;32;55
89;08.10.2015;2015;10;12;Torstai;71;111;182;23;31;54
89;08.10.2015;2015;10;13;Torstai;96;87;183;21;23;44
89;08.10.2015;2015;10;14;Torstai;141;91;232;31;22;53
89;08.10.2015;2015;10;15;Torstai;150;104;254;30;28;58
89;08.10.2015;2015;10;16;Torstai;212;117;329;23;19;42
89;08.10.2015;2015;10;17;Torstai;141;102;243;27;33;60
89;08.10.2015;2015;10;18;Torstai;113;79;192;30;38;68
89;08.10.2015;2015;10;19;Torstai;85;39;124;22;25;47
89;08.10.2015;2015;10;20;Torstai;66;33;99;22;11;33
89;08.10.2015;2015;10;21;Torstai;61;32;93;5;10;15
89;08.10.2015;2015;10;22;Torstai;22;12;34;4;4;8
89;08.10.2015;2015;10;23;Torstai;12;8;20;1;0;1
89;09.10.2015;2015;10;00;Perjantai;8;12;20;1;0;1
89;09.10.2015;2015;10;01;Perjantai;7;0;7;1;2;3
89;09.10.2015;2015;10;02;Perjantai;0;3;3;1;0;1
89;09.10.2015;2015;10;03;Perjantai;8;3;11;1;0;1
89;09.10.2015;2015;10;04;Perjantai;6;6;12;1;0;1
89;09.10.2015;2015;10;05;Perjantai;6;10;16;0;1;1
89;09.10.2015;2015;10;06;Perjantai;11;50;61;3;6;9
89;09.10.2015;2015;10;07;Perjantai;44;158;202;5;16;21
89;09.10.2015;2015;10;08;Perjantai;43;251;294;3;26;29
89;09.10.2015;2015;10;09;Perjantai;35;119;154;5;29;34
89;09.10.2015;2015;10;10;Perjantai;41;60;101;17;39;56
89;09.10.2015;2015;10;11;Perjantai;56;90;146;25;16;41
89;09.10.2015;2015;10;12;Perjantai;81;85;166;16;21;37
89;09.10.2015;2015;10;13;Perjantai;102;77;179;22;27;49
89;09.10.2015;2015;10;14;Perjantai;134;93;227;26;30;56
89;09.10.2015;2015;10;15;Perjantai;158;97;255;24;30;54
89;09.10.2015;2015;10;16;Perjantai;196;114;310;27;25;52
89;09.10.2015;2015;10;17;Perjantai;94;78;172;25;26;51
89;09.10.2015;2015;10;18;Perjantai;77;62;139;27;15;42
89;09.10.2015;2015;10;19;Perjantai;73;52;125;18;17;35
89;09.10.2015;2015;10;20;Perjantai;37;28;65;17;10;27
89;09.10.2015;2015;10;21;Perjantai;34;27;61;9;11;20
89;09.10.2015;2015;10;22;Perjantai;17;22;39;3;8;11
89;09.10.2015;2015;10;23;Perjantai;29;15;44;2;6;8
89;10.10.2015;2015;10;00;Lauantai;25;14;39;3;0;3
89;10.10.2015;2015;10;01;Lauantai;20;17;37;3;7;10
89;10.10.2015;2015;10;02;Lauantai;11;7;18;6;4;10
89;10.10.2015;2015;10;03;Lauantai;18;0;18;5;0;5
89;10.10.2015;2015;10;04;Lauantai;18;3;21;7;1;8
89;10.10.2015;2015;10;05;Lauantai;3;4;7;0;1;1
89;10.10.2015;2015;10;06;Lauantai;4;14;18;0;3;3
89;10.10.2015;2015;10;07;Lauantai;5;13;18;3;8;11
89;10.10.2015;2015;10;08;Lauantai;8;48;56;7;21;28
89;10.10.2015;2015;10;09;Lauantai;24;60;84;10;16;26
89;10.10.2015;2015;10;10;Lauantai;35;73;108;17;27;44
89;10.10.2015;2015;10;11;Lauantai;42;83;125;19;49;68
89;10.10.2015;2015;10;12;Lauantai;53;57;110;23;31;54
89;10.10.2015;2015;10;13;Lauantai;74;77;151;35;38;73
89;10.10.2015;2015;10;14;Lauantai;65;74;139;30;24;54
89;10.10.2015;2015;10;15;Lauantai;111;60;171;29;28;57
89;10.10.2015;2015;10;16;Lauantai;68;57;125;22;29;51
89;10.10.2015;2015;10;17;Lauantai;59;44;103;27;20;47
89;10.10.2015;2015;10;18;Lauantai;66;46;112;33;20;53
89;10.10.2015;2015;10;19;Lauantai;28;32;60;18;29;47
89;10.10.2015;2015;10;20;Lauantai;32;39;71;7;13;20
89;10.10.2015;2015;10;21;Lauantai;20;32;52;5;4;9
89;10.10.2015;2015;10;22;Lauantai;22;22;44;1;7;8
89;10.10.2015;2015;10;23;Lauantai;10;17;27;4;8;12
89;11.10.2015;2015;10;00;Sunnuntai;20;23;43;3;14;17
89;11.10.2015;2015;10;01;Sunnuntai;15;9;24;1;3;4
89;11.10.2015;2015;10;02;Sunnuntai;21;3;24;0;2;2
89;11.10.2015;2015;10;03;Sunnuntai;25;0;25;6;0;6
89;11.10.2015;2015;10;04;Sunnuntai;20;1;21;8;0;8
89;11.10.2015;2015;10;05;Sunnuntai;7;3;10;4;0;4
89;11.10.2015;2015;10;06;Sunnuntai;2;8;10;0;4;4
89;11.10.2015;2015;10;07;Sunnuntai;3;3;6;1;1;2
89;11.10.2015;2015;10;08;Sunnuntai;3;19;22;8;7;15
89;11.10.2015;2015;10;09;Sunnuntai;15;36;51;11;18;29
89;11.10.2015;2015;10;10;Sunnuntai;19;39;58;22;25;47
89;11.10.2015;2015;10;11;Sunnuntai;35;67;102;46;64;110
89;11.10.2015;2015;10;12;Sunnuntai;41;100;141;32;62;94
89;11.10.2015;2015;10;13;Sunnuntai;94;96;190;37;60;97
89;11.10.2015;2015;10;14;Sunnuntai;84;93;177;44;54;98
89;11.10.2015;2015;10;15;Sunnuntai;100;102;202;35;54;89
89;11.10.2015;2015;10;16;Sunnuntai;85;59;144;36;51;87
89;11.10.2015;2015;10;17;Sunnuntai;70;54;124;34;27;61
89;11.10.2015;2015;10;18;Sunnuntai;55;54;109;32;28;60
89;11.10.2015;2015;10;19;Sunnuntai;29;33;62;13;28;41
89;11.10.2015;2015;10;20;Sunnuntai;41;23;64;17;12;29
89;11.10.2015;2015;10;21;Sunnuntai;18;14;32;9;4;13
89;11.10.2015;2015;10;22;Sunnuntai;7;7;14;3;3;6
89;11.10.2015;2015;10;23;Sunnuntai;9;6;15;0;1;1
89;12.10.2015;2015;10;00;Maanantai;3;3;6;0;0;0
89;12.10.2015;2015;10;01;Maanantai;4;0;4;0;0;0
89;12.10.2015;2015;10;02;Maanantai;0;1;1;1;0;1
89;12.10.2015;2015;10;03;Maanantai;1;1;2;0;0;0
89;12.10.2015;2015;10;04;Maanantai;3;3;6;0;0;0
89;12.10.2015;2015;10;05;Maanantai;4;14;18;1;2;3
89;12.10.2015;2015;10;06;Maanantai;16;44;60;1;11;12
89;12.10.2015;2015;10;07;Maanantai;43;163;206;4;16;20
89;12.10.2015;2015;10;08;Maanantai;57;286;343;15;56;71
89;12.10.2015;2015;10;09;Maanantai;43;132;175;23;46;69
89;12.10.2015;2015;10;10;Maanantai;49;82;131;23;43;66
89;12.10.2015;2015;10;11;Maanantai;61;91;152;32;43;75
89;12.10.2015;2015;10;12;Maanantai;71;76;147;17;33;50
89;12.10.2015;2015;10;13;Maanantai;90;81;171;31;29;60
89;12.10.2015;2015;10;14;Maanantai;164;91;255;30;22;52
89;12.10.2015;2015;10;15;Maanantai;183;84;267;57;29;86
89;12.10.2015;2015;10;16;Maanantai;262;131;393;38;22;60
89;12.10.2015;2015;10;17;Maanantai;115;93;208;40;35;75
89;12.10.2015;2015;10;18;Maanantai;104;68;172;32;35;67
89;12.10.2015;2015;10;19;Maanantai;73;52;125;26;22;48
89;12.10.2015;2015;10;20;Maanantai;59;27;86;18;27;45
89;12.10.2015;2015;10;21;Maanantai;49;25;74;8;12;20
89;12.10.2015;2015;10;22;Maanantai;16;6;22;5;2;7
89;12.10.2015;2015;10;23;Maanantai;6;2;8;2;0;2
89;13.10.2015;2015;10;00;Tiistai;4;6;10;1;0;1
89;13.10.2015;2015;10;01;Tiistai;3;0;3;0;1;1
89;13.10.2015;2015;10;02;Tiistai;1;0;1;0;0;0
89;13.10.2015;2015;10;03;Tiistai;0;1;1;0;0;0
89;13.10.2015;2015;10;04;Tiistai;2;1;3;0;0;0
89;13.10.2015;2015;10;05;Tiistai;3;13;16;0;2;2
89;13.10.2015;2015;10;06;Tiistai;19;49;68;4;6;10
89;13.10.2015;2015;10;07;Tiistai;41;182;223;6;16;22
89;13.10.2015;2015;10;08;Tiistai;72;297;369;10;50;60
89;13.10.2015;2015;10;09;Tiistai;51;120;171;15;35;50
89;13.10.2015;2015;10;10;Tiistai;60;87;147;35;40;75
89;13.10.2015;2015;10;11;Tiistai;64;77;141;33;32;65
89;13.10.2015;2015;10;12;Tiistai;62;96;158;32;29;61
89;13.10.2015;2015;10;13;Tiistai;85;82;167;28;26;54
89;13.10.2015;2015;10;14;Tiistai;149;109;258;25;36;61
89;13.10.2015;2015;10;15;Tiistai;195;111;306;21;29;50
89;13.10.2015;2015;10;16;Tiistai;278;126;404;38;34;72
89;13.10.2015;2015;10;17;Tiistai;141;97;238;44;41;85
89;13.10.2015;2015;10;18;Tiistai;119;68;187;36;39;75
89;13.10.2015;2015;10;19;Tiistai;83;45;128;31;44;75
89;13.10.2015;2015;10;20;Tiistai;56;36;92;18;24;42
89;13.10.2015;2015;10;21;Tiistai;34;29;63;9;12;21
89;13.10.2015;2015;10;22;Tiistai;17;17;34;5;3;8
89;13.10.2015;2015;10;23;Tiistai;6;2;8;1;0;1
89;14.10.2015;2015;10;00;Keskiviikko;6;4;10;0;0;0
89;14.10.2015;2015;10;01;Keskiviikko;3;0;3;1;0;1
89;14.10.2015;2015;10;02;Keskiviikko;4;2;6;0;0;0
89;14.10.2015;2015;10;03;Keskiviikko;6;1;7;0;0;0
89;14.10.2015;2015;10;04;Keskiviikko;5;3;8;0;0;0
89;14.10.2015;2015;10;05;Keskiviikko;5;13;18;1;1;2
89;14.10.2015;2015;10;06;Keskiviikko;12;52;64;2;10;12
89;14.10.2015;2015;10;07;Keskiviikko;42;166;208;11;23;34
89;14.10.2015;2015;10;08;Keskiviikko;57;274;331;8;50;58
89;14.10.2015;2015;10;09;Keskiviikko;48;133;181;21;35;56
89;14.10.2015;2015;10;10;Keskiviikko;33;64;97;18;41;59
89;14.10.2015;2015;10;11;Keskiviikko;68;95;163;21;35;56
89;14.10.2015;2015;10;12;Keskiviikko;75;105;180;26;30;56
89;14.10.2015;2015;10;13;Keskiviikko;87;91;178;27;30;57
89;14.10.2015;2015;10;14;Keskiviikko;159;118;277;35;41;76
89;14.10.2015;2015;10;15;Keskiviikko;184;104;288;31;31;62
89;14.10.2015;2015;10;16;Keskiviikko;259;125;384;36;20;56
89;14.10.2015;2015;10;17;Keskiviikko;155;93;248;49;35;84
89;14.10.2015;2015;10;18;Keskiviikko;105;66;171;41;37;78
89;14.10.2015;2015;10;19;Keskiviikko;73;49;122;27;31;58
89;14.10.2015;2015;10;20;Keskiviikko;54;23;77;25;7;32
89;14.10.2015;2015;10;21;Keskiviikko;44;25;69;17;10;27
89;14.10.2015;2015;10;22;Keskiviikko;18;12;30;3;4;7
89;14.10.2015;2015;10;23;Keskiviikko;12;3;15;1;4;5
89;15.10.2015;2015;10;00;Torstai;3;14;17;0;1;1
89;15.10.2015;2015;10;01;Torstai;3;0;3;0;1;1
89;15.10.2015;2015;10;02;Torstai;4;1;5;0;0;0
89;15.10.2015;2015;10;03;Torstai;8;2;10;1;0;1
89;15.10.2015;2015;10;04;Torstai;6;5;11;0;1;1
89;15.10.2015;2015;10;05;Torstai;2;12;14;0;2;2
89;15.10.2015;2015;10;06;Torstai;17;49;66;7;11;18
89;15.10.2015;2015;10;07;Torstai;41;166;207;7;20;27
89;15.10.2015;2015;10;08;Torstai;43;310;353;12;30;42
89;15.10.2015;2015;10;09;Torstai;49;121;170;14;39;53
89;15.10.2015;2015;10;10;Torstai;50;96;146;17;28;45
89;15.10.2015;2015;10;11;Torstai;65;76;141;16;36;52
89;15.10.2015;2015;10;12;Torstai;86;96;182;26;33;59
89;15.10.2015;2015;10;13;Torstai;100;89;189;31;85;116
89;15.10.2015;2015;10;14;Torstai;120;106;226;33;19;52
89;15.10.2015;2015;10;15;Torstai;172;105;277;36;15;51
89;15.10.2015;2015;10;16;Torstai;221;117;338;33;23;56
89;15.10.2015;2015;10;17;Torstai;124;102;226;38;31;69
89;15.10.2015;2015;10;18;Torstai;106;78;184;29;38;67
89;15.10.2015;2015;10;19;Torstai;78;64;142;28;30;58
89;15.10.2015;2015;10;20;Torstai;58;36;94;18;15;33
89;15.10.2015;2015;10;21;Torstai;42;35;77;11;7;18
89;15.10.2015;2015;10;22;Torstai;31;11;42;9;13;22
89;15.10.2015;2015;10;23;Torstai;24;6;30;7;3;10
89;16.10.2015;2015;10;00;Perjantai;19;3;22;0;1;1
89;16.10.2015;2015;10;01;Perjantai;6;5;11;1;0;1
89;16.10.2015;2015;10;02;Perjantai;15;0;15;2;0;2
89;16.10.2015;2015;10;03;Perjantai;6;1;7;0;0;0
89;16.10.2015;2015;10;04;Perjantai;6;2;8;3;0;3
89;16.10.2015;2015;10;05;Perjantai;2;13;15;0;1;1
89;16.10.2015;2015;10;06;Perjantai;10;45;55;2;8;10
89;16.10.2015;2015;10;07;Perjantai;39;157;196;3;23;26
89;16.10.2015;2015;10;08;Perjantai;41;239;280;11;31;42
89;16.10.2015;2015;10;09;Perjantai;38;125;163;17;31;48
89;16.10.2015;2015;10;10;Perjantai;41;97;138;14;32;46
89;16.10.2015;2015;10;11;Perjantai;69;77;146;21;26;47
89;16.10.2015;2015;10;12;Perjantai;87;124;211;27;34;61
89;16.10.2015;2015;10;13;Perjantai;117;96;213;37;35;72
89;16.10.2015;2015;10;14;Perjantai;176;90;266;25;22;47
89;16.10.2015;2015;10;15;Perjantai;177;76;253;24;23;47
89;16.10.2015;2015;10;16;Perjantai;148;121;269;25;23;48
89;16.10.2015;2015;10;17;Perjantai;117;78;195;30;22;52
89;16.10.2015;2015;10;18;Perjantai;86;60;146;25;23;48
89;16.10.2015;2015;10;19;Perjantai;48;43;91;22;24;46
89;16.10.2015;2015;10;20;Perjantai;44;23;67;11;15;26
89;16.10.2015;2015;10;21;Perjantai;52;21;73;13;15;28
89;16.10.2015;2015;10;22;Perjantai;34;34;68;1;7;8
89;16.10.2015;2015;10;23;Perjantai;20;26;46;2;1;3
89;17.10.2015;2015;10;00;Lauantai;22;11;33;3;9;12
89;17.10.2015;2015;10;01;Lauantai;20;7;27;0;2;2
89;17.10.2015;2015;10;02;Lauantai;13;6;19;0;2;2
89;17.10.2015;2015;10;03;Lauantai;21;9;30;4;0;4
89;17.10.2015;2015;10;04;Lauantai;12;3;15;8;1;9
89;17.10.2015;2015;10;05;Lauantai;7;4;11;1;1;2
89;17.10.2015;2015;10;06;Lauantai;3;14;17;0;0;0
89;17.10.2015;2015;10;07;Lauantai;4;9;13;3;4;7
89;17.10.2015;2015;10;08;Lauantai;6;26;32;4;13;17
89;17.10.2015;2015;10;09;Lauantai;15;57;72;11;26;37
89;17.10.2015;2015;10;10;Lauantai;31;70;101;15;40;55
89;17.10.2015;2015;10;11;Lauantai;45;79;124;30;56;86
89;17.10.2015;2015;10;12;Lauantai;65;100;165;41;57;98
89;17.10.2015;2015;10;13;Lauantai;70;93;163;32;54;86
89;17.10.2015;2015;10;14;Lauantai;76;78;154;28;37;65
89;17.10.2015;2015;10;15;Lauantai;91;74;165;33;41;74
89;17.10.2015;2015;10;16;Lauantai;93;53;146;34;39;73
89;17.10.2015;2015;10;17;Lauantai;63;71;134;31;35;66
89;17.10.2015;2015;10;18;Lauantai;48;60;108;32;23;55
89;17.10.2015;2015;10;19;Lauantai;35;34;69;18;18;36
89;17.10.2015;2015;10;20;Lauantai;30;24;54;5;8;13
89;17.10.2015;2015;10;21;Lauantai;31;15;46;9;16;25
89;17.10.2015;2015;10;22;Lauantai;27;35;62;13;12;25
89;17.10.2015;2015;10;23;Lauantai;21;23;44;6;9;15
89;18.10.2015;2015;10;00;Sunnuntai;15;20;35;1;7;8
89;18.10.2015;2015;10;01;Sunnuntai;16;9;25;8;4;12
89;18.10.2015;2015;10;02;Sunnuntai;25;7;32;9;0;9
89;18.10.2015;2015;10;03;Sunnuntai;17;3;20;4;2;6
89;18.10.2015;2015;10;04;Sunnuntai;20;3;23;0;1;1
89;18.10.2015;2015;10;05;Sunnuntai;6;1;7;3;0;3
89;18.10.2015;2015;10;06;Sunnuntai;3;11;14;0;1;1
89;18.10.2015;2015;10;07;Sunnuntai;3;9;12;3;4;7
89;18.10.2015;2015;10;08;Sunnuntai;6;11;17;8;10;18
89;18.10.2015;2015;10;09;Sunnuntai;9;27;36;10;16;26
89;18.10.2015;2015;10;10;Sunnuntai;22;27;49;15;33;48
89;18.10.2015;2015;10;11;Sunnuntai;31;55;86;36;49;85
89;18.10.2015;2015;10;12;Sunnuntai;48;62;110;20;41;61
89;18.10.2015;2015;10;13;Sunnuntai;47;52;99;28;41;69
89;18.10.2015;2015;10;14;Sunnuntai;67;50;117;50;42;92
89;18.10.2015;2015;10;15;Sunnuntai;69;60;129;32;28;60
89;18.10.2015;2015;10;16;Sunnuntai;58;70;128;29;48;77
89;18.10.2015;2015;10;17;Sunnuntai;72;31;103;42;33;75
89;18.10.2015;2015;10;18;Sunnuntai;39;27;66;36;36;72
89;18.10.2015;2015;10;19;Sunnuntai;25;23;48;20;27;47
89;18.10.2015;2015;10;20;Sunnuntai;30;18;48;9;10;19
89;18.10.2015;2015;10;21;Sunnuntai;18;20;38;5;8;13
89;18.10.2015;2015;10;22;Sunnuntai;18;11;29;10;4;14
89;18.10.2015;2015;10;23;Sunnuntai;7;10;17;0;2;2
89;19.10.2015;2015;10;00;Maanantai;7;4;11;1;0;1
89;19.10.2015;2015;10;01;Maanantai;1;1;2;0;0;0
89;19.10.2015;2015;10;02;Maanantai;2;3;5;1;0;1
89;19.10.2015;2015;10;03;Maanantai;5;1;6;1;0;1
89;19.10.2015;2015;10;04;Maanantai;5;5;10;1;0;1
89;19.10.2015;2015;10;05;Maanantai;5;9;14;0;1;1
89;19.10.2015;2015;10;06;Maanantai;11;43;54;2;6;8
89;19.10.2015;2015;10;07;Maanantai;30;109;139;3;17;20
89;19.10.2015;2015;10;08;Maanantai;17;165;182;9;22;31
89;19.10.2015;2015;10;09;Maanantai;29;93;122;13;26;39
89;19.10.2015;2015;10;10;Maanantai;43;69;112;14;32;46
89;19.10.2015;2015;10;11;Maanantai;69;85;154;23;29;52
89;19.10.2015;2015;10;12;Maanantai;54;89;143;22;29;51
89;19.10.2015;2015;10;13;Maanantai;90;81;171;19;25;44
89;19.10.2015;2015;10;14;Maanantai;101;89;190;27;25;52
89;19.10.2015;2015;10;15;Maanantai;143;85;228;19;14;33
89;19.10.2015;2015;10;16;Maanantai;180;77;257;16;28;44
89;19.10.2015;2015;10;17;Maanantai;124;68;192;38;29;67
89;19.10.2015;2015;10;18;Maanantai;105;51;156;33;35;68
89;19.10.2015;2015;10;19;Maanantai;54;43;97;33;31;64
89;19.10.2015;2015;10;20;Maanantai;37;18;55;16;25;41
89;19.10.2015;2015;10;21;Maanantai;19;27;46;9;7;16
89;19.10.2015;2015;10;22;Maanantai;22;9;31;9;6;15
89;19.10.2015;2015;10;23;Maanantai;11;6;17;1;5;6
89;20.10.2015;2015;10;00;Tiistai;2;0;2;0;0;0
89;20.10.2015;2015;10;01;Tiistai;1;0;1;0;0;0
89;20.10.2015;2015;10;02;Tiistai;1;0;1;1;0;1
89;20.10.2015;2015;10;03;Tiistai;4;1;5;0;1;1
89;20.10.2015;2015;10;04;Tiistai;7;4;11;3;0;3
89;20.10.2015;2015;10;05;Tiistai;2;11;13;0;0;0
89;20.10.2015;2015;10;06;Tiistai;11;45;56;1;5;6
89;20.10.2015;2015;10;07;Tiistai;25;109;134;9;21;30
89;20.10.2015;2015;10;08;Tiistai;28;145;173;5;28;33
89;20.10.2015;2015;10;09;Tiistai;31;59;90;9;27;36
89;20.10.2015;2015;10;10;Tiistai;38;68;106;20;28;48
89;20.10.2015;2015;10;11;Tiistai;54;72;126;26;20;46
89;20.10.2015;2015;10;12;Tiistai;52;69;121;25;25;50
89;20.10.2015;2015;10;13;Tiistai;56;54;110;17;18;35
89;20.10.2015;2015;10;14;Tiistai;71;49;120;20;15;35
89;20.10.2015;2015;10;15;Tiistai;123;45;168;19;21;40
89;20.10.2015;2015;10;16;Tiistai;123;59;182;14;14;28
89;20.10.2015;2015;10;17;Tiistai;75;49;124;20;10;30
89;20.10.2015;2015;10;18;Tiistai;60;27;87;20;15;35
89;20.10.2015;2015;10;19;Tiistai;34;22;56;19;22;41
89;20.10.2015;2015;10;20;Tiistai;23;29;52;13;15;28
89;20.10.2015;2015;10;21;Tiistai;28;26;54;13;6;19
89;20.10.2015;2015;10;22;Tiistai;21;9;30;4;3;7
89;20.10.2015;2015;10;23;Tiistai;4;3;7;0;2;2
89;21.10.2015;2015;10;00;Keskiviikko;6;1;7;1;2;3
89;21.10.2015;2015;10;01;Keskiviikko;2;0;2;2;1;3
89;21.10.2015;2015;10;02;Keskiviikko;1;2;3;3;3;6
89;21.10.2015;2015;10;03;Keskiviikko;5;2;7;2;0;2
89;21.10.2015;2015;10;04;Keskiviikko;1;4;5;1;0;1
89;21.10.2015;2015;10;05;Keskiviikko;3;11;14;0;0;0
89;21.10.2015;2015;10;06;Keskiviikko;7;34;41;2;4;6
89;21.10.2015;2015;10;07;Keskiviikko;21;98;119;5;18;23
89;21.10.2015;2015;10;08;Keskiviikko;24;140;164;12;23;35
89;21.10.2015;2015;10;09;Keskiviikko;38;82;120;11;24;35
89;21.10.2015;2015;10;10;Keskiviikko;32;71;103;9;36;45
89;21.10.2015;2015;10;11;Keskiviikko;35;61;96;13;30;43
89;21.10.2015;2015;10;12;Keskiviikko;63;71;134;17;26;43
89;21.10.2015;2015;10;13;Keskiviikko;53;91;144;24;28;52
89;21.10.2015;2015;10;14;Keskiviikko;84;55;139;28;26;54
89;21.10.2015;2015;10;15;Keskiviikko;109;50;159;18;15;33
89;21.10.2015;2015;10;16;Keskiviikko;142;52;194;27;20;47
89;21.10.2015;2015;10;17;Keskiviikko;71;52;123;15;12;27
89;21.10.2015;2015;10;18;Keskiviikko;54;20;74;12;23;35
89;21.10.2015;2015;10;19;Keskiviikko;42;40;82;23;10;33
89;21.10.2015;2015;10;20;Keskiviikko;37;18;55;11;10;21
89;21.10.2015;2015;10;21;Keskiviikko;25;14;39;8;5;13
89;21.10.2015;2015;10;22;Keskiviikko;15;17;32;3;9;12
89;21.10.2015;2015;10;23;Keskiviikko;5;4;9;1;4;5
89;22.10.2015;2015;10;00;Torstai;2;3;5;3;2;5
89;22.10.2015;2015;10;01;Torstai;5;2;7;0;1;1
89;22.10.2015;2015;10;02;Torstai;8;3;11;0;0;0
89;22.10.2015;2015;10;03;Torstai;4;2;6;4;0;4
89;22.10.2015;2015;10;04;Torstai;7;2;9;0;0;0
89;22.10.2015;2015;10;05;Torstai;2;6;8;0;0;0
89;22.10.2015;2015;10;06;Torstai;9;34;43;1;4;5
89;22.10.2015;2015;10;07;Torstai;26;80;106;2;16;18
89;22.10.2015;2015;10;08;Torstai;18;142;160;4;27;31
89;22.10.2015;2015;10;09;Torstai;19;71;90;13;22;35
89;22.10.2015;2015;10;10;Torstai;27;64;91;15;34;49
89;22.10.2015;2015;10;11;Torstai;48;61;109;18;33;51
89;22.10.2015;2015;10;12;Torstai;44;94;138;17;31;48
89;22.10.2015;2015;10;13;Torstai;69;71;140;32;25;57
89;22.10.2015;2015;10;14;Torstai;83;57;140;23;20;43
89;22.10.2015;2015;10;15;Torstai;113;66;179;27;20;47
89;22.10.2015;2015;10;16;Torstai;116;59;175;22;15;37
89;22.10.2015;2015;10;17;Torstai;84;59;143;25;21;46
89;22.10.2015;2015;10;18;Torstai;65;50;115;24;27;51
89;22.10.2015;2015;10;19;Torstai;42;25;67;13;12;25
89;22.10.2015;2015;10;20;Torstai;32;28;60;9;12;21
89;22.10.2015;2015;10;21;Torstai;17;17;34;11;9;20
89;22.10.2015;2015;10;22;Torstai;17;10;27;4;3;7
89;22.10.2015;2015;10;23;Torstai;4;2;6;3;2;5
89;23.10.2015;2015;10;00;Perjantai;7;8;15;1;1;2
89;23.10.2015;2015;10;01;Perjantai;5;2;7;0;2;2
89;23.10.2015;2015;10;02;Perjantai;1;1;2;2;1;3
89;23.10.2015;2015;10;03;Perjantai;1;1;2;0;0;0
89;23.10.2015;2015;10;04;Perjantai;3;5;8;0;0;0
89;23.10.2015;2015;10;05;Perjantai;5;8;13;0;0;0
89;23.10.2015;2015;10;06;Perjantai;9;25;34;1;5;6
89;23.10.2015;2015;10;07;Perjantai;22;73;95;3;9;12
89;23.10.2015;2015;10;08;Perjantai;19;102;121;10;23;33
89;23.10.2015;2015;10;09;Perjantai;14;79;93;6;20;26
89;23.10.2015;2015;10;10;Perjantai;34;35;69;13;23;36
89;23.10.2015;2015;10;11;Perjantai;36;55;91;20;27;47
89;23.10.2015;2015;10;12;Perjantai;49;49;98;18;15;33
89;23.10.2015;2015;10;13;Perjantai;45;53;98;23;11;34
89;23.10.2015;2015;10;14;Perjantai;58;59;117;15;19;34
89;23.10.2015;2015;10;15;Perjantai;95;49;144;15;17;32
89;23.10.2015;2015;10;16;Perjantai;103;55;158;18;18;36
89;23.10.2015;2015;10;17;Perjantai;65;39;104;14;16;30
89;23.10.2015;2015;10;18;Perjantai;55;36;91;9;13;22
89;23.10.2015;2015;10;19;Perjantai;33;17;50;9;8;17
89;23.10.2015;2015;10;20;Perjantai;20;36;56;8;14;22
89;23.10.2015;2015;10;21;Perjantai;25;20;45;7;5;12
89;23.10.2015;2015;10;22;Perjantai;20;25;45;3;7;10
89;23.10.2015;2015;10;23;Perjantai;6;41;47;1;6;7
89;24.10.2015;2015;10;00;Lauantai;10;21;31;3;5;8
89;24.10.2015;2015;10;01;Lauantai;11;4;15;5;7;12
89;24.10.2015;2015;10;02;Lauantai;21;6;27;5;2;7
89;24.10.2015;2015;10;03;Lauantai;20;1;21;5;0;5
89;24.10.2015;2015;10;04;Lauantai;17;4;21;3;0;3
89;24.10.2015;2015;10;05;Lauantai;4;6;10;0;0;0
89;24.10.2015;2015;10;06;Lauantai;4;14;18;0;1;1
89;24.10.2015;2015;10;07;Lauantai;6;8;14;4;3;7
89;24.10.2015;2015;10;08;Lauantai;4;32;36;4;8;12
89;24.10.2015;2015;10;09;Lauantai;7;33;40;12;16;28
89;24.10.2015;2015;10;10;Lauantai;23;48;71;16;22;38
89;24.10.2015;2015;10;11;Lauantai;31;66;97;21;48;69
89;24.10.2015;2015;10;12;Lauantai;44;78;122;19;45;64
89;24.10.2015;2015;10;13;Lauantai;52;74;126;34;39;73
89;24.10.2015;2015;10;14;Lauantai;73;54;127;38;33;71
89;24.10.2015;2015;10;15;Lauantai;84;63;147;31;29;60
89;24.10.2015;2015;10;16;Lauantai;61;56;117;41;32;73
89;24.10.2015;2015;10;17;Lauantai;59;37;96;32;35;67
89;24.10.2015;2015;10;18;Lauantai;42;30;72;27;22;49
89;24.10.2015;2015;10;19;Lauantai;26;36;62;16;15;31
89;24.10.2015;2015;10;20;Lauantai;25;29;54;6;17;23
89;24.10.2015;2015;10;21;Lauantai;22;18;40;9;15;24
89;24.10.2015;2015;10;22;Lauantai;14;20;34;2;10;12
89;24.10.2015;2015;10;23;Lauantai;7;19;26;2;11;13
89;25.10.2015;2015;10;00;Sunnuntai;7;27;34;1;8;9
89;25.10.2015;2015;10;01;Sunnuntai;14;8;22;11;10;21
89;25.10.2015;2015;10;02;Sunnuntai;24;4;28;9;3;12
89;25.10.2015;2015;10;03;Sunnuntai;29;3;32;16;1;17
89;25.10.2015;2015;10;04;Sunnuntai;12;1;13;0;0;0
89;25.10.2015;2015;10;05;Sunnuntai;2;1;3;2;0;2
89;25.10.2015;2015;10;06;Sunnuntai;3;9;12;0;2;2
89;25.10.2015;2015;10;07;Sunnuntai;10;9;19;3;8;11
89;25.10.2015;2015;10;08;Sunnuntai;5;13;18;8;9;17
89;25.10.2015;2015;10;09;Sunnuntai;7;21;28;19;25;44
89;25.10.2015;2015;10;10;Sunnuntai;18;25;43;40;42;82
89;25.10.2015;2015;10;11;Sunnuntai;23;38;61;16;27;43
89;25.10.2015;2015;10;12;Sunnuntai;22;22;44;18;18;36
89;25.10.2015;2015;10;13;Sunnuntai;22;28;50;12;19;31
89;25.10.2015;2015;10;14;Sunnuntai;23;22;45;15;11;26
89;25.10.2015;2015;10;15;Sunnuntai;39;22;61;8;13;21
89;25.10.2015;2015;10;16;Sunnuntai;25;28;53;9;8;17
89;25.10.2015;2015;10;17;Sunnuntai;31;17;48;14;12;26
89;25.10.2015;2015;10;18;Sunnuntai;32;15;47;20;16;36
89;25.10.2015;2015;10;19;Sunnuntai;23;8;31;11;11;22
89;25.10.2015;2015;10;20;Sunnuntai;15;10;25;10;10;20
89;25.10.2015;2015;10;21;Sunnuntai;13;12;25;8;7;15
89;25.10.2015;2015;10;22;Sunnuntai;11;3;14;0;1;1
89;25.10.2015;2015;10;23;Sunnuntai;5;2;7;0;1;1
89;26.10.2015;2015;10;00;Maanantai;5;0;5;3;2;5
89;26.10.2015;2015;10;01;Maanantai;1;2;3;0;0;0
89;26.10.2015;2015;10;02;Maanantai;1;2;3;0;0;0
89;26.10.2015;2015;10;03;Maanantai;3;0;3;5;0;5
89;26.10.2015;2015;10;04;Maanantai;2;2;4;1;0;1
89;26.10.2015;2015;10;05;Maanantai;4;9;13;0;1;1
89;26.10.2015;2015;10;06;Maanantai;13;49;62;2;8;10
89;26.10.2015;2015;10;07;Maanantai;31;122;153;2;13;15
89;26.10.2015;2015;10;08;Maanantai;37;191;228;4;38;42
89;26.10.2015;2015;10;09;Maanantai;40;106;146;8;25;33
89;26.10.2015;2015;10;10;Maanantai;34;46;80;17;23;40
89;26.10.2015;2015;10;11;Maanantai;61;71;132;18;23;41
89;26.10.2015;2015;10;12;Maanantai;62;82;144;17;19;36
89;26.10.2015;2015;10;13;Maanantai;88;61;149;24;48;72
89;26.10.2015;2015;10;14;Maanantai;98;84;182;23;44;67
89;26.10.2015;2015;10;15;Maanantai;155;64;219;31;23;54
89;26.10.2015;2015;10;16;Maanantai;176;88;264;35;21;56
89;26.10.2015;2015;10;17;Maanantai;83;76;159;26;24;50
89;26.10.2015;2015;10;18;Maanantai;58;44;102;41;44;85
89;26.10.2015;2015;10;19;Maanantai;55;30;85;14;19;33
89;26.10.2015;2015;10;20;Maanantai;47;26;73;20;19;39
89;26.10.2015;2015;10;21;Maanantai;33;13;46;10;9;19
89;26.10.2015;2015;10;22;Maanantai;17;8;25;2;1;3
89;26.10.2015;2015;10;23;Maanantai;5;1;6;1;0;1
89;27.10.2015;2015;10;00;Tiistai;1;6;7;0;2;2
89;27.10.2015;2015;10;01;Tiistai;0;0;0;2;0;2
89;27.10.2015;2015;10;02;Tiistai;0;1;1;0;0;0
89;27.10.2015;2015;10;03;Tiistai;1;1;2;0;0;0
89;27.10.2015;2015;10;04;Tiistai;2;3;5;1;2;3
89;27.10.2015;2015;10;05;Tiistai;1;8;9;0;3;3
89;27.10.2015;2015;10;06;Tiistai;16;35;51;3;11;14
89;27.10.2015;2015;10;07;Tiistai;33;133;166;6;29;35
89;27.10.2015;2015;10;08;Tiistai;47;219;266;6;33;39
89;27.10.2015;2015;10;09;Tiistai;34;82;116;10;36;46
89;27.10.2015;2015;10;10;Tiistai;36;61;97;16;29;45
89;27.10.2015;2015;10;11;Tiistai;53;75;128;13;21;34
89;27.10.2015;2015;10;12;Tiistai;67;80;147;18;21;39
89;27.10.2015;2015;10;13;Tiistai;81;53;134;20;22;42
89;27.10.2015;2015;10;14;Tiistai;114;62;176;31;22;53
89;27.10.2015;2015;10;15;Tiistai;128;73;201;26;21;47
89;27.10.2015;2015;10;16;Tiistai;200;102;302;35;29;64
89;27.10.2015;2015;10;17;Tiistai;91;65;156;23;27;50
89;27.10.2015;2015;10;18;Tiistai;66;51;117;34;32;66
89;27.10.2015;2015;10;19;Tiistai;54;36;90;16;24;40
89;27.10.2015;2015;10;20;Tiistai;45;31;76;21;13;34
89;27.10.2015;2015;10;21;Tiistai;40;21;61;5;5;10
89;27.10.2015;2015;10;22;Tiistai;20;11;31;5;3;8
89;27.10.2015;2015;10;23;Tiistai;6;6;12;2;7;9
89;28.10.2015;2015;10;00;Keskiviikko;8;2;10;1;0;1
89;28.10.2015;2015;10;01;Keskiviikko;2;2;4;2;1;3
89;28.10.2015;2015;10;02;Keskiviikko;1;0;1;2;1;3
89;28.10.2015;2015;10;03;Keskiviikko;2;2;4;3;0;3
89;28.10.2015;2015;10;04;Keskiviikko;2;4;6;1;0;1
89;28.10.2015;2015;10;05;Keskiviikko;4;13;17;0;4;4
89;28.10.2015;2015;10;06;Keskiviikko;9;35;44;6;14;20
89;28.10.2015;2015;10;07;Keskiviikko;33;130;163;4;27;31
89;28.10.2015;2015;10;08;Keskiviikko;43;219;262;9;45;54
89;28.10.2015;2015;10;09;Keskiviikko;38;109;147;11;38;49
89;28.10.2015;2015;10;10;Keskiviikko;40;69;109;17;33;50
89;28.10.2015;2015;10;11;Keskiviikko;58;67;125;19;27;46
89;28.10.2015;2015;10;12;Keskiviikko;61;73;134;23;19;42
89;28.10.2015;2015;10;13;Keskiviikko;73;66;139;24;22;46
89;28.10.2015;2015;10;14;Keskiviikko;122;74;196;29;21;50
89;28.10.2015;2015;10;15;Keskiviikko;115;90;205;34;21;55
89;28.10.2015;2015;10;16;Keskiviikko;187;85;272;45;15;60
89;28.10.2015;2015;10;17;Keskiviikko;110;88;198;21;25;46
89;28.10.2015;2015;10;18;Keskiviikko;72;58;130;34;30;64
89;28.10.2015;2015;10;19;Keskiviikko;61;32;93;29;30;59
89;28.10.2015;2015;10;20;Keskiviikko;68;27;95;26;20;46
89;28.10.2015;2015;10;21;Keskiviikko;43;27;70;9;7;16
89;28.10.2015;2015;10;22;Keskiviikko;16;11;27;6;2;8
89;28.10.2015;2015;10;23;Keskiviikko;11;9;20;1;5;6
89;29.10.2015;2015;10;00;Torstai;3;2;5;0;1;1
89;29.10.2015;2015;10;01;Torstai;4;5;9;0;0;0
89;29.10.2015;2015;10;02;Torstai;4;1;5;0;1;1
89;29.10.2015;2015;10;03;Torstai;1;1;2;2;3;5
89;29.10.2015;2015;10;04;Torstai;1;2;3;1;0;1
89;29.10.2015;2015;10;05;Torstai;4;8;12;0;4;4
89;29.10.2015;2015;10;06;Torstai;13;32;45;4;13;17
89;29.10.2015;2015;10;07;Torstai;35;153;188;1;29;30
89;29.10.2015;2015;10;08;Torstai;51;236;287;14;43;57
89;29.10.2015;2015;10;09;Torstai;44;108;152;6;36;42
89;29.10.2015;2015;10;10;Torstai;36;70;106;24;32;56
89;29.10.2015;2015;10;11;Torstai;36;79;115;23;45;68
89;29.10.2015;2015;10;12;Torstai;44;80;124;28;19;47
89;29.10.2015;2015;10;13;Torstai;60;60;120;9;23;32
89;29.10.2015;2015;10;14;Torstai;97;77;174;28;30;58
89;29.10.2015;2015;10;15;Torstai;113;68;181;30;28;58
89;29.10.2015;2015;10;16;Torstai;175;79;254;28;23;51
89;29.10.2015;2015;10;17;Torstai;106;66;172;43;26;69
89;29.10.2015;2015;10;18;Torstai;79;62;141;19;22;41
89;29.10.2015;2015;10;19;Torstai;60;37;97;15;21;36
89;29.10.2015;2015;10;20;Torstai;53;23;76;21;22;43
89;29.10.2015;2015;10;21;Torstai;34;26;60;3;10;13
89;29.10.2015;2015;10;22;Torstai;22;15;37;5;0;5
89;29.10.2015;2015;10;23;Torstai;15;5;20;1;3;4
89;30.10.2015;2015;10;00;Perjantai;10;6;16;2;0;2
89;30.10.2015;2015;10;01;Perjantai;4;1;5;0;0;0
89;30.10.2015;2015;10;02;Perjantai;3;1;4;1;1;2
89;30.10.2015;2015;10;03;Perjantai;6;2;8;2;0;2
89;30.10.2015;2015;10;04;Perjantai;3;5;8;2;1;3
89;30.10.2015;2015;10;05;Perjantai;6;5;11;0;2;2
89;30.10.2015;2015;10;06;Perjantai;15;42;57;1;8;9
89;30.10.2015;2015;10;07;Perjantai;32;112;144;4;21;25
89;30.10.2015;2015;10;08;Perjantai;33;183;216;13;40;53
89;30.10.2015;2015;10;09;Perjantai;18;94;112;10;27;37
89;30.10.2015;2015;10;10;Perjantai;40;81;121;14;35;49
89;30.10.2015;2015;10;11;Perjantai;43;64;107;8;30;38
89;30.10.2015;2015;10;12;Perjantai;68;78;146;18;14;32
89;30.10.2015;2015;10;13;Perjantai;97;66;163;18;18;36
89;30.10.2015;2015;10;14;Perjantai;116;88;204;22;23;45
89;30.10.2015;2015;10;15;Perjantai;134;105;239;26;29;55
89;30.10.2015;2015;10;16;Perjantai;131;61;192;28;18;46
89;30.10.2015;2015;10;17;Perjantai;78;57;135;15;22;37
89;30.10.2015;2015;10;18;Perjantai;53;48;101;23;19;42
89;30.10.2015;2015;10;19;Perjantai;40;40;80;19;15;34
89;30.10.2015;2015;10;20;Perjantai;37;31;68;11;4;15
89;30.10.2015;2015;10;21;Perjantai;26;28;54;9;7;16
89;30.10.2015;2015;10;22;Perjantai;19;44;63;2;13;15
89;30.10.2015;2015;10;23;Perjantai;12;23;35;1;6;7
89;31.10.2015;2015;10;00;Lauantai;21;22;43;5;6;11
89;31.10.2015;2015;10;01;Lauantai;22;6;28;8;5;13
89;31.10.2015;2015;10;02;Lauantai;16;2;18;4;0;4
89;31.10.2015;2015;10;03;Lauantai;20;2;22;3;2;5
89;31.10.2015;2015;10;04;Lauantai;20;0;20;12;0;12
89;31.10.2015;2015;10;05;Lauantai;2;1;3;1;1;2
89;31.10.2015;2015;10;06;Lauantai;3;6;9;3;4;7
89;31.10.2015;2015;10;07;Lauantai;1;1;2;6;3;9
89;31.10.2015;2015;10;08;Lauantai;6;4;10;2;3;5
89;31.10.2015;2015;10;09;Lauantai;5;8;13;5;20;25
89;31.10.2015;2015;10;10;Lauantai;7;6;13;14;6;20
89;31.10.2015;2015;10;11;Lauantai;13;9;22;18;12;30
89;31.10.2015;2015;10;12;Lauantai;21;9;30;22;18;40
89;31.10.2015;2015;10;13;Lauantai;15;15;30;13;23;36
89;31.10.2015;2015;10;14;Lauantai;31;26;57;19;22;41
89;31.10.2015;2015;10;15;Lauantai;19;17;36;18;6;24
89;31.10.2015;2015;10;16;Lauantai;20;3;23;16;13;29
89;31.10.2015;2015;10;17;Lauantai;22;24;46;19;20;39
89;31.10.2015;2015;10;18;Lauantai;15;39;54;15;13;28
89;31.10.2015;2015;10;19;Lauantai;28;24;52;15;8;23
89;31.10.2015;2015;10;20;Lauantai;28;27;55;11;14;25
89;31.10.2015;2015;10;21;Lauantai;17;19;36;6;5;11
89;31.10.2015;2015;10;22;Lauantai;11;22;33;2;11;13
89;31.10.2015;2015;10;23;Lauantai;15;29;44;7;14;21
89;01.11.2015;2015;11;00;Sunnuntai;12;23;35;8;5;13
89;01.11.2015;2015;11;01;Sunnuntai;6;12;18;5;2;7
89;01.11.2015;2015;11;02;Sunnuntai;17;1;18;6;0;6
89;01.11.2015;2015;11;03;Sunnuntai;18;0;18;11;0;11
89;01.11.2015;2015;11;04;Sunnuntai;16;0;16;8;1;9
89;01.11.2015;2015;11;05;Sunnuntai;4;2;6;2;0;2
89;01.11.2015;2015;11;06;Sunnuntai;2;0;2;0;2;2
89;01.11.2015;2015;11;07;Sunnuntai;2;2;4;3;0;3
89;01.11.2015;2015;11;08;Sunnuntai;4;2;6;0;1;1
89;01.11.2015;2015;11;09;Sunnuntai;4;5;9;7;8;15
89;01.11.2015;2015;11;10;Sunnuntai;6;4;10;13;19;32
89;01.11.2015;2015;11;11;Sunnuntai;9;11;20;25;29;54
89;01.11.2015;2015;11;12;Sunnuntai;23;7;30;31;26;57
89;01.11.2015;2015;11;13;Sunnuntai;28;30;58;28;26;54
89;01.11.2015;2015;11;14;Sunnuntai;26;10;36;21;32;53
89;01.11.2015;2015;11;15;Sunnuntai;45;26;71;23;18;41
89;01.11.2015;2015;11;16;Sunnuntai;25;26;51;19;25;44
89;01.11.2015;2015;11;17;Sunnuntai;22;25;47;19;22;41
89;01.11.2015;2015;11;18;Sunnuntai;27;16;43;19;18;37
89;01.11.2015;2015;11;19;Sunnuntai;21;18;39;9;15;24
89;01.11.2015;2015;11;20;Sunnuntai;19;19;38;6;9;15
89;01.11.2015;2015;11;21;Sunnuntai;16;13;29;2;5;7
89;01.11.2015;2015;11;22;Sunnuntai;10;10;20;1;1;2
89;01.11.2015;2015;11;23;Sunnuntai;11;4;15;1;1;2
89;02.11.2015;2015;11;00;Maanantai;7;3;10;1;2;3
89;02.11.2015;2015;11;01;Maanantai;2;0;2;0;0;0
89;02.11.2015;2015;11;02;Maanantai;0;3;3;0;0;0
89;02.11.2015;2015;11;03;Maanantai;2;3;5;2;0;2
89;02.11.2015;2015;11;04;Maanantai;2;3;5;0;0;0
89;02.11.2015;2015;11;05;Maanantai;1;11;12;0;0;0
89;02.11.2015;2015;11;06;Maanantai;13;31;44;2;9;11
89;02.11.2015;2015;11;07;Maanantai;33;131;164;8;19;27
89;02.11.2015;2015;11;08;Maanantai;34;251;285;5;35;40
89;02.11.2015;2015;11;09;Maanantai;26;121;147;13;28;41
89;02.11.2015;2015;11;10;Maanantai;42;63;105;13;30;43
89;02.11.2015;2015;11;11;Maanantai;57;68;125;14;30;44
89;02.11.2015;2015;11;12;Maanantai;59;64;123;19;23;42
89;02.11.2015;2015;11;13;Maanantai;78;67;145;19;18;37
89;02.11.2015;2015;11;14;Maanantai;125;75;200;13;28;41
89;02.11.2015;2015;11;15;Maanantai;154;75;229;21;14;35
89;02.11.2015;2015;11;16;Maanantai;194;106;300;27;17;44
89;02.11.2015;2015;11;17;Maanantai;72;53;125;24;24;48
89;02.11.2015;2015;11;18;Maanantai;55;48;103;30;23;53
89;02.11.2015;2015;11;19;Maanantai;53;29;82;21;22;43
89;02.11.2015;2015;11;20;Maanantai;56;30;86;18;15;33
89;02.11.2015;2015;11;21;Maanantai;38;19;57;9;9;18
89;02.11.2015;2015;11;22;Maanantai;13;12;25;2;5;7
89;02.11.2015;2015;11;23;Maanantai;8;3;11;1;2;3
89;03.11.2015;2015;11;00;Tiistai;2;5;7;1;1;2
89;03.11.2015;2015;11;01;Tiistai;4;2;6;1;0;1
89;03.11.2015;2015;11;02;Tiistai;0;0;0;1;1;2
89;03.11.2015;2015;11;03;Tiistai;3;2;5;1;0;1
89;03.11.2015;2015;11;04;Tiistai;1;2;3;0;0;0
89;03.11.2015;2015;11;05;Tiistai;1;11;12;0;1;1
89;03.11.2015;2015;11;06;Tiistai;11;41;52;3;7;10
89;03.11.2015;2015;11;07;Tiistai;39;122;161;9;24;33
89;03.11.2015;2015;11;08;Tiistai;61;249;310;3;46;49
89;03.11.2015;2015;11;09;Tiistai;41;103;144;7;35;42
89;03.11.2015;2015;11;10;Tiistai;45;72;117;27;35;62
89;03.11.2015;2015;11;11;Tiistai;65;78;143;35;40;75
89;03.11.2015;2015;11;12;Tiistai;62;83;145;18;24;42
89;03.11.2015;2015;11;13;Tiistai;76;80;156;18;25;43
89;03.11.2015;2015;11;14;Tiistai;129;72;201;28;13;41
89;03.11.2015;2015;11;15;Tiistai;157;89;246;21;26;47
89;03.11.2015;2015;11;16;Tiistai;226;109;335;37;23;60
89;03.11.2015;2015;11;17;Tiistai;92;87;179;25;32;57
89;03.11.2015;2015;11;18;Tiistai;82;51;133;29;34;63
89;03.11.2015;2015;11;19;Tiistai;67;40;107;19;25;44
89;03.11.2015;2015;11;20;Tiistai;49;43;92;23;18;41
89;03.11.2015;2015;11;21;Tiistai;33;27;60;9;9;18
89;03.11.2015;2015;11;22;Tiistai;19;10;29;3;1;4
89;03.11.2015;2015;11;23;Tiistai;10;4;14;2;4;6
89;04.11.2015;2015;11;00;Keskiviikko;6;7;13;2;2;4
89;04.11.2015;2015;11;01;Keskiviikko;2;7;9;1;1;2
89;04.11.2015;2015;11;02;Keskiviikko;2;1;3;1;0;1
89;04.11.2015;2015;11;03;Keskiviikko;4;1;5;2;0;2
89;04.11.2015;2015;11;04;Keskiviikko;1;2;3;0;0;0
89;04.11.2015;2015;11;05;Keskiviikko;1;15;16;1;2;3
89;04.11.2015;2015;11;06;Keskiviikko;14;30;44;3;10;13
89;04.11.2015;2015;11;07;Keskiviikko;42;138;180;4;28;32
89;04.11.2015;2015;11;08;Keskiviikko;53;245;298;8;35;43
89;04.11.2015;2015;11;09;Keskiviikko;38;123;161;16;53;69
89;04.11.2015;2015;11;10;Keskiviikko;42;75;117;16;36;52
89;04.11.2015;2015;11;11;Keskiviikko;61;73;134;15;34;49
89;04.11.2015;2015;11;12;Keskiviikko;58;89;147;24;28;52
89;04.11.2015;2015;11;13;Keskiviikko;75;79;154;16;34;50
89;04.11.2015;2015;11;14;Keskiviikko;147;104;251;29;19;48
89;04.11.2015;2015;11;15;Keskiviikko;152;95;247;26;17;43
89;04.11.2015;2015;11;16;Keskiviikko;198;102;300;22;28;50
89;04.11.2015;2015;11;17;Keskiviikko;144;77;221;31;29;60
89;04.11.2015;2015;11;18;Keskiviikko;79;58;137;25;26;51
89;04.11.2015;2015;11;19;Keskiviikko;62;47;109;25;30;55
89;04.11.2015;2015;11;20;Keskiviikko;43;21;64;7;13;20
89;04.11.2015;2015;11;21;Keskiviikko;29;29;58;20;6;26
89;04.11.2015;2015;11;22;Keskiviikko;18;30;48;4;13;17
89;04.11.2015;2015;11;23;Keskiviikko;7;17;24;2;3;5
89;05.11.2015;2015;11;00;Torstai;14;2;16;2;1;3
89;05.11.2015;2015;11;01;Torstai;7;1;8;2;0;2
89;05.11.2015;2015;11;02;Torstai;1;4;5;1;0;1
89;05.11.2015;2015;11;03;Torstai;4;0;4;1;0;1
89;05.11.2015;2015;11;04;Torstai;2;6;8;3;0;3
89;05.11.2015;2015;11;05;Torstai;4;12;16;2;2;4
89;05.11.2015;2015;11;06;Torstai;10;36;46;2;7;9
89;05.11.2015;2015;11;07;Torstai;39;142;181;4;26;30
89;05.11.2015;2015;11;08;Torstai;53;224;277;14;43;57
89;05.11.2015;2015;11;09;Torstai;46;103;149;13;32;45
89;05.11.2015;2015;11;10;Torstai;38;71;109;13;34;47
89;05.11.2015;2015;11;11;Torstai;50;82;132;25;23;48
89;05.11.2015;2015;11;12;Torstai;55;72;127;23;23;46
89;05.11.2015;2015;11;13;Torstai;83;72;155;20;25;45
89;05.11.2015;2015;11;14;Torstai;98;77;175;25;16;41
89;05.11.2015;2015;11;15;Torstai;155;69;224;34;29;63
89;05.11.2015;2015;11;16;Torstai;164;84;248;28;28;56
89;05.11.2015;2015;11;17;Torstai;103;85;188;24;17;41
89;05.11.2015;2015;11;18;Torstai;66;64;130;27;27;54
89;05.11.2015;2015;11;19;Torstai;47;32;79;15;27;42
89;05.11.2015;2015;11;20;Torstai;55;37;92;18;19;37
89;05.11.2015;2015;11;21;Torstai;39;22;61;9;8;17
89;05.11.2015;2015;11;22;Torstai;24;10;34;5;3;8
89;05.11.2015;2015;11;23;Torstai;11;12;23;3;4;7
89;06.11.2015;2015;11;00;Perjantai;5;2;7;1;2;3
89;06.11.2015;2015;11;01;Perjantai;3;2;5;1;0;1
89;06.11.2015;2015;11;02;Perjantai;5;0;5;0;0;0
89;06.11.2015;2015;11;03;Perjantai;5;1;6;3;1;4
89;06.11.2015;2015;11;04;Perjantai;4;6;10;2;0;2
89;06.11.2015;2015;11;05;Perjantai;2;9;11;1;1;2
89;06.11.2015;2015;11;06;Perjantai;12;32;44;3;8;11
89;06.11.2015;2015;11;07;Perjantai;28;112;140;6;30;36
89;06.11.2015;2015;11;08;Perjantai;40;187;227;4;43;47
89;06.11.2015;2015;11;09;Perjantai;35;90;125;5;27;32
89;06.11.2015;2015;11;10;Perjantai;36;73;109;9;36;45
89;06.11.2015;2015;11;11;Perjantai;70;65;135;22;40;62
89;06.11.2015;2015;11;12;Perjantai;62;84;146;24;28;52
89;06.11.2015;2015;11;13;Perjantai;86;60;146;29;24;53
89;06.11.2015;2015;11;14;Perjantai;126;72;198;39;37;76
89;06.11.2015;2015;11;15;Perjantai;122;67;189;22;32;54
89;06.11.2015;2015;11;16;Perjantai;107;64;171;24;23;47
89;06.11.2015;2015;11;17;Perjantai;68;55;123;26;27;53
89;06.11.2015;2015;11;18;Perjantai;51;47;98;24;23;47
89;06.11.2015;2015;11;19;Perjantai;36;22;58;9;13;22
89;06.11.2015;2015;11;20;Perjantai;42;24;66;12;17;29
89;06.11.2015;2015;11;21;Perjantai;19;21;40;6;7;13
89;06.11.2015;2015;11;22;Perjantai;22;17;39;6;4;10
89;06.11.2015;2015;11;23;Perjantai;13;7;20;3;2;5
89;07.11.2015;2015;11;00;Lauantai;6;11;17;5;3;8
89;07.11.2015;2015;11;01;Lauantai;15;4;19;5;0;5
89;07.11.2015;2015;11;02;Lauantai;5;6;11;3;4;7
89;07.11.2015;2015;11;03;Lauantai;29;3;32;8;0;8
89;07.11.2015;2015;11;04;Lauantai;5;3;8;7;0;7
89;07.11.2015;2015;11;05;Lauantai;8;3;11;0;1;1
89;07.11.2015;2015;11;06;Lauantai;9;8;17;2;4;6
89;07.11.2015;2015;11;07;Lauantai;3;12;15;2;2;4
89;07.11.2015;2015;11;08;Lauantai;6;23;29;4;11;15
89;07.11.2015;2015;11;09;Lauantai;17;46;63;10;19;29
89;07.11.2015;2015;11;10;Lauantai;15;26;41;13;22;35
89;07.11.2015;2015;11;11;Lauantai;31;39;70;20;33;53
89;07.11.2015;2015;11;12;Lauantai;28;68;96;15;19;34
89;07.11.2015;2015;11;13;Lauantai;29;44;73;26;30;56
89;07.11.2015;2015;11;14;Lauantai;56;25;81;12;26;38
89;07.11.2015;2015;11;15;Lauantai;41;41;82;17;20;37
89;07.11.2015;2015;11;16;Lauantai;51;23;74;21;26;47
89;07.11.2015;2015;11;17;Lauantai;37;21;58;17;15;32
89;07.11.2015;2015;11;18;Lauantai;31;20;51;13;12;25
89;07.11.2015;2015;11;19;Lauantai;12;17;29;15;14;29
89;07.11.2015;2015;11;20;Lauantai;18;24;42;7;10;17
89;07.11.2015;2015;11;21;Lauantai;14;10;24;7;10;17
89;07.11.2015;2015;11;22;Lauantai;16;23;39;7;5;12
89;07.11.2015;2015;11;23;Lauantai;10;14;24;3;5;8
89;08.11.2015;2015;11;00;Sunnuntai;13;19;32;6;3;9
89;08.11.2015;2015;11;01;Sunnuntai;8;4;12;2;1;3
89;08.11.2015;2015;11;02;Sunnuntai;14;5;19;8;3;11
89;08.11.2015;2015;11;03;Sunnuntai;11;3;14;2;0;2
89;08.11.2015;2015;11;04;Sunnuntai;11;0;11;2;3;5
89;08.11.2015;2015;11;05;Sunnuntai;3;1;4;3;0;3
89;08.11.2015;2015;11;06;Sunnuntai;4;11;15;0;2;2
89;08.11.2015;2015;11;07;Sunnuntai;3;5;8;3;2;5
89;08.11.2015;2015;11;08;Sunnuntai;4;10;14;10;5;15
89;08.11.2015;2015;11;09;Sunnuntai;10;23;33;15;21;36
89;08.11.2015;2015;11;10;Sunnuntai;13;25;38;22;28;50
89;08.11.2015;2015;11;11;Sunnuntai;30;46;76;32;50;82
89;08.11.2015;2015;11;12;Sunnuntai;40;54;94;40;60;100
89;08.11.2015;2015;11;13;Sunnuntai;50;39;89;39;46;85
89;08.11.2015;2015;11;14;Sunnuntai;50;36;86;32;34;66
89;08.11.2015;2015;11;15;Sunnuntai;56;33;89;26;20;46
89;08.11.2015;2015;11;16;Sunnuntai;50;29;79;36;35;71
89;08.11.2015;2015;11;17;Sunnuntai;30;34;64;18;22;40
89;08.11.2015;2015;11;18;Sunnuntai;40;24;64;12;23;35
89;08.11.2015;2015;11;19;Sunnuntai;19;20;39;17;14;31
89;08.11.2015;2015;11;20;Sunnuntai;22;9;31;18;20;38
89;08.11.2015;2015;11;21;Sunnuntai;15;14;29;8;3;11
89;08.11.2015;2015;11;22;Sunnuntai;5;1;6;1;6;7
89;08.11.2015;2015;11;23;Sunnuntai;2;6;8;1;2;3
89;09.11.2015;2015;11;00;Maanantai;5;2;7;1;0;1
89;09.11.2015;2015;11;01;Maanantai;2;1;3;1;1;2
89;09.11.2015;2015;11;02;Maanantai;1;0;1;0;0;0
89;09.11.2015;2015;11;03;Maanantai;1;1;2;0;0;0
89;09.11.2015;2015;11;04;Maanantai;3;1;4;0;2;2
89;09.11.2015;2015;11;05;Maanantai;5;9;14;0;0;0
89;09.11.2015;2015;11;06;Maanantai;8;39;47;3;10;13
89;09.11.2015;2015;11;07;Maanantai;34;142;176;7;18;25
89;09.11.2015;2015;11;08;Maanantai;54;239;293;12;49;61
89;09.11.2015;2015;11;09;Maanantai;35;118;153;11;37;48
89;09.11.2015;2015;11;10;Maanantai;37;78;115;15;35;50
89;09.11.2015;2015;11;11;Maanantai;49;76;125;23;31;54
89;09.11.2015;2015;11;12;Maanantai;78;77;155;13;20;33
89;09.11.2015;2015;11;13;Maanantai;73;66;139;27;23;50
89;09.11.2015;2015;11;14;Maanantai;102;77;179;19;19;38
89;09.11.2015;2015;11;15;Maanantai;145;77;222;37;29;66
89;09.11.2015;2015;11;16;Maanantai;208;62;270;28;21;49
89;09.11.2015;2015;11;17;Maanantai;87;48;135;32;18;50
89;09.11.2015;2015;11;18;Maanantai;62;49;111;42;24;66
89;09.11.2015;2015;11;19;Maanantai;63;32;95;23;33;56
89;09.11.2015;2015;11;20;Maanantai;34;24;58;21;25;46
89;09.11.2015;2015;11;21;Maanantai;28;12;40;12;15;27
89;09.11.2015;2015;11;22;Maanantai;16;7;23;3;3;6
89;09.11.2015;2015;11;23;Maanantai;2;2;4;2;2;4
89;10.11.2015;2015;11;00;Tiistai;4;3;7;0;1;1
89;10.11.2015;2015;11;01;Tiistai;0;0;0;0;0;0
89;10.11.2015;2015;11;02;Tiistai;0;0;0;0;1;1
89;10.11.2015;2015;11;03;Tiistai;4;1;5;0;0;0
89;10.11.2015;2015;11;04;Tiistai;1;1;2;0;3;3
89;10.11.2015;2015;11;05;Tiistai;4;10;14;0;0;0
89;10.11.2015;2015;11;06;Tiistai;16;21;37;3;6;9
89;10.11.2015;2015;11;07;Tiistai;27;115;142;6;19;25
89;10.11.2015;2015;11;08;Tiistai;45;180;225;8;34;42
89;10.11.2015;2015;11;09;Tiistai;25;73;98;4;18;22
89;10.11.2015;2015;11;10;Tiistai;29;50;79;12;20;32
89;10.11.2015;2015;11;11;Tiistai;31;45;76;9;17;26
89;10.11.2015;2015;11;12;Tiistai;28;43;71;16;14;30
89;10.11.2015;2015;11;13;Tiistai;46;42;88;9;17;26
89;10.11.2015;2015;11;14;Tiistai;98;55;153;30;14;44
89;10.11.2015;2015;11;15;Tiistai;111;47;158;22;7;29
89;10.11.2015;2015;11;16;Tiistai;144;76;220;22;11;33
89;10.11.2015;2015;11;17;Tiistai;64;47;111;18;24;42
89;10.11.2015;2015;11;18;Tiistai;69;33;102;24;20;44
89;10.11.2015;2015;11;19;Tiistai;46;30;76;14;9;23
89;10.11.2015;2015;11;20;Tiistai;38;29;67;18;17;35
89;10.11.2015;2015;11;21;Tiistai;39;20;59;7;12;19
89;10.11.2015;2015;11;22;Tiistai;15;2;17;4;4;8
89;10.11.2015;2015;11;23;Tiistai;7;3;10;2;1;3
89;11.11.2015;2015;11;00;Keskiviikko;4;3;7;0;1;1
89;11.11.2015;2015;11;01;Keskiviikko;1;0;1;1;0;1
89;11.11.2015;2015;11;02;Keskiviikko;2;0;2;0;0;0
89;11.11.2015;2015;11;03;Keskiviikko;1;2;3;0;1;1
89;11.11.2015;2015;11;04;Keskiviikko;2;3;5;1;1;2
89;11.11.2015;2015;11;05;Keskiviikko;3;8;11;0;0;0
89;11.11.2015;2015;11;06;Keskiviikko;7;36;43;4;8;12
89;11.11.2015;2015;11;07;Keskiviikko;34;113;147;8;22;30
89;11.11.2015;2015;11;08;Keskiviikko;46;204;250;7;30;37
89;11.11.2015;2015;11;09;Keskiviikko;32;86;118;12;32;44
89;11.11.2015;2015;11;10;Keskiviikko;30;69;99;18;31;49
89;11.11.2015;2015;11;11;Keskiviikko;60;50;110;26;24;50
89;11.11.2015;2015;11;12;Keskiviikko;50;81;131;31;14;45
89;11.11.2015;2015;11;13;Keskiviikko;78;64;142;19;28;47
89;11.11.2015;2015;11;14;Keskiviikko;110;63;173;33;26;59
89;11.11.2015;2015;11;15;Keskiviikko;117;87;204;34;16;50
89;11.11.2015;2015;11;16;Keskiviikko;157;84;241;26;24;50
89;11.11.2015;2015;11;17;Keskiviikko;86;65;151;22;21;43
89;11.11.2015;2015;11;18;Keskiviikko;68;59;127;34;22;56
89;11.11.2015;2015;11;19;Keskiviikko;72;33;105;27;28;55
89;11.11.2015;2015;11;20;Keskiviikko;40;16;56;28;23;51
89;11.11.2015;2015;11;21;Keskiviikko;37;20;57;12;8;20
89;11.11.2015;2015;11;22;Keskiviikko;11;10;21;3;3;6
89;11.11.2015;2015;11;23;Keskiviikko;10;4;14;3;3;6
89;12.11.2015;2015;11;00;Torstai;2;4;6;4;3;7
89;12.11.2015;2015;11;01;Torstai;6;3;9;0;1;1
89;12.11.2015;2015;11;02;Torstai;2;2;4;2;0;2
89;12.11.2015;2015;11;03;Torstai;0;3;3;5;1;6
89;12.11.2015;2015;11;04;Torstai;1;2;3;4;0;4
89;12.11.2015;2015;11;05;Torstai;0;4;4;1;1;2
89;12.11.2015;2015;11;06;Torstai;13;34;47;3;8;11
89;12.11.2015;2015;11;07;Torstai;33;106;139;9;22;31
89;12.11.2015;2015;11;08;Torstai;31;195;226;12;33;45
89;12.11.2015;2015;11;09;Torstai;32;112;144;16;29;45
89;12.11.2015;2015;11;10;Torstai;42;53;95;19;21;40
89;12.11.2015;2015;11;11;Torstai;44;69;113;8;23;31
89;12.11.2015;2015;11;12;Torstai;55;63;118;17;26;43
89;12.11.2015;2015;11;13;Torstai;74;58;132;18;27;45
89;12.11.2015;2015;11;14;Torstai;91;71;162;36;20;56
89;12.11.2015;2015;11;15;Torstai;133;50;183;19;15;34
89;12.11.2015;2015;11;16;Torstai;149;70;219;37;16;53
89;12.11.2015;2015;11;17;Torstai;94;56;150;25;22;47
89;12.11.2015;2015;11;18;Torstai;61;45;106;22;27;49
89;12.11.2015;2015;11;19;Torstai;48;36;84;18;23;41
89;12.11.2015;2015;11;20;Torstai;60;40;100;26;18;44
89;12.11.2015;2015;11;21;Torstai;26;17;43;12;19;31
89;12.11.2015;2015;11;22;Torstai;16;14;30;2;4;6
89;12.11.2015;2015;11;23;Torstai;6;4;10;4;7;11
89;13.11.2015;2015;11;00;Perjantai;5;3;8;2;2;4
89;13.11.2015;2015;11;01;Perjantai;4;4;8;4;2;6
89;13.11.2015;2015;11;02;Perjantai;3;2;5;2;0;2
89;13.11.2015;2015;11;03;Perjantai;3;2;5;1;0;1
89;13.11.2015;2015;11;04;Perjantai;5;2;7;1;0;1
89;13.11.2015;2015;11;05;Perjantai;5;10;15;2;0;2
89;13.11.2015;2015;11;06;Perjantai;10;36;46;1;9;10
89;13.11.2015;2015;11;07;Perjantai;34;111;145;3;19;22
89;13.11.2015;2015;11;08;Perjantai;39;168;207;7;36;43
89;13.11.2015;2015;11;09;Perjantai;33;99;132;11;29;40
89;13.11.2015;2015;11;10;Perjantai;43;56;99;18;24;42
89;13.11.2015;2015;11;11;Perjantai;39;62;101;19;36;55
89;13.11.2015;2015;11;12;Perjantai;60;74;134;34;30;64
89;13.11.2015;2015;11;13;Perjantai;103;78;181;26;30;56
89;13.11.2015;2015;11;14;Perjantai;107;74;181;21;28;49
89;13.11.2015;2015;11;15;Perjantai;139;72;211;25;20;45
89;13.11.2015;2015;11;16;Perjantai;89;77;166;27;22;49
89;13.11.2015;2015;11;17;Perjantai;74;61;135;22;27;49
89;13.11.2015;2015;11;18;Perjantai;57;22;79;32;15;47
89;13.11.2015;2015;11;19;Perjantai;56;19;75;16;17;33
89;13.11.2015;2015;11;20;Perjantai;30;31;61;11;9;20
89;13.11.2015;2015;11;21;Perjantai;20;25;45;5;8;13
89;13.11.2015;2015;11;22;Perjantai;19;24;43;9;6;15
89;13.11.2015;2015;11;23;Perjantai;12;12;24;4;4;8
89;14.11.2015;2015;11;00;Lauantai;13;15;28;7;6;13
89;14.11.2015;2015;11;01;Lauantai;15;5;20;2;2;4
89;14.11.2015;2015;11;02;Lauantai;12;2;14;5;0;5
89;14.11.2015;2015;11;03;Lauantai;11;1;12;8;0;8
89;14.11.2015;2015;11;04;Lauantai;10;7;17;4;1;5
89;14.11.2015;2015;11;05;Lauantai;5;3;8;0;1;1
89;14.11.2015;2015;11;06;Lauantai;1;4;5;0;3;3
89;14.11.2015;2015;11;07;Lauantai;4;5;9;0;2;2
89;14.11.2015;2015;11;08;Lauantai;6;25;31;6;9;15
89;14.11.2015;2015;11;09;Lauantai;9;48;57;11;15;26
89;14.11.2015;2015;11;10;Lauantai;17;27;44;14;23;37
89;14.11.2015;2015;11;11;Lauantai;16;53;69;23;27;50
89;14.11.2015;2015;11;12;Lauantai;39;65;104;16;23;39
89;14.11.2015;2015;11;13;Lauantai;39;47;86;17;36;53
89;14.11.2015;2015;11;14;Lauantai;55;25;80;20;21;41
89;14.11.2015;2015;11;15;Lauantai;44;39;83;23;16;39
89;14.11.2015;2015;11;16;Lauantai;44;25;69;16;18;34
89;14.11.2015;2015;11;17;Lauantai;39;24;63;16;24;40
89;14.11.2015;2015;11;18;Lauantai;22;28;50;13;12;25
89;14.11.2015;2015;11;19;Lauantai;19;26;45;14;16;30
89;14.11.2015;2015;11;20;Lauantai;12;21;33;10;14;24
89;14.11.2015;2015;11;21;Lauantai;17;19;36;10;5;15
89;14.11.2015;2015;11;22;Lauantai;20;21;41;5;7;12
89;14.11.2015;2015;11;23;Lauantai;20;10;30;3;6;9
89;15.11.2015;2015;11;00;Sunnuntai;11;19;30;6;9;15
89;15.11.2015;2015;11;01;Sunnuntai;16;4;20;6;4;10
89;15.11.2015;2015;11;02;Sunnuntai;9;3;12;4;1;5
89;15.11.2015;2015;11;03;Sunnuntai;21;2;23;4;0;4
89;15.11.2015;2015;11;04;Sunnuntai;16;1;17;7;0;7
89;15.11.2015;2015;11;05;Sunnuntai;5;4;9;0;0;0
89;15.11.2015;2015;11;06;Sunnuntai;3;8;11;1;2;3
89;15.11.2015;2015;11;07;Sunnuntai;4;3;7;1;0;1
89;15.11.2015;2015;11;08;Sunnuntai;5;3;8;5;4;9
89;15.11.2015;2015;11;09;Sunnuntai;5;27;32;13;32;45
89;15.11.2015;2015;11;10;Sunnuntai;12;28;40;25;24;49
89;15.11.2015;2015;11;11;Sunnuntai;16;33;49;29;50;79
89;15.11.2015;2015;11;12;Sunnuntai;44;43;87;31;33;64
89;15.11.2015;2015;11;13;Sunnuntai;37;41;78;25;39;64
89;15.11.2015;2015;11;14;Sunnuntai;48;43;91;20;28;48
89;15.11.2015;2015;11;15;Sunnuntai;42;37;79;27;22;49
89;15.11.2015;2015;11;16;Sunnuntai;42;30;72;23;30;53
89;15.11.2015;2015;11;17;Sunnuntai;27;33;60;14;13;27
89;15.11.2015;2015;11;18;Sunnuntai;28;27;55;16;21;37
89;15.11.2015;2015;11;19;Sunnuntai;22;11;33;14;19;33
89;15.11.2015;2015;11;20;Sunnuntai;27;13;40;12;18;30
89;15.11.2015;2015;11;21;Sunnuntai;17;6;23;10;7;17
89;15.11.2015;2015;11;22;Sunnuntai;9;7;16;4;4;8
89;15.11.2015;2015;11;23;Sunnuntai;7;2;9;1;1;2
89;16.11.2015;2015;11;00;Maanantai;5;1;6;0;0;0
89;16.11.2015;2015;11;01;Maanantai;3;2;5;0;1;1
89;16.11.2015;2015;11;02;Maanantai;1;0;1;0;0;0
89;16.11.2015;2015;11;03;Maanantai;0;3;3;2;1;3
89;16.11.2015;2015;11;04;Maanantai;2;4;6;1;1;2
89;16.11.2015;2015;11;05;Maanantai;1;9;10;1;0;1
89;16.11.2015;2015;11;06;Maanantai;9;33;42;2;11;13
89;16.11.2015;2015;11;07;Maanantai;37;125;162;7;22;29
89;16.11.2015;2015;11;08;Maanantai;39;214;253;8;76;84
89;16.11.2015;2015;11;09;Maanantai;27;111;138;8;33;41
89;16.11.2015;2015;11;10;Maanantai;34;64;98;16;36;52
89;16.11.2015;2015;11;11;Maanantai;56;51;107;23;35;58
89;16.11.2015;2015;11;12;Maanantai;68;70;138;24;23;47
89;16.11.2015;2015;11;13;Maanantai;67;52;119;28;41;69
89;16.11.2015;2015;11;14;Maanantai;112;62;174;26;18;44
89;16.11.2015;2015;11;15;Maanantai;120;59;179;34;18;52
89;16.11.2015;2015;11;16;Maanantai;166;70;236;42;18;60
89;16.11.2015;2015;11;17;Maanantai;103;53;156;26;28;54
89;16.11.2015;2015;11;18;Maanantai;51;64;115;36;33;69
89;16.11.2015;2015;11;19;Maanantai;42;32;74;34;29;63
89;16.11.2015;2015;11;20;Maanantai;43;31;74;23;20;43
89;16.11.2015;2015;11;21;Maanantai;55;10;65;9;8;17
89;16.11.2015;2015;11;22;Maanantai;16;5;21;1;3;4
89;16.11.2015;2015;11;23;Maanantai;3;2;5;2;2;4
89;17.11.2015;2015;11;00;Tiistai;1;0;1;2;3;5
89;17.11.2015;2015;11;01;Tiistai;0;5;5;0;0;0
89;17.11.2015;2015;11;02;Tiistai;2;0;2;1;0;1
89;17.11.2015;2015;11;03;Tiistai;1;2;3;3;1;4
89;17.11.2015;2015;11;04;Tiistai;3;4;7;0;2;2
89;17.11.2015;2015;11;05;Tiistai;1;7;8;0;1;1
89;17.11.2015;2015;11;06;Tiistai;17;38;55;4;9;13
89;17.11.2015;2015;11;07;Tiistai;28;119;147;7;32;39
89;17.11.2015;2015;11;08;Tiistai;35;242;277;13;47;60
89;17.11.2015;2015;11;09;Tiistai;42;85;127;7;34;41
89;17.11.2015;2015;11;10;Tiistai;33;72;105;25;26;51
89;17.11.2015;2015;11;11;Tiistai;48;56;104;15;38;53
89;17.11.2015;2015;11;12;Tiistai;58;63;121;19;12;31
89;17.11.2015;2015;11;13;Tiistai;76;40;116;17;23;40
89;17.11.2015;2015;11;14;Tiistai;93;50;143;23;20;43
89;17.11.2015;2015;11;15;Tiistai;144;46;190;28;8;36
89;17.11.2015;2015;11;16;Tiistai;162;86;248;32;11;43
89;17.11.2015;2015;11;17;Tiistai;91;64;155;23;16;39
89;17.11.2015;2015;11;18;Tiistai;65;24;89;21;22;43
89;17.11.2015;2015;11;19;Tiistai;50;40;90;22;21;43
89;17.11.2015;2015;11;20;Tiistai;39;28;67;23;19;42
89;17.11.2015;2015;11;21;Tiistai;35;12;47;9;5;14
89;17.11.2015;2015;11;22;Tiistai;12;4;16;7;2;9
89;17.11.2015;2015;11;23;Tiistai;3;6;9;0;0;0
89;18.11.2015;2015;11;00;Keskiviikko;2;4;6;0;0;0
89;18.11.2015;2015;11;01;Keskiviikko;1;3;4;1;1;2
89;18.11.2015;2015;11;02;Keskiviikko;4;4;8;0;1;1
89;18.11.2015;2015;11;03;Keskiviikko;3;6;9;1;1;2
89;18.11.2015;2015;11;04;Keskiviikko;2;4;6;2;0;2
89;18.11.2015;2015;11;05;Keskiviikko;2;10;12;0;0;0
89;18.11.2015;2015;11;06;Keskiviikko;18;36;54;2;9;11
89;18.11.2015;2015;11;07;Keskiviikko;37;118;155;10;19;29
89;18.11.2015;2015;11;08;Keskiviikko;38;224;262;10;34;44
89;18.11.2015;2015;11;09;Keskiviikko;24;94;118;16;32;48
89;18.11.2015;2015;11;10;Keskiviikko;42;75;117;17;30;47
89;18.11.2015;2015;11;11;Keskiviikko;55;87;142;27;28;55
89;18.11.2015;2015;11;12;Keskiviikko;72;66;138;19;26;45
89;18.11.2015;2015;11;13;Keskiviikko;66;50;116;21;31;52
89;18.11.2015;2015;11;14;Keskiviikko;123;91;214;23;19;42
89;18.11.2015;2015;11;15;Keskiviikko;129;80;209;37;19;56
89;18.11.2015;2015;11;16;Keskiviikko;150;89;239;32;22;54
89;18.11.2015;2015;11;17;Keskiviikko;109;58;167;34;39;73
89;18.11.2015;2015;11;18;Keskiviikko;73;42;115;33;28;61
89;18.11.2015;2015;11;19;Keskiviikko;52;28;80;22;26;48
89;18.11.2015;2015;11;20;Keskiviikko;52;25;77;18;23;41
89;18.11.2015;2015;11;21;Keskiviikko;40;23;63;15;12;27
89;18.11.2015;2015;11;22;Keskiviikko;23;7;30;5;4;9
89;18.11.2015;2015;11;23;Keskiviikko;8;9;17;2;3;5
89;19.11.2015;2015;11;00;Torstai;7;5;12;2;3;5
89;19.11.2015;2015;11;01;Torstai;5;5;10;2;1;3
89;19.11.2015;2015;11;02;Torstai;4;3;7;1;0;1
89;19.11.2015;2015;11;03;Torstai;3;2;5;2;0;2
89;19.11.2015;2015;11;04;Torstai;2;4;6;1;1;2
89;19.11.2015;2015;11;05;Torstai;3;2;5;0;1;1
89;19.11.2015;2015;11;06;Torstai;12;32;44;0;5;5
89;19.11.2015;2015;11;07;Torstai;28;115;143;8;21;29
89;19.11.2015;2015;11;08;Torstai;39;207;246;14;39;53
89;19.11.2015;2015;11;09;Torstai;29;96;125;20;19;39
89;19.11.2015;2015;11;10;Torstai;42;88;130;12;32;44
89;19.11.2015;2015;11;11;Torstai;42;82;124;21;29;50
89;19.11.2015;2015;11;12;Torstai;62;60;122;16;37;53
89;19.11.2015;2015;11;13;Torstai;71;48;119;16;24;40
89;19.11.2015;2015;11;14;Torstai;109;68;177;20;22;42
89;19.11.2015;2015;11;15;Torstai;137;81;218;37;13;50
89;19.11.2015;2015;11;16;Torstai;153;76;229;29;24;53
89;19.11.2015;2015;11;17;Torstai;95;55;150;26;29;55
89;19.11.2015;2015;11;18;Torstai;61;42;103;17;34;51
89;19.11.2015;2015;11;19;Torstai;43;54;97;29;16;45
89;19.11.2015;2015;11;20;Torstai;49;19;68;17;17;34
89;19.11.2015;2015;11;21;Torstai;30;15;45;16;6;22
89;19.11.2015;2015;11;22;Torstai;19;9;28;4;6;10
89;19.11.2015;2015;11;23;Torstai;7;4;11;8;5;13
89;20.11.2015;2015;11;00;Perjantai;4;4;8;3;4;7
89;20.11.2015;2015;11;01;Perjantai;4;2;6;1;0;1
89;20.11.2015;2015;11;02;Perjantai;9;1;10;1;0;1
89;20.11.2015;2015;11;03;Perjantai;5;0;5;0;0;0
89;20.11.2015;2015;11;04;Perjantai;1;4;5;0;0;0
89;20.11.2015;2015;11;05;Perjantai;3;9;12;0;1;1
89;20.11.2015;2015;11;06;Perjantai;9;40;49;2;9;11
89;20.11.2015;2015;11;07;Perjantai;32;113;145;3;29;32
89;20.11.2015;2015;11;08;Perjantai;34;172;206;9;33;42
89;20.11.2015;2015;11;09;Perjantai;21;71;92;5;34;39
89;20.11.2015;2015;11;10;Perjantai;29;62;91;21;29;50
89;20.11.2015;2015;11;11;Perjantai;47;68;115;19;29;48
89;20.11.2015;2015;11;12;Perjantai;51;58;109;19;22;41
89;20.11.2015;2015;11;13;Perjantai;76;51;127;24;20;44
89;20.11.2015;2015;11;14;Perjantai;92;65;157;24;19;43
89;20.11.2015;2015;11;15;Perjantai;120;69;189;30;25;55
89;20.11.2015;2015;11;16;Perjantai;111;70;181;31;32;63
89;20.11.2015;2015;11;17;Perjantai;63;71;134;17;45;62
89;20.11.2015;2015;11;18;Perjantai;53;58;111;19;26;45
89;20.11.2015;2015;11;19;Perjantai;45;26;71;23;21;44
89;20.11.2015;2015;11;20;Perjantai;41;17;58;20;17;37
89;20.11.2015;2015;11;21;Perjantai;35;14;49;14;11;25
89;20.11.2015;2015;11;22;Perjantai;29;21;50;6;4;10
89;20.11.2015;2015;11;23;Perjantai;18;9;27;4;5;9
89;21.11.2015;2015;11;00;Lauantai;13;7;20;5;6;11
89;21.11.2015;2015;11;01;Lauantai;10;1;11;1;0;1
89;21.11.2015;2015;11;02;Lauantai;10;4;14;3;1;4
89;21.11.2015;2015;11;03;Lauantai;16;2;18;5;2;7
89;21.11.2015;2015;11;04;Lauantai;9;6;15;7;0;7
89;21.11.2015;2015;11;05;Lauantai;2;1;3;1;2;3
89;21.11.2015;2015;11;06;Lauantai;4;7;11;2;2;4
89;21.11.2015;2015;11;07;Lauantai;1;1;2;3;6;9
89;21.11.2015;2015;11;08;Lauantai;1;0;1;7;5;12
89;21.11.2015;2015;11;09;Lauantai;6;8;14;4;18;22
89;21.11.2015;2015;11;10;Lauantai;7;4;11;13;10;23
89;21.11.2015;2015;11;11;Lauantai;8;3;11;24;20;44
89;21.11.2015;2015;11;12;Lauantai;16;13;29;16;12;28
89;21.11.2015;2015;11;13;Lauantai;19;5;24;22;22;44
89;21.11.2015;2015;11;14;Lauantai;13;7;20;16;20;36
89;21.11.2015;2015;11;15;Lauantai;44;34;78;33;23;56
89;21.11.2015;2015;11;16;Lauantai;24;15;39;25;25;50
89;21.11.2015;2015;11;17;Lauantai;20;16;36;20;23;43
89;21.11.2015;2015;11;18;Lauantai;23;28;51;26;22;48
89;21.11.2015;2015;11;19;Lauantai;10;20;30;16;20;36
89;21.11.2015;2015;11;20;Lauantai;15;13;28;12;12;24
89;21.11.2015;2015;11;21;Lauantai;17;10;27;13;9;22
89;21.11.2015;2015;11;22;Lauantai;19;24;43;5;7;12
89;21.11.2015;2015;11;23;Lauantai;16;17;33;1;10;11
89;22.11.2015;2015;11;00;Sunnuntai;4;8;12;4;5;9
89;22.11.2015;2015;11;01;Sunnuntai;16;8;24;5;2;7
89;22.11.2015;2015;11;02;Sunnuntai;14;10;24;9;1;10
89;22.11.2015;2015;11;03;Sunnuntai;13;3;16;6;0;6
89;22.11.2015;2015;11;04;Sunnuntai;4;0;4;7;0;7
89;22.11.2015;2015;11;05;Sunnuntai;0;2;2;3;0;3
89;22.11.2015;2015;11;06;Sunnuntai;0;3;3;0;2;2
89;22.11.2015;2015;11;07;Sunnuntai;2;0;2;2;0;2
89;22.11.2015;2015;11;08;Sunnuntai;1;7;8;8;3;11
89;22.11.2015;2015;11;09;Sunnuntai;3;7;10;8;18;26
89;22.11.2015;2015;11;10;Sunnuntai;6;13;19;20;22;42
89;22.11.2015;2015;11;11;Sunnuntai;11;29;40;23;26;49
89;22.11.2015;2015;11;12;Sunnuntai;26;32;58;30;44;74
89;22.11.2015;2015;11;13;Sunnuntai;30;35;65;52;42;94
89;22.11.2015;2015;11;14;Sunnuntai;41;30;71;41;48;89
89;22.11.2015;2015;11;15;Sunnuntai;31;28;59;27;30;57
89;22.11.2015;2015;11;16;Sunnuntai;24;16;40;35;30;65
89;22.11.2015;2015;11;17;Sunnuntai;33;23;56;25;31;56
89;22.11.2015;2015;11;18;Sunnuntai;25;21;46;22;28;50
89;22.11.2015;2015;11;19;Sunnuntai;13;19;32;22;26;48
89;22.11.2015;2015;11;20;Sunnuntai;27;8;35;27;13;40
89;22.11.2015;2015;11;21;Sunnuntai;17;5;22;13;9;22
89;22.11.2015;2015;11;22;Sunnuntai;6;5;11;7;6;13
89;22.11.2015;2015;11;23;Sunnuntai;4;2;6;3;0;3
89;23.11.2015;2015;11;00;Maanantai;2;1;3;0;3;3
89;23.11.2015;2015;11;01;Maanantai;3;0;3;0;2;2
89;23.11.2015;2015;11;02;Maanantai;1;1;2;2;0;2
89;23.11.2015;2015;11;03;Maanantai;3;4;7;0;0;0
89;23.11.2015;2015;11;04;Maanantai;2;2;4;0;1;1
89;23.11.2015;2015;11;05;Maanantai;4;10;14;1;0;1
89;23.11.2015;2015;11;06;Maanantai;9;23;32;3;4;7
89;23.11.2015;2015;11;07;Maanantai;29;121;150;5;38;43
89;23.11.2015;2015;11;08;Maanantai;34;176;210;9;55;64
89;23.11.2015;2015;11;09;Maanantai;30;129;159;14;25;39
89;23.11.2015;2015;11;10;Maanantai;34;77;111;18;27;45
89;23.11.2015;2015;11;11;Maanantai;34;52;86;25;40;65
89;23.11.2015;2015;11;12;Maanantai;72;83;155;21;27;48
89;23.11.2015;2015;11;13;Maanantai;78;48;126;35;42;77
89;23.11.2015;2015;11;14;Maanantai;98;54;152;31;25;56
89;23.11.2015;2015;11;15;Maanantai;123;60;183;29;17;46
89;23.11.2015;2015;11;16;Maanantai;142;70;212;54;21;75
89;23.11.2015;2015;11;17;Maanantai;101;51;152;30;20;50
89;23.11.2015;2015;11;18;Maanantai;61;38;99;31;38;69
89;23.11.2015;2015;11;19;Maanantai;56;25;81;33;29;62
89;23.11.2015;2015;11;20;Maanantai;30;21;51;21;20;41
89;23.11.2015;2015;11;21;Maanantai;42;21;63;13;13;26
89;23.11.2015;2015;11;22;Maanantai;17;5;22;5;3;8
89;23.11.2015;2015;11;23;Maanantai;6;3;9;2;5;7
89;24.11.2015;2015;11;00;Tiistai;2;5;7;3;0;3
89;24.11.2015;2015;11;01;Tiistai;3;0;3;0;0;0
89;24.11.2015;2015;11;02;Tiistai;1;2;3;0;1;1
89;24.11.2015;2015;11;03;Tiistai;2;2;4;0;0;0
89;24.11.2015;2015;11;04;Tiistai;2;3;5;0;1;1
89;24.11.2015;2015;11;05;Tiistai;3;9;12;0;1;1
89;24.11.2015;2015;11;06;Tiistai;11;25;36;6;8;14
89;24.11.2015;2015;11;07;Tiistai;23;120;143;15;31;46
89;24.11.2015;2015;11;08;Tiistai;35;218;253;24;62;86
89;24.11.2015;2015;11;09;Tiistai;27;84;111;21;39;60
89;24.11.2015;2015;11;10;Tiistai;33;59;92;12;36;48
89;24.11.2015;2015;11;11;Tiistai;53;63;116;14;31;45
89;24.11.2015;2015;11;12;Tiistai;43;53;96;30;25;55
89;24.11.2015;2015;11;13;Tiistai;81;57;138;28;32;60
89;24.11.2015;2015;11;14;Tiistai;101;62;163;32;17;49
89;24.11.2015;2015;11;15;Tiistai;125;65;190;37;16;53
89;24.11.2015;2015;11;16;Tiistai;140;77;217;41;24;65
89;24.11.2015;2015;11;17;Tiistai;97;67;164;28;17;45
89;24.11.2015;2015;11;18;Tiistai;70;47;117;32;33;65
89;24.11.2015;2015;11;19;Tiistai;57;15;72;26;30;56
89;24.11.2015;2015;11;20;Tiistai;48;26;74;25;15;40
89;24.11.2015;2015;11;21;Tiistai;37;20;57;8;9;17
89;24.11.2015;2015;11;22;Tiistai;16;6;22;4;4;8
89;24.11.2015;2015;11;23;Tiistai;3;1;4;2;2;4
89;25.11.2015;2015;11;00;Keskiviikko;1;4;5;1;0;1
89;25.11.2015;2015;11;01;Keskiviikko;2;2;4;2;1;3
89;25.11.2015;2015;11;02;Keskiviikko;4;0;4;2;0;2
89;25.11.2015;2015;11;03;Keskiviikko;2;4;6;0;1;1
89;25.11.2015;2015;11;04;Keskiviikko;3;5;8;1;1;2
89;25.11.2015;2015;11;05;Keskiviikko;3;10;13;1;1;2
89;25.11.2015;2015;11;06;Keskiviikko;9;28;37;3;11;14
89;25.11.2015;2015;11;07;Keskiviikko;37;98;135;7;32;39
89;25.11.2015;2015;11;08;Keskiviikko;26;166;192;13;37;50
89;25.11.2015;2015;11;09;Keskiviikko;24;107;131;9;24;33
89;25.11.2015;2015;11;10;Keskiviikko;28;64;92;3;19;22
89;25.11.2015;2015;11;11;Keskiviikko;30;49;79;16;23;39
89;25.11.2015;2015;11;12;Keskiviikko;51;42;93;19;29;48
89;25.11.2015;2015;11;13;Keskiviikko;40;39;79;32;22;54
89;25.11.2015;2015;11;14;Keskiviikko;72;54;126;26;16;42
89;25.11.2015;2015;11;15;Keskiviikko;109;41;150;25;14;39
89;25.11.2015;2015;11;16;Keskiviikko;112;57;169;32;13;45
89;25.11.2015;2015;11;17;Keskiviikko;75;52;127;23;17;40
89;25.11.2015;2015;11;18;Keskiviikko;52;36;88;19;24;43
89;25.11.2015;2015;11;19;Keskiviikko;42;16;58;16;14;30
89;25.11.2015;2015;11;20;Keskiviikko;28;14;42;25;13;38
89;25.11.2015;2015;11;21;Keskiviikko;33;19;52;7;4;11
89;25.11.2015;2015;11;22;Keskiviikko;10;3;13;5;5;10
89;25.11.2015;2015;11;23;Keskiviikko;6;4;10;1;1;2
89;26.11.2015;2015;11;00;Torstai;1;4;5;2;2;4
89;26.11.2015;2015;11;01;Torstai;0;1;1;3;1;4
89;26.11.2015;2015;11;02;Torstai;2;0;2;3;0;3
89;26.11.2015;2015;11;03;Torstai;4;1;5;2;0;2
89;26.11.2015;2015;11;04;Torstai;2;2;4;2;0;2
89;26.11.2015;2015;11;05;Torstai;5;6;11;0;0;0
89;26.11.2015;2015;11;06;Torstai;13;25;38;3;9;12
89;26.11.2015;2015;11;07;Torstai;23;104;127;8;33;41
89;26.11.2015;2015;11;08;Torstai;37;168;205;14;41;55
89;26.11.2015;2015;11;09;Torstai;27;90;117;18;30;48
89;26.11.2015;2015;11;10;Torstai;42;52;94;14;32;46
89;26.11.2015;2015;11;11;Torstai;44;59;103;30;20;50
89;26.11.2015;2015;11;12;Torstai;52;73;125;19;37;56
89;26.11.2015;2015;11;13;Torstai;64;55;119;31;34;65
89;26.11.2015;2015;11;14;Torstai;89;66;155;30;28;58
89;26.11.2015;2015;11;15;Torstai;120;76;196;34;25;59
89;26.11.2015;2015;11;16;Torstai;115;66;181;38;22;60
89;26.11.2015;2015;11;17;Torstai;93;78;171;28;19;47
89;26.11.2015;2015;11;18;Torstai;62;51;113;31;31;62
89;26.11.2015;2015;11;19;Torstai;49;31;80;25;26;51
89;26.11.2015;2015;11;20;Torstai;60;31;91;34;27;61
89;26.11.2015;2015;11;21;Torstai;44;12;56;11;9;20
89;26.11.2015;2015;11;22;Torstai;20;5;25;11;7;18
89;26.11.2015;2015;11;23;Torstai;9;1;10;4;2;6
89;27.11.2015;2015;11;00;Perjantai;5;2;7;1;3;4
89;27.11.2015;2015;11;01;Perjantai;7;1;8;2;1;3
89;27.11.2015;2015;11;02;Perjantai;2;0;2;2;0;2
89;27.11.2015;2015;11;03;Perjantai;1;3;4;1;0;1
89;27.11.2015;2015;11;04;Perjantai;2;4;6;1;1;2
89;27.11.2015;2015;11;05;Perjantai;4;5;9;0;2;2
89;27.11.2015;2015;11;06;Perjantai;12;23;35;0;8;8
89;27.11.2015;2015;11;07;Perjantai;23;83;106;3;26;29
89;27.11.2015;2015;11;08;Perjantai;27;145;172;4;21;25
89;27.11.2015;2015;11;09;Perjantai;31;77;108;12;15;27
89;27.11.2015;2015;11;10;Perjantai;34;43;77;8;15;23
89;27.11.2015;2015;11;11;Perjantai;35;82;117;14;23;37
89;27.11.2015;2015;11;12;Perjantai;58;79;137;16;36;52
89;27.11.2015;2015;11;13;Perjantai;76;65;141;24;28;52
89;27.11.2015;2015;11;14;Perjantai;103;34;137;25;22;47
89;27.11.2015;2015;11;15;Perjantai;115;73;188;31;27;58
89;27.11.2015;2015;11;16;Perjantai;80;55;135;29;16;45
89;27.11.2015;2015;11;17;Perjantai;77;47;124;27;25;52
89;27.11.2015;2015;11;18;Perjantai;36;37;73;26;19;45
89;27.11.2015;2015;11;19;Perjantai;45;23;68;16;11;27
89;27.11.2015;2015;11;20;Perjantai;38;39;77;12;11;23
89;27.11.2015;2015;11;21;Perjantai;25;18;43;10;8;18
89;27.11.2015;2015;11;22;Perjantai;16;28;44;8;6;14
89;27.11.2015;2015;11;23;Perjantai;14;10;24;7;4;11
89;28.11.2015;2015;11;00;Lauantai;13;11;24;5;6;11
89;28.11.2015;2015;11;01;Lauantai;17;11;28;7;3;10
89;28.11.2015;2015;11;02;Lauantai;9;2;11;2;3;5
89;28.11.2015;2015;11;03;Lauantai;10;0;10;6;0;6
89;28.11.2015;2015;11;04;Lauantai;8;3;11;8;1;9
89;28.11.2015;2015;11;05;Lauantai;5;3;8;1;1;2
89;28.11.2015;2015;11;06;Lauantai;4;8;12;2;2;4
89;28.11.2015;2015;11;07;Lauantai;5;3;8;4;5;9
89;28.11.2015;2015;11;08;Lauantai;6;16;22;4;11;15
89;28.11.2015;2015;11;09;Lauantai;9;33;42;9;8;17
89;28.11.2015;2015;11;10;Lauantai;20;36;56;14;20;34
89;28.11.2015;2015;11;11;Lauantai;23;31;54;10;13;23
89;28.11.2015;2015;11;12;Lauantai;19;27;46;10;16;26
89;28.11.2015;2015;11;13;Lauantai;33;36;69;13;17;30
89;28.11.2015;2015;11;14;Lauantai;33;25;58;9;19;28
89;28.11.2015;2015;11;15;Lauantai;35;24;59;23;13;36
89;28.11.2015;2015;11;16;Lauantai;31;37;68;12;9;21
89;28.11.2015;2015;11;17;Lauantai;35;17;52;10;16;26
89;28.11.2015;2015;11;18;Lauantai;46;17;63;4;11;15
89;28.11.2015;2015;11;19;Lauantai;19;18;37;14;6;20
89;28.11.2015;2015;11;20;Lauantai;13;14;27;7;4;11
89;28.11.2015;2015;11;21;Lauantai;11;9;20;7;9;16
89;28.11.2015;2015;11;22;Lauantai;17;10;27;5;4;9
89;28.11.2015;2015;11;23;Lauantai;2;10;12;1;3;4
89;29.11.2015;2015;11;00;Sunnuntai;5;7;12;7;8;15
89;29.11.2015;2015;11;01;Sunnuntai;8;7;15;6;5;11
89;29.11.2015;2015;11;02;Sunnuntai;6;5;11;5;1;6
89;29.11.2015;2015;11;03;Sunnuntai;12;4;16;7;1;8
89;29.11.2015;2015;11;04;Sunnuntai;8;0;8;10;0;10
89;29.11.2015;2015;11;05;Sunnuntai;5;1;6;2;0;2
89;29.11.2015;2015;11;06;Sunnuntai;4;12;16;0;0;0
89;29.11.2015;2015;11;07;Sunnuntai;0;3;3;3;2;5
89;29.11.2015;2015;11;08;Sunnuntai;2;9;11;5;8;13
89;29.11.2015;2015;11;09;Sunnuntai;11;23;34;4;23;27
89;29.11.2015;2015;11;10;Sunnuntai;16;18;34;32;41;73
89;29.11.2015;2015;11;11;Sunnuntai;20;39;59;38;28;66
89;29.11.2015;2015;11;12;Sunnuntai;24;62;86;35;63;98
89;29.11.2015;2015;11;13;Sunnuntai;55;65;120;36;55;91
89;29.11.2015;2015;11;14;Sunnuntai;62;46;108;44;44;88
89;29.11.2015;2015;11;15;Sunnuntai;51;57;108;32;26;58
89;29.11.2015;2015;11;16;Sunnuntai;41;32;73;23;20;43
89;29.11.2015;2015;11;17;Sunnuntai;35;17;52;17;19;36
89;29.11.2015;2015;11;18;Sunnuntai;36;25;61;21;27;48
89;29.11.2015;2015;11;19;Sunnuntai;26;18;44;16;20;36
89;29.11.2015;2015;11;20;Sunnuntai;25;14;39;11;12;23
89;29.11.2015;2015;11;21;Sunnuntai;13;10;23;8;5;13
89;29.11.2015;2015;11;22;Sunnuntai;9;10;19;4;6;10
89;29.11.2015;2015;11;23;Sunnuntai;8;4;12;1;5;6
89;30.11.2015;2015;11;00;Maanantai;3;1;4;0;1;1
89;30.11.2015;2015;11;01;Maanantai;2;0;2;1;1;2
89;30.11.2015;2015;11;02;Maanantai;0;1;1;0;0;0
89;30.11.2015;2015;11;03;Maanantai;1;2;3;0;0;0
89;30.11.2015;2015;11;04;Maanantai;2;2;4;0;1;1
89;30.11.2015;2015;11;05;Maanantai;5;13;18;0;0;0
89;30.11.2015;2015;11;06;Maanantai;11;28;39;3;11;14
89;30.11.2015;2015;11;07;Maanantai;31;98;129;5;23;28
89;30.11.2015;2015;11;08;Maanantai;33;181;214;5;44;49
89;30.11.2015;2015;11;09;Maanantai;24;118;142;15;29;44
89;30.11.2015;2015;11;10;Maanantai;41;53;94;20;29;49
89;30.11.2015;2015;11;11;Maanantai;64;66;130;30;31;61
89;30.11.2015;2015;11;12;Maanantai;71;52;123;29;17;46
89;30.11.2015;2015;11;13;Maanantai;70;73;143;28;20;48
89;30.11.2015;2015;11;14;Maanantai;85;61;146;24;20;44
89;30.11.2015;2015;11;15;Maanantai;130;61;191;20;19;39
89;30.11.2015;2015;11;16;Maanantai;127;71;198;29;19;48
89;30.11.2015;2015;11;17;Maanantai;91;47;138;23;16;39
89;30.11.2015;2015;11;18;Maanantai;53;39;92;23;23;46
89;30.11.2015;2015;11;19;Maanantai;46;18;64;18;19;37
89;30.11.2015;2015;11;20;Maanantai;40;26;66;14;18;32
89;30.11.2015;2015;11;21;Maanantai;31;19;50;7;12;19
89;30.11.2015;2015;11;22;Maanantai;18;7;25;4;5;9
89;30.11.2015;2015;11;23;Maanantai;7;2;9;2;1;3
89;01.12.2015;2015;12;00;Tiistai;4;1;5;2;3;5
89;01.12.2015;2015;12;01;Tiistai;0;0;0;0;1;1
89;01.12.2015;2015;12;02;Tiistai;3;1;4;0;0;0
89;01.12.2015;2015;12;03;Tiistai;2;2;4;0;1;1
89;01.12.2015;2015;12;04;Tiistai;0;3;3;0;1;1
89;01.12.2015;2015;12;05;Tiistai;3;6;9;0;1;1
89;01.12.2015;2015;12;06;Tiistai;12;33;45;1;9;10
89;01.12.2015;2015;12;07;Tiistai;19;124;143;5;28;33
89;01.12.2015;2015;12;08;Tiistai;42;184;226;4;38;42
89;01.12.2015;2015;12;09;Tiistai;32;89;121;9;31;40
89;01.12.2015;2015;12;10;Tiistai;28;62;90;12;28;40
89;01.12.2015;2015;12;11;Tiistai;32;60;92;22;30;52
89;01.12.2015;2015;12;12;Tiistai;55;52;107;23;31;54
89;01.12.2015;2015;12;13;Tiistai;55;48;103;35;26;61
89;01.12.2015;2015;12;14;Tiistai;86;63;149;25;32;57
89;01.12.2015;2015;12;15;Tiistai;119;66;185;38;21;59
89;01.12.2015;2015;12;16;Tiistai;152;61;213;25;23;48
89;01.12.2015;2015;12;17;Tiistai;80;62;142;30;18;48
89;01.12.2015;2015;12;18;Tiistai;69;32;101;27;21;48
89;01.12.2015;2015;12;19;Tiistai;55;40;95;31;19;50
89;01.12.2015;2015;12;20;Tiistai;45;26;71;17;20;37
89;01.12.2015;2015;12;21;Tiistai;40;22;62;14;9;23
89;01.12.2015;2015;12;22;Tiistai;9;13;22;5;1;6
89;01.12.2015;2015;12;23;Tiistai;7;1;8;1;3;4
89;02.12.2015;2015;12;00;Keskiviikko;10;1;11;2;2;4
89;02.12.2015;2015;12;01;Keskiviikko;1;3;4;0;2;2
89;02.12.2015;2015;12;02;Keskiviikko;0;1;1;1;0;1
89;02.12.2015;2015;12;03;Keskiviikko;3;2;5;0;1;1
89;02.12.2015;2015;12;04;Keskiviikko;2;8;10;2;1;3
89;02.12.2015;2015;12;05;Keskiviikko;4;14;18;0;0;0
89;02.12.2015;2015;12;06;Keskiviikko;10;30;40;5;12;17
89;02.12.2015;2015;12;07;Keskiviikko;32;98;130;4;31;35
89;02.12.2015;2015;12;08;Keskiviikko;27;144;171;10;61;71
89;02.12.2015;2015;12;09;Keskiviikko;29;95;124;9;44;53
89;02.12.2015;2015;12;10;Keskiviikko;35;68;103;24;31;55
89;02.12.2015;2015;12;11;Keskiviikko;40;50;90;19;36;55
89;02.12.2015;2015;12;12;Keskiviikko;55;44;99;27;49;76
89;02.12.2015;2015;12;13;Keskiviikko;55;56;111;25;29;54
89;02.12.2015;2015;12;14;Keskiviikko;91;55;146;35;21;56
89;02.12.2015;2015;12;15;Keskiviikko;125;64;189;19;17;36
89;02.12.2015;2015;12;16;Keskiviikko;166;70;236;39;29;68
89;02.12.2015;2015;12;17;Keskiviikko;79;70;149;33;28;61
89;02.12.2015;2015;12;18;Keskiviikko;60;51;111;30;29;59
89;02.12.2015;2015;12;19;Keskiviikko;52;40;92;28;29;57
89;02.12.2015;2015;12;20;Keskiviikko;49;20;69;30;22;52
89;02.12.2015;2015;12;21;Keskiviikko;31;21;52;7;4;11
89;02.12.2015;2015;12;22;Keskiviikko;30;16;46;2;2;4
89;02.12.2015;2015;12;23;Keskiviikko;7;3;10;2;3;5
89;03.12.2015;2015;12;00;Torstai;6;5;11;1;1;2
89;03.12.2015;2015;12;01;Torstai;3;3;6;0;2;2
89;03.12.2015;2015;12;02;Torstai;2;1;3;2;0;2
89;03.12.2015;2015;12;03;Torstai;5;2;7;0;1;1
89;03.12.2015;2015;12;04;Torstai;4;1;5;0;1;1
89;03.12.2015;2015;12;05;Torstai;2;4;6;0;1;1
89;03.12.2015;2015;12;06;Torstai;12;26;38;1;8;9
89;03.12.2015;2015;12;07;Torstai;27;102;129;5;21;26
89;03.12.2015;2015;12;08;Torstai;39;184;223;13;45;58
89;03.12.2015;2015;12;09;Torstai;27;71;98;5;24;29
89;03.12.2015;2015;12;10;Torstai;30;59;89;5;22;27
89;03.12.2015;2015;12;11;Torstai;30;49;79;17;20;37
89;03.12.2015;2015;12;12;Torstai;46;52;98;21;35;56
89;03.12.2015;2015;12;13;Torstai;63;57;120;20;36;56
89;03.12.2015;2015;12;14;Torstai;73;57;130;36;38;74
89;03.12.2015;2015;12;15;Torstai;110;68;178;34;27;61
89;03.12.2015;2015;12;16;Torstai;126;73;199;29;25;54
89;03.12.2015;2015;12;17;Torstai;73;71;144;21;32;53
89;03.12.2015;2015;12;18;Torstai;58;50;108;21;13;34
89;03.12.2015;2015;12;19;Torstai;48;42;90;22;21;43
89;03.12.2015;2015;12;20;Torstai;31;27;58;25;13;38
89;03.12.2015;2015;12;21;Torstai;41;11;52;21;7;28
89;03.12.2015;2015;12;22;Torstai;28;6;34;8;4;12
89;03.12.2015;2015;12;23;Torstai;6;4;10;3;3;6
89;04.12.2015;2015;12;00;Perjantai;9;4;13;1;1;2
89;04.12.2015;2015;12;01;Perjantai;6;0;6;1;0;1
89;04.12.2015;2015;12;02;Perjantai;4;0;4;0;0;0
89;04.12.2015;2015;12;03;Perjantai;2;0;2;0;0;0
89;04.12.2015;2015;12;04;Perjantai;3;2;5;2;1;3
89;04.12.2015;2015;12;05;Perjantai;3;10;13;0;0;0
89;04.12.2015;2015;12;06;Perjantai;7;30;37;0;7;7
89;04.12.2015;2015;12;07;Perjantai;18;107;125;6;29;35
89;04.12.2015;2015;12;08;Perjantai;37;143;180;11;37;48
89;04.12.2015;2015;12;09;Perjantai;41;118;159;12;24;36
89;04.12.2015;2015;12;10;Perjantai;23;52;75;11;35;46
89;04.12.2015;2015;12;11;Perjantai;79;76;155;17;38;55
89;04.12.2015;2015;12;12;Perjantai;51;70;121;20;28;48
89;04.12.2015;2015;12;13;Perjantai;72;53;125;20;33;53
89;04.12.2015;2015;12;14;Perjantai;90;58;148;24;24;48
89;04.12.2015;2015;12;15;Perjantai;117;46;163;26;20;46
89;04.12.2015;2015;12;16;Perjantai;96;69;165;23;19;42
89;04.12.2015;2015;12;17;Perjantai;64;41;105;17;22;39
89;04.12.2015;2015;12;18;Perjantai;48;28;76;27;11;38
89;04.12.2015;2015;12;19;Perjantai;40;21;61;10;9;19
89;04.12.2015;2015;12;20;Perjantai;26;14;40;9;11;20
89;04.12.2015;2015;12;21;Perjantai;33;13;46;9;3;12
89;04.12.2015;2015;12;22;Perjantai;24;15;39;7;9;16
89;04.12.2015;2015;12;23;Perjantai;16;12;28;3;6;9
89;05.12.2015;2015;12;00;Lauantai;7;8;15;6;7;13
89;05.12.2015;2015;12;01;Lauantai;8;5;13;4;10;14
89;05.12.2015;2015;12;02;Lauantai;15;6;21;10;1;11
89;05.12.2015;2015;12;03;Lauantai;6;3;9;3;0;3
89;05.12.2015;2015;12;04;Lauantai;10;1;11;8;3;11
89;05.12.2015;2015;12;05;Lauantai;6;2;8;2;0;2
89;05.12.2015;2015;12;06;Lauantai;4;9;13;0;3;3
89;05.12.2015;2015;12;07;Lauantai;6;9;15;1;3;4
89;05.12.2015;2015;12;08;Lauantai;9;9;18;11;6;17
89;05.12.2015;2015;12;09;Lauantai;16;19;35;14;15;29
89;05.12.2015;2015;12;10;Lauantai;28;18;46;36;26;62
89;05.12.2015;2015;12;11;Lauantai;37;38;75;26;38;64
89;05.12.2015;2015;12;12;Lauantai;40;40;80;37;30;67
89;05.12.2015;2015;12;13;Lauantai;54;42;96;39;29;68
89;05.12.2015;2015;12;14;Lauantai;58;28;86;38;27;65
89;05.12.2015;2015;12;15;Lauantai;58;22;80;23;28;51
89;05.12.2015;2015;12;16;Lauantai;42;38;80;28;23;51
89;05.12.2015;2015;12;17;Lauantai;37;22;59;23;23;46
89;05.12.2015;2015;12;18;Lauantai;25;12;37;11;12;23
89;05.12.2015;2015;12;19;Lauantai;24;13;37;13;9;22
89;05.12.2015;2015;12;20;Lauantai;22;9;31;11;6;17
89;05.12.2015;2015;12;21;Lauantai;12;6;18;10;3;13
89;05.12.2015;2015;12;22;Lauantai;11;9;20;1;1;2
89;05.12.2015;2015;12;23;Lauantai;8;16;24;2;4;6
89;06.12.2015;2015;12;00;Sunnuntai;3;3;6;4;3;7
89;06.12.2015;2015;12;01;Sunnuntai;10;2;12;2;4;6
89;06.12.2015;2015;12;02;Sunnuntai;9;6;15;15;0;15
89;06.12.2015;2015;12;03;Sunnuntai;15;3;18;10;1;11
89;06.12.2015;2015;12;04;Sunnuntai;11;0;11;12;0;12
89;06.12.2015;2015;12;05;Sunnuntai;1;1;2;3;1;4
89;06.12.2015;2015;12;06;Sunnuntai;0;2;2;2;4;6
89;06.12.2015;2015;12;07;Sunnuntai;3;0;3;0;4;4
89;06.12.2015;2015;12;08;Sunnuntai;3;7;10;2;4;6
89;06.12.2015;2015;12;09;Sunnuntai;6;6;12;11;16;27
89;06.12.2015;2015;12;10;Sunnuntai;15;19;34;22;17;39
89;06.12.2015;2015;12;11;Sunnuntai;18;11;29;33;31;64
89;06.12.2015;2015;12;12;Sunnuntai;22;15;37;44;50;94
89;06.12.2015;2015;12;13;Sunnuntai;15;19;34;36;34;70
89;06.12.2015;2015;12;14;Sunnuntai;29;14;43;28;66;94
89;06.12.2015;2015;12;15;Sunnuntai;23;15;38;27;18;45
89;06.12.2015;2015;12;16;Sunnuntai;12;11;23;26;17;43
89;06.12.2015;2015;12;17;Sunnuntai;14;12;26;12;12;24
89;06.12.2015;2015;12;18;Sunnuntai;30;10;40;13;18;31
89;06.12.2015;2015;12;19;Sunnuntai;17;8;25;6;13;19
89;06.12.2015;2015;12;20;Sunnuntai;13;15;28;4;6;10
89;06.12.2015;2015;12;21;Sunnuntai;9;5;14;6;6;12
89;06.12.2015;2015;12;22;Sunnuntai;11;8;19;4;2;6
89;06.12.2015;2015;12;23;Sunnuntai;4;8;12;0;1;1
89;07.12.2015;2015;12;00;Maanantai;2;0;2;2;0;2
89;07.12.2015;2015;12;01;Maanantai;3;0;3;2;1;3
89;07.12.2015;2015;12;02;Maanantai;1;0;1;1;0;1
89;07.12.2015;2015;12;03;Maanantai;0;0;0;0;0;0
89;07.12.2015;2015;12;04;Maanantai;1;1;2;0;2;2
89;07.12.2015;2015;12;05;Maanantai;3;8;11;1;1;2
89;07.12.2015;2015;12;06;Maanantai;11;22;33;1;7;8
89;07.12.2015;2015;12;07;Maanantai;22;84;106;6;26;32
89;07.12.2015;2015;12;08;Maanantai;31;124;155;10;58;68
89;07.12.2015;2015;12;09;Maanantai;25;82;107;12;28;40
89;07.12.2015;2015;12;10;Maanantai;23;55;78;16;25;41
89;07.12.2015;2015;12;11;Maanantai;34;45;79;16;35;51
89;07.12.2015;2015;12;12;Maanantai;42;52;94;14;27;41
89;07.12.2015;2015;12;13;Maanantai;53;49;102;25;31;56
89;07.12.2015;2015;12;14;Maanantai;69;56;125;24;21;45
89;07.12.2015;2015;12;15;Maanantai;80;43;123;24;21;45
89;07.12.2015;2015;12;16;Maanantai;102;62;164;44;27;71
89;07.12.2015;2015;12;17;Maanantai;61;31;92;25;23;48
89;07.12.2015;2015;12;18;Maanantai;41;25;66;22;22;44
89;07.12.2015;2015;12;19;Maanantai;37;28;65;29;16;45
89;07.12.2015;2015;12;20;Maanantai;37;20;57;18;14;32
89;07.12.2015;2015;12;21;Maanantai;29;10;39;9;5;14
89;07.12.2015;2015;12;22;Maanantai;12;8;20;5;0;5
89;07.12.2015;2015;12;23;Maanantai;3;1;4;4;2;6
89;08.12.2015;2015;12;00;Tiistai;3;1;4;2;1;3
89;08.12.2015;2015;12;01;Tiistai;1;2;3;0;1;1
89;08.12.2015;2015;12;02;Tiistai;2;2;4;0;0;0
89;08.12.2015;2015;12;03;Tiistai;3;1;4;0;0;0
89;08.12.2015;2015;12;04;Tiistai;2;0;2;0;1;1
89;08.12.2015;2015;12;05;Tiistai;3;9;12;1;0;1
89;08.12.2015;2015;12;06;Tiistai;10;28;38;1;6;7
89;08.12.2015;2015;12;07;Tiistai;16;96;112;7;36;43
89;08.12.2015;2015;12;08;Tiistai;26;163;189;5;60;65
89;08.12.2015;2015;12;09;Tiistai;26;86;112;12;24;36
89;08.12.2015;2015;12;10;Tiistai;25;51;76;20;32;52
89;08.12.2015;2015;12;11;Tiistai;41;49;90;29;28;57
89;08.12.2015;2015;12;12;Tiistai;39;44;83;26;31;57
89;08.12.2015;2015;12;13;Tiistai;57;40;97;29;33;62
89;08.12.2015;2015;12;14;Tiistai;74;50;124;35;22;57
89;08.12.2015;2015;12;15;Tiistai;94;49;143;37;14;51
89;08.12.2015;2015;12;16;Tiistai;111;49;160;50;32;82
89;08.12.2015;2015;12;17;Tiistai;73;42;115;28;25;53
89;08.12.2015;2015;12;18;Tiistai;47;27;74;40;28;68
89;08.12.2015;2015;12;19;Tiistai;32;33;65;23;20;43
89;08.12.2015;2015;12;20;Tiistai;53;20;73;25;15;40
89;08.12.2015;2015;12;21;Tiistai;32;15;47;20;15;35
89;08.12.2015;2015;12;22;Tiistai;10;4;14;8;1;9
89;08.12.2015;2015;12;23;Tiistai;10;1;11;3;4;7
89;09.12.2015;2015;12;00;Keskiviikko;4;0;4;4;1;5
89;09.12.2015;2015;12;01;Keskiviikko;2;1;3;0;0;0
89;09.12.2015;2015;12;02;Keskiviikko;1;1;2;0;0;0
89;09.12.2015;2015;12;03;Keskiviikko;1;1;2;2;0;2
89;09.12.2015;2015;12;04;Keskiviikko;3;3;6;3;3;6
89;09.12.2015;2015;12;05;Keskiviikko;3;8;11;1;0;1
89;09.12.2015;2015;12;06;Keskiviikko;14;32;46;1;5;6
89;09.12.2015;2015;12;07;Keskiviikko;13;88;101;7;40;47
89;09.12.2015;2015;12;08;Keskiviikko;34;182;216;7;46;53
89;09.12.2015;2015;12;09;Keskiviikko;24;92;116;13;30;43
89;09.12.2015;2015;12;10;Keskiviikko;29;49;78;15;28;43
89;09.12.2015;2015;12;11;Keskiviikko;33;46;79;27;24;51
89;09.12.2015;2015;12;12;Keskiviikko;29;33;62;26;19;45
89;09.12.2015;2015;12;13;Keskiviikko;44;36;80;27;19;46
89;09.12.2015;2015;12;14;Keskiviikko;62;42;104;26;16;42
89;09.12.2015;2015;12;15;Keskiviikko;88;33;121;36;17;53
89;09.12.2015;2015;12;16;Keskiviikko;88;49;137;38;22;60
89;09.12.2015;2015;12;17;Keskiviikko;76;35;111;33;13;46
89;09.12.2015;2015;12;18;Keskiviikko;36;30;66;27;14;41
89;09.12.2015;2015;12;19;Keskiviikko;19;21;40;23;12;35
89;09.12.2015;2015;12;20;Keskiviikko;40;20;60;17;14;31
89;09.12.2015;2015;12;21;Keskiviikko;17;12;29;11;7;18
89;09.12.2015;2015;12;22;Keskiviikko;15;4;19;11;8;19
89;09.12.2015;2015;12;23;Keskiviikko;8;7;15;1;2;3
89;10.12.2015;2015;12;00;Torstai;9;3;12;2;5;7
89;10.12.2015;2015;12;01;Torstai;2;0;2;3;1;4
89;10.12.2015;2015;12;02;Torstai;2;0;2;0;1;1
89;10.12.2015;2015;12;03;Torstai;3;2;5;2;0;2
89;10.12.2015;2015;12;04;Torstai;6;6;12;7;7;14
89;10.12.2015;2015;12;05;Torstai;5;7;12;3;1;4
89;10.12.2015;2015;12;06;Torstai;8;30;38;2;6;8
89;10.12.2015;2015;12;07;Torstai;13;106;119;7;35;42
89;10.12.2015;2015;12;08;Torstai;22;156;178;16;60;76
89;10.12.2015;2015;12;09;Torstai;30;66;96;14;33;47
89;10.12.2015;2015;12;10;Torstai;40;59;99;16;33;49
89;10.12.2015;2015;12;11;Torstai;31;69;100;23;29;52
89;10.12.2015;2015;12;12;Torstai;39;51;90;32;39;71
89;10.12.2015;2015;12;13;Torstai;46;43;89;34;33;67
89;10.12.2015;2015;12;14;Torstai;64;26;90;36;26;62
89;10.12.2015;2015;12;15;Torstai;75;38;113;26;20;46
89;10.12.2015;2015;12;16;Torstai;117;33;150;41;13;54
89;10.12.2015;2015;12;17;Torstai;58;37;95;27;16;43
89;10.12.2015;2015;12;18;Torstai;45;27;72;28;17;45
89;10.12.2015;2015;12;19;Torstai;39;30;69;15;21;36
89;10.12.2015;2015;12;20;Torstai;34;23;57;21;20;41
89;10.12.2015;2015;12;21;Torstai;23;19;42;10;7;17
89;10.12.2015;2015;12;22;Torstai;12;4;16;4;3;7
89;10.12.2015;2015;12;23;Torstai;6;4;10;0;2;2
89;11.12.2015;2015;12;00;Perjantai;9;8;17;1;2;3
89;11.12.2015;2015;12;01;Perjantai;0;2;2;3;1;4
89;11.12.2015;2015;12;02;Perjantai;3;0;3;0;1;1
89;11.12.2015;2015;12;03;Perjantai;8;2;10;0;1;1
89;11.12.2015;2015;12;04;Perjantai;3;4;7;6;2;8
89;11.12.2015;2015;12;05;Perjantai;3;7;10;0;1;1
89;11.12.2015;2015;12;06;Perjantai;12;26;38;4;11;15
89;11.12.2015;2015;12;07;Perjantai;12;72;84;5;40;45
89;11.12.2015;2015;12;08;Perjantai;32;123;155;23;54;77
89;11.12.2015;2015;12;09;Perjantai;17;65;82;6;59;65
89;11.12.2015;2015;12;10;Perjantai;36;35;71;38;21;59
89;11.12.2015;2015;12;11;Perjantai;28;48;76;23;39;62
89;11.12.2015;2015;12;12;Perjantai;36;51;87;26;32;58
89;11.12.2015;2015;12;13;Perjantai;66;51;117;38;27;65
89;11.12.2015;2015;12;14;Perjantai;94;40;134;44;45;89
89;11.12.2015;2015;12;15;Perjantai;81;52;133;41;28;69
89;11.12.2015;2015;12;16;Perjantai;67;39;106;38;30;68
89;11.12.2015;2015;12;17;Perjantai;67;38;105;22;22;44
89;11.12.2015;2015;12;18;Perjantai;45;43;88;17;24;41
89;11.12.2015;2015;12;19;Perjantai;24;34;58;20;13;33
89;11.12.2015;2015;12;20;Perjantai;40;29;69;17;24;41
89;11.12.2015;2015;12;21;Perjantai;29;19;48;7;16;23
89;11.12.2015;2015;12;22;Perjantai;21;27;48;8;11;19
89;11.12.2015;2015;12;23;Perjantai;26;23;49;9;6;15
89;12.12.2015;2015;12;00;Lauantai;19;7;26;7;10;17
89;12.12.2015;2015;12;01;Lauantai;12;7;19;2;1;3
89;12.12.2015;2015;12;02;Lauantai;8;3;11;9;3;12
89;12.12.2015;2015;12;03;Lauantai;11;3;14;8;0;8
89;12.12.2015;2015;12;04;Lauantai;9;3;12;8;0;8
89;12.12.2015;2015;12;05;Lauantai;4;0;4;1;1;2
89;12.12.2015;2015;12;06;Lauantai;2;9;11;3;3;6
89;12.12.2015;2015;12;07;Lauantai;1;5;6;5;3;8
89;12.12.2015;2015;12;08;Lauantai;7;15;22;11;14;25
89;12.12.2015;2015;12;09;Lauantai;9;33;42;12;18;30
89;12.12.2015;2015;12;10;Lauantai;14;34;48;18;36;54
89;12.12.2015;2015;12;11;Lauantai;22;52;74;26;50;76
89;12.12.2015;2015;12;12;Lauantai;26;45;71;36;53;89
89;12.12.2015;2015;12;13;Lauantai;27;50;77;41;32;73
89;12.12.2015;2015;12;14;Lauantai;39;39;78;41;32;73
89;12.12.2015;2015;12;15;Lauantai;56;42;98;36;22;58
89;12.12.2015;2015;12;16;Lauantai;40;37;77;23;16;39
89;12.12.2015;2015;12;17;Lauantai;45;23;68;15;21;36
89;12.12.2015;2015;12;18;Lauantai;30;19;49;30;15;45
89;12.12.2015;2015;12;19;Lauantai;32;18;50;22;18;40
89;12.12.2015;2015;12;20;Lauantai;10;9;19;10;16;26
89;12.12.2015;2015;12;21;Lauantai;13;16;29;9;7;16
89;12.12.2015;2015;12;22;Lauantai;14;19;33;10;6;16
89;12.12.2015;2015;12;23;Lauantai;14;9;23;4;8;12
89;13.12.2015;2015;12;00;Sunnuntai;8;7;15;2;9;11
89;13.12.2015;2015;12;01;Sunnuntai;8;8;16;2;3;5
89;13.12.2015;2015;12;02;Sunnuntai;11;14;25;9;6;15
89;13.12.2015;2015;12;03;Sunnuntai;15;1;16;9;0;9
89;13.12.2015;2015;12;04;Sunnuntai;13;0;13;4;1;5
89;13.12.2015;2015;12;05;Sunnuntai;3;0;3;2;3;5
89;13.12.2015;2015;12;06;Sunnuntai;1;7;8;1;1;2
89;13.12.2015;2015;12;07;Sunnuntai;2;1;3;2;2;4
89;13.12.2015;2015;12;08;Sunnuntai;3;5;8;10;7;17
89;13.12.2015;2015;12;09;Sunnuntai;4;11;15;13;11;24
89;13.12.2015;2015;12;10;Sunnuntai;11;10;21;31;28;59
89;13.12.2015;2015;12;11;Sunnuntai;15;26;41;42;48;90
89;13.12.2015;2015;12;12;Sunnuntai;24;39;63;52;64;116
89;13.12.2015;2015;12;13;Sunnuntai;20;35;55;44;56;100
89;13.12.2015;2015;12;14;Sunnuntai;43;23;66;51;40;91
89;13.12.2015;2015;12;15;Sunnuntai;30;17;47;32;24;56
89;13.12.2015;2015;12;16;Sunnuntai;15;16;31;26;9;35
89;13.12.2015;2015;12;17;Sunnuntai;15;14;29;21;20;41
89;13.12.2015;2015;12;18;Sunnuntai;22;19;41;12;16;28
89;13.12.2015;2015;12;19;Sunnuntai;13;17;30;16;9;25
89;13.12.2015;2015;12;20;Sunnuntai;15;13;28;11;11;22
89;13.12.2015;2015;12;21;Sunnuntai;12;8;20;8;4;12
89;13.12.2015;2015;12;22;Sunnuntai;9;8;17;2;0;2
89;13.12.2015;2015;12;23;Sunnuntai;3;4;7;3;6;9
89;14.12.2015;2015;12;00;Maanantai;2;2;4;1;0;1
89;14.12.2015;2015;12;01;Maanantai;0;0;0;0;0;0
89;14.12.2015;2015;12;02;Maanantai;4;2;6;0;1;1
89;14.12.2015;2015;12;03;Maanantai;1;1;2;0;1;1
89;14.12.2015;2015;12;04;Maanantai;1;2;3;1;2;3
89;14.12.2015;2015;12;05;Maanantai;5;7;12;0;1;1
89;14.12.2015;2015;12;06;Maanantai;9;26;35;3;7;10
89;14.12.2015;2015;12;07;Maanantai;22;104;126;6;44;50
89;14.12.2015;2015;12;08;Maanantai;22;154;176;16;64;80
89;14.12.2015;2015;12;09;Maanantai;21;86;107;7;37;44
89;14.12.2015;2015;12;10;Maanantai;29;62;91;23;36;59
89;14.12.2015;2015;12;11;Maanantai;38;47;85;19;39;58
89;14.12.2015;2015;12;12;Maanantai;52;41;93;28;38;66
89;14.12.2015;2015;12;13;Maanantai;43;50;93;41;41;82
89;14.12.2015;2015;12;14;Maanantai;85;40;125;29;26;55
89;14.12.2015;2015;12;15;Maanantai;115;51;166;44;31;75
89;14.12.2015;2015;12;16;Maanantai;129;50;179;45;18;63
89;14.12.2015;2015;12;17;Maanantai;74;32;106;35;18;53
89;14.12.2015;2015;12;18;Maanantai;54;28;82;43;24;67
89;14.12.2015;2015;12;19;Maanantai;30;21;51;35;14;49
89;14.12.2015;2015;12;20;Maanantai;31;23;54;13;14;27
89;14.12.2015;2015;12;21;Maanantai;21;22;43;15;11;26
89;14.12.2015;2015;12;22;Maanantai;8;5;13;7;7;14
89;14.12.2015;2015;12;23;Maanantai;5;6;11;3;1;4
89;15.12.2015;2015;12;00;Tiistai;2;1;3;0;1;1
89;15.12.2015;2015;12;01;Tiistai;2;0;2;0;0;0
89;15.12.2015;2015;12;02;Tiistai;0;0;0;1;1;2
89;15.12.2015;2015;12;03;Tiistai;2;1;3;0;1;1
89;15.12.2015;2015;12;04;Tiistai;3;3;6;0;2;2
89;15.12.2015;2015;12;05;Tiistai;3;9;12;1;1;2
89;15.12.2015;2015;12;06;Tiistai;14;31;45;1;8;9
89;15.12.2015;2015;12;07;Tiistai;22;96;118;11;40;51
89;15.12.2015;2015;12;08;Tiistai;26;169;195;13;56;69
89;15.12.2015;2015;12;09;Tiistai;18;66;84;21;34;55
89;15.12.2015;2015;12;10;Tiistai;31;55;86;22;39;61
89;15.12.2015;2015;12;11;Tiistai;29;54;83;26;31;57
89;15.12.2015;2015;12;12;Tiistai;36;43;79;22;33;55
89;15.12.2015;2015;12;13;Tiistai;70;50;120;23;29;52
89;15.12.2015;2015;12;14;Tiistai;63;38;101;32;30;62
89;15.12.2015;2015;12;15;Tiistai;97;50;147;54;23;77
89;15.12.2015;2015;12;16;Tiistai;136;53;189;60;23;83
89;15.12.2015;2015;12;17;Tiistai;75;39;114;43;27;70
89;15.12.2015;2015;12;18;Tiistai;49;38;87;36;24;60
89;15.12.2015;2015;12;19;Tiistai;37;34;71;34;25;59
89;15.12.2015;2015;12;20;Tiistai;42;16;58;17;12;29
89;15.12.2015;2015;12;21;Tiistai;18;13;31;14;9;23
89;15.12.2015;2015;12;22;Tiistai;16;8;24;6;3;9
89;15.12.2015;2015;12;23;Tiistai;11;2;13;4;1;5
89;16.12.2015;2015;12;00;Keskiviikko;5;5;10;5;2;7
89;16.12.2015;2015;12;01;Keskiviikko;4;1;5;0;1;1
89;16.12.2015;2015;12;02;Keskiviikko;3;1;4;1;1;2
89;16.12.2015;2015;12;03;Keskiviikko;4;1;5;0;0;0
89;16.12.2015;2015;12;04;Keskiviikko;2;4;6;0;1;1
89;16.12.2015;2015;12;05;Keskiviikko;5;9;14;0;0;0
89;16.12.2015;2015;12;06;Keskiviikko;7;35;42;3;13;16
89;16.12.2015;2015;12;07;Keskiviikko;26;92;118;13;33;46
89;16.12.2015;2015;12;08;Keskiviikko;42;166;208;12;63;75
89;16.12.2015;2015;12;09;Keskiviikko;14;97;111;11;33;44
89;16.12.2015;2015;12;10;Keskiviikko;32;68;100;31;39;70
89;16.12.2015;2015;12;11;Keskiviikko;36;52;88;25;34;59
89;16.12.2015;2015;12;12;Keskiviikko;45;55;100;21;37;58
89;16.12.2015;2015;12;13;Keskiviikko;61;65;126;31;45;76
89;16.12.2015;2015;12;14;Keskiviikko;82;45;127;42;46;88
89;16.12.2015;2015;12;15;Keskiviikko;93;54;147;45;44;89
89;16.12.2015;2015;12;16;Keskiviikko;127;57;184;40;31;71
89;16.12.2015;2015;12;17;Keskiviikko;78;50;128;38;18;56
89;16.12.2015;2015;12;18;Keskiviikko;53;27;80;25;16;41
89;16.12.2015;2015;12;19;Keskiviikko;42;22;64;34;35;69
89;16.12.2015;2015;12;20;Keskiviikko;34;21;55;25;16;41
89;16.12.2015;2015;12;21;Keskiviikko;29;9;38;17;6;23
89;16.12.2015;2015;12;22;Keskiviikko;16;3;19;5;11;16
89;16.12.2015;2015;12;23;Keskiviikko;8;4;12;3;2;5
89;17.12.2015;2015;12;00;Torstai;7;1;8;3;2;5
89;17.12.2015;2015;12;01;Torstai;4;1;5;0;0;0
89;17.12.2015;2015;12;02;Torstai;1;1;2;0;0;0
89;17.12.2015;2015;12;03;Torstai;2;1;3;0;0;0
89;17.12.2015;2015;12;04;Torstai;4;1;5;1;1;2
89;17.12.2015;2015;12;05;Torstai;3;8;11;1;1;2
89;17.12.2015;2015;12;06;Torstai;11;35;46;0;7;7
89;17.12.2015;2015;12;07;Torstai;22;93;115;12;25;37
89;17.12.2015;2015;12;08;Torstai;30;123;153;16;41;57
89;17.12.2015;2015;12;09;Torstai;21;75;96;9;83;92
89;17.12.2015;2015;12;10;Torstai;25;47;72;60;32;92
89;17.12.2015;2015;12;11;Torstai;28;55;83;17;30;47
89;17.12.2015;2015;12;12;Torstai;40;66;106;17;27;44
89;17.12.2015;2015;12;13;Torstai;51;50;101;26;38;64
89;17.12.2015;2015;12;14;Torstai;72;40;112;30;37;67
89;17.12.2015;2015;12;15;Torstai;87;55;142;48;23;71
89;17.12.2015;2015;12;16;Torstai;127;48;175;37;25;62
89;17.12.2015;2015;12;17;Torstai;58;47;105;31;29;60
89;17.12.2015;2015;12;18;Torstai;57;46;103;26;14;40
89;17.12.2015;2015;12;19;Torstai;51;23;74;22;13;35
89;17.12.2015;2015;12;20;Torstai;37;25;62;25;18;43
89;17.12.2015;2015;12;21;Torstai;23;11;34;9;17;26
89;17.12.2015;2015;12;22;Torstai;17;8;25;4;4;8
89;17.12.2015;2015;12;23;Torstai;9;5;14;4;6;10
89;18.12.2015;2015;12;00;Perjantai;10;6;16;4;0;4
89;18.12.2015;2015;12;01;Perjantai;1;2;3;1;1;2
89;18.12.2015;2015;12;02;Perjantai;3;0;3;1;0;1
89;18.12.2015;2015;12;03;Perjantai;4;4;8;1;0;1
89;18.12.2015;2015;12;04;Perjantai;4;5;9;3;0;3
89;18.12.2015;2015;12;05;Perjantai;2;9;11;0;2;2
89;18.12.2015;2015;12;06;Perjantai;9;30;39;2;9;11
89;18.12.2015;2015;12;07;Perjantai;17;85;102;10;35;45
89;18.12.2015;2015;12;08;Perjantai;20;113;133;7;38;45
89;18.12.2015;2015;12;09;Perjantai;27;73;100;9;36;45
89;18.12.2015;2015;12;10;Perjantai;21;61;82;12;33;45
89;18.12.2015;2015;12;11;Perjantai;34;59;93;21;32;53
89;18.12.2015;2015;12;12;Perjantai;51;60;111;26;35;61
89;18.12.2015;2015;12;13;Perjantai;56;48;104;24;34;58
89;18.12.2015;2015;12;14;Perjantai;89;54;143;39;15;54
89;18.12.2015;2015;12;15;Perjantai;90;46;136;28;17;45
89;18.12.2015;2015;12;16;Perjantai;82;34;116;22;13;35
89;18.12.2015;2015;12;17;Perjantai;66;21;87;16;19;35
89;18.12.2015;2015;12;18;Perjantai;27;18;45;22;10;32
89;18.12.2015;2015;12;19;Perjantai;23;13;36;12;19;31
89;18.12.2015;2015;12;20;Perjantai;29;14;43;14;15;29
89;18.12.2015;2015;12;21;Perjantai;21;19;40;14;17;31
89;18.12.2015;2015;12;22;Perjantai;17;9;26;6;9;15
89;18.12.2015;2015;12;23;Perjantai;11;8;19;11;7;18
89;19.12.2015;2015;12;00;Lauantai;19;4;23;6;10;16
89;19.12.2015;2015;12;01;Lauantai;7;1;8;4;1;5
89;19.12.2015;2015;12;02;Lauantai;11;0;11;11;4;15
89;19.12.2015;2015;12;03;Lauantai;4;1;5;5;3;8
89;19.12.2015;2015;12;04;Lauantai;7;3;10;20;4;24
89;19.12.2015;2015;12;05;Lauantai;5;1;6;1;1;2
89;19.12.2015;2015;12;06;Lauantai;2;6;8;0;1;1
89;19.12.2015;2015;12;07;Lauantai;0;11;11;2;5;7
89;19.12.2015;2015;12;08;Lauantai;3;27;30;9;12;21
89;19.12.2015;2015;12;09;Lauantai;18;32;50;12;26;38
89;19.12.2015;2015;12;10;Lauantai;18;29;47;23;34;57
89;19.12.2015;2015;12;11;Lauantai;29;48;77;21;46;67
89;19.12.2015;2015;12;12;Lauantai;30;49;79;40;43;83
89;19.12.2015;2015;12;13;Lauantai;45;37;82;28;23;51
89;19.12.2015;2015;12;14;Lauantai;40;44;84;23;55;78
89;19.12.2015;2015;12;15;Lauantai;31;39;70;42;44;86
89;19.12.2015;2015;12;16;Lauantai;48;19;67;42;22;64
89;19.12.2015;2015;12;17;Lauantai;36;25;61;32;26;58
89;19.12.2015;2015;12;18;Lauantai;42;23;65;29;21;50
89;19.12.2015;2015;12;19;Lauantai;14;19;33;14;15;29
89;19.12.2015;2015;12;20;Lauantai;29;23;52;22;20;42
89;19.12.2015;2015;12;21;Lauantai;21;12;33;16;7;23
89;19.12.2015;2015;12;22;Lauantai;14;12;26;10;10;20
89;19.12.2015;2015;12;23;Lauantai;13;8;21;3;10;13
89;20.12.2015;2015;12;00;Sunnuntai;9;24;33;4;7;11
89;20.12.2015;2015;12;01;Sunnuntai;4;10;14;3;6;9
89;20.12.2015;2015;12;02;Sunnuntai;5;4;9;4;7;11
89;20.12.2015;2015;12;03;Sunnuntai;10;1;11;13;0;13
89;20.12.2015;2015;12;04;Sunnuntai;9;1;10;13;3;16
89;20.12.2015;2015;12;05;Sunnuntai;2;2;4;1;2;3
89;20.12.2015;2015;12;06;Sunnuntai;5;1;6;1;1;2
89;20.12.2015;2015;12;07;Sunnuntai;3;1;4;1;3;4
89;20.12.2015;2015;12;08;Sunnuntai;1;2;3;6;2;8
89;20.12.2015;2015;12;09;Sunnuntai;2;8;10;9;10;19
89;20.12.2015;2015;12;10;Sunnuntai;7;10;17;17;13;30
89;20.12.2015;2015;12;11;Sunnuntai;15;28;43;23;38;61
89;20.12.2015;2015;12;12;Sunnuntai;18;25;43;21;33;54
89;20.12.2015;2015;12;13;Sunnuntai;22;22;44;23;26;49
89;20.12.2015;2015;12;14;Sunnuntai;20;24;44;19;38;57
89;20.12.2015;2015;12;15;Sunnuntai;32;24;56;26;16;42
89;20.12.2015;2015;12;16;Sunnuntai;23;19;42;23;24;47
89;20.12.2015;2015;12;17;Sunnuntai;25;17;42;19;13;32
89;20.12.2015;2015;12;18;Sunnuntai;20;13;33;22;13;35
89;20.12.2015;2015;12;19;Sunnuntai;10;8;18;10;13;23
89;20.12.2015;2015;12;20;Sunnuntai;10;15;25;10;10;20
89;20.12.2015;2015;12;21;Sunnuntai;8;10;18;6;8;14
89;20.12.2015;2015;12;22;Sunnuntai;6;6;12;3;5;8
89;20.12.2015;2015;12;23;Sunnuntai;10;1;11;2;0;2
89;21.12.2015;2015;12;00;Maanantai;2;2;4;3;1;4
89;21.12.2015;2015;12;01;Maanantai;1;0;1;0;0;0
89;21.12.2015;2015;12;02;Maanantai;1;0;1;1;0;1
89;21.12.2015;2015;12;03;Maanantai;4;2;6;2;1;3
89;21.12.2015;2015;12;04;Maanantai;7;4;11;1;1;2
89;21.12.2015;2015;12;05;Maanantai;4;12;16;3;4;7
89;21.12.2015;2015;12;06;Maanantai;10;18;28;0;8;8
89;21.12.2015;2015;12;07;Maanantai;11;36;47;4;14;18
89;21.12.2015;2015;12;08;Maanantai;10;71;81;7;29;36
89;21.12.2015;2015;12;09;Maanantai;9;47;56;5;22;27
89;21.12.2015;2015;12;10;Maanantai;21;29;50;10;28;38
89;21.12.2015;2015;12;11;Maanantai;29;40;69;17;12;29
89;21.12.2015;2015;12;12;Maanantai;27;44;71;21;34;55
89;21.12.2015;2015;12;13;Maanantai;43;56;99;23;24;47
89;21.12.2015;2015;12;14;Maanantai;45;37;82;20;23;43
89;21.12.2015;2015;12;15;Maanantai;59;40;99;29;26;55
89;21.12.2015;2015;12;16;Maanantai;74;31;105;32;20;52
89;21.12.2015;2015;12;17;Maanantai;58;22;80;21;21;42
89;21.12.2015;2015;12;18;Maanantai;41;22;63;25;19;44
89;21.12.2015;2015;12;19;Maanantai;33;25;58;23;21;44
89;21.12.2015;2015;12;20;Maanantai;37;14;51;15;10;25
89;21.12.2015;2015;12;21;Maanantai;13;16;29;8;8;16
89;21.12.2015;2015;12;22;Maanantai;12;6;18;10;7;17
89;21.12.2015;2015;12;23;Maanantai;8;6;14;6;4;10
89;22.12.2015;2015;12;00;Tiistai;6;4;10;2;0;2
89;22.12.2015;2015;12;01;Tiistai;2;2;4;3;1;4
89;22.12.2015;2015;12;02;Tiistai;1;0;1;1;0;1
89;22.12.2015;2015;12;03;Tiistai;3;1;4;0;0;0
89;22.12.2015;2015;12;04;Tiistai;1;2;3;0;0;0
89;22.12.2015;2015;12;05;Tiistai;3;5;8;0;0;0
89;22.12.2015;2015;12;06;Tiistai;10;22;32;1;8;9
89;22.12.2015;2015;12;07;Tiistai;9;36;45;5;24;29
89;22.12.2015;2015;12;08;Tiistai;16;64;80;8;34;42
89;22.12.2015;2015;12;09;Tiistai;15;31;46;7;17;24
89;22.12.2015;2015;12;10;Tiistai;18;33;51;12;29;41
89;22.12.2015;2015;12;11;Tiistai;32;40;72;14;29;43
89;22.12.2015;2015;12;12;Tiistai;32;42;74;15;23;38
89;22.12.2015;2015;12;13;Tiistai;36;47;83;23;25;48
89;22.12.2015;2015;12;14;Tiistai;54;36;90;21;29;50
89;22.12.2015;2015;12;15;Tiistai;63;30;93;18;19;37
89;22.12.2015;2015;12;16;Tiistai;61;46;107;34;12;46
89;22.12.2015;2015;12;17;Tiistai;53;23;76;24;14;38
89;22.12.2015;2015;12;18;Tiistai;48;27;75;24;18;42
89;22.12.2015;2015;12;19;Tiistai;28;15;43;16;16;32
89;22.12.2015;2015;12;20;Tiistai;27;12;39;9;9;18
89;22.12.2015;2015;12;21;Tiistai;21;9;30;9;8;17
89;22.12.2015;2015;12;22;Tiistai;11;2;13;6;3;9
89;22.12.2015;2015;12;23;Tiistai;2;0;2;2;0;2
89;23.12.2015;2015;12;00;Keskiviikko;1;0;1;0;2;2
89;23.12.2015;2015;12;01;Keskiviikko;2;2;4;2;1;3
89;23.12.2015;2015;12;02;Keskiviikko;2;1;3;0;2;2
89;23.12.2015;2015;12;03;Keskiviikko;0;0;0;0;1;1
89;23.12.2015;2015;12;04;Keskiviikko;1;4;5;0;1;1
89;23.12.2015;2015;12;05;Keskiviikko;4;7;11;0;0;0
89;23.12.2015;2015;12;06;Keskiviikko;8;18;26;1;6;7
89;23.12.2015;2015;12;07;Keskiviikko;11;42;53;1;13;14
89;23.12.2015;2015;12;08;Keskiviikko;15;57;72;4;21;25
89;23.12.2015;2015;12;09;Keskiviikko;16;37;53;7;11;18
89;23.12.2015;2015;12;10;Keskiviikko;21;38;59;12;24;36
89;23.12.2015;2015;12;11;Keskiviikko;19;34;53;17;28;45
89;23.12.2015;2015;12;12;Keskiviikko;31;34;65;27;38;65
89;23.12.2015;2015;12;13;Keskiviikko;41;37;78;20;19;39
89;23.12.2015;2015;12;14;Keskiviikko;54;35;89;31;22;53
89;23.12.2015;2015;12;15;Keskiviikko;49;32;81;21;26;47
89;23.12.2015;2015;12;16;Keskiviikko;44;14;58;25;16;41
89;23.12.2015;2015;12;17;Keskiviikko;38;20;58;16;17;33
89;23.12.2015;2015;12;18;Keskiviikko;23;14;37;16;18;34
89;23.12.2015;2015;12;19;Keskiviikko;15;8;23;12;15;27
89;23.12.2015;2015;12;20;Keskiviikko;11;22;33;11;17;28
89;23.12.2015;2015;12;21;Keskiviikko;20;6;26;12;7;19
89;23.12.2015;2015;12;22;Keskiviikko;8;2;10;5;3;8
89;23.12.2015;2015;12;23;Keskiviikko;2;0;2;4;1;5
89;24.12.2015;2015;12;00;Torstai;2;1;3;0;1;1
89;24.12.2015;2015;12;01;Torstai;2;0;2;0;0;0
89;24.12.2015;2015;12;02;Torstai;1;2;3;1;6;7
89;24.12.2015;2015;12;03;Torstai;0;2;2;2;0;2
89;24.12.2015;2015;12;04;Torstai;0;0;0;2;0;2
89;24.12.2015;2015;12;05;Torstai;3;2;5;1;2;3
89;24.12.2015;2015;12;06;Torstai;1;7;8;2;5;7
89;24.12.2015;2015;12;07;Torstai;1;5;6;5;5;10
89;24.12.2015;2015;12;08;Torstai;3;11;14;6;7;13
89;24.12.2015;2015;12;09;Torstai;11;9;20;14;17;31
89;24.12.2015;2015;12;10;Torstai;4;20;24;19;19;38
89;24.12.2015;2015;12;11;Torstai;15;7;22;21;28;49
89;24.12.2015;2015;12;12;Torstai;10;29;39;15;24;39
89;24.12.2015;2015;12;13;Torstai;16;5;21;33;25;58
89;24.12.2015;2015;12;14;Torstai;8;13;21;26;19;45
89;24.12.2015;2015;12;15;Torstai;10;7;17;16;14;30
89;24.12.2015;2015;12;16;Torstai;9;4;13;16;6;22
89;24.12.2015;2015;12;17;Torstai;3;4;7;6;8;14
89;24.12.2015;2015;12;18;Torstai;10;7;17;4;18;22
89;24.12.2015;2015;12;19;Torstai;2;5;7;12;7;19
89;24.12.2015;2015;12;20;Torstai;9;3;12;11;7;18
89;24.12.2015;2015;12;21;Torstai;6;5;11;7;5;12
89;24.12.2015;2015;12;22;Torstai;4;1;5;6;6;12
89;24.12.2015;2015;12;23;Torstai;3;1;4;13;6;19
89;25.12.2015;2015;12;00;Perjantai;5;2;7;3;2;5
89;25.12.2015;2015;12;01;Perjantai;0;1;1;1;0;1
89;25.12.2015;2015;12;02;Perjantai;2;1;3;1;1;2
89;25.12.2015;2015;12;03;Perjantai;4;2;6;0;0;0
89;25.12.2015;2015;12;04;Perjantai;2;2;4;0;1;1
89;25.12.2015;2015;12;05;Perjantai;1;2;3;1;0;1
89;25.12.2015;2015;12;06;Perjantai;0;4;4;2;2;4
89;25.12.2015;2015;12;07;Perjantai;1;2;3;1;0;1
89;25.12.2015;2015;12;08;Perjantai;0;2;2;9;4;13
89;25.12.2015;2015;12;09;Perjantai;1;2;3;7;2;9
89;25.12.2015;2015;12;10;Perjantai;4;5;9;10;11;21
89;25.12.2015;2015;12;11;Perjantai;9;10;19;12;31;43
89;25.12.2015;2015;12;12;Perjantai;5;16;21;20;26;46
89;25.12.2015;2015;12;13;Perjantai;15;11;26;25;31;56
89;25.12.2015;2015;12;14;Perjantai;9;8;17;30;24;54
89;25.12.2015;2015;12;15;Perjantai;9;5;14;24;21;45
89;25.12.2015;2015;12;16;Perjantai;8;4;12;24;15;39
89;25.12.2015;2015;12;17;Perjantai;10;5;15;18;15;33
89;25.12.2015;2015;12;18;Perjantai;7;4;11;14;12;26
89;25.12.2015;2015;12;19;Perjantai;8;4;12;7;10;17
89;25.12.2015;2015;12;20;Perjantai;3;9;12;4;6;10
89;25.12.2015;2015;12;21;Perjantai;5;3;8;8;3;11
89;25.12.2015;2015;12;22;Perjantai;3;4;7;1;2;3
89;25.12.2015;2015;12;23;Perjantai;4;9;13;1;1;2
89;26.12.2015;2015;12;00;Lauantai;1;1;2;2;1;3
89;26.12.2015;2015;12;01;Lauantai;2;1;3;2;1;3
89;26.12.2015;2015;12;02;Lauantai;2;5;7;3;1;4
89;26.12.2015;2015;12;03;Lauantai;1;1;2;2;0;2
89;26.12.2015;2015;12;04;Lauantai;2;0;2;2;0;2
89;26.12.2015;2015;12;05;Lauantai;2;2;4;1;2;3
89;26.12.2015;2015;12;06;Lauantai;2;3;5;1;1;2
89;26.12.2015;2015;12;07;Lauantai;2;4;6;4;3;7
89;26.12.2015;2015;12;08;Lauantai;1;4;5;2;3;5
89;26.12.2015;2015;12;09;Lauantai;2;2;4;7;5;12
89;26.12.2015;2015;12;10;Lauantai;13;7;20;18;7;25
89;26.12.2015;2015;12;11;Lauantai;8;5;13;27;24;51
89;26.12.2015;2015;12;12;Lauantai;15;14;29;48;33;81
89;26.12.2015;2015;12;13;Lauantai;9;19;28;41;33;74
89;26.12.2015;2015;12;14;Lauantai;13;15;28;43;29;72
89;26.12.2015;2015;12;15;Lauantai;14;7;21;27;24;51
89;26.12.2015;2015;12;16;Lauantai;17;12;29;17;6;23
89;26.12.2015;2015;12;17;Lauantai;12;11;23;16;10;26
89;26.12.2015;2015;12;18;Lauantai;12;10;22;18;27;45
89;26.12.2015;2015;12;19;Lauantai;6;8;14;11;11;22
89;26.12.2015;2015;12;20;Lauantai;3;6;9;6;9;15
89;26.12.2015;2015;12;21;Lauantai;8;10;18;5;8;13
89;26.12.2015;2015;12;22;Lauantai;3;9;12;2;4;6
89;26.12.2015;2015;12;23;Lauantai;6;6;12;6;5;11
89;27.12.2015;2015;12;00;Sunnuntai;5;6;11;3;3;6
89;27.12.2015;2015;12;01;Sunnuntai;4;0;4;4;8;12
89;27.12.2015;2015;12;02;Sunnuntai;6;3;9;11;3;14
89;27.12.2015;2015;12;03;Sunnuntai;10;1;11;12;3;15
89;27.12.2015;2015;12;04;Sunnuntai;6;0;6;15;0;15
89;27.12.2015;2015;12;05;Sunnuntai;2;3;5;5;4;9
89;27.12.2015;2015;12;06;Sunnuntai;3;3;6;1;1;2
89;27.12.2015;2015;12;07;Sunnuntai;1;2;3;3;1;4
89;27.12.2015;2015;12;08;Sunnuntai;0;2;2;5;5;10
89;27.12.2015;2015;12;09;Sunnuntai;5;8;13;8;9;17
89;27.12.2015;2015;12;10;Sunnuntai;3;5;8;15;31;46
89;27.12.2015;2015;12;11;Sunnuntai;12;15;27;24;37;61
89;27.12.2015;2015;12;12;Sunnuntai;19;23;42;39;41;80
89;27.12.2015;2015;12;13;Sunnuntai;17;20;37;37;40;77
89;27.12.2015;2015;12;14;Sunnuntai;26;18;44;40;38;78
89;27.12.2015;2015;12;15;Sunnuntai;22;18;40;33;22;55
89;27.12.2015;2015;12;16;Sunnuntai;14;12;26;26;16;42
89;27.12.2015;2015;12;17;Sunnuntai;17;13;30;24;22;46
89;27.12.2015;2015;12;18;Sunnuntai;21;23;44;19;33;52
89;27.12.2015;2015;12;19;Sunnuntai;14;7;21;27;14;41
89;27.12.2015;2015;12;20;Sunnuntai;7;7;14;11;14;25
89;27.12.2015;2015;12;21;Sunnuntai;4;5;9;10;6;16
89;27.12.2015;2015;12;22;Sunnuntai;7;4;11;3;3;6
89;27.12.2015;2015;12;23;Sunnuntai;8;6;14;4;5;9
89;28.12.2015;2015;12;00;Maanantai;0;2;2;1;2;3
89;28.12.2015;2015;12;01;Maanantai;1;0;1;1;0;1
89;28.12.2015;2015;12;02;Maanantai;2;0;2;0;2;2
89;28.12.2015;2015;12;03;Maanantai;2;3;5;2;0;2
89;28.12.2015;2015;12;04;Maanantai;3;5;8;2;0;2
89;28.12.2015;2015;12;05;Maanantai;3;10;13;1;0;1
89;28.12.2015;2015;12;06;Maanantai;11;19;30;0;8;8
89;28.12.2015;2015;12;07;Maanantai;7;38;45;1;23;24
89;28.12.2015;2015;12;08;Maanantai;13;52;65;6;19;25
89;28.12.2015;2015;12;09;Maanantai;11;37;48;15;16;31
89;28.12.2015;2015;12;10;Maanantai;13;32;45;18;26;44
89;28.12.2015;2015;12;11;Maanantai;27;28;55;27;43;70
89;28.12.2015;2015;12;12;Maanantai;30;35;65;31;38;69
89;28.12.2015;2015;12;13;Maanantai;24;39;63;28;35;63
89;28.12.2015;2015;12;14;Maanantai;37;36;73;37;29;66
89;28.12.2015;2015;12;15;Maanantai;53;28;81;29;23;52
89;28.12.2015;2015;12;16;Maanantai;54;26;80;42;17;59
89;28.12.2015;2015;12;17;Maanantai;38;12;50;33;18;51
89;28.12.2015;2015;12;18;Maanantai;30;13;43;22;18;40
89;28.12.2015;2015;12;19;Maanantai;17;14;31;20;13;33
89;28.12.2015;2015;12;20;Maanantai;17;12;29;20;5;25
89;28.12.2015;2015;12;21;Maanantai;17;8;25;6;5;11
89;28.12.2015;2015;12;22;Maanantai;12;1;13;7;2;9
89;28.12.2015;2015;12;23;Maanantai;3;3;6;2;2;4
89;29.12.2015;2015;12;00;Tiistai;2;2;4;0;0;0
89;29.12.2015;2015;12;01;Tiistai;0;3;3;1;0;1
89;29.12.2015;2015;12;02;Tiistai;2;2;4;0;0;0
89;29.12.2015;2015;12;03;Tiistai;2;2;4;0;0;0
89;29.12.2015;2015;12;04;Tiistai;1;2;3;1;4;5
89;29.12.2015;2015;12;05;Tiistai;2;8;10;1;1;2
89;29.12.2015;2015;12;06;Tiistai;8;20;28;2;8;10
89;29.12.2015;2015;12;07;Tiistai;12;35;47;5;23;28
89;29.12.2015;2015;12;08;Tiistai;10;41;51;6;21;27
89;29.12.2015;2015;12;09;Tiistai;4;30;34;5;24;29
89;29.12.2015;2015;12;10;Tiistai;7;29;36;14;18;32
89;29.12.2015;2015;12;11;Tiistai;20;27;47;24;36;60
89;29.12.2015;2015;12;12;Tiistai;28;31;59;23;31;54
89;29.12.2015;2015;12;13;Tiistai;21;29;50;19;49;68
89;29.12.2015;2015;12;14;Tiistai;26;35;61;35;34;69
89;29.12.2015;2015;12;15;Tiistai;59;21;80;39;28;67
89;29.12.2015;2015;12;16;Tiistai;61;21;82;32;15;47
89;29.12.2015;2015;12;17;Tiistai;41;17;58;25;14;39
89;29.12.2015;2015;12;18;Tiistai;28;12;40;26;23;49
89;29.12.2015;2015;12;19;Tiistai;26;9;35;27;15;42
89;29.12.2015;2015;12;20;Tiistai;20;15;35;16;12;28
89;29.12.2015;2015;12;21;Tiistai;13;5;18;10;7;17
89;29.12.2015;2015;12;22;Tiistai;3;3;6;4;3;7
89;29.12.2015;2015;12;23;Tiistai;3;4;7;6;4;10
89;30.12.2015;2015;12;00;Keskiviikko;4;5;9;1;2;3
89;30.12.2015;2015;12;01;Keskiviikko;2;1;3;1;3;4
89;30.12.2015;2015;12;02;Keskiviikko;1;0;1;1;1;2
89;30.12.2015;2015;12;03;Keskiviikko;6;1;7;0;0;0
89;30.12.2015;2015;12;04;Keskiviikko;1;4;5;0;1;1
89;30.12.2015;2015;12;05;Keskiviikko;7;8;15;1;2;3
89;30.12.2015;2015;12;06;Keskiviikko;12;17;29;0;8;8
89;30.12.2015;2015;12;07;Keskiviikko;10;37;47;6;13;19
89;30.12.2015;2015;12;08;Keskiviikko;11;42;53;3;25;28
89;30.12.2015;2015;12;09;Keskiviikko;9;38;47;8;21;29
89;30.12.2015;2015;12;10;Keskiviikko;21;34;55;20;45;65
89;30.12.2015;2015;12;11;Keskiviikko;29;29;58;27;35;62
89;30.12.2015;2015;12;12;Keskiviikko;23;43;66;26;40;66
89;30.12.2015;2015;12;13;Keskiviikko;34;30;64;35;29;64
89;30.12.2015;2015;12;14;Keskiviikko;38;41;79;32;38;70
89;30.12.2015;2015;12;15;Keskiviikko;67;27;94;27;25;52
89;30.12.2015;2015;12;16;Keskiviikko;65;43;108;41;27;68
89;30.12.2015;2015;12;17;Keskiviikko;58;28;86;26;16;42
89;30.12.2015;2015;12;18;Keskiviikko;32;16;48;31;18;49
89;30.12.2015;2015;12;19;Keskiviikko;23;11;34;28;17;45
89;30.12.2015;2015;12;20;Keskiviikko;20;16;36;12;11;23
89;30.12.2015;2015;12;21;Keskiviikko;22;13;35;22;9;31
89;30.12.2015;2015;12;22;Keskiviikko;12;5;17;8;5;13
89;30.12.2015;2015;12;23;Keskiviikko;5;2;7;0;5;5
89;31.12.2015;2015;12;00;Torstai;5;2;7;2;1;3
89;31.12.2015;2015;12;01;Torstai;9;1;10;0;3;3
89;31.12.2015;2015;12;02;Torstai;2;4;6;1;3;4
89;31.12.2015;2015;12;03;Torstai;1;1;2;0;0;0
89;31.12.2015;2015;12;04;Torstai;1;4;5;1;0;1
89;31.12.2015;2015;12;05;Torstai;4;8;12;0;0;0
89;31.12.2015;2015;12;06;Torstai;8;25;33;0;4;4
89;31.12.2015;2015;12;07;Torstai;9;38;47;3;17;20
89;31.12.2015;2015;12;08;Torstai;9;39;48;6;20;26
89;31.12.2015;2015;12;09;Torstai;11;32;43;8;14;22
89;31.12.2015;2015;12;10;Torstai;16;24;40;12;27;39
89;31.12.2015;2015;12;11;Torstai;18;40;58;23;32;55
89;31.12.2015;2015;12;12;Torstai;28;39;67;32;30;62
89;31.12.2015;2015;12;13;Torstai;49;45;94;28;30;58
89;31.12.2015;2015;12;14;Torstai;62;31;93;44;28;72
89;31.12.2015;2015;12;15;Torstai;58;27;85;35;32;67
89;31.12.2015;2015;12;16;Torstai;37;16;53;16;19;35
89;31.12.2015;2015;12;17;Torstai;30;23;53;19;13;32
89;31.12.2015;2015;12;18;Torstai;30;19;49;19;18;37
89;31.12.2015;2015;12;19;Torstai;17;36;53;10;62;72
89;31.12.2015;2015;12;20;Torstai;43;11;54;54;28;82
89;31.12.2015;2015;12;21;Torstai;12;13;25;26;17;43
89;31.12.2015;2015;12;22;Torstai;10;23;33;19;16;35
89;31.12.2015;2015;12;23;Torstai;9;17;26;10;20;30
89;01.01.2016;2016;01;00;Perjantai;12;23;35;10;28;38
89;01.01.2016;2016;01;01;Perjantai;8;18;26;16;6;22
89;01.01.2016;2016;01;02;Perjantai;15;8;23;16;15;31
89;01.01.2016;2016;01;03;Perjantai;21;1;22;22;3;25
89;01.01.2016;2016;01;04;Perjantai;16;3;19;29;4;33
89;01.01.2016;2016;01;05;Perjantai;9;1;10;16;9;25
89;01.01.2016;2016;01;06;Perjantai;4;6;10;0;3;3
89;01.01.2016;2016;01;07;Perjantai;1;4;5;0;0;0
89;01.01.2016;2016;01;08;Perjantai;5;2;7;3;4;7
89;01.01.2016;2016;01;09;Perjantai;3;6;9;2;12;14
89;01.01.2016;2016;01;10;Perjantai;4;4;8;25;23;48
89;01.01.2016;2016;01;11;Perjantai;10;15;25;29;37;66
89;01.01.2016;2016;01;12;Perjantai;13;22;35;36;35;71
89;01.01.2016;2016;01;13;Perjantai;20;20;40;42;54;96
89;01.01.2016;2016;01;14;Perjantai;18;15;33;41;43;84
89;01.01.2016;2016;01;15;Perjantai;20;13;33;32;34;66
89;01.01.2016;2016;01;16;Perjantai;18;15;33;22;17;39
89;01.01.2016;2016;01;17;Perjantai;11;8;19;25;16;41
89;01.01.2016;2016;01;18;Perjantai;11;7;18;11;15;26
89;01.01.2016;2016;01;19;Perjantai;8;6;14;21;28;49
89;01.01.2016;2016;01;20;Perjantai;14;10;24;12;12;24
89;01.01.2016;2016;01;21;Perjantai;8;8;16;9;4;13
89;01.01.2016;2016;01;22;Perjantai;9;5;14;1;4;5
89;01.01.2016;2016;01;23;Perjantai;1;1;2;2;3;5
89;02.01.2016;2016;01;00;Lauantai;3;1;4;1;0;1
89;02.01.2016;2016;01;01;Lauantai;3;0;3;3;1;4
89;02.01.2016;2016;01;02;Lauantai;4;1;5;0;0;0
89;02.01.2016;2016;01;03;Lauantai;1;0;1;0;0;0
89;02.01.2016;2016;01;04;Lauantai;3;1;4;3;0;3
89;02.01.2016;2016;01;05;Lauantai;2;0;2;0;1;1
89;02.01.2016;2016;01;06;Lauantai;0;8;8;1;1;2
89;02.01.2016;2016;01;07;Lauantai;2;7;9;2;5;7
89;02.01.2016;2016;01;08;Lauantai;0;7;7;4;6;10
89;02.01.2016;2016;01;09;Lauantai;3;13;16;6;10;16
89;02.01.2016;2016;01;10;Lauantai;6;20;26;12;23;35
89;02.01.2016;2016;01;11;Lauantai;9;19;28;11;27;38
89;02.01.2016;2016;01;12;Lauantai;15;25;40;16;40;56
89;02.01.2016;2016;01;13;Lauantai;19;24;43;43;36;79
89;02.01.2016;2016;01;14;Lauantai;28;20;48;40;38;78
89;02.01.2016;2016;01;15;Lauantai;23;27;50;29;20;49
89;02.01.2016;2016;01;16;Lauantai;18;15;33;32;10;42
89;02.01.2016;2016;01;17;Lauantai;24;18;42;20;17;37
89;02.01.2016;2016;01;18;Lauantai;18;10;28;12;2;14
89;02.01.2016;2016;01;19;Lauantai;9;9;18;13;14;27
89;02.01.2016;2016;01;20;Lauantai;10;6;16;3;7;10
89;02.01.2016;2016;01;21;Lauantai;6;5;11;13;8;21
89;02.01.2016;2016;01;22;Lauantai;5;11;16;9;7;16
89;02.01.2016;2016;01;23;Lauantai;3;3;6;7;5;12
89;03.01.2016;2016;01;00;Sunnuntai;3;7;10;3;2;5
89;03.01.2016;2016;01;01;Sunnuntai;4;1;5;0;1;1
89;03.01.2016;2016;01;02;Sunnuntai;0;2;2;1;1;2
89;03.01.2016;2016;01;03;Sunnuntai;6;4;10;6;1;7
89;03.01.2016;2016;01;04;Sunnuntai;3;0;3;1;0;1
89;03.01.2016;2016;01;05;Sunnuntai;1;1;2;0;0;0
89;03.01.2016;2016;01;06;Sunnuntai;0;6;6;1;1;2
89;03.01.2016;2016;01;07;Sunnuntai;4;9;13;2;2;4
89;03.01.2016;2016;01;08;Sunnuntai;1;1;2;7;10;17
89;03.01.2016;2016;01;09;Sunnuntai;2;8;10;16;13;29
89;03.01.2016;2016;01;10;Sunnuntai;8;6;14;27;21;48
89;03.01.2016;2016;01;11;Sunnuntai;10;20;30;39;43;82
89;03.01.2016;2016;01;12;Sunnuntai;18;29;47;36;60;96
89;03.01.2016;2016;01;13;Sunnuntai;30;33;63;51;39;90
89;03.01.2016;2016;01;14;Sunnuntai;23;24;47;39;48;87
89;03.01.2016;2016;01;15;Sunnuntai;27;18;45;36;51;87
89;03.01.2016;2016;01;16;Sunnuntai;27;8;35;21;37;58
89;03.01.2016;2016;01;17;Sunnuntai;15;13;28;25;24;49
89;03.01.2016;2016;01;18;Sunnuntai;21;11;32;19;23;42
89;03.01.2016;2016;01;19;Sunnuntai;14;8;22;21;17;38
89;03.01.2016;2016;01;20;Sunnuntai;17;11;28;8;5;13
89;03.01.2016;2016;01;21;Sunnuntai;6;6;12;12;12;24
89;03.01.2016;2016;01;22;Sunnuntai;7;4;11;3;5;8
89;03.01.2016;2016;01;23;Sunnuntai;6;2;8;3;4;7
89;04.01.2016;2016;01;00;Maanantai;5;2;7;1;1;2
89;04.01.2016;2016;01;01;Maanantai;3;1;4;0;1;1
89;04.01.2016;2016;01;02;Maanantai;1;0;1;0;0;0
89;04.01.2016;2016;01;03;Maanantai;2;1;3;0;0;0
89;04.01.2016;2016;01;04;Maanantai;2;4;6;3;2;5
89;04.01.2016;2016;01;05;Maanantai;2;8;10;2;3;5
89;04.01.2016;2016;01;06;Maanantai;5;26;31;2;6;8
89;04.01.2016;2016;01;07;Maanantai;12;58;70;4;34;38
89;04.01.2016;2016;01;08;Maanantai;9;67;76;3;40;43
89;04.01.2016;2016;01;09;Maanantai;11;29;40;8;22;30
89;04.01.2016;2016;01;10;Maanantai;7;29;36;13;24;37
89;04.01.2016;2016;01;11;Maanantai;15;27;42;16;29;45
89;04.01.2016;2016;01;12;Maanantai;20;28;48;14;33;47
89;04.01.2016;2016;01;13;Maanantai;25;32;57;21;29;50
89;04.01.2016;2016;01;14;Maanantai;37;22;59;24;18;42
89;04.01.2016;2016;01;15;Maanantai;74;28;102;36;31;67
89;04.01.2016;2016;01;16;Maanantai;74;25;99;45;8;53
89;04.01.2016;2016;01;17;Maanantai;35;20;55;19;16;35
89;04.01.2016;2016;01;18;Maanantai;26;16;42;21;19;40
89;04.01.2016;2016;01;19;Maanantai;19;9;28;21;13;34
89;04.01.2016;2016;01;20;Maanantai;17;5;22;16;12;28
89;04.01.2016;2016;01;21;Maanantai;14;2;16;8;5;13
89;04.01.2016;2016;01;22;Maanantai;8;4;12;4;0;4
89;04.01.2016;2016;01;23;Maanantai;12;4;16;1;2;3
89;05.01.2016;2016;01;00;Tiistai;4;4;8;2;0;2
89;05.01.2016;2016;01;01;Tiistai;2;2;4;0;0;0
89;05.01.2016;2016;01;02;Tiistai;3;0;3;1;0;1
89;05.01.2016;2016;01;03;Tiistai;0;2;2;0;1;1
89;05.01.2016;2016;01;04;Tiistai;2;3;5;0;2;2
89;05.01.2016;2016;01;05;Tiistai;1;8;9;0;2;2
89;05.01.2016;2016;01;06;Tiistai;9;24;33;3;11;14
89;05.01.2016;2016;01;07;Tiistai;10;50;60;3;30;33
89;05.01.2016;2016;01;08;Tiistai;10;72;82;12;40;52
89;05.01.2016;2016;01;09;Tiistai;16;30;46;6;23;29
89;05.01.2016;2016;01;10;Tiistai;17;35;52;15;27;42
89;05.01.2016;2016;01;11;Tiistai;22;32;54;18;32;50
89;05.01.2016;2016;01;12;Tiistai;27;35;62;18;27;45
89;05.01.2016;2016;01;13;Tiistai;31;28;59;32;34;66
89;05.01.2016;2016;01;14;Tiistai;30;28;58;28;32;60
89;05.01.2016;2016;01;15;Tiistai;50;22;72;29;24;53
89;05.01.2016;2016;01;16;Tiistai;75;24;99;35;16;51
89;05.01.2016;2016;01;17;Tiistai;64;33;97;25;6;31
89;05.01.2016;2016;01;18;Tiistai;27;30;57;23;14;37
89;05.01.2016;2016;01;19;Tiistai;20;12;32;12;10;22
89;05.01.2016;2016;01;20;Tiistai;22;14;36;16;8;24
89;05.01.2016;2016;01;21;Tiistai;18;3;21;8;7;15
89;05.01.2016;2016;01;22;Tiistai;6;2;8;1;3;4
89;05.01.2016;2016;01;23;Tiistai;5;4;9;1;2;3
89;06.01.2016;2016;01;00;Keskiviikko;11;7;18;3;1;4
89;06.01.2016;2016;01;01;Keskiviikko;2;1;3;2;0;2
89;06.01.2016;2016;01;02;Keskiviikko;2;5;7;2;0;2
89;06.01.2016;2016;01;03;Keskiviikko;2;0;2;2;0;2
89;06.01.2016;2016;01;04;Keskiviikko;4;1;5;1;1;2
89;06.01.2016;2016;01;05;Keskiviikko;1;3;4;1;0;1
89;06.01.2016;2016;01;06;Keskiviikko;1;5;6;0;0;0
89;06.01.2016;2016;01;07;Keskiviikko;2;1;3;0;2;2
89;06.01.2016;2016;01;08;Keskiviikko;1;3;4;1;1;2
89;06.01.2016;2016;01;09;Keskiviikko;2;6;8;5;7;12
89;06.01.2016;2016;01;10;Keskiviikko;3;5;8;13;7;20
89;06.01.2016;2016;01;11;Keskiviikko;4;2;6;6;15;21
89;06.01.2016;2016;01;12;Keskiviikko;12;14;26;15;27;42
89;06.01.2016;2016;01;13;Keskiviikko;8;5;13;27;21;48
89;06.01.2016;2016;01;14;Keskiviikko;10;5;15;16;22;38
89;06.01.2016;2016;01;15;Keskiviikko;13;14;27;11;21;32
89;06.01.2016;2016;01;16;Keskiviikko;10;9;19;12;10;22
89;06.01.2016;2016;01;17;Keskiviikko;11;8;19;14;17;31
89;06.01.2016;2016;01;18;Keskiviikko;7;7;14;13;5;18
89;06.01.2016;2016;01;19;Keskiviikko;14;3;17;6;10;16
89;06.01.2016;2016;01;20;Keskiviikko;6;4;10;10;7;17
89;06.01.2016;2016;01;21;Keskiviikko;2;4;6;6;5;11
89;06.01.2016;2016;01;22;Keskiviikko;6;3;9;4;2;6
89;06.01.2016;2016;01;23;Keskiviikko;4;0;4;2;3;5
89;07.01.2016;2016;01;00;Torstai;3;2;5;0;3;3
89;07.01.2016;2016;01;01;Torstai;0;2;2;1;0;1
89;07.01.2016;2016;01;02;Torstai;0;0;0;0;0;0
89;07.01.2016;2016;01;03;Torstai;0;1;1;0;0;0
89;07.01.2016;2016;01;04;Torstai;2;3;5;1;2;3
89;07.01.2016;2016;01;05;Torstai;1;4;5;0;2;2
89;07.01.2016;2016;01;06;Torstai;5;18;23;2;7;9
89;07.01.2016;2016;01;07;Torstai;9;34;43;6;29;35
89;07.01.2016;2016;01;08;Torstai;3;58;61;6;55;61
89;07.01.2016;2016;01;09;Torstai;9;30;39;3;29;32
89;07.01.2016;2016;01;10;Torstai;11;17;28;2;20;22
89;07.01.2016;2016;01;11;Torstai;9;11;20;11;19;30
89;07.01.2016;2016;01;12;Torstai;19;16;35;9;17;26
89;07.01.2016;2016;01;13;Torstai;13;17;30;21;20;41
89;07.01.2016;2016;01;14;Torstai;29;17;46;26;13;39
89;07.01.2016;2016;01;15;Torstai;41;19;60;23;14;37
89;07.01.2016;2016;01;16;Torstai;48;22;70;48;17;65
89;07.01.2016;2016;01;17;Torstai;38;14;52;26;10;36
89;07.01.2016;2016;01;18;Torstai;14;9;23;23;7;30
89;07.01.2016;2016;01;19;Torstai;16;3;19;11;8;19
89;07.01.2016;2016;01;20;Torstai;14;3;17;9;6;15
89;07.01.2016;2016;01;21;Torstai;11;6;17;8;3;11
89;07.01.2016;2016;01;22;Torstai;5;2;7;8;1;9
89;07.01.2016;2016;01;23;Torstai;3;3;6;3;0;3
89;08.01.2016;2016;01;00;Perjantai;2;1;3;1;0;1
89;08.01.2016;2016;01;01;Perjantai;0;0;0;1;0;1
89;08.01.2016;2016;01;02;Perjantai;0;0;0;0;0;0
89;08.01.2016;2016;01;03;Perjantai;1;1;2;0;0;0
89;08.01.2016;2016;01;04;Perjantai;1;6;7;0;1;1
89;08.01.2016;2016;01;05;Perjantai;3;2;5;0;2;2
89;08.01.2016;2016;01;06;Perjantai;6;10;16;1;9;10
89;08.01.2016;2016;01;07;Perjantai;8;45;53;6;29;35
89;08.01.2016;2016;01;08;Perjantai;7;74;81;4;49;53
89;08.01.2016;2016;01;09;Perjantai;12;30;42;6;37;43
89;08.01.2016;2016;01;10;Perjantai;13;19;32;25;23;48
89;08.01.2016;2016;01;11;Perjantai;11;28;39;17;33;50
89;08.01.2016;2016;01;12;Perjantai;20;36;56;26;27;53
89;08.01.2016;2016;01;13;Perjantai;39;29;68;28;31;59
89;08.01.2016;2016;01;14;Perjantai;47;24;71;39;21;60
89;08.01.2016;2016;01;15;Perjantai;50;25;75;45;29;74
89;08.01.2016;2016;01;16;Perjantai;56;27;83;49;18;67
89;08.01.2016;2016;01;17;Perjantai;45;18;63;28;21;49
89;08.01.2016;2016;01;18;Perjantai;16;11;27;26;10;36
89;08.01.2016;2016;01;19;Perjantai;14;23;37;16;14;30
89;08.01.2016;2016;01;20;Perjantai;19;13;32;13;14;27
89;08.01.2016;2016;01;21;Perjantai;20;10;30;7;8;15
89;08.01.2016;2016;01;22;Perjantai;9;6;15;4;4;8
89;08.01.2016;2016;01;23;Perjantai;4;3;7;3;3;6
89;09.01.2016;2016;01;00;Lauantai;5;4;9;3;3;6
89;09.01.2016;2016;01;01;Lauantai;3;1;4;4;5;9
89;09.01.2016;2016;01;02;Lauantai;0;1;1;0;5;5
89;09.01.2016;2016;01;03;Lauantai;5;0;5;2;0;2
89;09.01.2016;2016;01;04;Lauantai;3;3;6;4;0;4
89;09.01.2016;2016;01;05;Lauantai;0;0;0;0;2;2
89;09.01.2016;2016;01;06;Lauantai;2;5;7;0;4;4
89;09.01.2016;2016;01;07;Lauantai;3;5;8;2;2;4
89;09.01.2016;2016;01;08;Lauantai;1;11;12;5;9;14
89;09.01.2016;2016;01;09;Lauantai;4;17;21;11;7;18
89;09.01.2016;2016;01;10;Lauantai;9;22;31;5;37;42
89;09.01.2016;2016;01;11;Lauantai;10;26;36;20;35;55
89;09.01.2016;2016;01;12;Lauantai;11;28;39;25;29;54
89;09.01.2016;2016;01;13;Lauantai;19;31;50;33;49;82
89;09.01.2016;2016;01;14;Lauantai;28;12;40;43;39;82
89;09.01.2016;2016;01;15;Lauantai;22;26;48;38;33;71
89;09.01.2016;2016;01;16;Lauantai;24;23;47;26;18;44
89;09.01.2016;2016;01;17;Lauantai;23;26;49;19;10;29
89;09.01.2016;2016;01;18;Lauantai;15;11;26;21;25;46
89;09.01.2016;2016;01;19;Lauantai;10;4;14;18;19;37
89;09.01.2016;2016;01;20;Lauantai;17;15;32;15;14;29
89;09.01.2016;2016;01;21;Lauantai;9;8;17;8;12;20
89;09.01.2016;2016;01;22;Lauantai;8;7;15;11;10;21
89;09.01.2016;2016;01;23;Lauantai;3;8;11;3;3;6
89;10.01.2016;2016;01;00;Sunnuntai;3;2;5;4;5;9
89;10.01.2016;2016;01;01;Sunnuntai;5;1;6;3;1;4
89;10.01.2016;2016;01;02;Sunnuntai;1;3;4;2;1;3
89;10.01.2016;2016;01;03;Sunnuntai;5;2;7;4;0;4
89;10.01.2016;2016;01;04;Sunnuntai;5;0;5;6;0;6
89;10.01.2016;2016;01;05;Sunnuntai;4;3;7;2;2;4
89;10.01.2016;2016;01;06;Sunnuntai;1;9;10;2;1;3
89;10.01.2016;2016;01;07;Sunnuntai;2;2;4;1;3;4
89;10.01.2016;2016;01;08;Sunnuntai;4;1;5;2;2;4
89;10.01.2016;2016;01;09;Sunnuntai;4;6;10;16;21;37
89;10.01.2016;2016;01;10;Sunnuntai;6;11;17;37;25;62
89;10.01.2016;2016;01;11;Sunnuntai;4;19;23;35;48;83
89;10.01.2016;2016;01;12;Sunnuntai;20;26;46;51;65;116
89;10.01.2016;2016;01;13;Sunnuntai;19;32;51;62;56;118
89;10.01.2016;2016;01;14;Sunnuntai;27;35;62;63;62;125
89;10.01.2016;2016;01;15;Sunnuntai;15;22;37;41;41;82
89;10.01.2016;2016;01;16;Sunnuntai;23;10;33;25;35;60
89;10.01.2016;2016;01;17;Sunnuntai;21;12;33;28;28;56
89;10.01.2016;2016;01;18;Sunnuntai;24;17;41;22;20;42
89;10.01.2016;2016;01;19;Sunnuntai;12;11;23;36;24;60
89;10.01.2016;2016;01;20;Sunnuntai;31;15;46;10;13;23
89;10.01.2016;2016;01;21;Sunnuntai;11;11;22;9;4;13
89;10.01.2016;2016;01;22;Sunnuntai;4;5;9;2;2;4
89;10.01.2016;2016;01;23;Sunnuntai;6;0;6;3;3;6
89;11.01.2016;2016;01;00;Maanantai;1;1;2;4;1;5
89;11.01.2016;2016;01;01;Maanantai;1;1;2;0;0;0
89;11.01.2016;2016;01;02;Maanantai;0;0;0;0;2;2
89;11.01.2016;2016;01;03;Maanantai;0;1;1;0;0;0
89;11.01.2016;2016;01;04;Maanantai;3;4;7;3;0;3
89;11.01.2016;2016;01;05;Maanantai;5;8;13;1;2;3
89;11.01.2016;2016;01;06;Maanantai;9;25;34;1;10;11
89;11.01.2016;2016;01;07;Maanantai;15;92;107;13;41;54
89;11.01.2016;2016;01;08;Maanantai;22;118;140;7;52;59
89;11.01.2016;2016;01;09;Maanantai;24;64;88;21;52;73
89;11.01.2016;2016;01;10;Maanantai;17;39;56;13;33;46
89;11.01.2016;2016;01;11;Maanantai;19;29;48;23;35;58
89;11.01.2016;2016;01;12;Maanantai;39;52;91;21;23;44
89;11.01.2016;2016;01;13;Maanantai;38;25;63;30;28;58
89;11.01.2016;2016;01;14;Maanantai;52;27;79;34;32;66
89;11.01.2016;2016;01;15;Maanantai;69;34;103;38;19;57
89;11.01.2016;2016;01;16;Maanantai;94;27;121;51;28;79
89;11.01.2016;2016;01;17;Maanantai;55;28;83;28;16;44
89;11.01.2016;2016;01;18;Maanantai;32;18;50;26;16;42
89;11.01.2016;2016;01;19;Maanantai;34;22;56;25;13;38
89;11.01.2016;2016;01;20;Maanantai;30;7;37;18;11;29
89;11.01.2016;2016;01;21;Maanantai;19;7;26;10;7;17
89;11.01.2016;2016;01;22;Maanantai;7;1;8;7;1;8
89;11.01.2016;2016;01;23;Maanantai;3;4;7;0;1;1
89;12.01.2016;2016;01;00;Tiistai;1;1;2;1;0;1
89;12.01.2016;2016;01;01;Tiistai;0;1;1;0;0;0
89;12.01.2016;2016;01;02;Tiistai;0;0;0;0;0;0
89;12.01.2016;2016;01;03;Tiistai;1;1;2;0;1;1
89;12.01.2016;2016;01;04;Tiistai;1;2;3;0;1;1
89;12.01.2016;2016;01;05;Tiistai;1;7;8;0;2;2
89;12.01.2016;2016;01;06;Tiistai;8;36;44;2;14;16
89;12.01.2016;2016;01;07;Tiistai;24;92;116;6;53;59
89;12.01.2016;2016;01;08;Tiistai;19;101;120;19;61;80
89;12.01.2016;2016;01;09;Tiistai;20;72;92;7;42;49
89;12.01.2016;2016;01;10;Tiistai;16;52;68;18;34;52
89;12.01.2016;2016;01;11;Tiistai;29;32;61;19;31;50
89;12.01.2016;2016;01;12;Tiistai;22;31;53;15;25;40
89;12.01.2016;2016;01;13;Tiistai;44;34;78;24;18;42
89;12.01.2016;2016;01;14;Tiistai;64;31;95;30;27;57
89;12.01.2016;2016;01;15;Tiistai;79;35;114;35;21;56
89;12.01.2016;2016;01;16;Tiistai;104;41;145;39;21;60
89;12.01.2016;2016;01;17;Tiistai;62;40;102;21;21;42
89;12.01.2016;2016;01;18;Tiistai;42;19;61;23;13;36
89;12.01.2016;2016;01;19;Tiistai;35;15;50;18;17;35
89;12.01.2016;2016;01;20;Tiistai;28;12;40;15;15;30
89;12.01.2016;2016;01;21;Tiistai;20;3;23;5;8;13
89;12.01.2016;2016;01;22;Tiistai;4;1;5;7;5;12
89;12.01.2016;2016;01;23;Tiistai;2;2;4;0;0;0
89;13.01.2016;2016;01;00;Keskiviikko;2;1;3;0;0;0
89;13.01.2016;2016;01;01;Keskiviikko;1;0;1;0;0;0
89;13.01.2016;2016;01;02;Keskiviikko;0;1;1;0;2;2
89;13.01.2016;2016;01;03;Keskiviikko;0;0;0;0;0;0
89;13.01.2016;2016;01;04;Keskiviikko;1;7;8;0;0;0
89;13.01.2016;2016;01;05;Keskiviikko;1;7;8;0;1;1
89;13.01.2016;2016;01;06;Keskiviikko;13;31;44;3;18;21
89;13.01.2016;2016;01;07;Keskiviikko;27;75;102;6;48;54
89;13.01.2016;2016;01;08;Keskiviikko;16;110;126;12;55;67
89;13.01.2016;2016;01;09;Keskiviikko;16;62;78;15;30;45
89;13.01.2016;2016;01;10;Keskiviikko;14;38;52;10;27;37
89;13.01.2016;2016;01;11;Keskiviikko;22;28;50;23;28;51
89;13.01.2016;2016;01;12;Keskiviikko;26;39;65;17;24;41
89;13.01.2016;2016;01;13;Keskiviikko;27;32;59;26;21;47
89;13.01.2016;2016;01;14;Keskiviikko;68;49;117;31;25;56
89;13.01.2016;2016;01;15;Keskiviikko;79;43;122;31;20;51
89;13.01.2016;2016;01;16;Keskiviikko;102;54;156;45;17;62
89;13.01.2016;2016;01;17;Keskiviikko;51;37;88;37;15;52
89;13.01.2016;2016;01;18;Keskiviikko;37;24;61;20;10;30
89;13.01.2016;2016;01;19;Keskiviikko;27;15;42;22;13;35
89;13.01.2016;2016;01;20;Keskiviikko;36;12;48;12;21;33
89;13.01.2016;2016;01;21;Keskiviikko;21;10;31;6;4;10
89;13.01.2016;2016;01;22;Keskiviikko;7;3;10;3;2;5
89;13.01.2016;2016;01;23;Keskiviikko;1;3;4;2;0;2
89;14.01.2016;2016;01;00;Torstai;0;4;4;2;0;2
89;14.01.2016;2016;01;01;Torstai;1;1;2;3;1;4
89;14.01.2016;2016;01;02;Torstai;3;1;4;0;0;0
89;14.01.2016;2016;01;03;Torstai;1;3;4;2;0;2
89;14.01.2016;2016;01;04;Torstai;3;4;7;1;1;2
89;14.01.2016;2016;01;05;Torstai;0;6;6;0;0;0
89;14.01.2016;2016;01;06;Torstai;9;28;37;1;14;15
89;14.01.2016;2016;01;07;Torstai;20;93;113;8;46;54
89;14.01.2016;2016;01;08;Torstai;32;116;148;9;48;57
89;14.01.2016;2016;01;09;Torstai;25;68;93;4;35;39
89;14.01.2016;2016;01;10;Torstai;14;33;47;23;31;54
89;14.01.2016;2016;01;11;Torstai;25;49;74;22;37;59
89;14.01.2016;2016;01;12;Torstai;30;33;63;19;32;51
89;14.01.2016;2016;01;13;Torstai;50;40;90;23;25;48
89;14.01.2016;2016;01;14;Torstai;57;51;108;23;24;47
89;14.01.2016;2016;01;15;Torstai;89;32;121;39;17;56
89;14.01.2016;2016;01;16;Torstai;117;42;159;53;24;77
89;14.01.2016;2016;01;17;Torstai;68;33;101;35;14;49
89;14.01.2016;2016;01;18;Torstai;41;25;66;33;15;48
89;14.01.2016;2016;01;19;Torstai;34;29;63;30;24;54
89;14.01.2016;2016;01;20;Torstai;25;23;48;14;22;36
89;14.01.2016;2016;01;21;Torstai;23;14;37;8;6;14
89;14.01.2016;2016;01;22;Torstai;9;6;15;7;4;11
89;14.01.2016;2016;01;23;Torstai;12;6;18;5;3;8
89;15.01.2016;2016;01;00;Perjantai;3;1;4;0;1;1
89;15.01.2016;2016;01;01;Perjantai;1;1;2;2;1;3
89;15.01.2016;2016;01;02;Perjantai;6;4;10;0;1;1
89;15.01.2016;2016;01;03;Perjantai;2;1;3;2;0;2
89;15.01.2016;2016;01;04;Perjantai;2;4;6;0;0;0
89;15.01.2016;2016;01;05;Perjantai;1;5;6;0;1;1
89;15.01.2016;2016;01;06;Perjantai;8;25;33;1;13;14
89;15.01.2016;2016;01;07;Perjantai;20;86;106;8;33;41
89;15.01.2016;2016;01;08;Perjantai;21;121;142;11;34;45
89;15.01.2016;2016;01;09;Perjantai;15;48;63;12;31;43
89;15.01.2016;2016;01;10;Perjantai;18;32;50;23;27;50
89;15.01.2016;2016;01;11;Perjantai;22;26;48;22;29;51
89;15.01.2016;2016;01;12;Perjantai;23;51;74;17;31;48
89;15.01.2016;2016;01;13;Perjantai;50;34;84;30;32;62
89;15.01.2016;2016;01;14;Perjantai;58;45;103;50;27;77
89;15.01.2016;2016;01;15;Perjantai;81;26;107;29;17;46
89;15.01.2016;2016;01;16;Perjantai;81;29;110;39;18;57
89;15.01.2016;2016;01;17;Perjantai;45;33;78;27;29;56
89;15.01.2016;2016;01;18;Perjantai;23;25;48;18;21;39
89;15.01.2016;2016;01;19;Perjantai;28;15;43;17;8;25
89;15.01.2016;2016;01;20;Perjantai;20;14;34;11;10;21
89;15.01.2016;2016;01;21;Perjantai;19;10;29;6;5;11
89;15.01.2016;2016;01;22;Perjantai;16;11;27;10;3;13
89;15.01.2016;2016;01;23;Perjantai;9;9;18;8;7;15
89;16.01.2016;2016;01;00;Lauantai;6;4;10;2;5;7
89;16.01.2016;2016;01;01;Lauantai;1;3;4;4;1;5
89;16.01.2016;2016;01;02;Lauantai;4;4;8;1;0;1
89;16.01.2016;2016;01;03;Lauantai;10;0;10;4;1;5
89;16.01.2016;2016;01;04;Lauantai;9;1;10;1;0;1
89;16.01.2016;2016;01;05;Lauantai;1;2;3;4;1;5
89;16.01.2016;2016;01;06;Lauantai;1;8;9;0;3;3
89;16.01.2016;2016;01;07;Lauantai;5;4;9;4;1;5
89;16.01.2016;2016;01;08;Lauantai;3;14;17;4;14;18
89;16.01.2016;2016;01;09;Lauantai;5;22;27;11;18;29
89;16.01.2016;2016;01;10;Lauantai;11;38;49;27;31;58
89;16.01.2016;2016;01;11;Lauantai;17;49;66;30;38;68
89;16.01.2016;2016;01;12;Lauantai;19;31;50;28;32;60
89;16.01.2016;2016;01;13;Lauantai;27;41;68;23;36;59
89;16.01.2016;2016;01;14;Lauantai;30;29;59;46;53;99
89;16.01.2016;2016;01;15;Lauantai;40;23;63;30;41;71
89;16.01.2016;2016;01;16;Lauantai;31;22;53;29;27;56
89;16.01.2016;2016;01;17;Lauantai;28;15;43;24;21;45
89;16.01.2016;2016;01;18;Lauantai;24;18;42;20;14;34
89;16.01.2016;2016;01;19;Lauantai;17;14;31;20;21;41
89;16.01.2016;2016;01;20;Lauantai;20;6;26;7;9;16
89;16.01.2016;2016;01;21;Lauantai;6;7;13;4;14;18
89;16.01.2016;2016;01;22;Lauantai;9;12;21;12;7;19
89;16.01.2016;2016;01;23;Lauantai;0;6;6;5;3;8
89;17.01.2016;2016;01;00;Sunnuntai;1;11;12;3;2;5
89;17.01.2016;2016;01;01;Sunnuntai;9;4;13;4;2;6
89;17.01.2016;2016;01;02;Sunnuntai;5;3;8;5;0;5
89;17.01.2016;2016;01;03;Sunnuntai;13;1;14;5;0;5
89;17.01.2016;2016;01;04;Sunnuntai;7;1;8;7;0;7
89;17.01.2016;2016;01;05;Sunnuntai;0;1;1;1;0;1
89;17.01.2016;2016;01;06;Sunnuntai;1;3;4;1;3;4
89;17.01.2016;2016;01;07;Sunnuntai;0;4;4;1;1;2
89;17.01.2016;2016;01;08;Sunnuntai;4;6;10;2;2;4
89;17.01.2016;2016;01;09;Sunnuntai;4;10;14;2;6;8
89;17.01.2016;2016;01;10;Sunnuntai;2;7;9;8;11;19
89;17.01.2016;2016;01;11;Sunnuntai;8;12;20;8;17;25
89;17.01.2016;2016;01;12;Sunnuntai;7;16;23;22;34;56
89;17.01.2016;2016;01;13;Sunnuntai;14;8;22;15;19;34
89;17.01.2016;2016;01;14;Sunnuntai;11;7;18;18;21;39
89;17.01.2016;2016;01;15;Sunnuntai;17;8;25;27;34;61
89;17.01.2016;2016;01;16;Sunnuntai;14;12;26;9;16;25
89;17.01.2016;2016;01;17;Sunnuntai;5;13;18;13;19;32
89;17.01.2016;2016;01;18;Sunnuntai;13;17;30;9;7;16
89;17.01.2016;2016;01;19;Sunnuntai;7;8;15;9;9;18
89;17.01.2016;2016;01;20;Sunnuntai;13;7;20;5;7;12
89;17.01.2016;2016;01;21;Sunnuntai;8;8;16;6;1;7
89;17.01.2016;2016;01;22;Sunnuntai;5;7;12;5;1;6
89;17.01.2016;2016;01;23;Sunnuntai;0;1;1;2;1;3
89;18.01.2016;2016;01;00;Maanantai;2;0;2;1;0;1
89;18.01.2016;2016;01;01;Maanantai;0;0;0;1;1;2
89;18.01.2016;2016;01;02;Maanantai;1;0;1;1;0;1
89;18.01.2016;2016;01;03;Maanantai;2;2;4;0;0;0
89;18.01.2016;2016;01;04;Maanantai;0;2;2;1;1;2
89;18.01.2016;2016;01;05;Maanantai;0;6;6;0;1;1
89;18.01.2016;2016;01;06;Maanantai;6;16;22;1;6;7
89;18.01.2016;2016;01;07;Maanantai;13;62;75;9;35;44
89;18.01.2016;2016;01;08;Maanantai;16;98;114;13;62;75
89;18.01.2016;2016;01;09;Maanantai;13;45;58;11;41;52
89;18.01.2016;2016;01;10;Maanantai;14;33;47;19;25;44
89;18.01.2016;2016;01;11;Maanantai;17;27;44;22;38;60
89;18.01.2016;2016;01;12;Maanantai;30;31;61;22;20;42
89;18.01.2016;2016;01;13;Maanantai;25;33;58;22;20;42
89;18.01.2016;2016;01;14;Maanantai;57;29;86;30;26;56
89;18.01.2016;2016;01;15;Maanantai;58;28;86;35;22;57
89;18.01.2016;2016;01;16;Maanantai;86;36;122;52;18;70
89;18.01.2016;2016;01;17;Maanantai;39;17;56;37;14;51
89;18.01.2016;2016;01;18;Maanantai;34;15;49;32;18;50
89;18.01.2016;2016;01;19;Maanantai;22;10;32;18;11;29
89;18.01.2016;2016;01;20;Maanantai;21;13;34;6;10;16
89;18.01.2016;2016;01;21;Maanantai;13;5;18;7;6;13
89;18.01.2016;2016;01;22;Maanantai;8;3;11;3;1;4
89;18.01.2016;2016;01;23;Maanantai;1;4;5;2;1;3
89;19.01.2016;2016;01;00;Tiistai;1;0;1;1;0;1
89;19.01.2016;2016;01;01;Tiistai;0;0;0;0;1;1
89;19.01.2016;2016;01;02;Tiistai;1;0;1;1;0;1
89;19.01.2016;2016;01;03;Tiistai;1;1;2;1;0;1
89;19.01.2016;2016;01;04;Tiistai;1;0;1;0;0;0
89;19.01.2016;2016;01;05;Tiistai;2;6;8;0;3;3
89;19.01.2016;2016;01;06;Tiistai;2;9;11;3;9;12
89;19.01.2016;2016;01;07;Tiistai;9;38;47;2;31;33
89;19.01.2016;2016;01;08;Tiistai;14;95;109;12;57;69
89;19.01.2016;2016;01;09;Tiistai;6;63;69;7;25;32
89;19.01.2016;2016;01;10;Tiistai;13;31;44;13;27;40
89;19.01.2016;2016;01;11;Tiistai;14;24;38;18;21;39
89;19.01.2016;2016;01;12;Tiistai;18;29;47;13;15;28
89;19.01.2016;2016;01;13;Tiistai;18;21;39;20;15;35
89;19.01.2016;2016;01;14;Tiistai;30;24;54;32;26;58
89;19.01.2016;2016;01;15;Tiistai;67;24;91;20;18;38
89;19.01.2016;2016;01;16;Tiistai;69;21;90;44;18;62
89;19.01.2016;2016;01;17;Tiistai;38;23;61;27;16;43
89;19.01.2016;2016;01;18;Tiistai;22;20;42;21;12;33
89;19.01.2016;2016;01;19;Tiistai;27;6;33;23;11;34
89;19.01.2016;2016;01;20;Tiistai;16;5;21;12;7;19
89;19.01.2016;2016;01;21;Tiistai;16;10;26;15;8;23
89;19.01.2016;2016;01;22;Tiistai;10;2;12;1;2;3
89;19.01.2016;2016;01;23;Tiistai;1;4;5;3;1;4
89;20.01.2016;2016;01;00;Keskiviikko;2;0;2;3;1;4
89;20.01.2016;2016;01;01;Keskiviikko;2;0;2;0;1;1
89;20.01.2016;2016;01;02;Keskiviikko;1;1;2;0;0;0
89;20.01.2016;2016;01;03;Keskiviikko;0;1;1;0;0;0
89;20.01.2016;2016;01;04;Keskiviikko;2;3;5;1;0;1
89;20.01.2016;2016;01;05;Keskiviikko;3;9;12;0;1;1
89;20.01.2016;2016;01;06;Keskiviikko;5;18;23;2;12;14
89;20.01.2016;2016;01;07;Keskiviikko;8;57;65;5;46;51
89;20.01.2016;2016;01;08;Keskiviikko;24;100;124;9;47;56
89;20.01.2016;2016;01;09;Keskiviikko;5;48;53;10;27;37
89;20.01.2016;2016;01;10;Keskiviikko;12;31;43;12;21;33
89;20.01.2016;2016;01;11;Keskiviikko;15;25;40;11;25;36
89;20.01.2016;2016;01;12;Keskiviikko;17;37;54;21;19;40
89;20.01.2016;2016;01;13;Keskiviikko;30;18;48;30;24;54
89;20.01.2016;2016;01;14;Keskiviikko;51;21;72;28;17;45
89;20.01.2016;2016;01;15;Keskiviikko;50;34;84;28;21;49
89;20.01.2016;2016;01;16;Keskiviikko;66;28;94;54;16;70
89;20.01.2016;2016;01;17;Keskiviikko;38;19;57;29;9;38
89;20.01.2016;2016;01;18;Keskiviikko;24;17;41;24;9;33
89;20.01.2016;2016;01;19;Keskiviikko;32;13;45;11;2;13
89;20.01.2016;2016;01;20;Keskiviikko;20;15;35;19;11;30
89;20.01.2016;2016;01;21;Keskiviikko;20;8;28;10;4;14
89;20.01.2016;2016;01;22;Keskiviikko;9;2;11;3;3;6
89;20.01.2016;2016;01;23;Keskiviikko;2;3;5;7;2;9
89;21.01.2016;2016;01;00;Torstai;2;0;2;0;4;4
89;21.01.2016;2016;01;01;Torstai;1;2;3;0;0;0
89;21.01.2016;2016;01;02;Torstai;0;0;0;1;1;2
89;21.01.2016;2016;01;03;Torstai;0;1;1;0;0;0
89;21.01.2016;2016;01;04;Torstai;3;0;3;0;2;2
89;21.01.2016;2016;01;05;Torstai;4;7;11;1;1;2
89;21.01.2016;2016;01;06;Torstai;5;16;21;1;10;11
89;21.01.2016;2016;01;07;Torstai;10;51;61;3;36;39
89;21.01.2016;2016;01;08;Torstai;17;76;93;12;54;66
89;21.01.2016;2016;01;09;Torstai;8;38;46;4;26;30
89;21.01.2016;2016;01;10;Torstai;3;20;23;7;17;24
89;21.01.2016;2016;01;11;Torstai;10;18;28;17;17;34
89;21.01.2016;2016;01;12;Torstai;19;8;27;18;15;33
89;21.01.2016;2016;01;13;Torstai;23;18;41;18;13;31
89;21.01.2016;2016;01;14;Torstai;27;16;43;26;19;45
89;21.01.2016;2016;01;15;Torstai;36;22;58;24;21;45
89;21.01.2016;2016;01;16;Torstai;49;19;68;35;16;51
89;21.01.2016;2016;01;17;Torstai;30;26;56;22;15;37
89;21.01.2016;2016;01;18;Torstai;29;15;44;17;9;26
89;21.01.2016;2016;01;19;Torstai;25;8;33;12;12;24
89;21.01.2016;2016;01;20;Torstai;16;15;31;11;11;22
89;21.01.2016;2016;01;21;Torstai;19;13;32;6;5;11
89;21.01.2016;2016;01;22;Torstai;5;3;8;1;1;2
89;21.01.2016;2016;01;23;Torstai;5;1;6;1;1;2
89;22.01.2016;2016;01;00;Perjantai;1;3;4;3;0;3
89;22.01.2016;2016;01;01;Perjantai;2;0;2;2;0;2
89;22.01.2016;2016;01;02;Perjantai;0;1;1;0;0;0
89;22.01.2016;2016;01;03;Perjantai;2;1;3;0;0;0
89;22.01.2016;2016;01;04;Perjantai;0;0;0;0;2;2
89;22.01.2016;2016;01;05;Perjantai;4;6;10;0;1;1
89;22.01.2016;2016;01;06;Perjantai;7;30;37;1;13;14
89;22.01.2016;2016;01;07;Perjantai;17;65;82;5;35;40
89;22.01.2016;2016;01;08;Perjantai;12;93;105;12;39;51
89;22.01.2016;2016;01;09;Perjantai;16;51;67;13;61;74
89;22.01.2016;2016;01;10;Perjantai;18;40;58;12;26;38
89;22.01.2016;2016;01;11;Perjantai;23;29;52;21;36;57
89;22.01.2016;2016;01;12;Perjantai;34;52;86;24;22;46
89;22.01.2016;2016;01;13;Perjantai;45;43;88;22;34;56
89;22.01.2016;2016;01;14;Perjantai;69;30;99;42;29;71
89;22.01.2016;2016;01;15;Perjantai;80;30;110;43;25;68
89;22.01.2016;2016;01;16;Perjantai;73;44;117;36;24;60
89;22.01.2016;2016;01;17;Perjantai;52;33;85;30;30;60
89;22.01.2016;2016;01;18;Perjantai;40;28;68;23;24;47
89;22.01.2016;2016;01;19;Perjantai;26;24;50;16;19;35
89;22.01.2016;2016;01;20;Perjantai;23;19;42;17;15;32
89;22.01.2016;2016;01;21;Perjantai;13;12;25;18;12;30
89;22.01.2016;2016;01;22;Perjantai;16;12;28;10;7;17
89;22.01.2016;2016;01;23;Perjantai;16;12;28;10;8;18
89;23.01.2016;2016;01;00;Lauantai;7;3;10;4;4;8
89;23.01.2016;2016;01;01;Lauantai;6;7;13;8;2;10
89;23.01.2016;2016;01;02;Lauantai;4;1;5;4;1;5
89;23.01.2016;2016;01;03;Lauantai;3;0;3;2;0;2
89;23.01.2016;2016;01;04;Lauantai;6;3;9;5;0;5
89;23.01.2016;2016;01;05;Lauantai;4;0;4;1;2;3
89;23.01.2016;2016;01;06;Lauantai;1;8;9;0;2;2
89;23.01.2016;2016;01;07;Lauantai;1;5;6;7;2;9
89;23.01.2016;2016;01;08;Lauantai;2;16;18;5;9;14
89;23.01.2016;2016;01;09;Lauantai;4;21;25;21;25;46
89;23.01.2016;2016;01;10;Lauantai;12;32;44;22;35;57
89;23.01.2016;2016;01;11;Lauantai;13;47;60;24;53;77
89;23.01.2016;2016;01;12;Lauantai;33;41;74;32;47;79
89;23.01.2016;2016;01;13;Lauantai;45;38;83;32;42;74
89;23.01.2016;2016;01;14;Lauantai;29;29;58;21;36;57
89;23.01.2016;2016;01;15;Lauantai;40;27;67;37;29;66
89;23.01.2016;2016;01;16;Lauantai;45;20;65;27;30;57
89;23.01.2016;2016;01;17;Lauantai;36;28;64;24;28;52
89;23.01.2016;2016;01;18;Lauantai;20;18;38;21;21;42
89;23.01.2016;2016;01;19;Lauantai;24;14;38;16;17;33
89;23.01.2016;2016;01;20;Lauantai;12;15;27;11;7;18
89;23.01.2016;2016;01;21;Lauantai;9;14;23;4;10;14
89;23.01.2016;2016;01;22;Lauantai;14;12;26;8;15;23
89;23.01.2016;2016;01;23;Lauantai;13;11;24;3;6;9
89;24.01.2016;2016;01;00;Sunnuntai;5;12;17;3;3;6
89;24.01.2016;2016;01;01;Sunnuntai;7;4;11;5;0;5
89;24.01.2016;2016;01;02;Sunnuntai;6;2;8;4;1;5
89;24.01.2016;2016;01;03;Sunnuntai;8;0;8;5;3;8
89;24.01.2016;2016;01;04;Sunnuntai;19;1;20;9;0;9
89;24.01.2016;2016;01;05;Sunnuntai;1;1;2;0;2;2
89;24.01.2016;2016;01;06;Sunnuntai;4;9;13;0;1;1
89;24.01.2016;2016;01;07;Sunnuntai;4;4;8;2;3;5
89;24.01.2016;2016;01;08;Sunnuntai;0;6;6;4;2;6
89;24.01.2016;2016;01;09;Sunnuntai;14;10;24;18;20;38
89;24.01.2016;2016;01;10;Sunnuntai;14;16;30;31;28;59
89;24.01.2016;2016;01;11;Sunnuntai;17;30;47;46;47;93
89;24.01.2016;2016;01;12;Sunnuntai;16;28;44;30;53;83
89;24.01.2016;2016;01;13;Sunnuntai;29;38;67;56;55;111
89;24.01.2016;2016;01;14;Sunnuntai;34;30;64;48;41;89
89;24.01.2016;2016;01;15;Sunnuntai;38;24;62;29;39;68
89;24.01.2016;2016;01;16;Sunnuntai;20;21;41;30;33;63
89;24.01.2016;2016;01;17;Sunnuntai;19;21;40;30;25;55
89;24.01.2016;2016;01;18;Sunnuntai;20;9;29;26;25;51
89;24.01.2016;2016;01;19;Sunnuntai;14;11;25;22;28;50
89;24.01.2016;2016;01;20;Sunnuntai;16;13;29;26;18;44
89;24.01.2016;2016;01;21;Sunnuntai;16;5;21;18;10;28
89;24.01.2016;2016;01;22;Sunnuntai;6;3;9;4;1;5
89;24.01.2016;2016;01;23;Sunnuntai;4;2;6;3;1;4
89;25.01.2016;2016;01;00;Maanantai;3;5;8;0;0;0
89;25.01.2016;2016;01;01;Maanantai;2;0;2;0;0;0
89;25.01.2016;2016;01;02;Maanantai;1;0;1;1;0;1
89;25.01.2016;2016;01;03;Maanantai;0;1;1;0;0;0
89;25.01.2016;2016;01;04;Maanantai;1;0;1;0;1;1
89;25.01.2016;2016;01;05;Maanantai;1;13;14;0;3;3
89;25.01.2016;2016;01;06;Maanantai;11;31;42;4;7;11
89;25.01.2016;2016;01;07;Maanantai;16;106;122;14;36;50
89;25.01.2016;2016;01;08;Maanantai;26;129;155;10;57;67
89;25.01.2016;2016;01;09;Maanantai;20;98;118;16;42;58
89;25.01.2016;2016;01;10;Maanantai;29;43;72;24;37;61
89;25.01.2016;2016;01;11;Maanantai;33;37;70;34;38;72
89;25.01.2016;2016;01;12;Maanantai;41;45;86;25;34;59
89;25.01.2016;2016;01;13;Maanantai;52;37;89;46;41;87
89;25.01.2016;2016;01;14;Maanantai;76;50;126;35;33;68
89;25.01.2016;2016;01;15;Maanantai;99;60;159;32;24;56
89;25.01.2016;2016;01;16;Maanantai;140;61;201;56;28;84
89;25.01.2016;2016;01;17;Maanantai;69;31;100;40;20;60
89;25.01.2016;2016;01;18;Maanantai;53;28;81;43;21;64
89;25.01.2016;2016;01;19;Maanantai;46;28;74;44;30;74
89;25.01.2016;2016;01;20;Maanantai;38;23;61;21;18;39
89;25.01.2016;2016;01;21;Maanantai;27;12;39;6;7;13
89;25.01.2016;2016;01;22;Maanantai;14;9;23;2;1;3
89;25.01.2016;2016;01;23;Maanantai;3;2;5;4;2;6
89;26.01.2016;2016;01;00;Tiistai;3;0;3;2;0;2
89;26.01.2016;2016;01;01;Tiistai;0;0;0;0;1;1
89;26.01.2016;2016;01;02;Tiistai;0;0;0;0;1;1
89;26.01.2016;2016;01;03;Tiistai;1;1;2;0;0;0
89;26.01.2016;2016;01;04;Tiistai;1;1;2;4;1;5
89;26.01.2016;2016;01;05;Tiistai;4;9;13;0;2;2
89;26.01.2016;2016;01;06;Tiistai;10;31;41;11;12;23
89;26.01.2016;2016;01;07;Tiistai;15;83;98;8;37;45
89;26.01.2016;2016;01;08;Tiistai;28;107;135;21;55;76
89;26.01.2016;2016;01;09;Tiistai;14;63;77;13;35;48
89;26.01.2016;2016;01;10;Tiistai;12;42;54;14;23;37
89;26.01.2016;2016;01;11;Tiistai;33;25;58;22;30;52
89;26.01.2016;2016;01;12;Tiistai;32;26;58;29;25;54
89;26.01.2016;2016;01;13;Tiistai;28;29;57;29;26;55
89;26.01.2016;2016;01;14;Tiistai;45;26;71;35;28;63
89;26.01.2016;2016;01;15;Tiistai;78;40;118;31;23;54
89;26.01.2016;2016;01;16;Tiistai;109;44;153;58;17;75
89;26.01.2016;2016;01;17;Tiistai;67;36;103;25;30;55
89;26.01.2016;2016;01;18;Tiistai;39;23;62;29;45;74
89;26.01.2016;2016;01;19;Tiistai;33;21;54;41;27;68
89;26.01.2016;2016;01;20;Tiistai;45;16;61;23;22;45
89;26.01.2016;2016;01;21;Tiistai;23;10;33;8;8;16
89;26.01.2016;2016;01;22;Tiistai;7;3;10;5;2;7
89;26.01.2016;2016;01;23;Tiistai;1;3;4;6;0;6
89;27.01.2016;2016;01;00;Keskiviikko;2;1;3;0;0;0
89;27.01.2016;2016;01;01;Keskiviikko;2;3;5;1;0;1
89;27.01.2016;2016;01;02;Keskiviikko;1;1;2;2;0;2
89;27.01.2016;2016;01;03;Keskiviikko;0;1;1;1;0;1
89;27.01.2016;2016;01;04;Keskiviikko;1;3;4;0;1;1
89;27.01.2016;2016;01;05;Keskiviikko;3;10;13;0;2;2
89;27.01.2016;2016;01;06;Keskiviikko;10;36;46;5;11;16
89;27.01.2016;2016;01;07;Keskiviikko;26;97;123;5;33;38
89;27.01.2016;2016;01;08;Keskiviikko;21;131;152;18;43;61
89;27.01.2016;2016;01;09;Keskiviikko;24;60;84;13;40;53
89;27.01.2016;2016;01;10;Keskiviikko;26;43;69;20;33;53
89;27.01.2016;2016;01;11;Keskiviikko;32;36;68;25;32;57
89;27.01.2016;2016;01;12;Keskiviikko;47;42;89;24;32;56
89;27.01.2016;2016;01;13;Keskiviikko;45;44;89;28;26;54
89;27.01.2016;2016;01;14;Keskiviikko;85;28;113;31;29;60
89;27.01.2016;2016;01;15;Keskiviikko;88;36;124;39;29;68
89;27.01.2016;2016;01;16;Keskiviikko;121;47;168;43;24;67
89;27.01.2016;2016;01;17;Keskiviikko;61;36;97;32;19;51
89;27.01.2016;2016;01;18;Keskiviikko;42;25;67;29;39;68
89;27.01.2016;2016;01;19;Keskiviikko;35;26;61;29;38;67
89;27.01.2016;2016;01;20;Keskiviikko;48;16;64;23;18;41
89;27.01.2016;2016;01;21;Keskiviikko;30;13;43;18;12;30
89;27.01.2016;2016;01;22;Keskiviikko;19;6;25;8;5;13
89;27.01.2016;2016;01;23;Keskiviikko;12;1;13;7;4;11
89;28.01.2016;2016;01;00;Torstai;2;2;4;2;0;2
89;28.01.2016;2016;01;01;Torstai;2;3;5;3;1;4
89;28.01.2016;2016;01;02;Torstai;1;2;3;0;1;1
89;28.01.2016;2016;01;03;Torstai;0;1;1;1;0;1
89;28.01.2016;2016;01;04;Torstai;3;2;5;1;1;2
89;28.01.2016;2016;01;05;Torstai;3;5;8;0;0;0
89;28.01.2016;2016;01;06;Torstai;13;30;43;3;14;17
89;28.01.2016;2016;01;07;Torstai;26;95;121;5;34;39
89;28.01.2016;2016;01;08;Torstai;25;110;135;11;48;59
89;28.01.2016;2016;01;09;Torstai;23;66;89;13;45;58
89;28.01.2016;2016;01;10;Torstai;15;38;53;15;43;58
89;28.01.2016;2016;01;11;Torstai;40;40;80;24;36;60
89;28.01.2016;2016;01;12;Torstai;34;44;78;23;29;52
89;28.01.2016;2016;01;13;Torstai;44;41;85;17;29;46
89;28.01.2016;2016;01;14;Torstai;68;37;105;28;27;55
89;28.01.2016;2016;01;15;Torstai;87;34;121;24;24;48
89;28.01.2016;2016;01;16;Torstai;125;41;166;40;17;57
89;28.01.2016;2016;01;17;Torstai;70;55;125;28;25;53
89;28.01.2016;2016;01;18;Torstai;52;26;78;35;22;57
89;28.01.2016;2016;01;19;Torstai;57;24;81;26;19;45
89;28.01.2016;2016;01;20;Torstai;27;22;49;18;14;32
89;28.01.2016;2016;01;21;Torstai;31;8;39;4;6;10
89;28.01.2016;2016;01;22;Torstai;12;3;15;7;7;14
89;28.01.2016;2016;01;23;Torstai;6;2;8;2;1;3
89;29.01.2016;2016;01;00;Perjantai;0;1;1;0;3;3
89;29.01.2016;2016;01;01;Perjantai;3;4;7;0;1;1
89;29.01.2016;2016;01;02;Perjantai;2;2;4;2;0;2
89;29.01.2016;2016;01;03;Perjantai;3;2;5;3;0;3
89;29.01.2016;2016;01;04;Perjantai;2;2;4;2;0;2
89;29.01.2016;2016;01;05;Perjantai;2;4;6;0;2;2
89;29.01.2016;2016;01;06;Perjantai;9;31;40;3;16;19
89;29.01.2016;2016;01;07;Perjantai;15;67;82;5;37;42
89;29.01.2016;2016;01;08;Perjantai;23;107;130;28;46;74
89;29.01.2016;2016;01;09;Perjantai;16;66;82;11;42;53
89;29.01.2016;2016;01;10;Perjantai;24;50;74;16;36;52
89;29.01.2016;2016;01;11;Perjantai;41;40;81;31;35;66
89;29.01.2016;2016;01;12;Perjantai;37;47;84;30;31;61
89;29.01.2016;2016;01;13;Perjantai;55;48;103;34;35;69
89;29.01.2016;2016;01;14;Perjantai;66;52;118;33;35;68
89;29.01.2016;2016;01;15;Perjantai;104;48;152;33;19;52
89;29.01.2016;2016;01;16;Perjantai;103;46;149;32;20;52
89;29.01.2016;2016;01;17;Perjantai;52;31;83;22;34;56
89;29.01.2016;2016;01;18;Perjantai;26;31;57;31;18;49
89;29.01.2016;2016;01;19;Perjantai;40;25;65;27;17;44
89;29.01.2016;2016;01;20;Perjantai;32;23;55;14;10;24
89;29.01.2016;2016;01;21;Perjantai;20;6;26;9;9;18
89;29.01.2016;2016;01;22;Perjantai;21;8;29;5;5;10
89;29.01.2016;2016;01;23;Perjantai;13;9;22;1;12;13
89;30.01.2016;2016;01;00;Lauantai;7;3;10;3;3;6
89;30.01.2016;2016;01;01;Lauantai;6;5;11;1;1;2
89;30.01.2016;2016;01;02;Lauantai;5;2;7;4;1;5
89;30.01.2016;2016;01;03;Lauantai;5;0;5;7;0;7
89;30.01.2016;2016;01;04;Lauantai;7;0;7;4;0;4
89;30.01.2016;2016;01;05;Lauantai;4;0;4;5;0;5
89;30.01.2016;2016;01;06;Lauantai;9;2;11;2;0;2
89;30.01.2016;2016;01;07;Lauantai;9;1;10;4;0;4
89;30.01.2016;2016;01;08;Lauantai;16;0;16;17;0;17
89;30.01.2016;2016;01;09;Lauantai;26;6;32;15;1;16
89;30.01.2016;2016;01;10;Lauantai;45;8;53;21;6;27
89;30.01.2016;2016;01;11;Lauantai;29;15;44;34;13;47
89;30.01.2016;2016;01;12;Lauantai;29;27;56;36;23;59
89;30.01.2016;2016;01;13;Lauantai;35;41;76;27;37;64
89;30.01.2016;2016;01;14;Lauantai;37;36;73;31;39;70
89;30.01.2016;2016;01;15;Lauantai;50;24;74;52;21;73
89;30.01.2016;2016;01;16;Lauantai;55;17;72;41;30;71
89;30.01.2016;2016;01;17;Lauantai;27;26;53;26;15;41
89;30.01.2016;2016;01;18;Lauantai;30;14;44;25;10;35
89;30.01.2016;2016;01;19;Lauantai;32;20;52;12;21;33
89;30.01.2016;2016;01;20;Lauantai;17;12;29;12;14;26
89;30.01.2016;2016;01;21;Lauantai;11;15;26;11;4;15
89;30.01.2016;2016;01;22;Lauantai;10;12;22;3;6;9
89;30.01.2016;2016;01;23;Lauantai;18;7;25;6;10;16
89;31.01.2016;2016;01;00;Sunnuntai;8;11;19;1;10;11
89;31.01.2016;2016;01;01;Sunnuntai;13;8;21;3;2;5
89;31.01.2016;2016;01;02;Sunnuntai;10;8;18;5;3;8
89;31.01.2016;2016;01;03;Sunnuntai;7;6;13;8;1;9
89;31.01.2016;2016;01;04;Sunnuntai;6;0;6;6;0;6
89;31.01.2016;2016;01;05;Sunnuntai;2;1;3;0;0;0
89;31.01.2016;2016;01;06;Sunnuntai;8;8;16;1;0;1
89;31.01.2016;2016;01;07;Sunnuntai;4;2;6;2;3;5
89;31.01.2016;2016;01;08;Sunnuntai;3;2;5;6;4;10
89;31.01.2016;2016;01;09;Sunnuntai;7;10;17;8;14;22
89;31.01.2016;2016;01;10;Sunnuntai;6;20;26;21;33;54
89;31.01.2016;2016;01;11;Sunnuntai;16;16;32;37;29;66
89;31.01.2016;2016;01;12;Sunnuntai;17;22;39;47;48;95
89;31.01.2016;2016;01;13;Sunnuntai;40;17;57;56;48;104
89;31.01.2016;2016;01;14;Sunnuntai;31;25;56;47;52;99
89;31.01.2016;2016;01;15;Sunnuntai;39;20;59;38;48;86
89;31.01.2016;2016;01;16;Sunnuntai;33;19;52;51;35;86
89;31.01.2016;2016;01;17;Sunnuntai;38;17;55;29;11;40
89;31.01.2016;2016;01;18;Sunnuntai;33;12;45;30;19;49
89;31.01.2016;2016;01;19;Sunnuntai;11;9;20;18;16;34
89;31.01.2016;2016;01;20;Sunnuntai;17;13;30;17;20;37
89;31.01.2016;2016;01;21;Sunnuntai;17;6;23;9;6;15
89;31.01.2016;2016;01;22;Sunnuntai;9;3;12;5;7;12
89;31.01.2016;2016;01;23;Sunnuntai;2;6;8;3;4;7
89;01.02.2016;2016;02;00;Maanantai;0;1;1;1;1;2
89;01.02.2016;2016;02;01;Maanantai;2;2;4;0;1;1
89;01.02.2016;2016;02;02;Maanantai;0;1;1;0;0;0
89;01.02.2016;2016;02;03;Maanantai;0;1;1;1;2;3
89;01.02.2016;2016;02;04;Maanantai;1;2;3;4;5;9
89;01.02.2016;2016;02;05;Maanantai;8;9;17;0;2;2
89;01.02.2016;2016;02;06;Maanantai;17;30;47;3;12;15
89;01.02.2016;2016;02;07;Maanantai;29;93;122;11;28;39
89;01.02.2016;2016;02;08;Maanantai;31;114;145;19;34;53
89;01.02.2016;2016;02;09;Maanantai;23;72;95;16;35;51
89;01.02.2016;2016;02;10;Maanantai;28;47;75;20;39;59
89;01.02.2016;2016;02;11;Maanantai;46;46;92;36;36;72
89;01.02.2016;2016;02;12;Maanantai;49;48;97;36;27;63
89;01.02.2016;2016;02;13;Maanantai;51;45;96;52;33;85
89;01.02.2016;2016;02;14;Maanantai;77;37;114;43;32;75
89;01.02.2016;2016;02;15;Maanantai;118;36;154;55;22;77
89;01.02.2016;2016;02;16;Maanantai;118;49;167;51;34;85
89;01.02.2016;2016;02;17;Maanantai;63;27;90;42;23;65
89;01.02.2016;2016;02;18;Maanantai;45;26;71;38;30;68
89;01.02.2016;2016;02;19;Maanantai;42;13;55;36;28;64
89;01.02.2016;2016;02;20;Maanantai;29;13;42;21;21;42
89;01.02.2016;2016;02;21;Maanantai;28;14;42;9;6;15
89;01.02.2016;2016;02;22;Maanantai;22;3;25;2;8;10
89;01.02.2016;2016;02;23;Maanantai;6;1;7;1;4;5
89;02.02.2016;2016;02;00;Tiistai;6;1;7;3;0;3
89;02.02.2016;2016;02;01;Tiistai;1;1;2;0;0;0
89;02.02.2016;2016;02;02;Tiistai;0;0;0;0;0;0
89;02.02.2016;2016;02;03;Tiistai;1;2;3;0;1;1
89;02.02.2016;2016;02;04;Tiistai;1;2;3;1;1;2
89;02.02.2016;2016;02;05;Tiistai;4;6;10;0;0;0
89;02.02.2016;2016;02;06;Tiistai;16;24;40;1;9;10
89;02.02.2016;2016;02;07;Tiistai;54;62;116;14;28;42
89;02.02.2016;2016;02;08;Tiistai;72;88;160;26;41;67
89;02.02.2016;2016;02;09;Tiistai;37;41;78;9;26;35
89;02.02.2016;2016;02;10;Tiistai;36;22;58;23;29;52
89;02.02.2016;2016;02;11;Tiistai;36;30;66;36;13;49
89;02.02.2016;2016;02;12;Tiistai;58;34;92;33;22;55
89;02.02.2016;2016;02;13;Tiistai;47;19;66;32;29;61
89;02.02.2016;2016;02;14;Tiistai;65;27;92;40;18;58
89;02.02.2016;2016;02;15;Tiistai;96;35;131;42;13;55
89;02.02.2016;2016;02;16;Tiistai;133;41;174;52;26;78
89;02.02.2016;2016;02;17;Tiistai;79;29;108;42;24;66
89;02.02.2016;2016;02;18;Tiistai;57;26;83;29;26;55
89;02.02.2016;2016;02;19;Tiistai;38;16;54;37;33;70
89;02.02.2016;2016;02;20;Tiistai;57;18;75;19;19;38
89;02.02.2016;2016;02;21;Tiistai;29;10;39;18;12;30
89;02.02.2016;2016;02;22;Tiistai;7;2;9;3;3;6
89;02.02.2016;2016;02;23;Tiistai;7;2;9;1;2;3
89;03.02.2016;2016;02;00;Keskiviikko;1;0;1;0;1;1
89;03.02.2016;2016;02;01;Keskiviikko;3;1;4;2;1;3
89;03.02.2016;2016;02;02;Keskiviikko;1;0;1;0;0;0
89;03.02.2016;2016;02;03;Keskiviikko;0;1;1;1;0;1
89;03.02.2016;2016;02;04;Keskiviikko;4;2;6;1;1;2
89;03.02.2016;2016;02;05;Keskiviikko;6;4;10;0;1;1
89;03.02.2016;2016;02;06;Keskiviikko;36;16;52;1;10;11
89;03.02.2016;2016;02;07;Keskiviikko;59;57;116;14;28;42
89;03.02.2016;2016;02;08;Keskiviikko;78;99;177;26;43;69
89;03.02.2016;2016;02;09;Keskiviikko;44;52;96;21;26;47
89;03.02.2016;2016;02;10;Keskiviikko;37;33;70;25;38;63
89;03.02.2016;2016;02;11;Keskiviikko;45;31;76;32;29;61
89;03.02.2016;2016;02;12;Keskiviikko;53;42;95;30;37;67
89;03.02.2016;2016;02;13;Keskiviikko;59;22;81;28;27;55
89;03.02.2016;2016;02;14;Keskiviikko;78;33;111;55;22;77
89;03.02.2016;2016;02;15;Keskiviikko;93;42;135;48;19;67
89;03.02.2016;2016;02;16;Keskiviikko;128;37;165;49;27;76
89;03.02.2016;2016;02;17;Keskiviikko;82;25;107;35;16;51
89;03.02.2016;2016;02;18;Keskiviikko;58;36;94;38;29;67
89;03.02.2016;2016;02;19;Keskiviikko;42;24;66;23;26;49
89;03.02.2016;2016;02;20;Keskiviikko;38;10;48;23;11;34
89;03.02.2016;2016;02;21;Keskiviikko;23;10;33;15;4;19
89;03.02.2016;2016;02;22;Keskiviikko;20;8;28;4;2;6
89;03.02.2016;2016;02;23;Keskiviikko;8;7;15;0;1;1
89;04.02.2016;2016;02;00;Torstai;1;1;2;1;0;1
89;04.02.2016;2016;02;01;Torstai;4;0;4;1;1;2
89;04.02.2016;2016;02;02;Torstai;1;0;1;0;1;1
89;04.02.2016;2016;02;03;Torstai;0;1;1;1;0;1
89;04.02.2016;2016;02;04;Torstai;5;0;5;0;1;1
89;04.02.2016;2016;02;05;Torstai;6;10;16;0;0;0
89;04.02.2016;2016;02;06;Torstai;23;17;40;2;11;13
89;04.02.2016;2016;02;07;Torstai;54;52;106;16;29;45
89;04.02.2016;2016;02;08;Torstai;71;75;146;13;45;58
89;04.02.2016;2016;02;09;Torstai;34;45;79;17;33;50
89;04.02.2016;2016;02;10;Torstai;39;37;76;30;24;54
89;04.02.2016;2016;02;11;Torstai;38;40;78;33;40;73
89;04.02.2016;2016;02;12;Torstai;43;41;84;34;38;72
89;04.02.2016;2016;02;13;Torstai;58;32;90;37;27;64
89;04.02.2016;2016;02;14;Torstai;79;29;108;31;33;64
89;04.02.2016;2016;02;15;Torstai;93;37;130;44;15;59
89;04.02.2016;2016;02;16;Torstai;100;39;139;32;15;47
89;04.02.2016;2016;02;17;Torstai;81;31;112;32;27;59
89;04.02.2016;2016;02;18;Torstai;55;30;85;40;23;63
89;04.02.2016;2016;02;19;Torstai;41;24;65;19;21;40
89;04.02.2016;2016;02;20;Torstai;32;15;47;19;13;32
89;04.02.2016;2016;02;21;Torstai;30;11;41;15;7;22
89;04.02.2016;2016;02;22;Torstai;23;7;30;7;4;11
89;04.02.2016;2016;02;23;Torstai;13;5;18;2;1;3
89;05.02.2016;2016;02;00;Perjantai;0;2;2;3;0;3
89;05.02.2016;2016;02;01;Perjantai;3;0;3;1;0;1
89;05.02.2016;2016;02;02;Perjantai;4;0;4;1;3;4
89;05.02.2016;2016;02;03;Perjantai;3;0;3;0;0;0
89;05.02.2016;2016;02;04;Perjantai;5;3;8;2;1;3
89;05.02.2016;2016;02;05;Perjantai;5;9;14;0;0;0
89;05.02.2016;2016;02;06;Perjantai;19;21;40;4;12;16
89;05.02.2016;2016;02;07;Perjantai;33;53;86;7;31;38
89;05.02.2016;2016;02;08;Perjantai;57;100;157;7;51;58
89;05.02.2016;2016;02;09;Perjantai;31;50;81;28;21;49
89;05.02.2016;2016;02;10;Perjantai;28;33;61;19;28;47
89;05.02.2016;2016;02;11;Perjantai;27;34;61;17;42;59
89;05.02.2016;2016;02;12;Perjantai;44;32;76;29;28;57
89;05.02.2016;2016;02;13;Perjantai;57;46;103;39;25;64
89;05.02.2016;2016;02;14;Perjantai;60;36;96;34;23;57
89;05.02.2016;2016;02;15;Perjantai;98;38;136;34;24;58
89;05.02.2016;2016;02;16;Perjantai;88;47;135;41;27;68
89;05.02.2016;2016;02;17;Perjantai;55;20;75;40;23;63
89;05.02.2016;2016;02;18;Perjantai;37;18;55;30;20;50
89;05.02.2016;2016;02;19;Perjantai;30;18;48;20;13;33
89;05.02.2016;2016;02;20;Perjantai;24;22;46;14;11;25
89;05.02.2016;2016;02;21;Perjantai;19;12;31;11;9;20
89;05.02.2016;2016;02;22;Perjantai;17;9;26;3;8;11
89;05.02.2016;2016;02;23;Perjantai;10;6;16;5;4;9
89;06.02.2016;2016;02;00;Lauantai;12;7;19;5;2;7
89;06.02.2016;2016;02;01;Lauantai;4;6;10;3;2;5
89;06.02.2016;2016;02;02;Lauantai;1;3;4;6;0;6
89;06.02.2016;2016;02;03;Lauantai;4;0;4;3;1;4
89;06.02.2016;2016;02;04;Lauantai;14;1;15;7;0;7
89;06.02.2016;2016;02;05;Lauantai;1;1;2;1;0;1
89;06.02.2016;2016;02;06;Lauantai;3;6;9;0;0;0
89;06.02.2016;2016;02;07;Lauantai;5;2;7;4;9;13
89;06.02.2016;2016;02;08;Lauantai;9;19;28;13;9;22
89;06.02.2016;2016;02;09;Lauantai;7;27;34;14;15;29
89;06.02.2016;2016;02;10;Lauantai;18;35;53;20;30;50
89;06.02.2016;2016;02;11;Lauantai;33;30;63;28;47;75
89;06.02.2016;2016;02;12;Lauantai;41;43;84;32;54;86
89;06.02.2016;2016;02;13;Lauantai;40;36;76;40;32;72
89;06.02.2016;2016;02;14;Lauantai;42;31;73;37;36;73
89;06.02.2016;2016;02;15;Lauantai;42;22;64;33;29;62
89;06.02.2016;2016;02;16;Lauantai;35;20;55;38;25;63
89;06.02.2016;2016;02;17;Lauantai;19;20;39;31;25;56
89;06.02.2016;2016;02;18;Lauantai;22;19;41;13;11;24
89;06.02.2016;2016;02;19;Lauantai;34;11;45;11;3;14
89;06.02.2016;2016;02;20;Lauantai;17;9;26;15;10;25
89;06.02.2016;2016;02;21;Lauantai;23;0;23;8;0;8
89;06.02.2016;2016;02;22;Lauantai;27;0;27;8;0;8
89;06.02.2016;2016;02;23;Lauantai;16;0;16;4;0;4
89;07.02.2016;2016;02;00;Sunnuntai;14;0;14;17;0;17
89;07.02.2016;2016;02;01;Sunnuntai;10;0;10;4;0;4
89;07.02.2016;2016;02;02;Sunnuntai;9;0;9;13;0;13
89;07.02.2016;2016;02;03;Sunnuntai;7;0;7;10;0;10
89;07.02.2016;2016;02;04;Sunnuntai;13;0;13;14;0;14
89;07.02.2016;2016;02;05;Sunnuntai;2;0;2;5;0;5
89;07.02.2016;2016;02;06;Sunnuntai;2;0;2;2;0;2
89;07.02.2016;2016;02;07;Sunnuntai;5;0;5;15;0;15
89;07.02.2016;2016;02;08;Sunnuntai;3;1;4;21;0;21
89;07.02.2016;2016;02;09;Sunnuntai;19;0;19;34;0;34
89;07.02.2016;2016;02;10;Sunnuntai;21;0;21;47;0;47
89;07.02.2016;2016;02;11;Sunnuntai;22;0;22;88;0;88
89;07.02.2016;2016;02;12;Sunnuntai;45;0;45;108;0;108
89;07.02.2016;2016;02;13;Sunnuntai;54;0;54;117;0;117
89;07.02.2016;2016;02;14;Sunnuntai;61;1;62;97;0;97
89;07.02.2016;2016;02;15;Sunnuntai;59;0;59;63;0;63
89;07.02.2016;2016;02;16;Sunnuntai;36;2;38;64;0;64
89;07.02.2016;2016;02;17;Sunnuntai;36;1;37;38;0;38
89;07.02.2016;2016;02;18;Sunnuntai;26;1;27;31;0;31
89;07.02.2016;2016;02;19;Sunnuntai;23;0;23;44;0;44
89;07.02.2016;2016;02;20;Sunnuntai;25;0;25;29;0;29
89;07.02.2016;2016;02;21;Sunnuntai;22;0;22;13;0;13
89;07.02.2016;2016;02;22;Sunnuntai;9;0;9;11;0;11
89;07.02.2016;2016;02;23;Sunnuntai;7;0;7;1;0;1
89;08.02.2016;2016;02;00;Maanantai;5;0;5;2;2;4
89;08.02.2016;2016;02;01;Maanantai;5;1;6;1;0;1
89;08.02.2016;2016;02;02;Maanantai;0;0;0;1;0;1
89;08.02.2016;2016;02;03;Maanantai;1;2;3;1;0;1
89;08.02.2016;2016;02;04;Maanantai;4;7;11;2;1;3
89;08.02.2016;2016;02;05;Maanantai;2;9;11;1;0;1
89;08.02.2016;2016;02;06;Maanantai;5;20;25;4;12;16
89;08.02.2016;2016;02;07;Maanantai;4;62;66;7;32;39
89;08.02.2016;2016;02;08;Maanantai;14;108;122;10;40;50
89;08.02.2016;2016;02;09;Maanantai;19;54;73;13;30;43
89;08.02.2016;2016;02;10;Maanantai;22;37;59;20;23;43
89;08.02.2016;2016;02;11;Maanantai;27;29;56;12;29;41
89;08.02.2016;2016;02;12;Maanantai;32;42;74;13;18;31
89;08.02.2016;2016;02;13;Maanantai;33;24;57;23;16;39
89;08.02.2016;2016;02;14;Maanantai;39;30;69;27;29;56
89;08.02.2016;2016;02;15;Maanantai;68;33;101;35;19;54
89;08.02.2016;2016;02;16;Maanantai;81;22;103;47;24;71
89;08.02.2016;2016;02;17;Maanantai;53;26;79;26;13;39
89;08.02.2016;2016;02;18;Maanantai;26;25;51;25;22;47
89;08.02.2016;2016;02;19;Maanantai;34;22;56;30;12;42
89;08.02.2016;2016;02;20;Maanantai;17;12;29;21;9;30
89;08.02.2016;2016;02;21;Maanantai;22;9;31;13;7;20
89;08.02.2016;2016;02;22;Maanantai;13;2;15;5;3;8
89;08.02.2016;2016;02;23;Maanantai;4;0;4;3;0;3
89;09.02.2016;2016;02;00;Tiistai;0;0;0;1;0;1
89;09.02.2016;2016;02;01;Tiistai;2;1;3;2;0;2
89;09.02.2016;2016;02;02;Tiistai;2;0;2;0;1;1
89;09.02.2016;2016;02;03;Tiistai;0;1;1;0;0;0
89;09.02.2016;2016;02;04;Tiistai;2;5;7;0;0;0
89;09.02.2016;2016;02;05;Tiistai;1;4;5;1;1;2
89;09.02.2016;2016;02;06;Tiistai;9;24;33;7;15;22
89;09.02.2016;2016;02;07;Tiistai;15;60;75;5;31;36
89;09.02.2016;2016;02;08;Tiistai;12;98;110;19;55;74
89;09.02.2016;2016;02;09;Tiistai;9;51;60;10;36;46
89;09.02.2016;2016;02;10;Tiistai;11;27;38;22;36;58
89;09.02.2016;2016;02;11;Tiistai;28;24;52;24;21;45
89;09.02.2016;2016;02;12;Tiistai;33;44;77;37;31;68
89;09.02.2016;2016;02;13;Tiistai;31;37;68;24;18;42
89;09.02.2016;2016;02;14;Tiistai;42;28;70;44;22;66
89;09.02.2016;2016;02;15;Tiistai;54;25;79;23;17;40
89;09.02.2016;2016;02;16;Tiistai;77;36;113;38;15;53
89;09.02.2016;2016;02;17;Tiistai;48;33;81;20;19;39
89;09.02.2016;2016;02;18;Tiistai;39;19;58;20;20;40
89;09.02.2016;2016;02;19;Tiistai;16;10;26;21;15;36
89;09.02.2016;2016;02;20;Tiistai;36;21;57;15;13;28
89;09.02.2016;2016;02;21;Tiistai;30;6;36;12;6;18
89;09.02.2016;2016;02;22;Tiistai;8;10;18;1;3;4
89;09.02.2016;2016;02;23;Tiistai;8;0;8;0;1;1
89;10.02.2016;2016;02;00;Keskiviikko;1;6;7;2;1;3
89;10.02.2016;2016;02;01;Keskiviikko;2;0;2;3;0;3
89;10.02.2016;2016;02;02;Keskiviikko;1;0;1;1;0;1
89;10.02.2016;2016;02;03;Keskiviikko;2;0;2;0;0;0
89;10.02.2016;2016;02;04;Keskiviikko;3;5;8;0;0;0
89;10.02.2016;2016;02;05;Keskiviikko;4;7;11;0;1;1
89;10.02.2016;2016;02;06;Keskiviikko;6;27;33;9;11;20
89;10.02.2016;2016;02;07;Keskiviikko;13;73;86;8;40;48
89;10.02.2016;2016;02;08;Keskiviikko;26;94;120;11;35;46
89;10.02.2016;2016;02;09;Keskiviikko;17;57;74;9;30;39
89;10.02.2016;2016;02;10;Keskiviikko;17;41;58;16;26;42
89;10.02.2016;2016;02;11;Keskiviikko;25;36;61;18;41;59
89;10.02.2016;2016;02;12;Keskiviikko;33;35;68;31;18;49
89;10.02.2016;2016;02;13;Keskiviikko;37;31;68;25;11;36
89;10.02.2016;2016;02;14;Keskiviikko;54;22;76;37;31;68
89;10.02.2016;2016;02;15;Keskiviikko;66;35;101;35;17;52
89;10.02.2016;2016;02;16;Keskiviikko;90;47;137;49;30;79
89;10.02.2016;2016;02;17;Keskiviikko;60;31;91;41;26;67
89;10.02.2016;2016;02;18;Keskiviikko;39;19;58;27;24;51
89;10.02.2016;2016;02;19;Keskiviikko;29;9;38;32;19;51
89;10.02.2016;2016;02;20;Keskiviikko;21;12;33;18;17;35
89;10.02.2016;2016;02;21;Keskiviikko;23;14;37;16;8;24
89;10.02.2016;2016;02;22;Keskiviikko;14;6;20;9;3;12
89;10.02.2016;2016;02;23;Keskiviikko;9;3;12;4;3;7
89;11.02.2016;2016;02;00;Torstai;1;1;2;1;0;1
89;11.02.2016;2016;02;01;Torstai;2;0;2;1;0;1
89;11.02.2016;2016;02;02;Torstai;0;0;0;3;0;3
89;11.02.2016;2016;02;03;Torstai;1;2;3;0;2;2
89;11.02.2016;2016;02;04;Torstai;6;8;14;4;4;8
89;11.02.2016;2016;02;05;Torstai;4;6;10;1;1;2
89;11.02.2016;2016;02;06;Torstai;9;22;31;4;13;17
89;11.02.2016;2016;02;07;Torstai;12;67;79;6;29;35
89;11.02.2016;2016;02;08;Torstai;22;128;150;13;46;59
89;11.02.2016;2016;02;09;Torstai;25;57;82;17;30;47
89;11.02.2016;2016;02;10;Torstai;14;39;53;26;25;51
89;11.02.2016;2016;02;11;Torstai;29;39;68;15;35;50
89;11.02.2016;2016;02;12;Torstai;32;43;75;31;30;61
89;11.02.2016;2016;02;13;Torstai;38;29;67;23;27;50
89;11.02.2016;2016;02;14;Torstai;57;39;96;38;20;58
89;11.02.2016;2016;02;15;Torstai;71;35;106;40;23;63
89;11.02.2016;2016;02;16;Torstai;104;47;151;38;21;59
89;11.02.2016;2016;02;17;Torstai;59;46;105;37;23;60
89;11.02.2016;2016;02;18;Torstai;46;38;84;22;16;38
89;11.02.2016;2016;02;19;Torstai;37;24;61;23;18;41
89;11.02.2016;2016;02;20;Torstai;40;22;62;15;10;25
89;11.02.2016;2016;02;21;Torstai;35;10;45;20;9;29
89;11.02.2016;2016;02;22;Torstai;13;5;18;7;3;10
89;11.02.2016;2016;02;23;Torstai;6;7;13;3;2;5
89;12.02.2016;2016;02;00;Perjantai;6;0;6;1;4;5
89;12.02.2016;2016;02;01;Perjantai;1;1;2;1;0;1
89;12.02.2016;2016;02;02;Perjantai;1;3;4;0;0;0
89;12.02.2016;2016;02;03;Perjantai;1;2;3;0;1;1
89;12.02.2016;2016;02;04;Perjantai;4;3;7;3;2;5
89;12.02.2016;2016;02;05;Perjantai;2;7;9;1;1;2
89;12.02.2016;2016;02;06;Perjantai;11;29;40;5;9;14
89;12.02.2016;2016;02;07;Perjantai;10;55;65;9;25;34
89;12.02.2016;2016;02;08;Perjantai;20;112;132;17;52;69
89;12.02.2016;2016;02;09;Perjantai;15;47;62;7;50;57
89;12.02.2016;2016;02;10;Perjantai;23;30;53;21;24;45
89;12.02.2016;2016;02;11;Perjantai;26;32;58;23;34;57
89;12.02.2016;2016;02;12;Perjantai;25;33;58;19;17;36
89;12.02.2016;2016;02;13;Perjantai;39;39;78;29;21;50
89;12.02.2016;2016;02;14;Perjantai;59;30;89;26;33;59
89;12.02.2016;2016;02;15;Perjantai;60;34;94;32;15;47
89;12.02.2016;2016;02;16;Perjantai;90;30;120;26;16;42
89;12.02.2016;2016;02;17;Perjantai;48;24;72;27;17;44
89;12.02.2016;2016;02;18;Perjantai;29;20;49;14;19;33
89;12.02.2016;2016;02;19;Perjantai;25;16;41;21;21;42
89;12.02.2016;2016;02;20;Perjantai;17;9;26;12;15;27
89;12.02.2016;2016;02;21;Perjantai;18;9;27;12;7;19
89;12.02.2016;2016;02;22;Perjantai;8;11;19;5;16;21
89;12.02.2016;2016;02;23;Perjantai;8;1;9;2;5;7
89;13.02.2016;2016;02;00;Lauantai;7;1;8;4;3;7
89;13.02.2016;2016;02;01;Lauantai;3;2;5;7;0;7
89;13.02.2016;2016;02;02;Lauantai;5;4;9;6;6;12
89;13.02.2016;2016;02;03;Lauantai;1;1;2;7;0;7
89;13.02.2016;2016;02;04;Lauantai;7;5;12;11;0;11
89;13.02.2016;2016;02;05;Lauantai;1;0;1;1;0;1
89;13.02.2016;2016;02;06;Lauantai;1;5;6;2;4;6
89;13.02.2016;2016;02;07;Lauantai;2;7;9;3;2;5
89;13.02.2016;2016;02;08;Lauantai;3;12;15;10;8;18
89;13.02.2016;2016;02;09;Lauantai;2;11;13;24;28;52
89;13.02.2016;2016;02;10;Lauantai;6;21;27;22;28;50
89;13.02.2016;2016;02;11;Lauantai;20;26;46;17;41;58
89;13.02.2016;2016;02;12;Lauantai;23;34;57;26;60;86
89;13.02.2016;2016;02;13;Lauantai;31;41;72;39;43;82
89;13.02.2016;2016;02;14;Lauantai;52;29;81;35;41;76
89;13.02.2016;2016;02;15;Lauantai;30;14;44;46;37;83
89;13.02.2016;2016;02;16;Lauantai;25;16;41;35;35;70
89;13.02.2016;2016;02;17;Lauantai;28;18;46;27;26;53
89;13.02.2016;2016;02;18;Lauantai;19;15;34;17;22;39
89;13.02.2016;2016;02;19;Lauantai;17;21;38;19;13;32
89;13.02.2016;2016;02;20;Lauantai;15;16;31;13;9;22
89;13.02.2016;2016;02;21;Lauantai;15;10;25;7;11;18
89;13.02.2016;2016;02;22;Lauantai;14;13;27;1;14;15
89;13.02.2016;2016;02;23;Lauantai;10;14;24;7;8;15
89;14.02.2016;2016;02;00;Sunnuntai;17;9;26;7;9;16
89;14.02.2016;2016;02;01;Sunnuntai;7;8;15;3;2;5
89;14.02.2016;2016;02;02;Sunnuntai;4;5;9;4;3;7
89;14.02.2016;2016;02;03;Sunnuntai;7;2;9;8;1;9
89;14.02.2016;2016;02;04;Sunnuntai;6;1;7;3;5;8
89;14.02.2016;2016;02;05;Sunnuntai;2;3;5;1;2;3
89;14.02.2016;2016;02;06;Sunnuntai;4;5;9;1;2;3
89;14.02.2016;2016;02;07;Sunnuntai;2;3;5;4;2;6
89;14.02.2016;2016;02;08;Sunnuntai;5;5;10;13;9;22
89;14.02.2016;2016;02;09;Sunnuntai;5;21;26;22;32;54
89;14.02.2016;2016;02;10;Sunnuntai;11;13;24;34;24;58
89;14.02.2016;2016;02;11;Sunnuntai;13;22;35;33;40;73
89;14.02.2016;2016;02;12;Sunnuntai;27;23;50;31;16;47
89;14.02.2016;2016;02;13;Sunnuntai;25;26;51;58;46;104
89;14.02.2016;2016;02;14;Sunnuntai;20;32;52;47;63;110
89;14.02.2016;2016;02;15;Sunnuntai;22;18;40;31;29;60
89;14.02.2016;2016;02;16;Sunnuntai;20;11;31;25;19;44
89;14.02.2016;2016;02;17;Sunnuntai;16;17;33;45;24;69
89;14.02.2016;2016;02;18;Sunnuntai;20;8;28;35;24;59
89;14.02.2016;2016;02;19;Sunnuntai;20;9;29;21;15;36
89;14.02.2016;2016;02;20;Sunnuntai;15;10;25;20;23;43
89;14.02.2016;2016;02;21;Sunnuntai;15;10;25;9;3;12
89;14.02.2016;2016;02;22;Sunnuntai;7;6;13;3;4;7
89;14.02.2016;2016;02;23;Sunnuntai;2;8;10;5;2;7
89;15.02.2016;2016;02;00;Maanantai;1;2;3;0;1;1
89;15.02.2016;2016;02;01;Maanantai;1;0;1;0;1;1
89;15.02.2016;2016;02;02;Maanantai;1;1;2;2;0;2
89;15.02.2016;2016;02;03;Maanantai;1;2;3;0;1;1
89;15.02.2016;2016;02;04;Maanantai;1;1;2;1;1;2
89;15.02.2016;2016;02;05;Maanantai;6;15;21;2;1;3
89;15.02.2016;2016;02;06;Maanantai;6;28;34;2;10;12
89;15.02.2016;2016;02;07;Maanantai;23;92;115;9;39;48
89;15.02.2016;2016;02;08;Maanantai;28;129;157;14;53;67
89;15.02.2016;2016;02;09;Maanantai;26;76;102;17;46;63
89;15.02.2016;2016;02;10;Maanantai;33;44;77;27;38;65
89;15.02.2016;2016;02;11;Maanantai;46;43;89;30;37;67
89;15.02.2016;2016;02;12;Maanantai;48;57;105;24;39;63
89;15.02.2016;2016;02;13;Maanantai;58;38;96;44;27;71
89;15.02.2016;2016;02;14;Maanantai;67;47;114;33;26;59
89;15.02.2016;2016;02;15;Maanantai;95;38;133;40;26;66
89;15.02.2016;2016;02;16;Maanantai;121;47;168;49;21;70
89;15.02.2016;2016;02;17;Maanantai;77;32;109;38;21;59
89;15.02.2016;2016;02;18;Maanantai;46;21;67;35;31;66
89;15.02.2016;2016;02;19;Maanantai;33;16;49;37;25;62
89;15.02.2016;2016;02;20;Maanantai;37;13;50;19;14;33
89;15.02.2016;2016;02;21;Maanantai;31;9;40;17;4;21
89;15.02.2016;2016;02;22;Maanantai;9;4;13;3;3;6
89;15.02.2016;2016;02;23;Maanantai;3;3;6;3;0;3
89;16.02.2016;2016;02;00;Tiistai;4;1;5;0;0;0
89;16.02.2016;2016;02;01;Tiistai;3;0;3;1;1;2
89;16.02.2016;2016;02;02;Tiistai;1;1;2;1;0;1
89;16.02.2016;2016;02;03;Tiistai;1;2;3;1;0;1
89;16.02.2016;2016;02;04;Tiistai;1;2;3;1;0;1
89;16.02.2016;2016;02;05;Tiistai;6;10;16;1;1;2
89;16.02.2016;2016;02;06;Tiistai;13;23;36;4;6;10
89;16.02.2016;2016;02;07;Tiistai;23;99;122;7;35;42
89;16.02.2016;2016;02;08;Tiistai;29;135;164;13;63;76
89;16.02.2016;2016;02;09;Tiistai;27;72;99;21;39;60
89;16.02.2016;2016;02;10;Tiistai;29;52;81;27;30;57
89;16.02.2016;2016;02;11;Tiistai;39;27;66;41;49;90
89;16.02.2016;2016;02;12;Tiistai;32;52;84;41;55;96
89;16.02.2016;2016;02;13;Tiistai;48;35;83;44;41;85
89;16.02.2016;2016;02;14;Tiistai;57;44;101;47;37;84
89;16.02.2016;2016;02;15;Tiistai;117;45;162;53;31;84
89;16.02.2016;2016;02;16;Tiistai;113;67;180;58;32;90
89;16.02.2016;2016;02;17;Tiistai;66;38;104;33;29;62
89;16.02.2016;2016;02;18;Tiistai;68;28;96;34;26;60
89;16.02.2016;2016;02;19;Tiistai;54;17;71;24;27;51
89;16.02.2016;2016;02;20;Tiistai;26;23;49;16;20;36
89;16.02.2016;2016;02;21;Tiistai;24;9;33;11;5;16
89;16.02.2016;2016;02;22;Tiistai;10;7;17;8;7;15
89;16.02.2016;2016;02;23;Tiistai;3;3;6;3;1;4
89;17.02.2016;2016;02;00;Keskiviikko;5;2;7;1;2;3
89;17.02.2016;2016;02;01;Keskiviikko;7;0;7;1;1;2
89;17.02.2016;2016;02;02;Keskiviikko;1;0;1;0;0;0
89;17.02.2016;2016;02;03;Keskiviikko;0;2;2;0;0;0
89;17.02.2016;2016;02;04;Keskiviikko;1;7;8;1;0;1
89;17.02.2016;2016;02;05;Keskiviikko;3;10;13;2;1;3
89;17.02.2016;2016;02;06;Keskiviikko;10;35;45;1;10;11
89;17.02.2016;2016;02;07;Keskiviikko;19;107;126;8;45;53
89;17.02.2016;2016;02;08;Keskiviikko;34;131;165;11;40;51
89;17.02.2016;2016;02;09;Keskiviikko;19;69;88;12;44;56
89;17.02.2016;2016;02;10;Keskiviikko;24;41;65;25;36;61
89;17.02.2016;2016;02;11;Keskiviikko;30;56;86;37;46;83
89;17.02.2016;2016;02;12;Keskiviikko;35;52;87;28;42;70
89;17.02.2016;2016;02;13;Keskiviikko;55;29;84;33;26;59
89;17.02.2016;2016;02;14;Keskiviikko;60;35;95;37;23;60
89;17.02.2016;2016;02;15;Keskiviikko;102;46;148;35;19;54
89;17.02.2016;2016;02;16;Keskiviikko;122;49;171;40;18;58
89;17.02.2016;2016;02;17;Keskiviikko;60;39;99;48;23;71
89;17.02.2016;2016;02;18;Keskiviikko;54;29;83;34;26;60
89;17.02.2016;2016;02;19;Keskiviikko;31;20;51;34;25;59
89;17.02.2016;2016;02;20;Keskiviikko;37;20;57;26;23;49
89;17.02.2016;2016;02;21;Keskiviikko;30;21;51;13;7;20
89;17.02.2016;2016;02;22;Keskiviikko;21;5;26;5;1;6
89;17.02.2016;2016;02;23;Keskiviikko;4;4;8;1;4;5
89;18.02.2016;2016;02;00;Torstai;8;0;8;0;1;1
89;18.02.2016;2016;02;01;Torstai;3;0;3;2;0;2
89;18.02.2016;2016;02;02;Torstai;2;1;3;1;1;2
89;18.02.2016;2016;02;03;Torstai;3;1;4;1;0;1
89;18.02.2016;2016;02;04;Torstai;0;4;4;1;0;1
89;18.02.2016;2016;02;05;Torstai;3;9;12;4;0;4
89;18.02.2016;2016;02;06;Torstai;11;29;40;3;8;11
89;18.02.2016;2016;02;07;Torstai;16;99;115;5;30;35
89;18.02.2016;2016;02;08;Torstai;36;132;168;17;52;69
89;18.02.2016;2016;02;09;Torstai;23;70;93;17;32;49
89;18.02.2016;2016;02;10;Torstai;25;58;83;26;37;63
89;18.02.2016;2016;02;11;Torstai;32;36;68;22;37;59
89;18.02.2016;2016;02;12;Torstai;46;47;93;20;30;50
89;18.02.2016;2016;02;13;Torstai;44;67;111;29;32;61
89;18.02.2016;2016;02;14;Torstai;83;31;114;39;29;68
89;18.02.2016;2016;02;15;Torstai;85;38;123;26;31;57
89;18.02.2016;2016;02;16;Torstai;119;57;176;39;29;68
89;18.02.2016;2016;02;17;Torstai;68;47;115;35;19;54
89;18.02.2016;2016;02;18;Torstai;52;21;73;35;26;61
89;18.02.2016;2016;02;19;Torstai;36;21;57;26;23;49
89;18.02.2016;2016;02;20;Torstai;28;16;44;24;9;33
89;18.02.2016;2016;02;21;Torstai;28;9;37;13;12;25
89;18.02.2016;2016;02;22;Torstai;15;10;25;2;4;6
89;18.02.2016;2016;02;23;Torstai;5;6;11;1;2;3
89;19.02.2016;2016;02;00;Perjantai;2;3;5;2;1;3
89;19.02.2016;2016;02;01;Perjantai;8;1;9;0;0;0
89;19.02.2016;2016;02;02;Perjantai;3;1;4;1;1;2
89;19.02.2016;2016;02;03;Perjantai;2;2;4;0;0;0
89;19.02.2016;2016;02;04;Perjantai;0;5;5;0;2;2
89;19.02.2016;2016;02;05;Perjantai;6;6;12;3;0;3
89;19.02.2016;2016;02;06;Perjantai;9;24;33;4;11;15
89;19.02.2016;2016;02;07;Perjantai;20;81;101;6;36;42
89;19.02.2016;2016;02;08;Perjantai;23;109;132;16;44;60
89;19.02.2016;2016;02;09;Perjantai;18;69;87;19;24;43
89;19.02.2016;2016;02;10;Perjantai;25;39;64;23;21;44
89;19.02.2016;2016;02;11;Perjantai;33;47;80;29;31;60
89;19.02.2016;2016;02;12;Perjantai;25;48;73;21;32;53
89;19.02.2016;2016;02;13;Perjantai;61;47;108;22;37;59
89;19.02.2016;2016;02;14;Perjantai;63;26;89;19;21;40
89;19.02.2016;2016;02;15;Perjantai;103;32;135;47;22;69
89;19.02.2016;2016;02;16;Perjantai;75;41;116;42;22;64
89;19.02.2016;2016;02;17;Perjantai;43;33;76;33;27;60
89;19.02.2016;2016;02;18;Perjantai;25;26;51;30;37;67
89;19.02.2016;2016;02;19;Perjantai;31;19;50;22;14;36
89;19.02.2016;2016;02;20;Perjantai;31;19;50;20;13;33
89;19.02.2016;2016;02;21;Perjantai;28;11;39;14;12;26
89;19.02.2016;2016;02;22;Perjantai;13;10;23;5;4;9
89;19.02.2016;2016;02;23;Perjantai;10;9;19;7;2;9
89;20.02.2016;2016;02;00;Lauantai;12;2;14;3;8;11
89;20.02.2016;2016;02;01;Lauantai;8;3;11;3;4;7
89;20.02.2016;2016;02;02;Lauantai;9;5;14;5;5;10
89;20.02.2016;2016;02;03;Lauantai;6;0;6;11;0;11
89;20.02.2016;2016;02;04;Lauantai;8;1;9;8;0;8
89;20.02.2016;2016;02;05;Lauantai;3;1;4;1;1;2
89;20.02.2016;2016;02;06;Lauantai;1;12;13;1;3;4
89;20.02.2016;2016;02;07;Lauantai;4;3;7;9;3;12
89;20.02.2016;2016;02;08;Lauantai;8;13;21;5;13;18
89;20.02.2016;2016;02;09;Lauantai;7;34;41;24;37;61
89;20.02.2016;2016;02;10;Lauantai;11;37;48;24;29;53
89;20.02.2016;2016;02;11;Lauantai;18;29;47;19;52;71
89;20.02.2016;2016;02;12;Lauantai;28;39;67;40;43;83
89;20.02.2016;2016;02;13;Lauantai;42;42;84;47;46;93
89;20.02.2016;2016;02;14;Lauantai;37;45;82;25;33;58
89;20.02.2016;2016;02;15;Lauantai;46;33;79;43;45;88
89;20.02.2016;2016;02;16;Lauantai;36;25;61;42;30;72
89;20.02.2016;2016;02;17;Lauantai;31;24;55;41;21;62
89;20.02.2016;2016;02;18;Lauantai;20;21;41;38;21;59
89;20.02.2016;2016;02;19;Lauantai;16;18;34;17;21;38
89;20.02.2016;2016;02;20;Lauantai;7;16;23;14;14;28
89;20.02.2016;2016;02;21;Lauantai;18;11;29;8;7;15
89;20.02.2016;2016;02;22;Lauantai;11;16;27;11;5;16
89;20.02.2016;2016;02;23;Lauantai;17;9;26;9;7;16
89;21.02.2016;2016;02;00;Sunnuntai;7;8;15;3;1;4
89;21.02.2016;2016;02;01;Sunnuntai;7;1;8;3;0;3
89;21.02.2016;2016;02;02;Sunnuntai;10;4;14;7;2;9
89;21.02.2016;2016;02;03;Sunnuntai;7;2;9;10;1;11
89;21.02.2016;2016;02;04;Sunnuntai;7;1;8;4;4;8
89;21.02.2016;2016;02;05;Sunnuntai;3;0;3;3;1;4
89;21.02.2016;2016;02;06;Sunnuntai;4;9;13;0;5;5
89;21.02.2016;2016;02;07;Sunnuntai;3;6;9;4;3;7
89;21.02.2016;2016;02;08;Sunnuntai;1;8;9;6;8;14
89;21.02.2016;2016;02;09;Sunnuntai;5;6;11;10;15;25
89;21.02.2016;2016;02;10;Sunnuntai;4;16;20;25;22;47
89;21.02.2016;2016;02;11;Sunnuntai;9;27;36;36;37;73
89;21.02.2016;2016;02;12;Sunnuntai;19;22;41;44;57;101
89;21.02.2016;2016;02;13;Sunnuntai;28;31;59;33;46;79
89;21.02.2016;2016;02;14;Sunnuntai;31;24;55;44;32;76
89;21.02.2016;2016;02;15;Sunnuntai;35;28;63;39;42;81
89;21.02.2016;2016;02;16;Sunnuntai;30;11;41;32;24;56
89;21.02.2016;2016;02;17;Sunnuntai;22;17;39;30;17;47
89;21.02.2016;2016;02;18;Sunnuntai;24;15;39;41;21;62
89;21.02.2016;2016;02;19;Sunnuntai;10;14;24;25;21;46
89;21.02.2016;2016;02;20;Sunnuntai;13;11;24;20;12;32
89;21.02.2016;2016;02;21;Sunnuntai;9;3;12;8;4;12
89;21.02.2016;2016;02;22;Sunnuntai;2;4;6;6;3;9
89;21.02.2016;2016;02;23;Sunnuntai;5;9;14;8;5;13
89;22.02.2016;2016;02;00;Maanantai;2;2;4;1;0;1
89;22.02.2016;2016;02;01;Maanantai;0;0;0;2;1;3
89;22.02.2016;2016;02;02;Maanantai;0;0;0;2;2;4
89;22.02.2016;2016;02;03;Maanantai;1;1;2;1;0;1
89;22.02.2016;2016;02;04;Maanantai;1;3;4;0;2;2
89;22.02.2016;2016;02;05;Maanantai;6;5;11;2;2;4
89;22.02.2016;2016;02;06;Maanantai;5;35;40;6;13;19
89;22.02.2016;2016;02;07;Maanantai;17;98;115;14;30;44
89;22.02.2016;2016;02;08;Maanantai;31;113;144;11;44;55
89;22.02.2016;2016;02;09;Maanantai;20;79;99;22;50;72
89;22.02.2016;2016;02;10;Maanantai;16;35;51;23;43;66
89;22.02.2016;2016;02;11;Maanantai;40;39;79;30;47;77
89;22.02.2016;2016;02;12;Maanantai;33;42;75;21;33;54
89;22.02.2016;2016;02;13;Maanantai;42;40;82;31;25;56
89;22.02.2016;2016;02;14;Maanantai;63;55;118;39;30;69
89;22.02.2016;2016;02;15;Maanantai;75;35;110;49;24;73
89;22.02.2016;2016;02;16;Maanantai;121;56;177;54;29;83
89;22.02.2016;2016;02;17;Maanantai;75;47;122;37;28;65
89;22.02.2016;2016;02;18;Maanantai;50;30;80;44;25;69
89;22.02.2016;2016;02;19;Maanantai;41;22;63;30;21;51
89;22.02.2016;2016;02;20;Maanantai;31;15;46;25;15;40
89;22.02.2016;2016;02;21;Maanantai;39;12;51;8;11;19
89;22.02.2016;2016;02;22;Maanantai;20;5;25;8;7;15
89;22.02.2016;2016;02;23;Maanantai;5;3;8;6;1;7
89;23.02.2016;2016;02;00;Tiistai;2;1;3;0;0;0
89;23.02.2016;2016;02;01;Tiistai;0;1;1;1;0;1
89;23.02.2016;2016;02;02;Tiistai;1;0;1;1;0;1
89;23.02.2016;2016;02;03;Tiistai;0;1;1;4;0;4
89;23.02.2016;2016;02;04;Tiistai;1;3;4;0;0;0
89;23.02.2016;2016;02;05;Tiistai;3;9;12;4;3;7
89;23.02.2016;2016;02;06;Tiistai;14;35;49;8;12;20
89;23.02.2016;2016;02;07;Tiistai;23;106;129;4;41;45
89;23.02.2016;2016;02;08;Tiistai;25;137;162;12;45;57
89;23.02.2016;2016;02;09;Tiistai;25;72;97;18;40;58
89;23.02.2016;2016;02;10;Tiistai;22;50;72;31;37;68
89;23.02.2016;2016;02;11;Tiistai;37;38;75;30;37;67
89;23.02.2016;2016;02;12;Tiistai;40;50;90;56;40;96
89;23.02.2016;2016;02;13;Tiistai;39;28;67;29;26;55
89;23.02.2016;2016;02;14;Tiistai;70;35;105;42;34;76
89;23.02.2016;2016;02;15;Tiistai;96;40;136;40;20;60
89;23.02.2016;2016;02;16;Tiistai;117;55;172;47;29;76
89;23.02.2016;2016;02;17;Tiistai;71;48;119;50;35;85
89;23.02.2016;2016;02;18;Tiistai;50;36;86;39;40;79
89;23.02.2016;2016;02;19;Tiistai;41;14;55;56;22;78
89;23.02.2016;2016;02;20;Tiistai;34;26;60;14;17;31
89;23.02.2016;2016;02;21;Tiistai;24;13;37;21;17;38
89;23.02.2016;2016;02;22;Tiistai;15;6;21;9;5;14
89;23.02.2016;2016;02;23;Tiistai;7;2;9;1;5;6
89;24.02.2016;2016;02;00;Keskiviikko;4;7;11;1;0;1
89;24.02.2016;2016;02;01;Keskiviikko;0;1;1;4;0;4
89;24.02.2016;2016;02;02;Keskiviikko;1;1;2;0;0;0
89;24.02.2016;2016;02;03;Keskiviikko;1;1;2;0;1;1
89;24.02.2016;2016;02;04;Keskiviikko;2;3;5;1;0;1
89;24.02.2016;2016;02;05;Keskiviikko;4;9;13;2;2;4
89;24.02.2016;2016;02;06;Keskiviikko;9;38;47;8;10;18
89;24.02.2016;2016;02;07;Keskiviikko;20;105;125;7;38;45
89;24.02.2016;2016;02;08;Keskiviikko;35;141;176;17;54;71
89;24.02.2016;2016;02;09;Keskiviikko;17;85;102;23;44;67
89;24.02.2016;2016;02;10;Keskiviikko;33;43;76;25;29;54
89;24.02.2016;2016;02;11;Keskiviikko;33;49;82;33;37;70
89;24.02.2016;2016;02;12;Keskiviikko;34;60;94;29;28;57
89;24.02.2016;2016;02;13;Keskiviikko;52;50;102;33;19;52
89;24.02.2016;2016;02;14;Keskiviikko;64;45;109;46;18;64
89;24.02.2016;2016;02;15;Keskiviikko;98;47;145;44;23;67
89;24.02.2016;2016;02;16;Keskiviikko;126;44;170;49;36;85
89;24.02.2016;2016;02;17;Keskiviikko;74;54;128;43;25;68
89;24.02.2016;2016;02;18;Keskiviikko;54;28;82;29;25;54
89;24.02.2016;2016;02;19;Keskiviikko;60;6;66;38;17;55
89;24.02.2016;2016;02;20;Keskiviikko;42;17;59;17;7;24
89;24.02.2016;2016;02;21;Keskiviikko;22;22;44;11;7;18
89;24.02.2016;2016;02;22;Keskiviikko;10;6;16;3;5;8
89;24.02.2016;2016;02;23;Keskiviikko;4;4;8;3;2;5
89;25.02.2016;2016;02;00;Torstai;1;5;6;1;1;2
89;25.02.2016;2016;02;01;Torstai;2;0;2;1;1;2
89;25.02.2016;2016;02;02;Torstai;1;0;1;1;0;1
89;25.02.2016;2016;02;03;Torstai;1;1;2;1;1;2
89;25.02.2016;2016;02;04;Torstai;3;1;4;1;0;1
89;25.02.2016;2016;02;05;Torstai;11;1;12;9;3;12
89;25.02.2016;2016;02;06;Torstai;26;14;40;6;5;11
89;25.02.2016;2016;02;07;Torstai;62;48;110;23;33;56
89;25.02.2016;2016;02;08;Torstai;92;86;178;39;37;76
89;25.02.2016;2016;02;09;Torstai;39;31;70;24;30;54
89;25.02.2016;2016;02;10;Torstai;43;31;74;32;22;54
89;25.02.2016;2016;02;11;Torstai;40;21;61;32;27;59
89;25.02.2016;2016;02;12;Torstai;41;37;78;42;30;72
89;25.02.2016;2016;02;13;Torstai;50;37;87;46;35;81
89;25.02.2016;2016;02;14;Torstai;71;39;110;50;45;95
89;25.02.2016;2016;02;15;Torstai;89;49;138;53;23;76
89;25.02.2016;2016;02;16;Torstai;127;34;161;73;24;97
89;25.02.2016;2016;02;17;Torstai;67;30;97;26;25;51
89;25.02.2016;2016;02;18;Torstai;51;37;88;43;19;62
89;25.02.2016;2016;02;19;Torstai;48;23;71;28;21;49
89;25.02.2016;2016;02;20;Torstai;41;17;58;32;17;49
89;25.02.2016;2016;02;21;Torstai;30;11;41;16;10;26
89;25.02.2016;2016;02;22;Torstai;22;6;28;9;11;20
89;25.02.2016;2016;02;23;Torstai;8;10;18;2;2;4
89;26.02.2016;2016;02;00;Perjantai;5;2;7;1;2;3
89;26.02.2016;2016;02;01;Perjantai;3;2;5;2;2;4
89;26.02.2016;2016;02;02;Perjantai;2;2;4;0;2;2
89;26.02.2016;2016;02;03;Perjantai;0;1;1;0;0;0
89;26.02.2016;2016;02;04;Perjantai;0;2;2;4;0;4
89;26.02.2016;2016;02;05;Perjantai;6;8;14;4;3;7
89;26.02.2016;2016;02;06;Perjantai;14;20;34;4;8;12
89;26.02.2016;2016;02;07;Perjantai;42;48;90;11;22;33
89;26.02.2016;2016;02;08;Perjantai;39;85;124;15;36;51
89;26.02.2016;2016;02;09;Perjantai;26;69;95;13;31;44
89;26.02.2016;2016;02;10;Perjantai;23;40;63;20;35;55
89;26.02.2016;2016;02;11;Perjantai;45;36;81;29;40;69
89;26.02.2016;2016;02;12;Perjantai;41;41;82;35;32;67
89;26.02.2016;2016;02;13;Perjantai;58;43;101;37;22;59
89;26.02.2016;2016;02;14;Perjantai;61;53;114;32;27;59
89;26.02.2016;2016;02;15;Perjantai;84;46;130;36;30;66
89;26.02.2016;2016;02;16;Perjantai;88;51;139;40;21;61
89;26.02.2016;2016;02;17;Perjantai;56;22;78;26;20;46
89;26.02.2016;2016;02;18;Perjantai;36;32;68;26;14;40
89;26.02.2016;2016;02;19;Perjantai;29;18;47;18;16;34
89;26.02.2016;2016;02;20;Perjantai;27;14;41;12;18;30
89;26.02.2016;2016;02;21;Perjantai;20;12;32;13;10;23
89;26.02.2016;2016;02;22;Perjantai;14;13;27;5;9;14
89;26.02.2016;2016;02;23;Perjantai;13;7;20;5;9;14
89;27.02.2016;2016;02;00;Lauantai;8;5;13;5;6;11
89;27.02.2016;2016;02;01;Lauantai;6;3;9;3;1;4
89;27.02.2016;2016;02;02;Lauantai;3;5;8;9;6;15
89;27.02.2016;2016;02;03;Lauantai;3;1;4;1;1;2
89;27.02.2016;2016;02;04;Lauantai;10;2;12;3;0;3
89;27.02.2016;2016;02;05;Lauantai;4;3;7;1;3;4
89;27.02.2016;2016;02;06;Lauantai;2;6;8;2;2;4
89;27.02.2016;2016;02;07;Lauantai;3;5;8;7;9;16
89;27.02.2016;2016;02;08;Lauantai;8;23;31;6;14;20
89;27.02.2016;2016;02;09;Lauantai;6;30;36;14;23;37
89;27.02.2016;2016;02;10;Lauantai;19;16;35;23;42;65
89;27.02.2016;2016;02;11;Lauantai;18;32;50;29;44;73
89;27.02.2016;2016;02;12;Lauantai;29;34;63;34;66;100
89;27.02.2016;2016;02;13;Lauantai;29;40;69;41;45;86
89;27.02.2016;2016;02;14;Lauantai;32;27;59;49;34;83
89;27.02.2016;2016;02;15;Lauantai;39;21;60;44;31;75
89;27.02.2016;2016;02;16;Lauantai;42;29;71;39;25;64
89;27.02.2016;2016;02;17;Lauantai;39;28;67;28;10;38
89;27.02.2016;2016;02;18;Lauantai;28;17;45;30;16;46
89;27.02.2016;2016;02;19;Lauantai;23;21;44;15;14;29
89;27.02.2016;2016;02;20;Lauantai;7;13;20;12;15;27
89;27.02.2016;2016;02;21;Lauantai;11;10;21;5;12;17
89;27.02.2016;2016;02;22;Lauantai;11;5;16;10;8;18
89;27.02.2016;2016;02;23;Lauantai;17;11;28;5;11;16
89;28.02.2016;2016;02;00;Sunnuntai;5;14;19;5;6;11
89;28.02.2016;2016;02;01;Sunnuntai;6;0;6;5;1;6
89;28.02.2016;2016;02;02;Sunnuntai;4;10;14;2;5;7
89;28.02.2016;2016;02;03;Sunnuntai;10;2;12;6;0;6
89;28.02.2016;2016;02;04;Sunnuntai;13;1;14;12;0;12
89;28.02.2016;2016;02;05;Sunnuntai;5;2;7;1;0;1
89;28.02.2016;2016;02;06;Sunnuntai;2;2;4;0;2;2
89;28.02.2016;2016;02;07;Sunnuntai;4;7;11;4;2;6
89;28.02.2016;2016;02;08;Sunnuntai;1;3;4;13;10;23
89;28.02.2016;2016;02;09;Sunnuntai;6;16;22;16;25;41
89;28.02.2016;2016;02;10;Sunnuntai;7;12;19;26;35;61
89;28.02.2016;2016;02;11;Sunnuntai;12;20;32;46;43;89
89;28.02.2016;2016;02;12;Sunnuntai;19;34;53;59;67;126
89;28.02.2016;2016;02;13;Sunnuntai;29;25;54;62;63;125
89;28.02.2016;2016;02;14;Sunnuntai;23;23;46;52;58;110
89;28.02.2016;2016;02;15;Sunnuntai;23;26;49;40;41;81
89;28.02.2016;2016;02;16;Sunnuntai;22;22;44;34;38;72
89;28.02.2016;2016;02;17;Sunnuntai;20;21;41;26;24;50
89;28.02.2016;2016;02;18;Sunnuntai;29;10;39;29;15;44
89;28.02.2016;2016;02;19;Sunnuntai;11;5;16;17;20;37
89;28.02.2016;2016;02;20;Sunnuntai;16;3;19;16;17;33
89;28.02.2016;2016;02;21;Sunnuntai;8;5;13;5;4;9
89;28.02.2016;2016;02;22;Sunnuntai;10;5;15;4;3;7
89;28.02.2016;2016;02;23;Sunnuntai;1;1;2;3;1;4
89;29.02.2016;2016;02;00;Maanantai;2;9;11;2;1;3
89;29.02.2016;2016;02;01;Maanantai;2;0;2;2;0;2
89;29.02.2016;2016;02;02;Maanantai;1;4;5;1;2;3
89;29.02.2016;2016;02;03;Maanantai;1;1;2;0;0;0
89;29.02.2016;2016;02;04;Maanantai;1;4;5;0;0;0
89;29.02.2016;2016;02;05;Maanantai;1;10;11;2;1;3
89;29.02.2016;2016;02;06;Maanantai;2;31;33;5;9;14
89;29.02.2016;2016;02;07;Maanantai;18;97;115;8;28;36
89;29.02.2016;2016;02;08;Maanantai;33;121;154;19;47;66
89;29.02.2016;2016;02;09;Maanantai;21;67;88;12;37;49
89;29.02.2016;2016;02;10;Maanantai;22;39;61;21;36;57
89;29.02.2016;2016;02;11;Maanantai;35;30;65;29;54;83
89;29.02.2016;2016;02;12;Maanantai;37;45;82;45;36;81
89;29.02.2016;2016;02;13;Maanantai;50;44;94;51;46;97
89;29.02.2016;2016;02;14;Maanantai;60;39;99;42;45;87
89;29.02.2016;2016;02;15;Maanantai;108;40;148;59;43;102
89;29.02.2016;2016;02;16;Maanantai;102;59;161;68;36;104
89;29.02.2016;2016;02;17;Maanantai;63;44;107;47;25;72
89;29.02.2016;2016;02;18;Maanantai;40;19;59;47;29;76
89;29.02.2016;2016;02;19;Maanantai;27;20;47;27;11;38
89;29.02.2016;2016;02;20;Maanantai;31;11;42;17;15;32
89;29.02.2016;2016;02;21;Maanantai;22;11;33;11;11;22
89;29.02.2016;2016;02;22;Maanantai;9;13;22;6;3;9
89;29.02.2016;2016;02;23;Maanantai;3;2;5;3;0;3
89;01.03.2016;2016;03;00;Tiistai;4;1;5;1;0;1
89;01.03.2016;2016;03;01;Tiistai;1;2;3;0;1;1
89;01.03.2016;2016;03;02;Tiistai;0;1;1;0;1;1
89;01.03.2016;2016;03;03;Tiistai;0;1;1;0;0;0
89;01.03.2016;2016;03;04;Tiistai;0;4;4;0;0;0
89;01.03.2016;2016;03;05;Tiistai;4;8;12;2;1;3
89;01.03.2016;2016;03;06;Tiistai;8;28;36;3;9;12
89;01.03.2016;2016;03;07;Tiistai;32;93;125;13;37;50
89;01.03.2016;2016;03;08;Tiistai;37;157;194;21;60;81
89;01.03.2016;2016;03;09;Tiistai;20;74;94;12;44;56
89;01.03.2016;2016;03;10;Tiistai;22;51;73;42;43;85
89;01.03.2016;2016;03;11;Tiistai;38;39;77;37;63;100
89;01.03.2016;2016;03;12;Tiistai;39;56;95;29;62;91
89;01.03.2016;2016;03;13;Tiistai;44;36;80;54;67;121
89;01.03.2016;2016;03;14;Tiistai;86;46;132;66;51;117
89;01.03.2016;2016;03;15;Tiistai;99;45;144;65;39;104
89;01.03.2016;2016;03;16;Tiistai;156;73;229;52;37;89
89;01.03.2016;2016;03;17;Tiistai;65;49;114;53;34;87
89;01.03.2016;2016;03;18;Tiistai;58;37;95;46;23;69
89;01.03.2016;2016;03;19;Tiistai;43;11;54;29;16;45
89;01.03.2016;2016;03;20;Tiistai;33;15;48;18;12;30
89;01.03.2016;2016;03;21;Tiistai;27;6;33;16;10;26
89;01.03.2016;2016;03;22;Tiistai;6;3;9;7;6;13
89;01.03.2016;2016;03;23;Tiistai;4;2;6;0;0;0
89;02.03.2016;2016;03;00;Keskiviikko;0;3;3;2;0;2
89;02.03.2016;2016;03;01;Keskiviikko;3;1;4;1;1;2
89;02.03.2016;2016;03;02;Keskiviikko;1;1;2;1;0;1
89;02.03.2016;2016;03;03;Keskiviikko;0;1;1;1;2;3
89;02.03.2016;2016;03;04;Keskiviikko;2;5;7;1;0;1
89;02.03.2016;2016;03;05;Keskiviikko;3;8;11;1;4;5
89;02.03.2016;2016;03;06;Keskiviikko;6;33;39;4;10;14
89;02.03.2016;2016;03;07;Keskiviikko;29;116;145;6;41;47
89;02.03.2016;2016;03;08;Keskiviikko;27;130;157;18;44;62
89;02.03.2016;2016;03;09;Keskiviikko;26;95;121;6;36;42
89;02.03.2016;2016;03;10;Keskiviikko;29;41;70;26;44;70
89;02.03.2016;2016;03;11;Keskiviikko;32;39;71;33;60;93
89;02.03.2016;2016;03;12;Keskiviikko;44;54;98;47;46;93
89;02.03.2016;2016;03;13;Keskiviikko;48;40;88;38;31;69
89;02.03.2016;2016;03;14;Keskiviikko;73;54;127;64;33;97
89;02.03.2016;2016;03;15;Keskiviikko;100;42;142;46;33;79
89;02.03.2016;2016;03;16;Keskiviikko;136;44;180;64;40;104
89;02.03.2016;2016;03;17;Keskiviikko;79;56;135;42;24;66
89;02.03.2016;2016;03;18;Keskiviikko;53;38;91;38;29;67
89;02.03.2016;2016;03;19;Keskiviikko;34;21;55;28;13;41
89;02.03.2016;2016;03;20;Keskiviikko;38;18;56;20;15;35
89;02.03.2016;2016;03;21;Keskiviikko;39;15;54;13;8;21
89;02.03.2016;2016;03;22;Keskiviikko;9;5;14;6;3;9
89;02.03.2016;2016;03;23;Keskiviikko;9;5;14;1;2;3
89;03.03.2016;2016;03;00;Torstai;5;4;9;0;0;0
89;03.03.2016;2016;03;01;Torstai;3;0;3;5;2;7
89;03.03.2016;2016;03;02;Torstai;0;2;2;2;2;4
89;03.03.2016;2016;03;03;Torstai;4;2;6;0;0;0
89;03.03.2016;2016;03;04;Torstai;4;4;8;3;0;3
89;03.03.2016;2016;03;05;Torstai;0;8;8;1;2;3
89;03.03.2016;2016;03;06;Torstai;10;24;34;5;7;12
89;03.03.2016;2016;03;07;Torstai;26;97;123;2;34;36
89;03.03.2016;2016;03;08;Torstai;26;155;181;18;39;57
89;03.03.2016;2016;03;09;Torstai;23;65;88;13;33;46
89;03.03.2016;2016;03;10;Torstai;33;41;74;24;36;60
89;03.03.2016;2016;03;11;Torstai;40;51;91;32;24;56
89;03.03.2016;2016;03;12;Torstai;33;55;88;26;42;68
89;03.03.2016;2016;03;13;Torstai;47;54;101;45;37;82
89;03.03.2016;2016;03;14;Torstai;84;59;143;43;37;80
89;03.03.2016;2016;03;15;Torstai;91;45;136;53;32;85
89;03.03.2016;2016;03;16;Torstai;134;55;189;49;27;76
89;03.03.2016;2016;03;17;Torstai;75;46;121;40;32;72
89;03.03.2016;2016;03;18;Torstai;53;41;94;28;23;51
89;03.03.2016;2016;03;19;Torstai;46;22;68;27;22;49
89;03.03.2016;2016;03;20;Torstai;36;21;57;11;18;29
89;03.03.2016;2016;03;21;Torstai;29;11;40;8;9;17
89;03.03.2016;2016;03;22;Torstai;13;8;21;10;2;12
89;03.03.2016;2016;03;23;Torstai;9;2;11;6;2;8
89;04.03.2016;2016;03;00;Perjantai;4;1;5;2;0;2
89;04.03.2016;2016;03;01;Perjantai;4;0;4;3;0;3
89;04.03.2016;2016;03;02;Perjantai;2;0;2;2;0;2
89;04.03.2016;2016;03;03;Perjantai;5;1;6;3;0;3
89;04.03.2016;2016;03;04;Perjantai;2;5;7;4;0;4
89;04.03.2016;2016;03;05;Perjantai;3;7;10;2;1;3
89;04.03.2016;2016;03;06;Perjantai;13;35;48;5;5;10
89;04.03.2016;2016;03;07;Perjantai;18;92;110;6;40;46
89;04.03.2016;2016;03;08;Perjantai;22;111;133;18;40;58
89;04.03.2016;2016;03;09;Perjantai;26;56;82;17;41;58
89;04.03.2016;2016;03;10;Perjantai;29;53;82;24;41;65
89;04.03.2016;2016;03;11;Perjantai;28;38;66;24;33;57
89;04.03.2016;2016;03;12;Perjantai;43;37;80;31;31;62
89;04.03.2016;2016;03;13;Perjantai;49;57;106;29;36;65
89;04.03.2016;2016;03;14;Perjantai;80;37;117;36;39;75
89;04.03.2016;2016;03;15;Perjantai;109;38;147;36;29;65
89;04.03.2016;2016;03;16;Perjantai;87;39;126;33;20;53
89;04.03.2016;2016;03;17;Perjantai;51;44;95;25;24;49
89;04.03.2016;2016;03;18;Perjantai;41;23;64;25;19;44
89;04.03.2016;2016;03;19;Perjantai;41;12;53;19;10;29
89;04.03.2016;2016;03;20;Perjantai;23;16;39;13;13;26
89;04.03.2016;2016;03;21;Perjantai;14;15;29;7;13;20
89;04.03.2016;2016;03;22;Perjantai;10;19;29;11;8;19
89;04.03.2016;2016;03;23;Perjantai;8;14;22;6;13;19
89;05.03.2016;2016;03;00;Lauantai;6;10;16;2;4;6
89;05.03.2016;2016;03;01;Lauantai;6;5;11;3;3;6
89;05.03.2016;2016;03;02;Lauantai;8;2;10;14;1;15
89;05.03.2016;2016;03;03;Lauantai;5;2;7;1;0;1
89;05.03.2016;2016;03;04;Lauantai;7;1;8;10;0;10
89;05.03.2016;2016;03;05;Lauantai;3;1;4;0;0;0
89;05.03.2016;2016;03;06;Lauantai;4;11;15;1;2;3
89;05.03.2016;2016;03;07;Lauantai;4;5;9;7;7;14
89;05.03.2016;2016;03;08;Lauantai;6;15;21;9;12;21
89;05.03.2016;2016;03;09;Lauantai;9;27;36;9;30;39
89;05.03.2016;2016;03;10;Lauantai;10;34;44;20;30;50
89;05.03.2016;2016;03;11;Lauantai;14;39;53;26;30;56
89;05.03.2016;2016;03;12;Lauantai;30;38;68;37;45;82
89;05.03.2016;2016;03;13;Lauantai;34;39;73;22;41;63
89;05.03.2016;2016;03;14;Lauantai;36;29;65;33;32;65
89;05.03.2016;2016;03;15;Lauantai;43;22;65;23;17;40
89;05.03.2016;2016;03;16;Lauantai;34;33;67;31;33;64
89;05.03.2016;2016;03;17;Lauantai;33;24;57;35;21;56
89;05.03.2016;2016;03;18;Lauantai;27;10;37;24;11;35
89;05.03.2016;2016;03;19;Lauantai;22;17;39;22;15;37
89;05.03.2016;2016;03;20;Lauantai;13;11;24;12;13;25
89;05.03.2016;2016;03;21;Lauantai;14;20;34;11;15;26
89;05.03.2016;2016;03;22;Lauantai;12;13;25;6;7;13
89;05.03.2016;2016;03;23;Lauantai;10;18;28;3;14;17
89;06.03.2016;2016;03;00;Sunnuntai;3;5;8;8;5;13
89;06.03.2016;2016;03;01;Sunnuntai;9;3;12;5;6;11
89;06.03.2016;2016;03;02;Sunnuntai;7;5;12;5;0;5
89;06.03.2016;2016;03;03;Sunnuntai;9;1;10;5;2;7
89;06.03.2016;2016;03;04;Sunnuntai;8;2;10;14;1;15
89;06.03.2016;2016;03;05;Sunnuntai;4;1;5;0;1;1
89;06.03.2016;2016;03;06;Sunnuntai;2;5;7;2;6;8
89;06.03.2016;2016;03;07;Sunnuntai;2;4;6;6;7;13
89;06.03.2016;2016;03;08;Sunnuntai;2;7;9;10;3;13
89;06.03.2016;2016;03;09;Sunnuntai;7;17;24;17;33;50
89;06.03.2016;2016;03;10;Sunnuntai;8;18;26;40;48;88
89;06.03.2016;2016;03;11;Sunnuntai;17;20;37;40;58;98
89;06.03.2016;2016;03;12;Sunnuntai;21;28;49;39;47;86
89;06.03.2016;2016;03;13;Sunnuntai;35;26;61;37;36;73
89;06.03.2016;2016;03;14;Sunnuntai;21;31;52;55;42;97
89;06.03.2016;2016;03;15;Sunnuntai;23;27;50;36;40;76
89;06.03.2016;2016;03;16;Sunnuntai;23;15;38;34;23;57
89;06.03.2016;2016;03;17;Sunnuntai;19;21;40;31;15;46
89;06.03.2016;2016;03;18;Sunnuntai;20;19;39;28;26;54
89;06.03.2016;2016;03;19;Sunnuntai;15;12;27;17;16;33
89;06.03.2016;2016;03;20;Sunnuntai;23;12;35;19;8;27
89;06.03.2016;2016;03;21;Sunnuntai;7;3;10;15;6;21
89;06.03.2016;2016;03;22;Sunnuntai;7;8;15;4;5;9
89;06.03.2016;2016;03;23;Sunnuntai;4;5;9;1;3;4
89;07.03.2016;2016;03;00;Maanantai;3;2;5;2;0;2
89;07.03.2016;2016;03;01;Maanantai;1;1;2;1;0;1
89;07.03.2016;2016;03;02;Maanantai;3;0;3;0;0;0
89;07.03.2016;2016;03;03;Maanantai;1;0;1;0;1;1
89;07.03.2016;2016;03;04;Maanantai;2;5;7;0;0;0
89;07.03.2016;2016;03;05;Maanantai;2;9;11;1;2;3
89;07.03.2016;2016;03;06;Maanantai;8;24;32;3;9;12
89;07.03.2016;2016;03;07;Maanantai;11;74;85;4;23;27
89;07.03.2016;2016;03;08;Maanantai;7;91;98;5;30;35
89;07.03.2016;2016;03;09;Maanantai;22;70;92;18;29;47
89;07.03.2016;2016;03;10;Maanantai;29;32;61;16;36;52
89;07.03.2016;2016;03;11;Maanantai;39;37;76;29;42;71
89;07.03.2016;2016;03;12;Maanantai;40;38;78;32;48;80
89;07.03.2016;2016;03;13;Maanantai;33;50;83;31;32;63
89;07.03.2016;2016;03;14;Maanantai;46;31;77;38;20;58
89;07.03.2016;2016;03;15;Maanantai;69;34;103;29;20;49
89;07.03.2016;2016;03;16;Maanantai;95;36;131;37;30;67
89;07.03.2016;2016;03;17;Maanantai;60;33;93;39;16;55
89;07.03.2016;2016;03;18;Maanantai;42;33;75;27;19;46
89;07.03.2016;2016;03;19;Maanantai;35;19;54;29;19;48
89;07.03.2016;2016;03;20;Maanantai;25;19;44;22;10;32
89;07.03.2016;2016;03;21;Maanantai;18;16;34;10;10;20
89;07.03.2016;2016;03;22;Maanantai;12;4;16;2;4;6
89;07.03.2016;2016;03;23;Maanantai;5;1;6;3;2;5
89;08.03.2016;2016;03;00;Tiistai;1;1;2;1;1;2
89;08.03.2016;2016;03;01;Tiistai;2;1;3;2;0;2
89;08.03.2016;2016;03;02;Tiistai;2;1;3;1;2;3
89;08.03.2016;2016;03;03;Tiistai;1;1;2;1;0;1
89;08.03.2016;2016;03;04;Tiistai;0;5;5;1;0;1
89;08.03.2016;2016;03;05;Tiistai;4;9;13;1;4;5
89;08.03.2016;2016;03;06;Tiistai;9;22;31;0;11;11
89;08.03.2016;2016;03;07;Tiistai;14;89;103;9;26;35
89;08.03.2016;2016;03;08;Tiistai;13;87;100;9;34;43
89;08.03.2016;2016;03;09;Tiistai;27;49;76;16;43;59
89;08.03.2016;2016;03;10;Tiistai;22;42;64;31;45;76
89;08.03.2016;2016;03;11;Tiistai;28;45;73;16;35;51
89;08.03.2016;2016;03;12;Tiistai;34;52;86;32;43;75
89;08.03.2016;2016;03;13;Tiistai;35;43;78;32;30;62
89;08.03.2016;2016;03;14;Tiistai;47;27;74;44;28;72
89;08.03.2016;2016;03;15;Tiistai;72;31;103;31;26;57
89;08.03.2016;2016;03;16;Tiistai;70;37;107;48;23;71
89;08.03.2016;2016;03;17;Tiistai;47;38;85;39;23;62
89;08.03.2016;2016;03;18;Tiistai;57;31;88;38;33;71
89;08.03.2016;2016;03;19;Tiistai;26;11;37;32;16;48
89;08.03.2016;2016;03;20;Tiistai;15;10;25;20;14;34
89;08.03.2016;2016;03;21;Tiistai;30;4;34;17;5;22
89;08.03.2016;2016;03;22;Tiistai;9;3;12;8;3;11
89;08.03.2016;2016;03;23;Tiistai;6;2;8;3;3;6
89;09.03.2016;2016;03;00;Keskiviikko;2;2;4;2;3;5
89;09.03.2016;2016;03;01;Keskiviikko;0;2;2;1;0;1
89;09.03.2016;2016;03;02;Keskiviikko;1;1;2;0;0;0
89;09.03.2016;2016;03;03;Keskiviikko;1;2;3;2;0;2
89;09.03.2016;2016;03;04;Keskiviikko;2;4;6;0;0;0
89;09.03.2016;2016;03;05;Keskiviikko;1;9;10;0;5;5
89;09.03.2016;2016;03;06;Keskiviikko;7;25;32;2;4;6
89;09.03.2016;2016;03;07;Keskiviikko;17;70;87;13;34;47
89;09.03.2016;2016;03;08;Keskiviikko;10;73;83;7;37;44
89;09.03.2016;2016;03;09;Keskiviikko;10;42;52;11;40;51
89;09.03.2016;2016;03;10;Keskiviikko;26;38;64;29;41;70
89;09.03.2016;2016;03;11;Keskiviikko;25;34;59;31;46;77
89;09.03.2016;2016;03;12;Keskiviikko;45;42;87;41;43;84
89;09.03.2016;2016;03;13;Keskiviikko;40;40;80;19;30;49
89;09.03.2016;2016;03;14;Keskiviikko;42;52;94;29;21;50
89;09.03.2016;2016;03;15;Keskiviikko;67;29;96;36;22;58
89;09.03.2016;2016;03;16;Keskiviikko;72;30;102;50;25;75
89;09.03.2016;2016;03;17;Keskiviikko;51;29;80;29;18;47
89;09.03.2016;2016;03;18;Keskiviikko;36;26;62;30;24;54
89;09.03.2016;2016;03;19;Keskiviikko;38;13;51;26;16;42
89;09.03.2016;2016;03;20;Keskiviikko;14;15;29;17;15;32
89;09.03.2016;2016;03;21;Keskiviikko;13;12;25;13;10;23
89;09.03.2016;2016;03;22;Keskiviikko;7;8;15;5;3;8
89;09.03.2016;2016;03;23;Keskiviikko;8;4;12;4;4;8
89;10.03.2016;2016;03;00;Torstai;2;2;4;2;0;2
89;10.03.2016;2016;03;01;Torstai;1;1;2;0;0;0
89;10.03.2016;2016;03;02;Torstai;3;0;3;2;3;5
89;10.03.2016;2016;03;03;Torstai;2;1;3;2;0;2
89;10.03.2016;2016;03;04;Torstai;4;2;6;5;2;7
89;10.03.2016;2016;03;05;Torstai;2;8;10;0;1;1
89;10.03.2016;2016;03;06;Torstai;10;22;32;2;5;7
89;10.03.2016;2016;03;07;Torstai;11;89;100;8;27;35
89;10.03.2016;2016;03;08;Torstai;15;69;84;8;27;35
89;10.03.2016;2016;03;09;Torstai;16;38;54;14;35;49
89;10.03.2016;2016;03;10;Torstai;27;36;63;23;39;62
89;10.03.2016;2016;03;11;Torstai;20;38;58;29;30;59
89;10.03.2016;2016;03;12;Torstai;28;38;66;30;36;66
89;10.03.2016;2016;03;13;Torstai;47;35;82;28;31;59
89;10.03.2016;2016;03;14;Torstai;45;37;82;36;27;63
89;10.03.2016;2016;03;15;Torstai;66;29;95;29;29;58
89;10.03.2016;2016;03;16;Torstai;86;38;124;36;21;57
89;10.03.2016;2016;03;17;Torstai;43;29;72;24;17;41
89;10.03.2016;2016;03;18;Torstai;42;24;66;37;24;61
89;10.03.2016;2016;03;19;Torstai;36;19;55;26;25;51
89;10.03.2016;2016;03;20;Torstai;25;23;48;14;16;30
89;10.03.2016;2016;03;21;Torstai;24;10;34;12;4;16
89;10.03.2016;2016;03;22;Torstai;14;12;26;7;2;9
89;10.03.2016;2016;03;23;Torstai;8;3;11;2;5;7
89;11.03.2016;2016;03;00;Perjantai;2;3;5;4;3;7
89;11.03.2016;2016;03;01;Perjantai;1;2;3;1;1;2
89;11.03.2016;2016;03;02;Perjantai;2;2;4;0;2;2
89;11.03.2016;2016;03;03;Perjantai;0;0;0;1;0;1
89;11.03.2016;2016;03;04;Perjantai;4;2;6;2;1;3
89;11.03.2016;2016;03;05;Perjantai;4;5;9;2;3;5
89;11.03.2016;2016;03;06;Perjantai;8;32;40;4;8;12
89;11.03.2016;2016;03;07;Perjantai;16;62;78;10;22;32
89;11.03.2016;2016;03;08;Perjantai;9;64;73;7;20;27
89;11.03.2016;2016;03;09;Perjantai;10;41;51;16;32;48
89;11.03.2016;2016;03;10;Perjantai;20;36;56;17;34;51
89;11.03.2016;2016;03;11;Perjantai;29;43;72;25;32;57
89;11.03.2016;2016;03;12;Perjantai;43;49;92;23;36;59
89;11.03.2016;2016;03;13;Perjantai;35;36;71;24;22;46
89;11.03.2016;2016;03;14;Perjantai;46;20;66;32;22;54
89;11.03.2016;2016;03;15;Perjantai;87;34;121;35;22;57
89;11.03.2016;2016;03;16;Perjantai;75;27;102;27;11;38
89;11.03.2016;2016;03;17;Perjantai;37;32;69;26;26;52
89;11.03.2016;2016;03;18;Perjantai;34;19;53;24;12;36
89;11.03.2016;2016;03;19;Perjantai;22;8;30;17;18;35
89;11.03.2016;2016;03;20;Perjantai;24;18;42;22;18;40
89;11.03.2016;2016;03;21;Perjantai;14;12;26;11;10;21
89;11.03.2016;2016;03;22;Perjantai;17;16;33;7;4;11
89;11.03.2016;2016;03;23;Perjantai;9;7;16;12;11;23
89;12.03.2016;2016;03;00;Lauantai;5;9;14;0;2;2
89;12.03.2016;2016;03;01;Lauantai;4;9;13;3;4;7
89;12.03.2016;2016;03;02;Lauantai;2;5;7;6;7;13
89;12.03.2016;2016;03;03;Lauantai;3;4;7;8;0;8
89;12.03.2016;2016;03;04;Lauantai;10;2;12;3;1;4
89;12.03.2016;2016;03;05;Lauantai;1;0;1;1;0;1
89;12.03.2016;2016;03;06;Lauantai;6;10;16;5;4;9
89;12.03.2016;2016;03;07;Lauantai;4;4;8;3;5;8
89;12.03.2016;2016;03;08;Lauantai;2;14;16;15;10;25
89;12.03.2016;2016;03;09;Lauantai;4;31;35;9;23;32
89;12.03.2016;2016;03;10;Lauantai;14;32;46;28;34;62
89;12.03.2016;2016;03;11;Lauantai;18;26;44;42;40;82
89;12.03.2016;2016;03;12;Lauantai;20;34;54;25;49;74
89;12.03.2016;2016;03;13;Lauantai;31;51;82;26;38;64
89;12.03.2016;2016;03;14;Lauantai;33;32;65;43;36;79
89;12.03.2016;2016;03;15;Lauantai;37;25;62;35;35;70
89;12.03.2016;2016;03;16;Lauantai;45;28;73;30;26;56
89;12.03.2016;2016;03;17;Lauantai;33;21;54;25;29;54
89;12.03.2016;2016;03;18;Lauantai;28;19;47;19;9;28
89;12.03.2016;2016;03;19;Lauantai;16;16;32;20;24;44
89;12.03.2016;2016;03;20;Lauantai;16;11;27;16;20;36
89;12.03.2016;2016;03;21;Lauantai;10;15;25;15;6;21
89;12.03.2016;2016;03;22;Lauantai;11;17;28;9;5;14
89;12.03.2016;2016;03;23;Lauantai;9;7;16;7;5;12
89;13.03.2016;2016;03;00;Sunnuntai;5;4;9;1;3;4
89;13.03.2016;2016;03;01;Sunnuntai;8;0;8;6;3;9
89;13.03.2016;2016;03;02;Sunnuntai;3;4;7;4;2;6
89;13.03.2016;2016;03;03;Sunnuntai;13;2;15;2;1;3
89;13.03.2016;2016;03;04;Sunnuntai;10;4;14;7;0;7
89;13.03.2016;2016;03;05;Sunnuntai;1;2;3;3;0;3
89;13.03.2016;2016;03;06;Sunnuntai;0;7;7;1;6;7
89;13.03.2016;2016;03;07;Sunnuntai;4;3;7;7;6;13
89;13.03.2016;2016;03;08;Sunnuntai;0;6;6;17;8;25
89;13.03.2016;2016;03;09;Sunnuntai;15;21;36;21;16;37
89;13.03.2016;2016;03;10;Sunnuntai;10;31;41;33;40;73
89;13.03.2016;2016;03;11;Sunnuntai;16;28;44;45;49;94
89;13.03.2016;2016;03;12;Sunnuntai;33;32;65;39;49;88
89;13.03.2016;2016;03;13;Sunnuntai;23;32;55;53;44;97
89;13.03.2016;2016;03;14;Sunnuntai;22;24;46;37;23;60
89;13.03.2016;2016;03;15;Sunnuntai;30;28;58;26;36;62
89;13.03.2016;2016;03;16;Sunnuntai;15;31;46;36;33;69
89;13.03.2016;2016;03;17;Sunnuntai;27;23;50;34;26;60
89;13.03.2016;2016;03;18;Sunnuntai;20;9;29;33;22;55
89;13.03.2016;2016;03;19;Sunnuntai;13;8;21;30;19;49
89;13.03.2016;2016;03;20;Sunnuntai;20;8;28;16;12;28
89;13.03.2016;2016;03;21;Sunnuntai;3;2;5;10;13;23
89;13.03.2016;2016;03;22;Sunnuntai;4;3;7;4;5;9
89;13.03.2016;2016;03;23;Sunnuntai;4;0;4;2;5;7
89;14.03.2016;2016;03;00;Maanantai;0;0;0;3;1;4
89;14.03.2016;2016;03;01;Maanantai;4;0;4;0;0;0
89;14.03.2016;2016;03;02;Maanantai;1;1;2;1;0;1
89;14.03.2016;2016;03;03;Maanantai;1;2;3;1;0;1
89;14.03.2016;2016;03;04;Maanantai;0;2;2;1;1;2
89;14.03.2016;2016;03;05;Maanantai;4;7;11;5;7;12
89;14.03.2016;2016;03;06;Maanantai;7;37;44;5;8;13
89;14.03.2016;2016;03;07;Maanantai;20;123;143;10;44;54
89;14.03.2016;2016;03;08;Maanantai;36;149;185;21;44;65
89;14.03.2016;2016;03;09;Maanantai;19;75;94;19;35;54
89;14.03.2016;2016;03;10;Maanantai;34;60;94;43;54;97
89;14.03.2016;2016;03;11;Maanantai;42;43;85;34;46;80
89;14.03.2016;2016;03;12;Maanantai;35;50;85;41;55;96
89;14.03.2016;2016;03;13;Maanantai;57;39;96;59;40;99
89;14.03.2016;2016;03;14;Maanantai;56;46;102;58;26;84
89;14.03.2016;2016;03;15;Maanantai;111;42;153;51;17;68
89;14.03.2016;2016;03;16;Maanantai;119;53;172;53;36;89
89;14.03.2016;2016;03;17;Maanantai;67;45;112;33;20;53
89;14.03.2016;2016;03;18;Maanantai;39;29;68;38;27;65
89;14.03.2016;2016;03;19;Maanantai;28;22;50;44;36;80
89;14.03.2016;2016;03;20;Maanantai;31;7;38;26;16;42
89;14.03.2016;2016;03;21;Maanantai;24;12;36;13;12;25
89;14.03.2016;2016;03;22;Maanantai;14;9;23;6;3;9
89;14.03.2016;2016;03;23;Maanantai;3;3;6;4;1;5
89;15.03.2016;2016;03;00;Tiistai;1;0;1;0;1;1
89;15.03.2016;2016;03;01;Tiistai;0;1;1;1;0;1
89;15.03.2016;2016;03;02;Tiistai;0;3;3;0;0;0
89;15.03.2016;2016;03;03;Tiistai;2;0;2;0;1;1
89;15.03.2016;2016;03;04;Tiistai;2;4;6;1;0;1
89;15.03.2016;2016;03;05;Tiistai;1;8;9;4;1;5
89;15.03.2016;2016;03;06;Tiistai;7;34;41;4;13;17
89;15.03.2016;2016;03;07;Tiistai;27;122;149;13;37;50
89;15.03.2016;2016;03;08;Tiistai;20;131;151;18;61;79
89;15.03.2016;2016;03;09;Tiistai;26;78;104;27;35;62
89;15.03.2016;2016;03;10;Tiistai;31;56;87;16;59;75
89;15.03.2016;2016;03;11;Tiistai;45;51;96;50;46;96
89;15.03.2016;2016;03;12;Tiistai;41;44;85;45;28;73
89;15.03.2016;2016;03;13;Tiistai;53;47;100;42;40;82
89;15.03.2016;2016;03;14;Tiistai;70;42;112;49;31;80
89;15.03.2016;2016;03;15;Tiistai;106;47;153;52;31;83
89;15.03.2016;2016;03;16;Tiistai;138;68;206;49;36;85
89;15.03.2016;2016;03;17;Tiistai;82;35;117;36;41;77
89;15.03.2016;2016;03;18;Tiistai;51;39;90;36;29;65
89;15.03.2016;2016;03;19;Tiistai;40;11;51;25;34;59
89;15.03.2016;2016;03;20;Tiistai;37;21;58;15;22;37
89;15.03.2016;2016;03;21;Tiistai;23;6;29;15;6;21
89;15.03.2016;2016;03;22;Tiistai;10;6;16;4;4;8
89;15.03.2016;2016;03;23;Tiistai;5;2;7;4;0;4
89;16.03.2016;2016;03;00;Keskiviikko;3;1;4;2;0;2
89;16.03.2016;2016;03;01;Keskiviikko;1;0;1;1;2;3
89;16.03.2016;2016;03;02;Keskiviikko;0;2;2;0;0;0
89;16.03.2016;2016;03;03;Keskiviikko;0;3;3;0;0;0
89;16.03.2016;2016;03;04;Keskiviikko;2;2;4;0;0;0
89;16.03.2016;2016;03;05;Keskiviikko;4;7;11;2;1;3
89;16.03.2016;2016;03;06;Keskiviikko;13;30;43;3;8;11
89;16.03.2016;2016;03;07;Keskiviikko;26;112;138;3;40;43
89;16.03.2016;2016;03;08;Keskiviikko;42;148;190;22;55;77
89;16.03.2016;2016;03;09;Keskiviikko;31;73;104;21;56;77
89;16.03.2016;2016;03;10;Keskiviikko;35;49;84;27;44;71
89;16.03.2016;2016;03;11;Keskiviikko;27;52;79;29;36;65
89;16.03.2016;2016;03;12;Keskiviikko;47;52;99;37;26;63
89;16.03.2016;2016;03;13;Keskiviikko;63;52;115;31;23;54
89;16.03.2016;2016;03;14;Keskiviikko;78;50;128;44;38;82
89;16.03.2016;2016;03;15;Keskiviikko;110;53;163;38;29;67
89;16.03.2016;2016;03;16;Keskiviikko;135;68;203;58;36;94
89;16.03.2016;2016;03;17;Keskiviikko;76;54;130;30;25;55
89;16.03.2016;2016;03;18;Keskiviikko;43;46;89;35;32;67
89;16.03.2016;2016;03;19;Keskiviikko;50;29;79;31;20;51
89;16.03.2016;2016;03;20;Keskiviikko;32;21;53;22;16;38
89;16.03.2016;2016;03;21;Keskiviikko;34;13;47;11;6;17
89;16.03.2016;2016;03;22;Keskiviikko;12;9;21;9;2;11
89;16.03.2016;2016;03;23;Keskiviikko;4;6;10;1;0;1
89;17.03.2016;2016;03;00;Torstai;8;2;10;1;2;3
89;17.03.2016;2016;03;01;Torstai;0;0;0;1;0;1
89;17.03.2016;2016;03;02;Torstai;2;0;2;1;1;2
89;17.03.2016;2016;03;03;Torstai;1;3;4;0;0;0
89;17.03.2016;2016;03;04;Torstai;6;8;14;2;1;3
89;17.03.2016;2016;03;05;Torstai;7;9;16;11;13;24
89;17.03.2016;2016;03;06;Torstai;12;26;38;1;8;9
89;17.03.2016;2016;03;07;Torstai;25;89;114;15;29;44
89;17.03.2016;2016;03;08;Torstai;30;164;194;15;48;63
89;17.03.2016;2016;03;09;Torstai;36;69;105;19;35;54
89;17.03.2016;2016;03;10;Torstai;29;39;68;20;33;53
89;17.03.2016;2016;03;11;Torstai;37;65;102;17;35;52
89;17.03.2016;2016;03;12;Torstai;50;63;113;27;22;49
89;17.03.2016;2016;03;13;Torstai;50;43;93;27;31;58
89;17.03.2016;2016;03;14;Torstai;67;49;116;38;28;66
89;17.03.2016;2016;03;15;Torstai;94;49;143;27;22;49
89;17.03.2016;2016;03;16;Torstai;97;53;150;33;24;57
89;17.03.2016;2016;03;17;Torstai;73;34;107;33;24;57
89;17.03.2016;2016;03;18;Torstai;63;23;86;24;33;57
89;17.03.2016;2016;03;19;Torstai;64;33;97;23;22;45
89;17.03.2016;2016;03;20;Torstai;29;24;53;14;17;31
89;17.03.2016;2016;03;21;Torstai;36;11;47;15;9;24
89;17.03.2016;2016;03;22;Torstai;20;6;26;1;2;3
89;17.03.2016;2016;03;23;Torstai;8;4;12;2;2;4
89;18.03.2016;2016;03;00;Perjantai;6;2;8;1;3;4
89;18.03.2016;2016;03;01;Perjantai;4;4;8;0;0;0
89;18.03.2016;2016;03;02;Perjantai;5;2;7;3;0;3
89;18.03.2016;2016;03;03;Perjantai;1;0;1;0;1;1
89;18.03.2016;2016;03;04;Perjantai;1;4;5;1;1;2
89;18.03.2016;2016;03;05;Perjantai;3;8;11;2;5;7
89;18.03.2016;2016;03;06;Perjantai;9;30;39;3;3;6
89;18.03.2016;2016;03;07;Perjantai;31;85;116;9;35;44
89;18.03.2016;2016;03;08;Perjantai;22;133;155;5;33;38
89;18.03.2016;2016;03;09;Perjantai;31;65;96;10;36;46
89;18.03.2016;2016;03;10;Perjantai;24;54;78;31;32;63
89;18.03.2016;2016;03;11;Perjantai;34;65;99;34;33;67
89;18.03.2016;2016;03;12;Perjantai;48;61;109;35;45;80
89;18.03.2016;2016;03;13;Perjantai;62;49;111;29;30;59
89;18.03.2016;2016;03;14;Perjantai;62;38;100;42;28;70
89;18.03.2016;2016;03;15;Perjantai;93;57;150;32;24;56
89;18.03.2016;2016;03;16;Perjantai;117;64;181;46;38;84
89;18.03.2016;2016;03;17;Perjantai;68;33;101;32;20;52
89;18.03.2016;2016;03;18;Perjantai;44;41;85;25;19;44
89;18.03.2016;2016;03;19;Perjantai;33;29;62;23;21;44
89;18.03.2016;2016;03;20;Perjantai;23;15;38;8;14;22
89;18.03.2016;2016;03;21;Perjantai;38;13;51;9;5;14
89;18.03.2016;2016;03;22;Perjantai;17;12;29;11;8;19
89;18.03.2016;2016;03;23;Perjantai;10;6;16;3;6;9
89;19.03.2016;2016;03;00;Lauantai;5;13;18;3;12;15
89;19.03.2016;2016;03;01;Lauantai;11;3;14;6;1;7
89;19.03.2016;2016;03;02;Lauantai;8;1;9;4;2;6
89;19.03.2016;2016;03;03;Lauantai;4;3;7;6;0;6
89;19.03.2016;2016;03;04;Lauantai;8;0;8;10;1;11
89;19.03.2016;2016;03;05;Lauantai;2;3;5;2;0;2
89;19.03.2016;2016;03;06;Lauantai;5;9;14;1;4;5
89;19.03.2016;2016;03;07;Lauantai;3;11;14;3;5;8
89;19.03.2016;2016;03;08;Lauantai;5;17;22;11;16;27
89;19.03.2016;2016;03;09;Lauantai;12;33;45;21;32;53
89;19.03.2016;2016;03;10;Lauantai;16;31;47;17;37;54
89;19.03.2016;2016;03;11;Lauantai;21;45;66;33;46;79
89;19.03.2016;2016;03;12;Lauantai;30;48;78;39;54;93
89;19.03.2016;2016;03;13;Lauantai;43;39;82;49;41;90
89;19.03.2016;2016;03;14;Lauantai;30;35;65;53;43;96
89;19.03.2016;2016;03;15;Lauantai;51;34;85;48;37;85
89;19.03.2016;2016;03;16;Lauantai;43;53;96;47;30;77
89;19.03.2016;2016;03;17;Lauantai;32;25;57;34;32;66
89;19.03.2016;2016;03;18;Lauantai;30;35;65;23;15;38
89;19.03.2016;2016;03;19;Lauantai;27;16;43;11;16;27
89;19.03.2016;2016;03;20;Lauantai;28;19;47;14;11;25
89;19.03.2016;2016;03;21;Lauantai;11;9;20;17;7;24
89;19.03.2016;2016;03;22;Lauantai;15;11;26;5;5;10
89;19.03.2016;2016;03;23;Lauantai;17;19;36;5;2;7
89;20.03.2016;2016;03;00;Sunnuntai;12;11;23;2;9;11
89;20.03.2016;2016;03;01;Sunnuntai;11;2;13;5;0;5
89;20.03.2016;2016;03;02;Sunnuntai;6;9;15;0;2;2
89;20.03.2016;2016;03;03;Sunnuntai;11;3;14;6;4;10
89;20.03.2016;2016;03;04;Sunnuntai;5;0;5;3;1;4
89;20.03.2016;2016;03;05;Sunnuntai;2;0;2;1;2;3
89;20.03.2016;2016;03;06;Sunnuntai;3;4;7;1;2;3
89;20.03.2016;2016;03;07;Sunnuntai;1;4;5;3;4;7
89;20.03.2016;2016;03;08;Sunnuntai;5;8;13;9;12;21
89;20.03.2016;2016;03;09;Sunnuntai;10;22;32;19;25;44
89;20.03.2016;2016;03;10;Sunnuntai;11;18;29;32;42;74
89;20.03.2016;2016;03;11;Sunnuntai;24;26;50;33;43;76
89;20.03.2016;2016;03;12;Sunnuntai;26;27;53;72;63;135
89;20.03.2016;2016;03;13;Sunnuntai;32;33;65;64;77;141
89;20.03.2016;2016;03;14;Sunnuntai;37;44;81;69;64;133
89;20.03.2016;2016;03;15;Sunnuntai;39;43;82;48;52;100
89;20.03.2016;2016;03;16;Sunnuntai;39;34;73;48;41;89
89;20.03.2016;2016;03;17;Sunnuntai;32;30;62;35;38;73
89;20.03.2016;2016;03;18;Sunnuntai;21;31;52;27;28;55
89;20.03.2016;2016;03;19;Sunnuntai;23;19;42;15;14;29
89;20.03.2016;2016;03;20;Sunnuntai;24;9;33;17;10;27
89;20.03.2016;2016;03;21;Sunnuntai;9;8;17;12;8;20
89;20.03.2016;2016;03;22;Sunnuntai;15;5;20;5;1;6
89;20.03.2016;2016;03;23;Sunnuntai;5;5;10;1;1;2
89;21.03.2016;2016;03;00;Maanantai;1;2;3;0;0;0
89;21.03.2016;2016;03;01;Maanantai;0;0;0;1;2;3
89;21.03.2016;2016;03;02;Maanantai;1;1;2;0;0;0
89;21.03.2016;2016;03;03;Maanantai;1;1;2;0;0;0
89;21.03.2016;2016;03;04;Maanantai;0;4;4;0;0;0
89;21.03.2016;2016;03;05;Maanantai;2;15;17;2;0;2
89;21.03.2016;2016;03;06;Maanantai;12;35;47;5;8;13
89;21.03.2016;2016;03;07;Maanantai;21;135;156;8;31;39
89;21.03.2016;2016;03;08;Maanantai;26;151;177;15;44;59
89;21.03.2016;2016;03;09;Maanantai;25;74;99;14;56;70
89;21.03.2016;2016;03;10;Maanantai;27;48;75;30;31;61
89;21.03.2016;2016;03;11;Maanantai;40;31;71;37;51;88
89;21.03.2016;2016;03;12;Maanantai;45;51;96;37;47;84
89;21.03.2016;2016;03;13;Maanantai;48;54;102;37;32;69
89;21.03.2016;2016;03;14;Maanantai;68;73;141;37;35;72
89;21.03.2016;2016;03;15;Maanantai;90;50;140;38;27;65
89;21.03.2016;2016;03;16;Maanantai;123;59;182;67;37;104
89;21.03.2016;2016;03;17;Maanantai;86;46;132;29;26;55
89;21.03.2016;2016;03;18;Maanantai;47;33;80;42;41;83
89;21.03.2016;2016;03;19;Maanantai;46;25;71;22;23;45
89;21.03.2016;2016;03;20;Maanantai;35;11;46;17;12;29
89;21.03.2016;2016;03;21;Maanantai;26;13;39;12;13;25
89;21.03.2016;2016;03;22;Maanantai;14;8;22;4;2;6
89;21.03.2016;2016;03;23;Maanantai;13;4;17;0;2;2
89;22.03.2016;2016;03;00;Tiistai;3;0;3;0;1;1
89;22.03.2016;2016;03;01;Tiistai;0;1;1;0;2;2
89;22.03.2016;2016;03;02;Tiistai;1;1;2;1;0;1
89;22.03.2016;2016;03;03;Tiistai;1;4;5;1;0;1
89;22.03.2016;2016;03;04;Tiistai;2;7;9;1;0;1
89;22.03.2016;2016;03;05;Tiistai;3;7;10;1;0;1
89;22.03.2016;2016;03;06;Tiistai;11;33;44;6;11;17
89;22.03.2016;2016;03;07;Tiistai;20;120;140;7;33;40
89;22.03.2016;2016;03;08;Tiistai;22;146;168;16;45;61
89;22.03.2016;2016;03;09;Tiistai;32;65;97;16;34;50
89;22.03.2016;2016;03;10;Tiistai;28;55;83;29;44;73
89;22.03.2016;2016;03;11;Tiistai;43;38;81;27;30;57
89;22.03.2016;2016;03;12;Tiistai;32;60;92;41;42;83
89;22.03.2016;2016;03;13;Tiistai;33;45;78;36;28;64
89;22.03.2016;2016;03;14;Tiistai;73;47;120;39;31;70
89;22.03.2016;2016;03;15;Tiistai;106;57;163;52;32;84
89;22.03.2016;2016;03;16;Tiistai;127;77;204;48;31;79
89;22.03.2016;2016;03;17;Tiistai;71;45;116;44;29;73
89;22.03.2016;2016;03;18;Tiistai;45;35;80;40;30;70
89;22.03.2016;2016;03;19;Tiistai;43;14;57;35;19;54
89;22.03.2016;2016;03;20;Tiistai;33;18;51;18;23;41
89;22.03.2016;2016;03;21;Tiistai;32;12;44;15;4;19
89;22.03.2016;2016;03;22;Tiistai;12;6;18;5;0;5
89;22.03.2016;2016;03;23;Tiistai;13;3;16;1;1;2
89;23.03.2016;2016;03;00;Keskiviikko;3;5;8;2;0;2
89;23.03.2016;2016;03;01;Keskiviikko;3;2;5;0;1;1
89;23.03.2016;2016;03;02;Keskiviikko;1;0;1;0;2;2
89;23.03.2016;2016;03;03;Keskiviikko;2;2;4;0;1;1
89;23.03.2016;2016;03;04;Keskiviikko;2;6;8;1;3;4
89;23.03.2016;2016;03;05;Keskiviikko;3;9;12;1;0;1
89;23.03.2016;2016;03;06;Keskiviikko;13;42;55;6;7;13
89;23.03.2016;2016;03;07;Keskiviikko;21;118;139;6;33;39
89;23.03.2016;2016;03;08;Keskiviikko;27;162;189;13;36;49
89;23.03.2016;2016;03;09;Keskiviikko;25;58;83;12;26;38
89;23.03.2016;2016;03;10;Keskiviikko;27;35;62;24;29;53
89;23.03.2016;2016;03;11;Keskiviikko;31;50;81;19;39;58
89;23.03.2016;2016;03;12;Keskiviikko;26;37;63;17;32;49
89;23.03.2016;2016;03;13;Keskiviikko;49;42;91;27;18;45
89;23.03.2016;2016;03;14;Keskiviikko;59;38;97;37;18;55
89;23.03.2016;2016;03;15;Keskiviikko;87;47;134;30;26;56
89;23.03.2016;2016;03;16;Keskiviikko;126;48;174;37;24;61
89;23.03.2016;2016;03;17;Keskiviikko;59;42;101;25;19;44
89;23.03.2016;2016;03;18;Keskiviikko;57;32;89;33;26;59
89;23.03.2016;2016;03;19;Keskiviikko;41;18;59;22;18;40
89;23.03.2016;2016;03;20;Keskiviikko;52;11;63;21;11;32
89;23.03.2016;2016;03;21;Keskiviikko;22;15;37;14;5;19
89;23.03.2016;2016;03;22;Keskiviikko;10;7;17;8;4;12
89;23.03.2016;2016;03;23;Keskiviikko;8;11;19;3;3;6
89;24.03.2016;2016;03;00;Torstai;8;3;11;3;1;4
89;24.03.2016;2016;03;01;Torstai;3;0;3;0;0;0
89;24.03.2016;2016;03;02;Torstai;4;1;5;1;1;2
89;24.03.2016;2016;03;03;Torstai;1;1;2;0;1;1
89;24.03.2016;2016;03;04;Torstai;0;4;4;2;1;3
89;24.03.2016;2016;03;05;Torstai;1;6;7;1;1;2
89;24.03.2016;2016;03;06;Torstai;10;23;33;9;8;17
89;24.03.2016;2016;03;07;Torstai;15;114;129;5;34;39
89;24.03.2016;2016;03;08;Torstai;19;129;148;22;42;64
89;24.03.2016;2016;03;09;Torstai;29;61;90;21;39;60
89;24.03.2016;2016;03;10;Torstai;21;45;66;29;27;56
89;24.03.2016;2016;03;11;Torstai;35;49;84;29;34;63
89;24.03.2016;2016;03;12;Torstai;50;43;93;13;16;29
89;24.03.2016;2016;03;13;Torstai;54;36;90;23;31;54
89;24.03.2016;2016;03;14;Torstai;60;30;90;27;17;44
89;24.03.2016;2016;03;15;Torstai;96;33;129;34;18;52
89;24.03.2016;2016;03;16;Torstai;68;45;113;34;14;48
89;24.03.2016;2016;03;17;Torstai;38;20;58;22;11;33
89;24.03.2016;2016;03;18;Torstai;30;9;39;23;21;44
89;24.03.2016;2016;03;19;Torstai;22;18;40;15;7;22
89;24.03.2016;2016;03;20;Torstai;14;15;29;8;11;19
89;24.03.2016;2016;03;21;Torstai;12;9;21;9;9;18
89;24.03.2016;2016;03;22;Torstai;11;9;20;4;1;5
89;24.03.2016;2016;03;23;Torstai;4;3;7;1;2;3
89;25.03.2016;2016;03;00;Perjantai;2;7;9;6;0;6
89;25.03.2016;2016;03;01;Perjantai;0;2;2;3;1;4
89;25.03.2016;2016;03;02;Perjantai;2;3;5;2;0;2
89;25.03.2016;2016;03;03;Perjantai;10;0;10;6;0;6
89;25.03.2016;2016;03;04;Perjantai;4;0;4;0;0;0
89;25.03.2016;2016;03;05;Perjantai;0;2;2;4;3;7
89;25.03.2016;2016;03;06;Perjantai;0;4;4;0;1;1
89;25.03.2016;2016;03;07;Perjantai;2;4;6;6;4;10
89;25.03.2016;2016;03;08;Perjantai;2;5;7;8;12;20
89;25.03.2016;2016;03;09;Perjantai;3;8;11;12;12;24
89;25.03.2016;2016;03;10;Perjantai;3;13;16;23;20;43
89;25.03.2016;2016;03;11;Perjantai;8;8;16;43;21;64
89;25.03.2016;2016;03;12;Perjantai;12;27;39;28;28;56
89;25.03.2016;2016;03;13;Perjantai;12;11;23;25;30;55
89;25.03.2016;2016;03;14;Perjantai;15;22;37;27;27;54
89;25.03.2016;2016;03;15;Perjantai;18;12;30;27;9;36
89;25.03.2016;2016;03;16;Perjantai;32;10;42;30;31;61
89;25.03.2016;2016;03;17;Perjantai;19;15;34;25;20;45
89;25.03.2016;2016;03;18;Perjantai;7;13;20;19;28;47
89;25.03.2016;2016;03;19;Perjantai;16;14;30;24;29;53
89;25.03.2016;2016;03;20;Perjantai;16;23;39;15;12;27
89;25.03.2016;2016;03;21;Perjantai;10;12;22;8;3;11
89;25.03.2016;2016;03;22;Perjantai;7;21;28;10;16;26
89;25.03.2016;2016;03;23;Perjantai;7;8;15;2;4;6
89;26.03.2016;2016;03;00;Lauantai;3;6;9;3;4;7
89;26.03.2016;2016;03;01;Lauantai;4;16;20;10;4;14
89;26.03.2016;2016;03;02;Lauantai;4;2;6;2;3;5
89;26.03.2016;2016;03;03;Lauantai;5;2;7;7;2;9
89;26.03.2016;2016;03;04;Lauantai;7;1;8;3;1;4
89;26.03.2016;2016;03;05;Lauantai;1;2;3;0;1;1
89;26.03.2016;2016;03;06;Lauantai;4;7;11;0;1;1
89;26.03.2016;2016;03;07;Lauantai;3;9;12;8;4;12
89;26.03.2016;2016;03;08;Lauantai;1;10;11;6;11;17
89;26.03.2016;2016;03;09;Lauantai;13;27;40;9;33;42
89;26.03.2016;2016;03;10;Lauantai;15;23;38;28;22;50
89;26.03.2016;2016;03;11;Lauantai;14;23;37;26;42;68
89;26.03.2016;2016;03;12;Lauantai;24;29;53;36;29;65
89;26.03.2016;2016;03;13;Lauantai;23;29;52;35;42;77
89;26.03.2016;2016;03;14;Lauantai;27;24;51;33;34;67
89;26.03.2016;2016;03;15;Lauantai;33;19;52;40;27;67
89;26.03.2016;2016;03;16;Lauantai;25;47;72;29;24;53
89;26.03.2016;2016;03;17;Lauantai;16;30;46;18;33;51
89;26.03.2016;2016;03;18;Lauantai;21;12;33;25;36;61
89;26.03.2016;2016;03;19;Lauantai;21;16;37;25;14;39
89;26.03.2016;2016;03;20;Lauantai;20;13;33;22;9;31
89;26.03.2016;2016;03;21;Lauantai;9;11;20;15;2;17
89;26.03.2016;2016;03;22;Lauantai;12;10;22;1;6;7
89;26.03.2016;2016;03;23;Lauantai;8;10;18;2;6;8
89;27.03.2016;2016;03;00;Sunnuntai;5;7;12;7;2;9
89;27.03.2016;2016;03;01;Sunnuntai;6;3;9;5;4;9
89;27.03.2016;2016;03;02;Sunnuntai;0;0;0;0;0;0
89;27.03.2016;2016;03;03;Sunnuntai;12;3;15;5;0;5
89;27.03.2016;2016;03;04;Sunnuntai;14;2;16;10;1;11
89;27.03.2016;2016;03;05;Sunnuntai;2;0;2;0;0;0
89;27.03.2016;2016;03;06;Sunnuntai;2;7;9;0;1;1
89;27.03.2016;2016;03;07;Sunnuntai;3;5;8;1;3;4
89;27.03.2016;2016;03;08;Sunnuntai;1;8;9;8;7;15
89;27.03.2016;2016;03;09;Sunnuntai;6;8;14;12;4;16
89;27.03.2016;2016;03;10;Sunnuntai;11;17;28;19;20;39
89;27.03.2016;2016;03;11;Sunnuntai;2;21;23;32;34;66
89;27.03.2016;2016;03;12;Sunnuntai;19;21;40;37;47;84
89;27.03.2016;2016;03;13;Sunnuntai;35;25;60;59;37;96
89;27.03.2016;2016;03;14;Sunnuntai;24;29;53;51;48;99
89;27.03.2016;2016;03;15;Sunnuntai;37;20;57;67;43;110
89;27.03.2016;2016;03;16;Sunnuntai;40;17;57;40;37;77
89;27.03.2016;2016;03;17;Sunnuntai;14;40;54;35;33;68
89;27.03.2016;2016;03;18;Sunnuntai;25;15;40;25;21;46
89;27.03.2016;2016;03;19;Sunnuntai;32;28;60;34;33;67
89;27.03.2016;2016;03;20;Sunnuntai;26;25;51;23;22;45
89;27.03.2016;2016;03;21;Sunnuntai;14;9;23;16;11;27
89;27.03.2016;2016;03;22;Sunnuntai;10;6;16;9;14;23
89;27.03.2016;2016;03;23;Sunnuntai;7;3;10;13;3;16
89;28.03.2016;2016;03;00;Maanantai;4;6;10;0;1;1
89;28.03.2016;2016;03;01;Maanantai;12;2;14;0;0;0
89;28.03.2016;2016;03;02;Maanantai;7;1;8;2;1;3
89;28.03.2016;2016;03;03;Maanantai;9;1;10;0;2;2
89;28.03.2016;2016;03;04;Maanantai;3;0;3;3;0;3
89;28.03.2016;2016;03;05;Maanantai;0;0;0;0;0;0
89;28.03.2016;2016;03;06;Maanantai;0;8;8;0;2;2
89;28.03.2016;2016;03;07;Maanantai;2;10;12;5;4;9
89;28.03.2016;2016;03;08;Maanantai;5;6;11;10;9;19
89;28.03.2016;2016;03;09;Maanantai;4;24;28;18;17;35
89;28.03.2016;2016;03;10;Maanantai;6;24;30;36;23;59
89;28.03.2016;2016;03;11;Maanantai;20;35;55;46;37;83
89;28.03.2016;2016;03;12;Maanantai;18;30;48;47;47;94
89;28.03.2016;2016;03;13;Maanantai;30;44;74;40;34;74
89;28.03.2016;2016;03;14;Maanantai;49;46;95;52;63;115
89;28.03.2016;2016;03;15;Maanantai;57;50;107;70;48;118
89;28.03.2016;2016;03;16;Maanantai;57;46;103;55;61;116
89;28.03.2016;2016;03;17;Maanantai;26;43;69;66;52;118
89;28.03.2016;2016;03;18;Maanantai;42;19;61;59;41;100
89;28.03.2016;2016;03;19;Maanantai;39;21;60;27;32;59
89;28.03.2016;2016;03;20;Maanantai;37;30;67;22;27;49
89;28.03.2016;2016;03;21;Maanantai;14;14;28;10;8;18
89;28.03.2016;2016;03;22;Maanantai;12;9;21;6;3;9
89;28.03.2016;2016;03;23;Maanantai;7;4;11;2;4;6
89;29.03.2016;2016;03;00;Tiistai;2;0;2;2;1;3
89;29.03.2016;2016;03;01;Tiistai;0;1;1;1;0;1
89;29.03.2016;2016;03;02;Tiistai;0;0;0;1;1;2
89;29.03.2016;2016;03;03;Tiistai;2;1;3;1;0;1
89;29.03.2016;2016;03;04;Tiistai;3;4;7;0;0;0
89;29.03.2016;2016;03;05;Tiistai;2;10;12;3;0;3
89;29.03.2016;2016;03;06;Tiistai;12;24;36;1;3;4
89;29.03.2016;2016;03;07;Tiistai;19;118;137;8;23;31
89;29.03.2016;2016;03;08;Tiistai;37;166;203;14;35;49
89;29.03.2016;2016;03;09;Tiistai;30;92;122;14;37;51
89;29.03.2016;2016;03;10;Tiistai;43;55;98;25;40;65
89;29.03.2016;2016;03;11;Tiistai;43;56;99;28;45;73
89;29.03.2016;2016;03;12;Tiistai;59;63;122;42;32;74
89;29.03.2016;2016;03;13;Tiistai;59;71;130;48;34;82
89;29.03.2016;2016;03;14;Tiistai;78;63;141;56;52;108
89;29.03.2016;2016;03;15;Tiistai;122;68;190;48;44;92
89;29.03.2016;2016;03;16;Tiistai;148;80;228;68;60;128
89;29.03.2016;2016;03;17;Tiistai;82;82;164;46;34;80
89;29.03.2016;2016;03;18;Tiistai;77;55;132;54;55;109
89;29.03.2016;2016;03;19;Tiistai;89;32;121;56;31;87
89;29.03.2016;2016;03;20;Tiistai;61;35;96;29;22;51
89;29.03.2016;2016;03;21;Tiistai;41;20;61;13;18;31
89;29.03.2016;2016;03;22;Tiistai;7;3;10;7;4;11
89;29.03.2016;2016;03;23;Tiistai;12;3;15;1;1;2
89;30.03.2016;2016;03;00;Keskiviikko;0;2;2;2;1;3
89;30.03.2016;2016;03;01;Keskiviikko;2;1;3;0;0;0
89;30.03.2016;2016;03;02;Keskiviikko;4;1;5;3;0;3
89;30.03.2016;2016;03;03;Keskiviikko;0;1;1;0;0;0
89;30.03.2016;2016;03;04;Keskiviikko;6;6;12;0;1;1
89;30.03.2016;2016;03;05;Keskiviikko;5;8;13;2;1;3
89;30.03.2016;2016;03;06;Keskiviikko;10;41;51;5;4;9
89;30.03.2016;2016;03;07;Keskiviikko;19;123;142;6;29;35
89;30.03.2016;2016;03;08;Keskiviikko;36;164;200;15;44;59
89;30.03.2016;2016;03;09;Keskiviikko;30;77;107;9;25;34
89;30.03.2016;2016;03;10;Keskiviikko;38;60;98;20;32;52
89;30.03.2016;2016;03;11;Keskiviikko;37;65;102;17;24;41
89;30.03.2016;2016;03;12;Keskiviikko;33;49;82;49;34;83
89;30.03.2016;2016;03;13;Keskiviikko;67;54;121;21;14;35
89;30.03.2016;2016;03;14;Keskiviikko;93;59;152;37;25;62
89;30.03.2016;2016;03;15;Keskiviikko;105;50;155;40;37;77
89;30.03.2016;2016;03;16;Keskiviikko;136;72;208;58;39;97
89;30.03.2016;2016;03;17;Keskiviikko;99;63;162;43;26;69
89;30.03.2016;2016;03;18;Keskiviikko;62;48;110;39;42;81
89;30.03.2016;2016;03;19;Keskiviikko;76;23;99;42;27;69
89;30.03.2016;2016;03;20;Keskiviikko;47;20;67;22;17;39
89;30.03.2016;2016;03;21;Keskiviikko;24;13;37;10;9;19
89;30.03.2016;2016;03;22;Keskiviikko;14;14;28;4;7;11
89;30.03.2016;2016;03;23;Keskiviikko;15;3;18;2;1;3
89;31.03.2016;2016;03;00;Torstai;5;0;5;0;0;0
89;31.03.2016;2016;03;01;Torstai;2;2;4;1;1;2
89;31.03.2016;2016;03;02;Torstai;5;1;6;1;0;1
89;31.03.2016;2016;03;03;Torstai;1;4;5;1;0;1
89;31.03.2016;2016;03;04;Torstai;5;7;12;0;1;1
89;31.03.2016;2016;03;05;Torstai;4;9;13;1;0;1
89;31.03.2016;2016;03;06;Torstai;7;33;40;1;8;9
89;31.03.2016;2016;03;07;Torstai;23;122;145;7;20;27
89;31.03.2016;2016;03;08;Torstai;38;164;202;20;48;68
89;31.03.2016;2016;03;09;Torstai;34;72;106;13;25;38
89;31.03.2016;2016;03;10;Torstai;30;64;94;12;22;34
89;31.03.2016;2016;03;11;Torstai;53;56;109;28;30;58
89;31.03.2016;2016;03;12;Torstai;53;50;103;17;26;43
89;31.03.2016;2016;03;13;Torstai;62;47;109;46;33;79
89;31.03.2016;2016;03;14;Torstai;73;55;128;38;24;62
89;31.03.2016;2016;03;15;Torstai;121;62;183;25;33;58
89;31.03.2016;2016;03;16;Torstai;153;70;223;44;47;91
89;31.03.2016;2016;03;17;Torstai;78;49;127;48;26;74
89;31.03.2016;2016;03;18;Torstai;59;41;100;38;24;62
89;31.03.2016;2016;03;19;Torstai;60;32;92;35;34;69
89;31.03.2016;2016;03;20;Torstai;44;41;85;29;27;56
89;31.03.2016;2016;03;21;Torstai;41;12;53;14;15;29
89;31.03.2016;2016;03;22;Torstai;16;17;33;5;5;10
89;31.03.2016;2016;03;23;Torstai;15;1;16;2;2;4
89;01.04.2016;2016;04;00;Perjantai;9;5;14;2;1;3
89;01.04.2016;2016;04;01;Perjantai;6;4;10;0;1;1
89;01.04.2016;2016;04;02;Perjantai;5;3;8;2;0;2
89;01.04.2016;2016;04;03;Perjantai;7;3;10;0;0;0
89;01.04.2016;2016;04;04;Perjantai;0;5;5;0;2;2
89;01.04.2016;2016;04;05;Perjantai;7;8;15;0;0;0
89;01.04.2016;2016;04;06;Perjantai;8;37;45;3;5;8
89;01.04.2016;2016;04;07;Perjantai;22;109;131;9;18;27
89;01.04.2016;2016;04;08;Perjantai;32;138;170;14;36;50
89;01.04.2016;2016;04;09;Perjantai;29;81;110;18;42;60
89;01.04.2016;2016;04;10;Perjantai;29;59;88;18;26;44
89;01.04.2016;2016;04;11;Perjantai;48;74;122;28;34;62
89;01.04.2016;2016;04;12;Perjantai;62;64;126;34;34;68
89;01.04.2016;2016;04;13;Perjantai;68;57;125;27;35;62
89;01.04.2016;2016;04;14;Perjantai;112;62;174;31;33;64
89;01.04.2016;2016;04;15;Perjantai;110;69;179;37;33;70
89;01.04.2016;2016;04;16;Perjantai;111;71;182;51;34;85
89;01.04.2016;2016;04;17;Perjantai;58;61;119;48;34;82
89;01.04.2016;2016;04;18;Perjantai;69;61;130;36;47;83
89;01.04.2016;2016;04;19;Perjantai;53;45;98;36;29;65
89;01.04.2016;2016;04;20;Perjantai;65;21;86;23;13;36
89;01.04.2016;2016;04;21;Perjantai;64;29;93;18;17;35
89;01.04.2016;2016;04;22;Perjantai;28;17;45;2;12;14
89;01.04.2016;2016;04;23;Perjantai;18;14;32;8;12;20
89;02.04.2016;2016;04;00;Lauantai;12;20;32;6;4;10
89;02.04.2016;2016;04;01;Lauantai;10;15;25;2;6;8
89;02.04.2016;2016;04;02;Lauantai;13;1;14;2;3;5
89;02.04.2016;2016;04;03;Lauantai;12;2;14;4;1;5
89;02.04.2016;2016;04;04;Lauantai;9;0;9;4;3;7
89;02.04.2016;2016;04;05;Lauantai;5;4;9;1;2;3
89;02.04.2016;2016;04;06;Lauantai;2;8;10;1;0;1
89;02.04.2016;2016;04;07;Lauantai;5;11;16;6;6;12
89;02.04.2016;2016;04;08;Lauantai;3;30;33;12;9;21
89;02.04.2016;2016;04;09;Lauantai;14;50;64;20;27;47
89;02.04.2016;2016;04;10;Lauantai;18;37;55;24;26;50
89;02.04.2016;2016;04;11;Lauantai;36;47;83;21;35;56
89;02.04.2016;2016;04;12;Lauantai;45;81;126;40;55;95
89;02.04.2016;2016;04;13;Lauantai;70;74;144;25;44;69
89;02.04.2016;2016;04;14;Lauantai;64;34;98;42;48;90
89;02.04.2016;2016;04;15;Lauantai;56;39;95;36;27;63
89;02.04.2016;2016;04;16;Lauantai;70;41;111;39;35;74
89;02.04.2016;2016;04;17;Lauantai;54;42;96;20;32;52
89;02.04.2016;2016;04;18;Lauantai;44;34;78;26;28;54
89;02.04.2016;2016;04;19;Lauantai;32;27;59;20;27;47
89;02.04.2016;2016;04;20;Lauantai;27;34;61;26;24;50
89;02.04.2016;2016;04;21;Lauantai;30;20;50;16;5;21
89;02.04.2016;2016;04;22;Lauantai;24;16;40;5;7;12
89;02.04.2016;2016;04;23;Lauantai;23;19;42;5;6;11
89;03.04.2016;2016;04;00;Sunnuntai;14;28;42;4;10;14
89;03.04.2016;2016;04;01;Sunnuntai;9;10;19;6;2;8
89;03.04.2016;2016;04;02;Sunnuntai;11;10;21;4;1;5
89;03.04.2016;2016;04;03;Sunnuntai;7;5;12;10;1;11
89;03.04.2016;2016;04;04;Sunnuntai;15;2;17;11;0;11
89;03.04.2016;2016;04;05;Sunnuntai;5;2;7;3;2;5
89;03.04.2016;2016;04;06;Sunnuntai;4;6;10;1;1;2
89;03.04.2016;2016;04;07;Sunnuntai;3;5;8;4;6;10
89;03.04.2016;2016;04;08;Sunnuntai;3;11;14;11;10;21
89;03.04.2016;2016;04;09;Sunnuntai;7;12;19;27;31;58
89;03.04.2016;2016;04;10;Sunnuntai;24;48;72;50;42;92
89;03.04.2016;2016;04;11;Sunnuntai;22;53;75;50;58;108
89;03.04.2016;2016;04;12;Sunnuntai;60;48;108;73;60;133
89;03.04.2016;2016;04;13;Sunnuntai;65;57;122;59;62;121
89;03.04.2016;2016;04;14;Sunnuntai;73;91;164;48;57;105
89;03.04.2016;2016;04;15;Sunnuntai;62;54;116;67;48;115
89;03.04.2016;2016;04;16;Sunnuntai;62;45;107;47;37;84
89;03.04.2016;2016;04;17;Sunnuntai;75;56;131;58;46;104
89;03.04.2016;2016;04;18;Sunnuntai;38;42;80;62;50;112
89;03.04.2016;2016;04;19;Sunnuntai;62;37;99;55;38;93
89;03.04.2016;2016;04;20;Sunnuntai;44;25;69;30;30;60
89;03.04.2016;2016;04;21;Sunnuntai;20;9;29;11;6;17
89;03.04.2016;2016;04;22;Sunnuntai;15;10;25;0;3;3
89;03.04.2016;2016;04;23;Sunnuntai;5;4;9;7;1;8
89;04.04.2016;2016;04;00;Maanantai;2;2;4;0;0;0
89;04.04.2016;2016;04;01;Maanantai;4;4;8;0;1;1
89;04.04.2016;2016;04;02;Maanantai;3;4;7;1;0;1
89;04.04.2016;2016;04;03;Maanantai;1;4;5;0;0;0
89;04.04.2016;2016;04;04;Maanantai;3;3;6;0;0;0
89;04.04.2016;2016;04;05;Maanantai;1;8;9;3;3;6
89;04.04.2016;2016;04;06;Maanantai;11;32;43;3;9;12
89;04.04.2016;2016;04;07;Maanantai;29;147;176;14;30;44
89;04.04.2016;2016;04;08;Maanantai;40;192;232;23;42;65
89;04.04.2016;2016;04;09;Maanantai;50;110;160;13;40;53
89;04.04.2016;2016;04;10;Maanantai;49;49;98;31;29;60
89;04.04.2016;2016;04;11;Maanantai;47;61;108;31;34;65
89;04.04.2016;2016;04;12;Maanantai;61;70;131;31;29;60
89;04.04.2016;2016;04;13;Maanantai;77;59;136;32;39;71
89;04.04.2016;2016;04;14;Maanantai;96;78;174;40;33;73
89;04.04.2016;2016;04;15;Maanantai;173;81;254;44;27;71
89;04.04.2016;2016;04;16;Maanantai;181;119;300;49;38;87
89;04.04.2016;2016;04;17;Maanantai;105;61;166;45;36;81
89;04.04.2016;2016;04;18;Maanantai;77;67;144;53;49;102
89;04.04.2016;2016;04;19;Maanantai;77;42;119;57;52;109
89;04.04.2016;2016;04;20;Maanantai;57;40;97;36;33;69
89;04.04.2016;2016;04;21;Maanantai;51;21;72;17;18;35
89;04.04.2016;2016;04;22;Maanantai;14;11;25;3;4;7
89;04.04.2016;2016;04;23;Maanantai;5;6;11;6;1;7
89;05.04.2016;2016;04;00;Tiistai;2;3;5;5;1;6
89;05.04.2016;2016;04;01;Tiistai;1;3;4;0;0;0
89;05.04.2016;2016;04;02;Tiistai;1;1;2;0;0;0
89;05.04.2016;2016;04;03;Tiistai;4;2;6;0;0;0
89;05.04.2016;2016;04;04;Tiistai;1;5;6;1;0;1
89;05.04.2016;2016;04;05;Tiistai;2;5;7;3;3;6
89;05.04.2016;2016;04;06;Tiistai;13;46;59;4;8;12
89;05.04.2016;2016;04;07;Tiistai;34;129;163;13;21;34
89;05.04.2016;2016;04;08;Tiistai;25;156;181;20;40;60
89;05.04.2016;2016;04;09;Tiistai;36;85;121;7;24;31
89;05.04.2016;2016;04;10;Tiistai;33;66;99;21;37;58
89;05.04.2016;2016;04;11;Tiistai;42;46;88;18;30;48
89;05.04.2016;2016;04;12;Tiistai;53;61;114;20;17;37
89;05.04.2016;2016;04;13;Tiistai;47;51;98;27;24;51
89;05.04.2016;2016;04;14;Tiistai;78;47;125;30;20;50
89;05.04.2016;2016;04;15;Tiistai;122;55;177;38;26;64
89;05.04.2016;2016;04;16;Tiistai;149;76;225;34;15;49
89;05.04.2016;2016;04;17;Tiistai;68;45;113;26;34;60
89;05.04.2016;2016;04;18;Tiistai;63;33;96;24;17;41
89;05.04.2016;2016;04;19;Tiistai;52;37;89;45;30;75
89;05.04.2016;2016;04;20;Tiistai;53;30;83;34;23;57
89;05.04.2016;2016;04;21;Tiistai;55;15;70;20;9;29
89;05.04.2016;2016;04;22;Tiistai;17;3;20;7;3;10
89;05.04.2016;2016;04;23;Tiistai;5;1;6;1;1;2
89;06.04.2016;2016;04;00;Keskiviikko;8;1;9;1;0;1
89;06.04.2016;2016;04;01;Keskiviikko;0;0;0;0;1;1
89;06.04.2016;2016;04;02;Keskiviikko;0;0;0;0;0;0
89;06.04.2016;2016;04;03;Keskiviikko;1;1;2;0;0;0
89;06.04.2016;2016;04;04;Keskiviikko;1;6;7;0;0;0
89;06.04.2016;2016;04;05;Keskiviikko;2;9;11;0;1;1
89;06.04.2016;2016;04;06;Keskiviikko;12;44;56;8;9;17
89;06.04.2016;2016;04;07;Keskiviikko;31;127;158;8;25;33
89;06.04.2016;2016;04;08;Keskiviikko;45;170;215;18;29;47
89;06.04.2016;2016;04;09;Keskiviikko;37;107;144;17;43;60
89;06.04.2016;2016;04;10;Keskiviikko;43;72;115;17;28;45
89;06.04.2016;2016;04;11;Keskiviikko;51;52;103;30;29;59
89;06.04.2016;2016;04;12;Keskiviikko;46;74;120;38;18;56
89;06.04.2016;2016;04;13;Keskiviikko;73;61;134;23;29;52
89;06.04.2016;2016;04;14;Keskiviikko;87;84;171;40;35;75
89;06.04.2016;2016;04;15;Keskiviikko;133;58;191;25;14;39
89;06.04.2016;2016;04;16;Keskiviikko;137;62;199;33;21;54
89;06.04.2016;2016;04;17;Keskiviikko;81;47;128;17;16;33
89;06.04.2016;2016;04;18;Keskiviikko;76;29;105;12;12;24
89;06.04.2016;2016;04;19;Keskiviikko;45;20;65;22;9;31
89;06.04.2016;2016;04;20;Keskiviikko;53;16;69;14;14;28
89;06.04.2016;2016;04;21;Keskiviikko;38;12;50;10;3;13
89;06.04.2016;2016;04;22;Keskiviikko;13;10;23;4;5;9
89;06.04.2016;2016;04;23;Keskiviikko;8;5;13;0;3;3
89;07.04.2016;2016;04;00;Torstai;2;0;2;1;0;1
89;07.04.2016;2016;04;01;Torstai;3;3;6;0;0;0
89;07.04.2016;2016;04;02;Torstai;2;1;3;2;1;3
89;07.04.2016;2016;04;03;Torstai;0;1;1;1;0;1
89;07.04.2016;2016;04;04;Torstai;2;8;10;0;0;0
89;07.04.2016;2016;04;05;Torstai;0;7;7;2;1;3
89;07.04.2016;2016;04;06;Torstai;14;50;64;6;12;18
89;07.04.2016;2016;04;07;Torstai;23;145;168;10;24;34
89;07.04.2016;2016;04;08;Torstai;43;178;221;8;59;67
89;07.04.2016;2016;04;09;Torstai;41;80;121;22;40;62
89;07.04.2016;2016;04;10;Torstai;34;40;74;24;28;52
89;07.04.2016;2016;04;11;Torstai;34;49;83;14;25;39
89;07.04.2016;2016;04;12;Torstai;50;72;122;21;26;47
89;07.04.2016;2016;04;13;Torstai;68;67;135;30;31;61
89;07.04.2016;2016;04;14;Torstai;86;66;152;21;24;45
89;07.04.2016;2016;04;15;Torstai;139;60;199;47;21;68
89;07.04.2016;2016;04;16;Torstai;148;72;220;40;27;67
89;07.04.2016;2016;04;17;Torstai;102;68;170;37;30;67
89;07.04.2016;2016;04;18;Torstai;76;56;132;43;23;66
89;07.04.2016;2016;04;19;Torstai;69;27;96;37;21;58
89;07.04.2016;2016;04;20;Torstai;46;26;72;26;21;47
89;07.04.2016;2016;04;21;Torstai;38;17;55;17;13;30
89;07.04.2016;2016;04;22;Torstai;24;17;41;6;6;12
89;07.04.2016;2016;04;23;Torstai;8;2;10;1;0;1
89;08.04.2016;2016;04;00;Perjantai;2;4;6;3;2;5
89;08.04.2016;2016;04;01;Perjantai;4;1;5;0;0;0
89;08.04.2016;2016;04;02;Perjantai;7;0;7;2;1;3
89;08.04.2016;2016;04;03;Perjantai;2;2;4;0;0;0
89;08.04.2016;2016;04;04;Perjantai;1;4;5;1;1;2
89;08.04.2016;2016;04;05;Perjantai;2;7;9;1;0;1
89;08.04.2016;2016;04;06;Perjantai;13;54;67;5;11;16
89;08.04.2016;2016;04;07;Perjantai;18;121;139;13;32;45
89;08.04.2016;2016;04;08;Perjantai;36;155;191;31;35;66
89;08.04.2016;2016;04;09;Perjantai;33;114;147;30;98;128
89;08.04.2016;2016;04;10;Perjantai;48;59;107;40;40;80
89;08.04.2016;2016;04;11;Perjantai;73;84;157;19;29;48
89;08.04.2016;2016;04;12;Perjantai;68;77;145;34;21;55
89;08.04.2016;2016;04;13;Perjantai;82;69;151;41;29;70
89;08.04.2016;2016;04;14;Perjantai;95;76;171;31;28;59
89;08.04.2016;2016;04;15;Perjantai;153;68;221;30;32;62
89;08.04.2016;2016;04;16;Perjantai;127;79;206;49;49;98
89;08.04.2016;2016;04;17;Perjantai;105;60;165;43;28;71
89;08.04.2016;2016;04;18;Perjantai;92;61;153;36;32;68
89;08.04.2016;2016;04;19;Perjantai;52;64;116;28;15;43
89;08.04.2016;2016;04;20;Perjantai;36;44;80;18;11;29
89;08.04.2016;2016;04;21;Perjantai;34;28;62;14;8;22
89;08.04.2016;2016;04;22;Perjantai;15;12;27;11;8;19
89;08.04.2016;2016;04;23;Perjantai;22;17;39;8;2;10
89;09.04.2016;2016;04;00;Lauantai;13;4;17;9;7;16
89;09.04.2016;2016;04;01;Lauantai;6;5;11;5;1;6
89;09.04.2016;2016;04;02;Lauantai;7;9;16;5;1;6
89;09.04.2016;2016;04;03;Lauantai;12;2;14;4;0;4
89;09.04.2016;2016;04;04;Lauantai;7;4;11;3;0;3
89;09.04.2016;2016;04;05;Lauantai;8;3;11;0;1;1
89;09.04.2016;2016;04;06;Lauantai;5;14;19;1;0;1
89;09.04.2016;2016;04;07;Lauantai;6;26;32;8;6;14
89;09.04.2016;2016;04;08;Lauantai;17;26;43;9;24;33
89;09.04.2016;2016;04;09;Lauantai;29;66;95;34;37;71
89;09.04.2016;2016;04;10;Lauantai;40;92;132;35;44;79
89;09.04.2016;2016;04;11;Lauantai;53;109;162;34;62;96
89;09.04.2016;2016;04;12;Lauantai;88;119;207;58;62;120
89;09.04.2016;2016;04;13;Lauantai;89;109;198;63;81;144
89;09.04.2016;2016;04;14;Lauantai;122;126;248;61;58;119
89;09.04.2016;2016;04;15;Lauantai;117;96;213;68;65;133
89;09.04.2016;2016;04;16;Lauantai;105;84;189;63;51;114
89;09.04.2016;2016;04;17;Lauantai;66;54;120;45;34;79
89;09.04.2016;2016;04;18;Lauantai;69;55;124;26;36;62
89;09.04.2016;2016;04;19;Lauantai;49;37;86;21;13;34
89;09.04.2016;2016;04;20;Lauantai;60;30;90;18;18;36
89;09.04.2016;2016;04;21;Lauantai;28;38;66;10;6;16
89;09.04.2016;2016;04;22;Lauantai;17;24;41;5;4;9
89;09.04.2016;2016;04;23;Lauantai;20;21;41;8;3;11
89;10.04.2016;2016;04;00;Sunnuntai;25;23;48;2;4;6
89;10.04.2016;2016;04;01;Sunnuntai;12;6;18;3;4;7
89;10.04.2016;2016;04;02;Sunnuntai;15;9;24;4;2;6
89;10.04.2016;2016;04;03;Sunnuntai;7;1;8;4;1;5
89;10.04.2016;2016;04;04;Sunnuntai;15;0;15;7;0;7
89;10.04.2016;2016;04;05;Sunnuntai;2;2;4;0;2;2
89;10.04.2016;2016;04;06;Sunnuntai;4;6;10;0;2;2
89;10.04.2016;2016;04;07;Sunnuntai;6;5;11;9;7;16
89;10.04.2016;2016;04;08;Sunnuntai;6;11;17;18;12;30
89;10.04.2016;2016;04;09;Sunnuntai;16;38;54;19;18;37
89;10.04.2016;2016;04;10;Sunnuntai;25;44;69;25;30;55
89;10.04.2016;2016;04;11;Sunnuntai;44;83;127;49;54;103
89;10.04.2016;2016;04;12;Sunnuntai;70;77;147;61;70;131
89;10.04.2016;2016;04;13;Sunnuntai;83;86;169;55;78;133
89;10.04.2016;2016;04;14;Sunnuntai;84;66;150;42;55;97
89;10.04.2016;2016;04;15;Sunnuntai;99;78;177;43;45;88
89;10.04.2016;2016;04;16;Sunnuntai;87;73;160;61;57;118
89;10.04.2016;2016;04;17;Sunnuntai;97;54;151;66;46;112
89;10.04.2016;2016;04;18;Sunnuntai;70;71;141;43;42;85
89;10.04.2016;2016;04;19;Sunnuntai;49;38;87;34;29;63
89;10.04.2016;2016;04;20;Sunnuntai;30;24;54;26;23;49
89;10.04.2016;2016;04;21;Sunnuntai;16;19;35;16;14;30
89;10.04.2016;2016;04;22;Sunnuntai;10;7;17;4;2;6
89;10.04.2016;2016;04;23;Sunnuntai;5;5;10;2;0;2
89;11.04.2016;2016;04;00;Maanantai;3;5;8;2;2;4
89;11.04.2016;2016;04;01;Maanantai;4;1;5;0;0;0
89;11.04.2016;2016;04;02;Maanantai;3;2;5;0;0;0
89;11.04.2016;2016;04;03;Maanantai;0;2;2;0;0;0
89;11.04.2016;2016;04;04;Maanantai;5;3;8;0;0;0
89;11.04.2016;2016;04;05;Maanantai;2;16;18;2;0;2
89;11.04.2016;2016;04;06;Maanantai;12;47;59;1;4;5
89;11.04.2016;2016;04;07;Maanantai;27;168;195;6;29;35
89;11.04.2016;2016;04;08;Maanantai;43;191;234;21;45;66
89;11.04.2016;2016;04;09;Maanantai;47;123;170;17;36;53
89;11.04.2016;2016;04;10;Maanantai;54;74;128;20;39;59
89;11.04.2016;2016;04;11;Maanantai;74;67;141;30;51;81
89;11.04.2016;2016;04;12;Maanantai;72;64;136;29;33;62
89;11.04.2016;2016;04;13;Maanantai;92;83;175;43;31;74
89;11.04.2016;2016;04;14;Maanantai;120;76;196;45;27;72
89;11.04.2016;2016;04;15;Maanantai;166;74;240;45;40;85
89;11.04.2016;2016;04;16;Maanantai;204;104;308;62;49;111
89;11.04.2016;2016;04;17;Maanantai;150;91;241;55;38;93
89;11.04.2016;2016;04;18;Maanantai;88;67;155;41;43;84
89;11.04.2016;2016;04;19;Maanantai;72;39;111;40;33;73
89;11.04.2016;2016;04;20;Maanantai;70;30;100;36;23;59
89;11.04.2016;2016;04;21;Maanantai;46;22;68;12;7;19
89;11.04.2016;2016;04;22;Maanantai;23;16;39;10;9;19
89;11.04.2016;2016;04;23;Maanantai;10;6;16;3;8;11
89;12.04.2016;2016;04;00;Tiistai;11;3;14;0;1;1
89;12.04.2016;2016;04;01;Tiistai;0;2;2;0;1;1
89;12.04.2016;2016;04;02;Tiistai;0;1;1;0;0;0
89;12.04.2016;2016;04;03;Tiistai;1;2;3;0;0;0
89;12.04.2016;2016;04;04;Tiistai;1;5;6;1;0;1
89;12.04.2016;2016;04;05;Tiistai;3;10;13;0;0;0
89;12.04.2016;2016;04;06;Tiistai;16;45;61;6;11;17
89;12.04.2016;2016;04;07;Tiistai;36;163;199;7;22;29
89;12.04.2016;2016;04;08;Tiistai;43;205;248;18;51;69
89;12.04.2016;2016;04;09;Tiistai;40;105;145;23;45;68
89;12.04.2016;2016;04;10;Tiistai;56;76;132;19;32;51
89;12.04.2016;2016;04;11;Tiistai;50;85;135;18;28;46
89;12.04.2016;2016;04;12;Tiistai;77;97;174;36;39;75
89;12.04.2016;2016;04;13;Tiistai;99;72;171;40;40;80
89;12.04.2016;2016;04;14;Tiistai;124;78;202;39;29;68
89;12.04.2016;2016;04;15;Tiistai;199;82;281;39;29;68
89;12.04.2016;2016;04;16;Tiistai;197;116;313;37;36;73
89;12.04.2016;2016;04;17;Tiistai;98;104;202;43;45;88
89;12.04.2016;2016;04;18;Tiistai;98;80;178;51;46;97
89;12.04.2016;2016;04;19;Tiistai;80;41;121;40;40;80
89;12.04.2016;2016;04;20;Tiistai;63;25;88;32;16;48
89;12.04.2016;2016;04;21;Tiistai;88;19;107;20;15;35
89;12.04.2016;2016;04;22;Tiistai;19;8;27;5;5;10
89;12.04.2016;2016;04;23;Tiistai;12;8;20;4;1;5
89;13.04.2016;2016;04;00;Keskiviikko;11;2;13;5;1;6
89;13.04.2016;2016;04;01;Keskiviikko;1;1;2;1;4;5
89;13.04.2016;2016;04;02;Keskiviikko;1;1;2;0;0;0
89;13.04.2016;2016;04;03;Keskiviikko;0;3;3;0;0;0
89;13.04.2016;2016;04;04;Keskiviikko;0;2;2;2;0;2
89;13.04.2016;2016;04;05;Keskiviikko;6;10;16;1;0;1
89;13.04.2016;2016;04;06;Keskiviikko;12;53;65;6;11;17
89;13.04.2016;2016;04;07;Keskiviikko;42;161;203;7;33;40
89;13.04.2016;2016;04;08;Keskiviikko;56;214;270;16;38;54
89;13.04.2016;2016;04;09;Keskiviikko;45;101;146;16;35;51
89;13.04.2016;2016;04;10;Keskiviikko;32;62;94;24;35;59
89;13.04.2016;2016;04;11;Keskiviikko;49;83;132;33;37;70
89;13.04.2016;2016;04;12;Keskiviikko;71;77;148;31;20;51
89;13.04.2016;2016;04;13;Keskiviikko;82;57;139;25;31;56
89;13.04.2016;2016;04;14;Keskiviikko;121;55;176;22;19;41
89;13.04.2016;2016;04;15;Keskiviikko;145;81;226;25;34;59
89;13.04.2016;2016;04;16;Keskiviikko;214;98;312;45;29;74
89;13.04.2016;2016;04;17;Keskiviikko;112;81;193;22;20;42
89;13.04.2016;2016;04;18;Keskiviikko;84;50;134;37;39;76
89;13.04.2016;2016;04;19;Keskiviikko;67;25;92;42;32;74
89;13.04.2016;2016;04;20;Keskiviikko;62;26;88;33;15;48
89;13.04.2016;2016;04;21;Keskiviikko;34;18;52;11;6;17
89;13.04.2016;2016;04;22;Keskiviikko;28;17;45;8;7;15
89;13.04.2016;2016;04;23;Keskiviikko;16;4;20;1;5;6
89;14.04.2016;2016;04;00;Torstai;5;3;8;4;4;8
89;14.04.2016;2016;04;01;Torstai;8;3;11;2;1;3
89;14.04.2016;2016;04;02;Torstai;0;0;0;0;0;0
89;14.04.2016;2016;04;03;Torstai;3;0;3;1;0;1
89;14.04.2016;2016;04;04;Torstai;0;5;5;0;0;0
89;14.04.2016;2016;04;05;Torstai;6;12;18;1;0;1
89;14.04.2016;2016;04;06;Torstai;18;44;62;5;7;12
89;14.04.2016;2016;04;07;Torstai;28;141;169;7;23;30
89;14.04.2016;2016;04;08;Torstai;37;217;254;13;52;65
89;14.04.2016;2016;04;09;Torstai;41;116;157;27;37;64
89;14.04.2016;2016;04;10;Torstai;57;93;150;31;42;73
89;14.04.2016;2016;04;11;Torstai;71;96;167;20;47;67
89;14.04.2016;2016;04;12;Torstai;82;108;190;45;40;85
89;14.04.2016;2016;04;13;Torstai;112;97;209;44;44;88
89;14.04.2016;2016;04;14;Torstai;122;106;228;42;29;71
89;14.04.2016;2016;04;15;Torstai;190;77;267;32;26;58
89;14.04.2016;2016;04;16;Torstai;187;110;297;39;42;81
89;14.04.2016;2016;04;17;Torstai;146;91;237;45;39;84
89;14.04.2016;2016;04;18;Torstai;122;74;196;37;37;74
89;14.04.2016;2016;04;19;Torstai;84;34;118;46;44;90
89;14.04.2016;2016;04;20;Torstai;92;27;119;36;33;69
89;14.04.2016;2016;04;21;Torstai;56;21;77;14;11;25
89;14.04.2016;2016;04;22;Torstai;31;8;39;7;6;13
89;14.04.2016;2016;04;23;Torstai;13;5;18;0;0;0
89;15.04.2016;2016;04;00;Perjantai;8;3;11;3;2;5
89;15.04.2016;2016;04;01;Perjantai;1;4;5;1;0;1
89;15.04.2016;2016;04;02;Perjantai;1;2;3;0;1;1
89;15.04.2016;2016;04;03;Perjantai;1;3;4;1;0;1
89;15.04.2016;2016;04;04;Perjantai;0;3;3;1;1;2
89;15.04.2016;2016;04;05;Perjantai;7;8;15;1;1;2
89;15.04.2016;2016;04;06;Perjantai;16;43;59;3;11;14
89;15.04.2016;2016;04;07;Perjantai;38;152;190;5;23;28
89;15.04.2016;2016;04;08;Perjantai;38;171;209;11;32;43
89;15.04.2016;2016;04;09;Perjantai;40;120;160;20;27;47
89;15.04.2016;2016;04;10;Perjantai;49;81;130;30;36;66
89;15.04.2016;2016;04;11;Perjantai;55;84;139;25;35;60
89;15.04.2016;2016;04;12;Perjantai;70;98;168;40;41;81
89;15.04.2016;2016;04;13;Perjantai;79;105;184;32;36;68
89;15.04.2016;2016;04;14;Perjantai;147;101;248;46;38;84
89;15.04.2016;2016;04;15;Perjantai;155;83;238;37;26;63
89;15.04.2016;2016;04;16;Perjantai;164;105;269;41;23;64
89;15.04.2016;2016;04;17;Perjantai;106;91;197;31;32;63
89;15.04.2016;2016;04;18;Perjantai;92;76;168;33;40;73
89;15.04.2016;2016;04;19;Perjantai;85;62;147;41;25;66
89;15.04.2016;2016;04;20;Perjantai;76;32;108;21;18;39
89;15.04.2016;2016;04;21;Perjantai;69;31;100;15;13;28
89;15.04.2016;2016;04;22;Perjantai;21;17;38;12;5;17
89;15.04.2016;2016;04;23;Perjantai;31;24;55;8;9;17
89;16.04.2016;2016;04;00;Lauantai;9;18;27;3;8;11
89;16.04.2016;2016;04;01;Lauantai;10;4;14;3;3;6
89;16.04.2016;2016;04;02;Lauantai;17;5;22;6;2;8
89;16.04.2016;2016;04;03;Lauantai;11;0;11;4;1;5
89;16.04.2016;2016;04;04;Lauantai;8;2;10;2;0;2
89;16.04.2016;2016;04;05;Lauantai;3;4;7;0;0;0
89;16.04.2016;2016;04;06;Lauantai;6;10;16;0;4;4
89;16.04.2016;2016;04;07;Lauantai;6;14;20;2;3;5
89;16.04.2016;2016;04;08;Lauantai;7;34;41;10;15;25
89;16.04.2016;2016;04;09;Lauantai;13;68;81;19;40;59
89;16.04.2016;2016;04;10;Lauantai;18;90;108;19;35;54
89;16.04.2016;2016;04;11;Lauantai;42;87;129;31;52;83
89;16.04.2016;2016;04;12;Lauantai;66;108;174;32;52;84
89;16.04.2016;2016;04;13;Lauantai;89;102;191;50;54;104
89;16.04.2016;2016;04;14;Lauantai;84;95;179;45;51;96
89;16.04.2016;2016;04;15;Lauantai;121;36;157;27;27;54
89;16.04.2016;2016;04;16;Lauantai;74;47;121;30;23;53
89;16.04.2016;2016;04;17;Lauantai;80;36;116;28;16;44
89;16.04.2016;2016;04;18;Lauantai;60;38;98;26;26;52
89;16.04.2016;2016;04;19;Lauantai;33;44;77;28;18;46
89;16.04.2016;2016;04;20;Lauantai;39;41;80;22;26;48
89;16.04.2016;2016;04;21;Lauantai;45;23;68;12;12;24
89;16.04.2016;2016;04;22;Lauantai;34;15;49;6;8;14
89;16.04.2016;2016;04;23;Lauantai;19;13;32;5;2;7
89;17.04.2016;2016;04;00;Sunnuntai;8;32;40;5;8;13
89;17.04.2016;2016;04;01;Sunnuntai;13;6;19;10;3;13
89;17.04.2016;2016;04;02;Sunnuntai;5;4;9;5;3;8
89;17.04.2016;2016;04;03;Sunnuntai;14;0;14;2;1;3
89;17.04.2016;2016;04;04;Sunnuntai;13;3;16;4;0;4
89;17.04.2016;2016;04;05;Sunnuntai;6;2;8;0;0;0
89;17.04.2016;2016;04;06;Sunnuntai;5;10;15;2;1;3
89;17.04.2016;2016;04;07;Sunnuntai;3;4;7;3;6;9
89;17.04.2016;2016;04;08;Sunnuntai;3;10;13;11;8;19
89;17.04.2016;2016;04;09;Sunnuntai;9;20;29;5;12;17
89;17.04.2016;2016;04;10;Sunnuntai;5;23;28;13;20;33
89;17.04.2016;2016;04;11;Sunnuntai;8;38;46;21;37;58
89;17.04.2016;2016;04;12;Sunnuntai;26;45;71;36;42;78
89;17.04.2016;2016;04;13;Sunnuntai;42;64;106;30;44;74
89;17.04.2016;2016;04;14;Sunnuntai;56;67;123;35;36;71
89;17.04.2016;2016;04;15;Sunnuntai;63;63;126;24;35;59
89;17.04.2016;2016;04;16;Sunnuntai;44;39;83;36;21;57
89;17.04.2016;2016;04;17;Sunnuntai;59;26;85;23;26;49
89;17.04.2016;2016;04;18;Sunnuntai;61;19;80;22;34;56
89;17.04.2016;2016;04;19;Sunnuntai;27;22;49;28;25;53
89;17.04.2016;2016;04;20;Sunnuntai;28;21;49;17;16;33
89;17.04.2016;2016;04;21;Sunnuntai;13;8;21;14;9;23
89;17.04.2016;2016;04;22;Sunnuntai;8;6;14;1;1;2
89;17.04.2016;2016;04;23;Sunnuntai;4;4;8;4;1;5
89;18.04.2016;2016;04;00;Maanantai;3;1;4;3;0;3
89;18.04.2016;2016;04;01;Maanantai;0;0;0;0;2;2
89;18.04.2016;2016;04;02;Maanantai;1;2;3;0;0;0
89;18.04.2016;2016;04;03;Maanantai;2;1;3;0;0;0
89;18.04.2016;2016;04;04;Maanantai;5;5;10;2;1;3
89;18.04.2016;2016;04;05;Maanantai;2;9;11;1;1;2
89;18.04.2016;2016;04;06;Maanantai;15;49;64;2;7;9
89;18.04.2016;2016;04;07;Maanantai;30;152;182;9;30;39
89;18.04.2016;2016;04;08;Maanantai;43;206;249;22;43;65
89;18.04.2016;2016;04;09;Maanantai;49;118;167;24;37;61
89;18.04.2016;2016;04;10;Maanantai;42;55;97;24;47;71
89;18.04.2016;2016;04;11;Maanantai;48;77;125;24;27;51
89;18.04.2016;2016;04;12;Maanantai;72;96;168;26;36;62
89;18.04.2016;2016;04;13;Maanantai;73;64;137;29;26;55
89;18.04.2016;2016;04;14;Maanantai;111;72;183;29;24;53
89;18.04.2016;2016;04;15;Maanantai;167;72;239;60;21;81
89;18.04.2016;2016;04;16;Maanantai;195;98;293;36;24;60
89;18.04.2016;2016;04;17;Maanantai;100;83;183;31;24;55
89;18.04.2016;2016;04;18;Maanantai;97;42;139;43;37;80
89;18.04.2016;2016;04;19;Maanantai;92;44;136;39;31;70
89;18.04.2016;2016;04;20;Maanantai;52;18;70;22;27;49
89;18.04.2016;2016;04;21;Maanantai;49;20;69;25;21;46
89;18.04.2016;2016;04;22;Maanantai;15;7;22;5;4;9
89;18.04.2016;2016;04;23;Maanantai;8;2;10;1;2;3
89;19.04.2016;2016;04;00;Tiistai;4;2;6;2;2;4
89;19.04.2016;2016;04;01;Tiistai;2;2;4;1;0;1
89;19.04.2016;2016;04;02;Tiistai;2;1;3;0;0;0
89;19.04.2016;2016;04;03;Tiistai;3;1;4;0;0;0
89;19.04.2016;2016;04;04;Tiistai;2;8;10;0;1;1
89;19.04.2016;2016;04;05;Tiistai;3;9;12;2;3;5
89;19.04.2016;2016;04;06;Tiistai;17;43;60;5;12;17
89;19.04.2016;2016;04;07;Tiistai;37;145;182;7;26;33
89;19.04.2016;2016;04;08;Tiistai;48;215;263;9;53;62
89;19.04.2016;2016;04;09;Tiistai;40;111;151;14;35;49
89;19.04.2016;2016;04;10;Tiistai;49;66;115;22;39;61
89;19.04.2016;2016;04;11;Tiistai;58;79;137;24;34;58
89;19.04.2016;2016;04;12;Tiistai;60;93;153;30;22;52
89;19.04.2016;2016;04;13;Tiistai;75;76;151;24;30;54
89;19.04.2016;2016;04;14;Tiistai;94;65;159;22;19;41
89;19.04.2016;2016;04;15;Tiistai;158;70;228;40;13;53
89;19.04.2016;2016;04;16;Tiistai;186;110;296;27;24;51
89;19.04.2016;2016;04;17;Tiistai;116;53;169;24;20;44
89;19.04.2016;2016;04;18;Tiistai;85;46;131;27;28;55
89;19.04.2016;2016;04;19;Tiistai;54;29;83;21;18;39
89;19.04.2016;2016;04;20;Tiistai;41;23;64;15;13;28
89;19.04.2016;2016;04;21;Tiistai;41;15;56;10;3;13
89;19.04.2016;2016;04;22;Tiistai;10;9;19;7;5;12
89;19.04.2016;2016;04;23;Tiistai;3;4;7;4;0;4
89;20.04.2016;2016;04;00;Keskiviikko;7;3;10;1;0;1
89;20.04.2016;2016;04;01;Keskiviikko;3;0;3;2;1;3
89;20.04.2016;2016;04;02;Keskiviikko;1;0;1;0;0;0
89;20.04.2016;2016;04;03;Keskiviikko;2;1;3;0;0;0
89;20.04.2016;2016;04;04;Keskiviikko;3;4;7;1;2;3
89;20.04.2016;2016;04;05;Keskiviikko;1;13;14;0;1;1
89;20.04.2016;2016;04;06;Keskiviikko;15;50;65;3;13;16
89;20.04.2016;2016;04;07;Keskiviikko;33;163;196;8;24;32
89;20.04.2016;2016;04;08;Keskiviikko;46;180;226;7;30;37
89;20.04.2016;2016;04;09;Keskiviikko;46;115;161;28;27;55
89;20.04.2016;2016;04;10;Keskiviikko;53;62;115;22;31;53
89;20.04.2016;2016;04;11;Keskiviikko;61;77;138;23;30;53
89;20.04.2016;2016;04;12;Keskiviikko;71;81;152;15;30;45
89;20.04.2016;2016;04;13;Keskiviikko;69;56;125;22;16;38
89;20.04.2016;2016;04;14;Keskiviikko;114;53;167;27;21;48
89;20.04.2016;2016;04;15;Keskiviikko;145;87;232;32;14;46
89;20.04.2016;2016;04;16;Keskiviikko;209;101;310;29;27;56
89;20.04.2016;2016;04;17;Keskiviikko;112;69;181;25;20;45
89;20.04.2016;2016;04;18;Keskiviikko;63;56;119;20;32;52
89;20.04.2016;2016;04;19;Keskiviikko;78;47;125;33;18;51
89;20.04.2016;2016;04;20;Keskiviikko;51;42;93;29;26;55
89;20.04.2016;2016;04;21;Keskiviikko;46;24;70;12;13;25
89;20.04.2016;2016;04;22;Keskiviikko;28;12;40;5;9;14
89;20.04.2016;2016;04;23;Keskiviikko;15;19;34;2;0;2
89;21.04.2016;2016;04;00;Torstai;7;9;16;4;3;7
89;21.04.2016;2016;04;01;Torstai;9;1;10;4;1;5
89;21.04.2016;2016;04;02;Torstai;9;1;10;3;1;4
89;21.04.2016;2016;04;03;Torstai;5;1;6;0;0;0
89;21.04.2016;2016;04;04;Torstai;4;5;9;0;2;2
89;21.04.2016;2016;04;05;Torstai;5;9;14;0;1;1
89;21.04.2016;2016;04;06;Torstai;14;43;57;1;11;12
89;21.04.2016;2016;04;07;Torstai;31;160;191;11;25;36
89;21.04.2016;2016;04;08;Torstai;50;196;246;13;42;55
89;21.04.2016;2016;04;09;Torstai;37;100;137;16;25;41
89;21.04.2016;2016;04;10;Torstai;42;60;102;18;23;41
89;21.04.2016;2016;04;11;Torstai;64;59;123;20;29;49
89;21.04.2016;2016;04;12;Torstai;61;91;152;24;31;55
89;21.04.2016;2016;04;13;Torstai;85;90;175;34;26;60
89;21.04.2016;2016;04;14;Torstai;104;69;173;37;24;61
89;21.04.2016;2016;04;15;Torstai;145;70;215;21;30;51
89;21.04.2016;2016;04;16;Torstai;173;104;277;25;21;46
89;21.04.2016;2016;04;17;Torstai;133;104;237;40;27;67
89;21.04.2016;2016;04;18;Torstai;82;64;146;24;28;52
89;21.04.2016;2016;04;19;Torstai;75;38;113;36;29;65
89;21.04.2016;2016;04;20;Torstai;82;41;123;27;28;55
89;21.04.2016;2016;04;21;Torstai;57;19;76;14;14;28
89;21.04.2016;2016;04;22;Torstai;21;12;33;3;2;5
89;21.04.2016;2016;04;23;Torstai;9;5;14;4;3;7
89;22.04.2016;2016;04;00;Perjantai;10;2;12;0;0;0
89;22.04.2016;2016;04;01;Perjantai;2;0;2;2;0;2
89;22.04.2016;2016;04;02;Perjantai;0;1;1;0;0;0
89;22.04.2016;2016;04;03;Perjantai;1;1;2;0;0;0
89;22.04.2016;2016;04;04;Perjantai;4;5;9;0;3;3
89;22.04.2016;2016;04;05;Perjantai;5;13;18;1;1;2
89;22.04.2016;2016;04;06;Perjantai;14;44;58;0;8;8
89;22.04.2016;2016;04;07;Perjantai;29;145;174;5;20;25
89;22.04.2016;2016;04;08;Perjantai;48;180;228;24;37;61
89;22.04.2016;2016;04;09;Perjantai;43;106;149;18;29;47
89;22.04.2016;2016;04;10;Perjantai;47;74;121;23;40;63
89;22.04.2016;2016;04;11;Perjantai;74;85;159;20;24;44
89;22.04.2016;2016;04;12;Perjantai;137;93;230;27;44;71
89;22.04.2016;2016;04;13;Perjantai;118;116;234;25;36;61
89;22.04.2016;2016;04;14;Perjantai;163;155;318;31;29;60
89;22.04.2016;2016;04;15;Perjantai;190;137;327;33;36;69
89;22.04.2016;2016;04;16;Perjantai;131;162;293;35;31;66
89;22.04.2016;2016;04;17;Perjantai;112;74;186;36;32;68
89;22.04.2016;2016;04;18;Perjantai;99;64;163;19;35;54
89;22.04.2016;2016;04;19;Perjantai;76;51;127;21;26;47
89;22.04.2016;2016;04;20;Perjantai;51;51;102;37;15;52
89;22.04.2016;2016;04;21;Perjantai;44;24;68;9;13;22
89;22.04.2016;2016;04;22;Perjantai;37;36;73;4;4;8
89;22.04.2016;2016;04;23;Perjantai;29;21;50;6;7;13
89;23.04.2016;2016;04;00;Lauantai;18;18;36;16;9;25
89;23.04.2016;2016;04;01;Lauantai;13;17;30;0;4;4
89;23.04.2016;2016;04;02;Lauantai;14;5;19;3;1;4
89;23.04.2016;2016;04;03;Lauantai;20;3;23;3;1;4
89;23.04.2016;2016;04;04;Lauantai;11;2;13;2;0;2
89;23.04.2016;2016;04;05;Lauantai;2;1;3;0;1;1
89;23.04.2016;2016;04;06;Lauantai;3;16;19;2;2;4
89;23.04.2016;2016;04;07;Lauantai;8;12;20;6;9;15
89;23.04.2016;2016;04;08;Lauantai;13;33;46;10;20;30
89;23.04.2016;2016;04;09;Lauantai;17;82;99;16;25;41
89;23.04.2016;2016;04;10;Lauantai;27;89;116;26;56;82
89;23.04.2016;2016;04;11;Lauantai;62;94;156;26;49;75
89;23.04.2016;2016;04;12;Lauantai;68;104;172;28;39;67
89;23.04.2016;2016;04;13;Lauantai;68;97;165;27;44;71
89;23.04.2016;2016;04;14;Lauantai;83;86;169;28;26;54
89;23.04.2016;2016;04;15;Lauantai;82;51;133;25;25;50
89;23.04.2016;2016;04;16;Lauantai;85;46;131;26;27;53
89;23.04.2016;2016;04;17;Lauantai;85;53;138;32;28;60
89;23.04.2016;2016;04;18;Lauantai;46;55;101;31;41;72
89;23.04.2016;2016;04;19;Lauantai;49;40;89;22;25;47
89;23.04.2016;2016;04;20;Lauantai;37;32;69;23;15;38
89;23.04.2016;2016;04;21;Lauantai;31;26;57;10;12;22
89;23.04.2016;2016;04;22;Lauantai;37;19;56;11;10;21
89;23.04.2016;2016;04;23;Lauantai;15;23;38;5;6;11
89;24.04.2016;2016;04;00;Sunnuntai;12;16;28;5;7;12
89;24.04.2016;2016;04;01;Sunnuntai;17;11;28;0;5;5
89;24.04.2016;2016;04;02;Sunnuntai;13;3;16;4;3;7
89;24.04.2016;2016;04;03;Sunnuntai;12;2;14;2;0;2
89;24.04.2016;2016;04;04;Sunnuntai;10;5;15;4;2;6
89;24.04.2016;2016;04;05;Sunnuntai;4;9;13;0;3;3
89;24.04.2016;2016;04;06;Sunnuntai;3;13;16;0;3;3
89;24.04.2016;2016;04;07;Sunnuntai;6;10;16;5;6;11
89;24.04.2016;2016;04;08;Sunnuntai;6;14;20;10;12;22
89;24.04.2016;2016;04;09;Sunnuntai;15;31;46;19;30;49
89;24.04.2016;2016;04;10;Sunnuntai;23;64;87;32;42;74
89;24.04.2016;2016;04;11;Sunnuntai;35;69;104;39;60;99
89;24.04.2016;2016;04;12;Sunnuntai;57;55;112;39;49;88
89;24.04.2016;2016;04;13;Sunnuntai;76;95;171;28;48;76
89;24.04.2016;2016;04;14;Sunnuntai;76;80;156;27;48;75
89;24.04.2016;2016;04;15;Sunnuntai;82;59;141;34;18;52
89;24.04.2016;2016;04;16;Sunnuntai;71;47;118;29;23;52
89;24.04.2016;2016;04;17;Sunnuntai;57;39;96;27;36;63
89;24.04.2016;2016;04;18;Sunnuntai;64;34;98;27;22;49
89;24.04.2016;2016;04;19;Sunnuntai;48;22;70;24;21;45
89;24.04.2016;2016;04;20;Sunnuntai;34;34;68;16;26;42
89;24.04.2016;2016;04;21;Sunnuntai;19;9;28;6;12;18
89;24.04.2016;2016;04;22;Sunnuntai;14;7;21;4;2;6
89;24.04.2016;2016;04;23;Sunnuntai;10;6;16;3;1;4
89;25.04.2016;2016;04;00;Maanantai;2;2;4;0;2;2
89;25.04.2016;2016;04;01;Maanantai;4;2;6;1;1;2
89;25.04.2016;2016;04;02;Maanantai;3;3;6;1;2;3
89;25.04.2016;2016;04;03;Maanantai;1;0;1;0;0;0
89;25.04.2016;2016;04;04;Maanantai;2;4;6;0;1;1
89;25.04.2016;2016;04;05;Maanantai;3;16;19;1;0;1
89;25.04.2016;2016;04;06;Maanantai;16;48;64;3;8;11
89;25.04.2016;2016;04;07;Maanantai;37;148;185;8;20;28
89;25.04.2016;2016;04;08;Maanantai;43;197;240;10;44;54
89;25.04.2016;2016;04;09;Maanantai;36;141;177;15;35;50
89;25.04.2016;2016;04;10;Maanantai;49;50;99;21;32;53
89;25.04.2016;2016;04;11;Maanantai;71;73;144;19;29;48
89;25.04.2016;2016;04;12;Maanantai;67;72;139;19;17;36
89;25.04.2016;2016;04;13;Maanantai;52;62;114;23;34;57
89;25.04.2016;2016;04;14;Maanantai;92;40;132;20;14;34
89;25.04.2016;2016;04;15;Maanantai;133;39;172;22;13;35
89;25.04.2016;2016;04;16;Maanantai;165;59;224;24;6;30
89;25.04.2016;2016;04;17;Maanantai;74;50;124;18;10;28
89;25.04.2016;2016;04;18;Maanantai;65;43;108;12;15;27
89;25.04.2016;2016;04;19;Maanantai;49;22;71;34;21;55
89;25.04.2016;2016;04;20;Maanantai;52;21;73;22;17;39
89;25.04.2016;2016;04;21;Maanantai;28;16;44;18;24;42
89;25.04.2016;2016;04;22;Maanantai;17;16;33;6;6;12
89;25.04.2016;2016;04;23;Maanantai;6;20;26;4;1;5
89;26.04.2016;2016;04;00;Tiistai;3;6;9;1;0;1
89;26.04.2016;2016;04;01;Tiistai;1;0;1;0;1;1
89;26.04.2016;2016;04;02;Tiistai;8;3;11;2;0;2
89;26.04.2016;2016;04;03;Tiistai;6;1;7;0;0;0
89;26.04.2016;2016;04;04;Tiistai;1;2;3;1;1;2
89;26.04.2016;2016;04;05;Tiistai;4;14;18;2;3;5
89;26.04.2016;2016;04;06;Tiistai;12;50;62;6;9;15
89;26.04.2016;2016;04;07;Tiistai;33;150;183;9;23;32
89;26.04.2016;2016;04;08;Tiistai;36;214;250;9;36;45
89;26.04.2016;2016;04;09;Tiistai;35;83;118;13;34;47
89;26.04.2016;2016;04;10;Tiistai;36;67;103;23;34;57
89;26.04.2016;2016;04;11;Tiistai;55;44;99;10;16;26
89;26.04.2016;2016;04;12;Tiistai;47;57;104;17;23;40
89;26.04.2016;2016;04;13;Tiistai;54;58;112;16;18;34
89;26.04.2016;2016;04;14;Tiistai;88;92;180;28;21;49
89;26.04.2016;2016;04;15;Tiistai;160;62;222;29;12;41
89;26.04.2016;2016;04;16;Tiistai;191;89;280;29;21;50
89;26.04.2016;2016;04;17;Tiistai;109;55;164;21;19;40
89;26.04.2016;2016;04;18;Tiistai;65;33;98;23;16;39
89;26.04.2016;2016;04;19;Tiistai;56;31;87;30;25;55
89;26.04.2016;2016;04;20;Tiistai;50;24;74;29;22;51
89;26.04.2016;2016;04;21;Tiistai;40;10;50;9;13;22
89;26.04.2016;2016;04;22;Tiistai;24;3;27;4;2;6
89;26.04.2016;2016;04;23;Tiistai;7;12;19;1;1;2
89;27.04.2016;2016;04;00;Keskiviikko;5;3;8;0;1;1
89;27.04.2016;2016;04;01;Keskiviikko;6;2;8;0;1;1
89;27.04.2016;2016;04;02;Keskiviikko;6;2;8;1;0;1
89;27.04.2016;2016;04;03;Keskiviikko;6;2;8;1;0;1
89;27.04.2016;2016;04;04;Keskiviikko;12;2;14;1;3;4
89;27.04.2016;2016;04;05;Keskiviikko;4;13;17;1;0;1
89;27.04.2016;2016;04;06;Keskiviikko;12;48;60;0;9;9
89;27.04.2016;2016;04;07;Keskiviikko;38;174;212;9;17;26
89;27.04.2016;2016;04;08;Keskiviikko;52;221;273;12;44;56
89;27.04.2016;2016;04;09;Keskiviikko;40;113;153;21;39;60
89;27.04.2016;2016;04;10;Keskiviikko;60;65;125;23;47;70
89;27.04.2016;2016;04;11;Keskiviikko;52;77;129;25;47;72
89;27.04.2016;2016;04;12;Keskiviikko;75;83;158;22;19;41
89;27.04.2016;2016;04;13;Keskiviikko;83;64;147;13;9;22
89;27.04.2016;2016;04;14;Keskiviikko;127;56;183;34;19;53
89;27.04.2016;2016;04;15;Keskiviikko;154;92;246;27;22;49
89;27.04.2016;2016;04;16;Keskiviikko;192;83;275;30;24;54
89;27.04.2016;2016;04;17;Keskiviikko;116;65;181;25;24;49
89;27.04.2016;2016;04;18;Keskiviikko;75;64;139;31;22;53
89;27.04.2016;2016;04;19;Keskiviikko;68;33;101;21;21;42
89;27.04.2016;2016;04;20;Keskiviikko;52;28;80;25;11;36
89;27.04.2016;2016;04;21;Keskiviikko;39;17;56;10;8;18
89;27.04.2016;2016;04;22;Keskiviikko;15;18;33;4;6;10
89;27.04.2016;2016;04;23;Keskiviikko;15;5;20;2;4;6
89;28.04.2016;2016;04;00;Torstai;4;4;8;2;0;2
89;28.04.2016;2016;04;01;Torstai;7;5;12;3;3;6
89;28.04.2016;2016;04;02;Torstai;5;2;7;0;2;2
89;28.04.2016;2016;04;03;Torstai;4;3;7;0;1;1
89;28.04.2016;2016;04;04;Torstai;9;4;13;1;1;2
89;28.04.2016;2016;04;05;Torstai;4;10;14;0;0;0
89;28.04.2016;2016;04;06;Torstai;18;46;64;0;8;8
89;28.04.2016;2016;04;07;Torstai;33;160;193;11;19;30
89;28.04.2016;2016;04;08;Torstai;45;233;278;14;52;66
89;28.04.2016;2016;04;09;Torstai;47;113;160;17;33;50
89;28.04.2016;2016;04;10;Torstai;42;82;124;31;29;60
89;28.04.2016;2016;04;11;Torstai;55;100;155;18;64;82
89;28.04.2016;2016;04;12;Torstai;86;97;183;26;30;56
89;28.04.2016;2016;04;13;Torstai;85;73;158;23;18;41
89;28.04.2016;2016;04;14;Torstai;119;85;204;18;31;49
89;28.04.2016;2016;04;15;Torstai;163;87;250;26;21;47
89;28.04.2016;2016;04;16;Torstai;203;112;315;32;18;50
89;28.04.2016;2016;04;17;Torstai;147;105;252;25;29;54
89;28.04.2016;2016;04;18;Torstai;95;64;159;29;37;66
89;28.04.2016;2016;04;19;Torstai;94;61;155;54;32;86
89;28.04.2016;2016;04;20;Torstai;75;47;122;29;33;62
89;28.04.2016;2016;04;21;Torstai;58;56;114;11;19;30
89;28.04.2016;2016;04;22;Torstai;40;38;78;6;10;16
89;28.04.2016;2016;04;23;Torstai;17;13;30;6;5;11
89;29.04.2016;2016;04;00;Perjantai;17;6;23;6;4;10
89;29.04.2016;2016;04;01;Perjantai;9;2;11;2;1;3
89;29.04.2016;2016;04;02;Perjantai;12;4;16;0;1;1
89;29.04.2016;2016;04;03;Perjantai;10;5;15;0;0;0
89;29.04.2016;2016;04;04;Perjantai;4;4;8;3;1;4
89;29.04.2016;2016;04;05;Perjantai;5;12;17;0;3;3
89;29.04.2016;2016;04;06;Perjantai;27;55;82;2;8;10
89;29.04.2016;2016;04;07;Perjantai;37;152;189;6;16;22
89;29.04.2016;2016;04;08;Perjantai;46;217;263;14;39;53
89;29.04.2016;2016;04;09;Perjantai;62;114;176;14;25;39
89;29.04.2016;2016;04;10;Perjantai;61;100;161;20;36;56
89;29.04.2016;2016;04;11;Perjantai;68;95;163;26;46;72
89;29.04.2016;2016;04;12;Perjantai;79;75;154;26;24;50
89;29.04.2016;2016;04;13;Perjantai;108;99;207;19;21;40
89;29.04.2016;2016;04;14;Perjantai;147;92;239;19;11;30
89;29.04.2016;2016;04;15;Perjantai;165;64;229;14;18;32
89;29.04.2016;2016;04;16;Perjantai;112;85;197;18;21;39
89;29.04.2016;2016;04;17;Perjantai;95;67;162;9;23;32
89;29.04.2016;2016;04;18;Perjantai;71;70;141;24;25;49
89;29.04.2016;2016;04;19;Perjantai;61;61;122;26;24;50
89;29.04.2016;2016;04;20;Perjantai;58;54;112;19;18;37
89;29.04.2016;2016;04;21;Perjantai;75;49;124;15;19;34
89;29.04.2016;2016;04;22;Perjantai;41;32;73;8;10;18
89;29.04.2016;2016;04;23;Perjantai;29;26;55;8;5;13
89;30.04.2016;2016;04;00;Lauantai;32;20;52;9;10;19
89;30.04.2016;2016;04;01;Lauantai;31;10;41;3;1;4
89;30.04.2016;2016;04;02;Lauantai;11;9;20;6;1;7
89;30.04.2016;2016;04;03;Lauantai;20;3;23;3;0;3
89;30.04.2016;2016;04;04;Lauantai;12;2;14;7;1;8
89;30.04.2016;2016;04;05;Lauantai;5;3;8;4;0;4
89;30.04.2016;2016;04;06;Lauantai;5;14;19;3;0;3
89;30.04.2016;2016;04;07;Lauantai;11;21;32;7;7;14
89;30.04.2016;2016;04;08;Lauantai;5;25;30;9;7;16
89;30.04.2016;2016;04;09;Lauantai;37;59;96;12;17;29
89;30.04.2016;2016;04;10;Lauantai;41;119;160;14;35;49
89;30.04.2016;2016;04;11;Lauantai;71;194;265;24;66;90
89;30.04.2016;2016;04;12;Lauantai;112;262;374;37;74;111
89;30.04.2016;2016;04;13;Lauantai;117;312;429;27;85;112
89;30.04.2016;2016;04;14;Lauantai;145;387;532;35;101;136
89;30.04.2016;2016;04;15;Lauantai;247;318;565;52;90;142
89;30.04.2016;2016;04;16;Lauantai;181;186;367;76;76;152
89;30.04.2016;2016;04;17;Lauantai;218;159;377;69;73;142
89;30.04.2016;2016;04;18;Lauantai;196;138;334;53;50;103
89;30.04.2016;2016;04;19;Lauantai;137;147;284;41;59;100
89;30.04.2016;2016;04;20;Lauantai;132;135;267;48;49;97
89;30.04.2016;2016;04;21;Lauantai;75;112;187;43;57;100
89;30.04.2016;2016;04;22;Lauantai;86;95;181;40;59;99
89;30.04.2016;2016;04;23;Lauantai;80;70;150;50;42;92
89;01.05.2016;2016;05;00;Sunnuntai;86;58;144;46;19;65
89;01.05.2016;2016;05;01;Sunnuntai;72;24;96;22;26;48
89;01.05.2016;2016;05;02;Sunnuntai;67;15;82;28;10;38
89;01.05.2016;2016;05;03;Sunnuntai;55;7;62;25;2;27
89;01.05.2016;2016;05;04;Sunnuntai;56;15;71;23;2;25
89;01.05.2016;2016;05;05;Sunnuntai;57;8;65;8;2;10
89;01.05.2016;2016;05;06;Sunnuntai;20;6;26;4;3;7
89;01.05.2016;2016;05;07;Sunnuntai;7;11;18;4;8;12
89;01.05.2016;2016;05;08;Sunnuntai;15;24;39;13;16;29
89;01.05.2016;2016;05;09;Sunnuntai;27;55;82;16;36;52
89;01.05.2016;2016;05;10;Sunnuntai;46;145;191;17;58;75
89;01.05.2016;2016;05;11;Sunnuntai;61;274;335;28;85;113
89;01.05.2016;2016;05;12;Sunnuntai;106;277;383;33;62;95
89;01.05.2016;2016;05;13;Sunnuntai;229;260;489;50;86;136
89;01.05.2016;2016;05;14;Sunnuntai;276;233;509;71;84;155
89;01.05.2016;2016;05;15;Sunnuntai;295;166;461;60;73;133
89;01.05.2016;2016;05;16;Sunnuntai;227;118;345;61;49;110
89;01.05.2016;2016;05;17;Sunnuntai;190;95;285;73;36;109
89;01.05.2016;2016;05;18;Sunnuntai;172;61;233;25;45;70
89;01.05.2016;2016;05;19;Sunnuntai;104;59;163;40;31;71
89;01.05.2016;2016;05;20;Sunnuntai;70;37;107;23;11;34
89;01.05.2016;2016;05;21;Sunnuntai;34;25;59;17;8;25
89;01.05.2016;2016;05;22;Sunnuntai;20;19;39;7;7;14
89;01.05.2016;2016;05;23;Sunnuntai;13;12;25;7;4;11
89;02.05.2016;2016;05;00;Maanantai;13;1;14;0;2;2
89;02.05.2016;2016;05;01;Maanantai;2;2;4;1;0;1
89;02.05.2016;2016;05;02;Maanantai;0;0;0;0;0;0
89;02.05.2016;2016;05;03;Maanantai;1;1;2;0;1;1
89;02.05.2016;2016;05;04;Maanantai;3;6;9;0;1;1
89;02.05.2016;2016;05;05;Maanantai;3;16;19;1;2;3
89;02.05.2016;2016;05;06;Maanantai;20;53;73;0;7;7
89;02.05.2016;2016;05;07;Maanantai;40;194;234;8;18;26
89;02.05.2016;2016;05;08;Maanantai;59;251;310;12;41;53
89;02.05.2016;2016;05;09;Maanantai;54;151;205;16;41;57
89;02.05.2016;2016;05;10;Maanantai;69;86;155;19;34;53
89;02.05.2016;2016;05;11;Maanantai;72;87;159;25;40;65
89;02.05.2016;2016;05;12;Maanantai;74;64;138;18;22;40
89;02.05.2016;2016;05;13;Maanantai;78;71;149;17;28;45
89;02.05.2016;2016;05;14;Maanantai;127;72;199;10;20;30
89;02.05.2016;2016;05;15;Maanantai;182;83;265;33;11;44
89;02.05.2016;2016;05;16;Maanantai;226;114;340;39;30;69
89;02.05.2016;2016;05;17;Maanantai;143;106;249;33;32;65
89;02.05.2016;2016;05;18;Maanantai;114;80;194;34;53;87
89;02.05.2016;2016;05;19;Maanantai;114;69;183;51;47;98
89;02.05.2016;2016;05;20;Maanantai;76;35;111;44;38;82
89;02.05.2016;2016;05;21;Maanantai;44;29;73;27;18;45
89;02.05.2016;2016;05;22;Maanantai;15;15;30;4;8;12
89;02.05.2016;2016;05;23;Maanantai;9;3;12;2;2;4
89;03.05.2016;2016;05;00;Tiistai;5;5;10;0;2;2
89;03.05.2016;2016;05;01;Tiistai;1;1;2;1;0;1
89;03.05.2016;2016;05;02;Tiistai;1;0;1;1;0;1
89;03.05.2016;2016;05;03;Tiistai;3;3;6;0;0;0
89;03.05.2016;2016;05;04;Tiistai;4;4;8;1;1;2
89;03.05.2016;2016;05;05;Tiistai;1;15;16;2;3;5
89;03.05.2016;2016;05;06;Tiistai;18;65;83;5;13;18
89;03.05.2016;2016;05;07;Tiistai;65;164;229;10;27;37
89;03.05.2016;2016;05;08;Tiistai;56;242;298;12;40;52
89;03.05.2016;2016;05;09;Tiistai;56;124;180;19;28;47
89;03.05.2016;2016;05;10;Tiistai;58;93;151;22;52;74
89;03.05.2016;2016;05;11;Tiistai;78;100;178;31;43;74
89;03.05.2016;2016;05;12;Tiistai;87;108;195;26;32;58
89;03.05.2016;2016;05;13;Tiistai;103;94;197;31;32;63
89;03.05.2016;2016;05;14;Tiistai;118;100;218;33;26;59
89;03.05.2016;2016;05;15;Tiistai;214;100;314;22;28;50
89;03.05.2016;2016;05;16;Tiistai;233;143;376;31;29;60
89;03.05.2016;2016;05;17;Tiistai;173;91;264;43;25;68
89;03.05.2016;2016;05;18;Tiistai;143;71;214;32;24;56
89;03.05.2016;2016;05;19;Tiistai;104;50;154;23;38;61
89;03.05.2016;2016;05;20;Tiistai;91;47;138;33;31;64
89;03.05.2016;2016;05;21;Tiistai;61;47;108;18;16;34
89;03.05.2016;2016;05;22;Tiistai;24;17;41;4;6;10
89;03.05.2016;2016;05;23;Tiistai;10;7;17;5;7;12
89;04.05.2016;2016;05;00;Keskiviikko;4;0;4;4;3;7
89;04.05.2016;2016;05;01;Keskiviikko;9;1;10;2;0;2
89;04.05.2016;2016;05;02;Keskiviikko;8;2;10;2;1;3
89;04.05.2016;2016;05;03;Keskiviikko;1;0;1;0;0;0
89;04.05.2016;2016;05;04;Keskiviikko;3;5;8;1;0;1
89;04.05.2016;2016;05;05;Keskiviikko;3;15;18;1;2;3
89;04.05.2016;2016;05;06;Keskiviikko;19;61;80;2;14;16
89;04.05.2016;2016;05;07;Keskiviikko;38;183;221;9;26;35
89;04.05.2016;2016;05;08;Keskiviikko;54;268;322;7;54;61
89;04.05.2016;2016;05;09;Keskiviikko;55;140;195;28;40;68
89;04.05.2016;2016;05;10;Keskiviikko;45;99;144;21;44;65
89;04.05.2016;2016;05;11;Keskiviikko;81;103;184;28;31;59
89;04.05.2016;2016;05;12;Keskiviikko;102;126;228;25;29;54
89;04.05.2016;2016;05;13;Keskiviikko;124;100;224;15;22;37
89;04.05.2016;2016;05;14;Keskiviikko;156;103;259;35;27;62
89;04.05.2016;2016;05;15;Keskiviikko;244;107;351;29;27;56
89;04.05.2016;2016;05;16;Keskiviikko;224;175;399;41;37;78
89;04.05.2016;2016;05;17;Keskiviikko;143;106;249;28;32;60
89;04.05.2016;2016;05;18;Keskiviikko;113;96;209;29;25;54
89;04.05.2016;2016;05;19;Keskiviikko;102;80;182;41;34;75
89;04.05.2016;2016;05;20;Keskiviikko;83;74;157;31;28;59
89;04.05.2016;2016;05;21;Keskiviikko;84;57;141;8;23;31
89;04.05.2016;2016;05;22;Keskiviikko;50;29;79;8;9;17
89;04.05.2016;2016;05;23;Keskiviikko;23;30;53;5;6;11
89;05.05.2016;2016;05;00;Torstai;17;15;32;4;4;8
89;05.05.2016;2016;05;01;Torstai;21;7;28;4;3;7
89;05.05.2016;2016;05;02;Torstai;11;1;12;5;1;6
89;05.05.2016;2016;05;03;Torstai;11;0;11;7;0;7
89;05.05.2016;2016;05;04;Torstai;14;6;20;2;0;2
89;05.05.2016;2016;05;05;Torstai;3;10;13;3;0;3
89;05.05.2016;2016;05;06;Torstai;6;13;19;1;2;3
89;05.05.2016;2016;05;07;Torstai;6;12;18;4;13;17
89;05.05.2016;2016;05;08;Torstai;10;26;36;12;13;25
89;05.05.2016;2016;05;09;Torstai;31;40;71;29;42;71
89;05.05.2016;2016;05;10;Torstai;34;76;110;23;56;79
89;05.05.2016;2016;05;11;Torstai;67;114;181;28;55;83
89;05.05.2016;2016;05;12;Torstai;97;117;214;46;78;124
89;05.05.2016;2016;05;13;Torstai;119;149;268;50;68;118
89;05.05.2016;2016;05;14;Torstai;128;165;293;51;55;106
89;05.05.2016;2016;05;15;Torstai;155;130;285;38;64;102
89;05.05.2016;2016;05;16;Torstai;151;163;314;51;62;113
89;05.05.2016;2016;05;17;Torstai;134;113;247;45;68;113
89;05.05.2016;2016;05;18;Torstai;118;84;202;43;40;83
89;05.05.2016;2016;05;19;Torstai;98;107;205;35;44;79
89;05.05.2016;2016;05;20;Torstai;77;63;140;30;47;77
89;05.05.2016;2016;05;21;Torstai;65;47;112;28;22;50
89;05.05.2016;2016;05;22;Torstai;46;25;71;13;4;17
89;05.05.2016;2016;05;23;Torstai;24;3;27;4;4;8
89;06.05.2016;2016;05;00;Perjantai;6;12;18;5;0;5
89;06.05.2016;2016;05;01;Perjantai;2;1;3;3;0;3
89;06.05.2016;2016;05;02;Perjantai;2;3;5;4;0;4
89;06.05.2016;2016;05;03;Perjantai;5;1;6;2;1;3
89;06.05.2016;2016;05;04;Perjantai;4;4;8;0;3;3
89;06.05.2016;2016;05;05;Perjantai;2;18;20;2;2;4
89;06.05.2016;2016;05;06;Perjantai;14;39;53;2;8;10
89;06.05.2016;2016;05;07;Perjantai;27;100;127;7;12;19
89;06.05.2016;2016;05;08;Perjantai;26;118;144;3;21;24
89;06.05.2016;2016;05;09;Perjantai;31;101;132;10;29;39
89;06.05.2016;2016;05;10;Perjantai;40;130;170;22;43;65
89;06.05.2016;2016;05;11;Perjantai;66;124;190;18;29;47
89;06.05.2016;2016;05;12;Perjantai;100;152;252;21;45;66
89;06.05.2016;2016;05;13;Perjantai;103;151;254;35;49;84
89;06.05.2016;2016;05;14;Perjantai;164;122;286;43;46;89
89;06.05.2016;2016;05;15;Perjantai;206;124;330;49;40;89
89;06.05.2016;2016;05;16;Perjantai;224;140;364;42;29;71
89;06.05.2016;2016;05;17;Perjantai;133;136;269;26;43;69
89;06.05.2016;2016;05;18;Perjantai;131;85;216;33;38;71
89;06.05.2016;2016;05;19;Perjantai;101;69;170;28;26;54
89;06.05.2016;2016;05;20;Perjantai;76;47;123;22;37;59
89;06.05.2016;2016;05;21;Perjantai;55;33;88;18;14;32
89;06.05.2016;2016;05;22;Perjantai;43;33;76;6;6;12
89;06.05.2016;2016;05;23;Perjantai;25;31;56;10;11;21
89;07.05.2016;2016;05;00;Lauantai;25;34;59;7;9;16
89;07.05.2016;2016;05;01;Lauantai;20;9;29;5;4;9
89;07.05.2016;2016;05;02;Lauantai;20;12;32;7;2;9
89;07.05.2016;2016;05;03;Lauantai;17;3;20;7;1;8
89;07.05.2016;2016;05;04;Lauantai;11;9;20;3;1;4
89;07.05.2016;2016;05;05;Lauantai;4;7;11;3;2;5
89;07.05.2016;2016;05;06;Lauantai;5;12;17;1;3;4
89;07.05.2016;2016;05;07;Lauantai;5;22;27;3;6;9
89;07.05.2016;2016;05;08;Lauantai;9;34;43;6;9;15
89;07.05.2016;2016;05;09;Lauantai;27;74;101;10;22;32
89;07.05.2016;2016;05;10;Lauantai;40;108;148;21;37;58
89;07.05.2016;2016;05;11;Lauantai;57;129;186;26;42;68
89;07.05.2016;2016;05;12;Lauantai;90;138;228;33;39;72
89;07.05.2016;2016;05;13;Lauantai;118;154;272;36;41;77
89;07.05.2016;2016;05;14;Lauantai;136;135;271;39;62;101
89;07.05.2016;2016;05;15;Lauantai;125;124;249;29;44;73
89;07.05.2016;2016;05;16;Lauantai;139;100;239;56;39;95
89;07.05.2016;2016;05;17;Lauantai;109;86;195;34;45;79
89;07.05.2016;2016;05;18;Lauantai;103;102;205;42;39;81
89;07.05.2016;2016;05;19;Lauantai;100;75;175;33;34;67
89;07.05.2016;2016;05;20;Lauantai;72;53;125;17;26;43
89;07.05.2016;2016;05;21;Lauantai;63;72;135;10;24;34
89;07.05.2016;2016;05;22;Lauantai;34;40;74;4;18;22
89;07.05.2016;2016;05;23;Lauantai;35;36;71;7;14;21
89;08.05.2016;2016;05;00;Sunnuntai;28;20;48;4;3;7
89;08.05.2016;2016;05;01;Sunnuntai;17;9;26;6;3;9
89;08.05.2016;2016;05;02;Sunnuntai;13;9;22;6;5;11
89;08.05.2016;2016;05;03;Sunnuntai;20;3;23;3;0;3
89;08.05.2016;2016;05;04;Sunnuntai;9;0;9;5;0;5
89;08.05.2016;2016;05;05;Sunnuntai;5;2;7;2;0;2
89;08.05.2016;2016;05;06;Sunnuntai;6;7;13;0;1;1
89;08.05.2016;2016;05;07;Sunnuntai;5;13;18;6;7;13
89;08.05.2016;2016;05;08;Sunnuntai;9;21;30;5;6;11
89;08.05.2016;2016;05;09;Sunnuntai;20;39;59;13;24;37
89;08.05.2016;2016;05;10;Sunnuntai;45;96;141;23;38;61
89;08.05.2016;2016;05;11;Sunnuntai;75;116;191;39;65;104
89;08.05.2016;2016;05;12;Sunnuntai;74;142;216;47;83;130
89;08.05.2016;2016;05;13;Sunnuntai;134;143;277;46;55;101
89;08.05.2016;2016;05;14;Sunnuntai;133;137;270;36;53;89
89;08.05.2016;2016;05;15;Sunnuntai;147;110;257;46;49;95
89;08.05.2016;2016;05;16;Sunnuntai;105;54;159;29;25;54
89;08.05.2016;2016;05;17;Sunnuntai;74;45;119;37;27;64
89;08.05.2016;2016;05;18;Sunnuntai;67;52;119;15;35;50
89;08.05.2016;2016;05;19;Sunnuntai;75;61;136;39;24;63
89;08.05.2016;2016;05;20;Sunnuntai;51;40;91;20;21;41
89;08.05.2016;2016;05;21;Sunnuntai;27;24;51;18;20;38
89;08.05.2016;2016;05;22;Sunnuntai;19;19;38;8;13;21
89;08.05.2016;2016;05;23;Sunnuntai;10;4;14;6;6;12
89;09.05.2016;2016;05;00;Maanantai;7;4;11;0;2;2
89;09.05.2016;2016;05;01;Maanantai;5;2;7;1;0;1
89;09.05.2016;2016;05;02;Maanantai;5;0;5;0;0;0
89;09.05.2016;2016;05;03;Maanantai;0;1;1;0;0;0
89;09.05.2016;2016;05;04;Maanantai;2;8;10;0;1;1
89;09.05.2016;2016;05;05;Maanantai;6;13;19;1;2;3
89;09.05.2016;2016;05;06;Maanantai;15;81;96;2;3;5
89;09.05.2016;2016;05;07;Maanantai;52;206;258;5;27;32
89;09.05.2016;2016;05;08;Maanantai;82;244;326;8;35;43
89;09.05.2016;2016;05;09;Maanantai;57;172;229;16;38;54
89;09.05.2016;2016;05;10;Maanantai;54;111;165;19;31;50
89;09.05.2016;2016;05;11;Maanantai;90;114;204;31;37;68
89;09.05.2016;2016;05;12;Maanantai;104;107;211;27;40;67
89;09.05.2016;2016;05;13;Maanantai;109;108;217;30;35;65
89;09.05.2016;2016;05;14;Maanantai;162;109;271;27;42;69
89;09.05.2016;2016;05;15;Maanantai;244;112;356;49;38;87
89;09.05.2016;2016;05;16;Maanantai;256;134;390;32;18;50
89;09.05.2016;2016;05;17;Maanantai;185;133;318;29;31;60
89;09.05.2016;2016;05;18;Maanantai;132;80;212;45;53;98
89;09.05.2016;2016;05;19;Maanantai;122;53;175;50;37;87
89;09.05.2016;2016;05;20;Maanantai;75;37;112;23;19;42
89;09.05.2016;2016;05;21;Maanantai;46;27;73;9;7;16
89;09.05.2016;2016;05;22;Maanantai;18;15;33;6;1;7
89;09.05.2016;2016;05;23;Maanantai;18;11;29;5;1;6
89;10.05.2016;2016;05;00;Tiistai;6;0;6;2;1;3
89;10.05.2016;2016;05;01;Tiistai;2;4;6;0;0;0
89;10.05.2016;2016;05;02;Tiistai;2;2;4;0;0;0
89;10.05.2016;2016;05;03;Tiistai;2;1;3;0;0;0
89;10.05.2016;2016;05;04;Tiistai;1;4;5;3;1;4
89;10.05.2016;2016;05;05;Tiistai;8;12;20;0;1;1
89;10.05.2016;2016;05;06;Tiistai;13;51;64;1;6;7
89;10.05.2016;2016;05;07;Tiistai;29;121;150;4;16;20
89;10.05.2016;2016;05;08;Tiistai;24;165;189;9;33;42
89;10.05.2016;2016;05;09;Tiistai;20;77;97;4;13;17
89;10.05.2016;2016;05;10;Tiistai;22;61;83;9;20;29
89;10.05.2016;2016;05;11;Tiistai;31;53;84;16;11;27
89;10.05.2016;2016;05;12;Tiistai;39;68;107;18;22;40
89;10.05.2016;2016;05;13;Tiistai;55;37;92;19;5;24
89;10.05.2016;2016;05;14;Tiistai;86;69;155;25;20;45
89;10.05.2016;2016;05;15;Tiistai;135;58;193;30;26;56
89;10.05.2016;2016;05;16;Tiistai;165;83;248;35;17;52
89;10.05.2016;2016;05;17;Tiistai;106;74;180;22;19;41
89;10.05.2016;2016;05;18;Tiistai;77;47;124;35;30;65
89;10.05.2016;2016;05;19;Tiistai;88;50;138;28;46;74
89;10.05.2016;2016;05;20;Tiistai;81;46;127;31;18;49
89;10.05.2016;2016;05;21;Tiistai;38;33;71;18;19;37
89;10.05.2016;2016;05;22;Tiistai;23;16;39;2;3;5
89;10.05.2016;2016;05;23;Tiistai;12;5;17;3;2;5
89;11.05.2016;2016;05;00;Keskiviikko;7;2;9;2;0;2
89;11.05.2016;2016;05;01;Keskiviikko;6;3;9;0;0;0
89;11.05.2016;2016;05;02;Keskiviikko;5;0;5;0;1;1
89;11.05.2016;2016;05;03;Keskiviikko;2;2;4;0;0;0
89;11.05.2016;2016;05;04;Keskiviikko;1;6;7;1;1;2
89;11.05.2016;2016;05;05;Keskiviikko;3;15;18;0;1;1
89;11.05.2016;2016;05;06;Keskiviikko;24;53;77;5;10;15
89;11.05.2016;2016;05;07;Keskiviikko;49;226;275;8;28;36
89;11.05.2016;2016;05;08;Keskiviikko;65;254;319;23;56;79
89;11.05.2016;2016;05;09;Keskiviikko;49;174;223;13;18;31
89;11.05.2016;2016;05;10;Keskiviikko;59;108;167;21;43;64
89;11.05.2016;2016;05;11;Keskiviikko;89;98;187;31;24;55
89;11.05.2016;2016;05;12;Keskiviikko;120;132;252;33;58;91
89;11.05.2016;2016;05;13;Keskiviikko;116;77;193;23;37;60
89;11.05.2016;2016;05;14;Keskiviikko;135;85;220;35;32;67
89;11.05.2016;2016;05;15;Keskiviikko;179;116;295;29;32;61
89;11.05.2016;2016;05;16;Keskiviikko;288;127;415;37;27;64
89;11.05.2016;2016;05;17;Keskiviikko;160;96;256;37;27;64
89;11.05.2016;2016;05;18;Keskiviikko;105;100;205;49;51;100
89;11.05.2016;2016;05;19;Keskiviikko;121;72;193;39;48;87
89;11.05.2016;2016;05;20;Keskiviikko;72;47;119;29;16;45
89;11.05.2016;2016;05;21;Keskiviikko;47;24;71;11;9;20
89;11.05.2016;2016;05;22;Keskiviikko;30;15;45;3;3;6
89;11.05.2016;2016;05;23;Keskiviikko;25;15;40;3;5;8
89;12.05.2016;2016;05;00;Torstai;9;2;11;1;4;5
89;12.05.2016;2016;05;01;Torstai;2;1;3;1;2;3
89;12.05.2016;2016;05;02;Torstai;3;6;9;2;2;4
89;12.05.2016;2016;05;03;Torstai;3;3;6;2;0;2
89;12.05.2016;2016;05;04;Torstai;4;8;12;1;1;2
89;12.05.2016;2016;05;05;Torstai;3;11;14;0;1;1
89;12.05.2016;2016;05;06;Torstai;21;64;85;2;11;13
89;12.05.2016;2016;05;07;Torstai;50;176;226;7;29;36
89;12.05.2016;2016;05;08;Torstai;52;276;328;8;41;49
89;12.05.2016;2016;05;09;Torstai;49;142;191;16;57;73
89;12.05.2016;2016;05;10;Torstai;59;121;180;25;31;56
89;12.05.2016;2016;05;11;Torstai;80;91;171;28;45;73
89;12.05.2016;2016;05;12;Torstai;84;141;225;25;27;52
89;12.05.2016;2016;05;13;Torstai;104;98;202;31;30;61
89;12.05.2016;2016;05;14;Torstai;185;124;309;28;36;64
89;12.05.2016;2016;05;15;Torstai;240;108;348;31;40;71
89;12.05.2016;2016;05;16;Torstai;273;148;421;33;32;65
89;12.05.2016;2016;05;17;Torstai;141;132;273;36;54;90
89;12.05.2016;2016;05;18;Torstai;145;117;262;39;40;79
89;12.05.2016;2016;05;19;Torstai;120;89;209;54;61;115
89;12.05.2016;2016;05;20;Torstai;114;61;175;29;26;55
89;12.05.2016;2016;05;21;Torstai;84;31;115;24;14;38
89;12.05.2016;2016;05;22;Torstai;35;35;70;6;8;14
89;12.05.2016;2016;05;23;Torstai;25;21;46;3;6;9
89;13.05.2016;2016;05;00;Perjantai;12;7;19;1;0;1
89;13.05.2016;2016;05;01;Perjantai;7;4;11;0;2;2
89;13.05.2016;2016;05;02;Perjantai;4;0;4;0;0;0
89;13.05.2016;2016;05;03;Perjantai;5;3;8;0;0;0
89;13.05.2016;2016;05;04;Perjantai;4;4;8;3;2;5
89;13.05.2016;2016;05;05;Perjantai;5;15;20;0;3;3
89;13.05.2016;2016;05;06;Perjantai;18;50;68;3;8;11
89;13.05.2016;2016;05;07;Perjantai;37;162;199;8;25;33
89;13.05.2016;2016;05;08;Perjantai;45;214;259;10;39;49
89;13.05.2016;2016;05;09;Perjantai;57;179;236;36;39;75
89;13.05.2016;2016;05;10;Perjantai;56;114;170;23;38;61
89;13.05.2016;2016;05;11;Perjantai;83;104;187;16;35;51
89;13.05.2016;2016;05;12;Perjantai;74;92;166;23;35;58
89;13.05.2016;2016;05;13;Perjantai;122;96;218;18;18;36
89;13.05.2016;2016;05;14;Perjantai;127;112;239;28;23;51
89;13.05.2016;2016;05;15;Perjantai;203;99;302;24;13;37
89;13.05.2016;2016;05;16;Perjantai;169;95;264;24;22;46
89;13.05.2016;2016;05;17;Perjantai;102;80;182;14;21;35
89;13.05.2016;2016;05;18;Perjantai;98;58;156;24;24;48
89;13.05.2016;2016;05;19;Perjantai;67;42;109;18;13;31
89;13.05.2016;2016;05;20;Perjantai;51;37;88;8;13;21
89;13.05.2016;2016;05;21;Perjantai;45;19;64;9;6;15
89;13.05.2016;2016;05;22;Perjantai;30;35;65;4;12;16
89;13.05.2016;2016;05;23;Perjantai;22;21;43;5;9;14
89;14.05.2016;2016;05;00;Lauantai;17;14;31;3;4;7
89;14.05.2016;2016;05;01;Lauantai;18;7;25;3;4;7
89;14.05.2016;2016;05;02;Lauantai;22;7;29;3;1;4
89;14.05.2016;2016;05;03;Lauantai;12;2;14;1;0;1
89;14.05.2016;2016;05;04;Lauantai;18;2;20;5;1;6
89;14.05.2016;2016;05;05;Lauantai;0;7;7;1;1;2
89;14.05.2016;2016;05;06;Lauantai;0;12;12;1;2;3
89;14.05.2016;2016;05;07;Lauantai;6;18;24;5;3;8
89;14.05.2016;2016;05;08;Lauantai;9;42;51;12;13;25
89;14.05.2016;2016;05;09;Lauantai;17;57;74;12;17;29
89;14.05.2016;2016;05;10;Lauantai;27;66;93;25;48;73
89;14.05.2016;2016;05;11;Lauantai;45;83;128;26;34;60
89;14.05.2016;2016;05;12;Lauantai;62;70;132;24;29;53
89;14.05.2016;2016;05;13;Lauantai;44;65;109;16;27;43
89;14.05.2016;2016;05;14;Lauantai;65;54;119;12;23;35
89;14.05.2016;2016;05;15;Lauantai;84;64;148;25;37;62
89;14.05.2016;2016;05;16;Lauantai;76;49;125;22;13;35
89;14.05.2016;2016;05;17;Lauantai;74;52;126;14;18;32
89;14.05.2016;2016;05;18;Lauantai;47;56;103;19;16;35
89;14.05.2016;2016;05;19;Lauantai;47;32;79;9;17;26
89;14.05.2016;2016;05;20;Lauantai;38;39;77;18;17;35
89;14.05.2016;2016;05;21;Lauantai;30;48;78;7;14;21
89;14.05.2016;2016;05;22;Lauantai;25;21;46;6;5;11
89;14.05.2016;2016;05;23;Lauantai;14;21;35;2;10;12
89;15.05.2016;2016;05;00;Sunnuntai;19;15;34;7;5;12
89;15.05.2016;2016;05;01;Sunnuntai;16;12;28;7;3;10
89;15.05.2016;2016;05;02;Sunnuntai;26;11;37;4;0;4
89;15.05.2016;2016;05;03;Sunnuntai;21;6;27;1;0;1
89;15.05.2016;2016;05;04;Sunnuntai;13;3;16;5;0;5
89;15.05.2016;2016;05;05;Sunnuntai;4;3;7;1;0;1
89;15.05.2016;2016;05;06;Sunnuntai;4;4;8;0;1;1
89;15.05.2016;2016;05;07;Sunnuntai;8;9;17;2;1;3
89;15.05.2016;2016;05;08;Sunnuntai;4;6;10;7;6;13
89;15.05.2016;2016;05;09;Sunnuntai;13;27;40;18;14;32
89;15.05.2016;2016;05;10;Sunnuntai;16;41;57;24;36;60
89;15.05.2016;2016;05;11;Sunnuntai;33;56;89;37;44;81
89;15.05.2016;2016;05;12;Sunnuntai;52;62;114;33;40;73
89;15.05.2016;2016;05;13;Sunnuntai;63;57;120;26;26;52
89;15.05.2016;2016;05;14;Sunnuntai;66;39;105;19;26;45
89;15.05.2016;2016;05;15;Sunnuntai;43;48;91;23;28;51
89;15.05.2016;2016;05;16;Sunnuntai;54;47;101;21;19;40
89;15.05.2016;2016;05;17;Sunnuntai;85;47;132;22;30;52
89;15.05.2016;2016;05;18;Sunnuntai;56;37;93;29;20;49
89;15.05.2016;2016;05;19;Sunnuntai;44;41;85;21;21;42
89;15.05.2016;2016;05;20;Sunnuntai;50;18;68;22;13;35
89;15.05.2016;2016;05;21;Sunnuntai;18;13;31;6;11;17
89;15.05.2016;2016;05;22;Sunnuntai;19;10;29;6;7;13
89;15.05.2016;2016;05;23;Sunnuntai;7;10;17;2;3;5
89;16.05.2016;2016;05;00;Maanantai;3;4;7;0;0;0
89;16.05.2016;2016;05;01;Maanantai;2;0;2;0;1;1
89;16.05.2016;2016;05;02;Maanantai;3;1;4;0;0;0
89;16.05.2016;2016;05;03;Maanantai;1;1;2;1;0;1
89;16.05.2016;2016;05;04;Maanantai;4;8;12;1;2;3
89;16.05.2016;2016;05;05;Maanantai;4;15;19;0;1;1
89;16.05.2016;2016;05;06;Maanantai;17;70;87;3;5;8
89;16.05.2016;2016;05;07;Maanantai;30;180;210;9;19;28
89;16.05.2016;2016;05;08;Maanantai;68;271;339;6;45;51
89;16.05.2016;2016;05;09;Maanantai;51;133;184;13;40;53
89;16.05.2016;2016;05;10;Maanantai;49;92;141;23;39;62
89;16.05.2016;2016;05;11;Maanantai;72;88;160;25;39;64
89;16.05.2016;2016;05;12;Maanantai;82;114;196;21;27;48
89;16.05.2016;2016;05;13;Maanantai;105;100;205;35;31;66
89;16.05.2016;2016;05;14;Maanantai;170;122;292;39;24;63
89;16.05.2016;2016;05;15;Maanantai;216;105;321;24;38;62
89;16.05.2016;2016;05;16;Maanantai;252;117;369;42;26;68
89;16.05.2016;2016;05;17;Maanantai;175;110;285;26;38;64
89;16.05.2016;2016;05;18;Maanantai;141;121;262;41;46;87
89;16.05.2016;2016;05;19;Maanantai;114;64;178;49;53;102
89;16.05.2016;2016;05;20;Maanantai;113;72;185;40;38;78
89;16.05.2016;2016;05;21;Maanantai;61;45;106;24;31;55
89;16.05.2016;2016;05;22;Maanantai;32;24;56;13;17;30
89;16.05.2016;2016;05;23;Maanantai;15;12;27;6;3;9
89;17.05.2016;2016;05;00;Tiistai;8;6;14;4;1;5
89;17.05.2016;2016;05;01;Tiistai;4;4;8;1;0;1
89;17.05.2016;2016;05;02;Tiistai;4;3;7;2;1;3
89;17.05.2016;2016;05;03;Tiistai;4;1;5;0;0;0
89;17.05.2016;2016;05;04;Tiistai;1;8;9;1;1;2
89;17.05.2016;2016;05;05;Tiistai;1;11;12;0;1;1
89;17.05.2016;2016;05;06;Tiistai;22;47;69;2;13;15
89;17.05.2016;2016;05;07;Tiistai;32;136;168;8;16;24
89;17.05.2016;2016;05;08;Tiistai;35;178;213;6;33;39
89;17.05.2016;2016;05;09;Tiistai;37;87;124;9;21;30
89;17.05.2016;2016;05;10;Tiistai;21;46;67;10;33;43
89;17.05.2016;2016;05;11;Tiistai;39;29;68;4;13;17
89;17.05.2016;2016;05;12;Tiistai;35;39;74;10;13;23
89;17.05.2016;2016;05;13;Tiistai;50;39;89;11;13;24
89;17.05.2016;2016;05;14;Tiistai;67;47;114;11;15;26
89;17.05.2016;2016;05;15;Tiistai;145;70;215;26;21;47
89;17.05.2016;2016;05;16;Tiistai;184;87;271;42;25;67
89;17.05.2016;2016;05;17;Tiistai;99;54;153;34;17;51
89;17.05.2016;2016;05;18;Tiistai;87;68;155;31;35;66
89;17.05.2016;2016;05;19;Tiistai;85;48;133;37;29;66
89;17.05.2016;2016;05;20;Tiistai;53;41;94;17;23;40
89;17.05.2016;2016;05;21;Tiistai;26;22;48;14;7;21
89;17.05.2016;2016;05;22;Tiistai;29;17;46;1;3;4
89;17.05.2016;2016;05;23;Tiistai;18;11;29;2;1;3
89;18.05.2016;2016;05;00;Keskiviikko;11;10;21;1;1;2
89;18.05.2016;2016;05;01;Keskiviikko;4;2;6;3;1;4
89;18.05.2016;2016;05;02;Keskiviikko;1;1;2;0;0;0
89;18.05.2016;2016;05;03;Keskiviikko;1;4;5;0;0;0
89;18.05.2016;2016;05;04;Keskiviikko;2;9;11;2;1;3
89;18.05.2016;2016;05;05;Keskiviikko;1;16;17;2;1;3
89;18.05.2016;2016;05;06;Keskiviikko;18;71;89;5;13;18
89;18.05.2016;2016;05;07;Keskiviikko;58;192;250;5;29;34
89;18.05.2016;2016;05;08;Keskiviikko;53;281;334;19;37;56
89;18.05.2016;2016;05;09;Keskiviikko;59;135;194;19;44;63
89;18.05.2016;2016;05;10;Keskiviikko;49;79;128;33;40;73
89;18.05.2016;2016;05;11;Keskiviikko;94;98;192;53;94;147
89;18.05.2016;2016;05;12;Keskiviikko;91;123;214;37;27;64
89;18.05.2016;2016;05;13;Keskiviikko;90;81;171;15;29;44
89;18.05.2016;2016;05;14;Keskiviikko;129;72;201;22;21;43
89;18.05.2016;2016;05;15;Keskiviikko;159;77;236;15;13;28
89;18.05.2016;2016;05;16;Keskiviikko;206;94;300;17;12;29
89;18.05.2016;2016;05;17;Keskiviikko;94;52;146;17;6;23
89;18.05.2016;2016;05;18;Keskiviikko;76;26;102;19;11;30
89;18.05.2016;2016;05;19;Keskiviikko;48;29;77;20;15;35
89;18.05.2016;2016;05;20;Keskiviikko;43;22;65;11;14;25
89;18.05.2016;2016;05;21;Keskiviikko;38;19;57;14;10;24
89;18.05.2016;2016;05;22;Keskiviikko;21;8;29;6;3;9
89;18.05.2016;2016;05;23;Keskiviikko;9;4;13;2;2;4
89;19.05.2016;2016;05;00;Torstai;6;6;12;2;1;3
89;19.05.2016;2016;05;01;Torstai;7;2;9;1;0;1
89;19.05.2016;2016;05;02;Torstai;3;0;3;1;1;2
89;19.05.2016;2016;05;03;Torstai;7;5;12;1;1;2
89;19.05.2016;2016;05;04;Torstai;5;4;9;2;0;2
89;19.05.2016;2016;05;05;Torstai;1;9;10;1;0;1
89;19.05.2016;2016;05;06;Torstai;18;51;69;1;8;9
89;19.05.2016;2016;05;07;Torstai;24;138;162;5;19;24
89;19.05.2016;2016;05;08;Torstai;38;191;229;4;27;31
89;19.05.2016;2016;05;09;Torstai;20;100;120;11;80;91
89;19.05.2016;2016;05;10;Torstai;27;77;104;10;39;49
89;19.05.2016;2016;05;11;Torstai;30;63;93;19;20;39
89;19.05.2016;2016;05;12;Torstai;65;79;144;25;22;47
89;19.05.2016;2016;05;13;Torstai;81;84;165;24;15;39
89;19.05.2016;2016;05;14;Torstai;107;75;182;16;27;43
89;19.05.2016;2016;05;15;Torstai;172;95;267;30;26;56
89;19.05.2016;2016;05;16;Torstai;196;81;277;35;17;52
89;19.05.2016;2016;05;17;Torstai;75;67;142;22;12;34
89;19.05.2016;2016;05;18;Torstai;92;52;144;16;19;35
89;19.05.2016;2016;05;19;Torstai;82;53;135;36;28;64
89;19.05.2016;2016;05;20;Torstai;89;36;125;22;13;35
89;19.05.2016;2016;05;21;Torstai;47;21;68;12;6;18
89;19.05.2016;2016;05;22;Torstai;11;14;25;5;2;7
89;19.05.2016;2016;05;23;Torstai;13;14;27;1;3;4
89;20.05.2016;2016;05;00;Perjantai;3;7;10;2;5;7
89;20.05.2016;2016;05;01;Perjantai;4;4;8;3;0;3
89;20.05.2016;2016;05;02;Perjantai;2;1;3;0;0;0
89;20.05.2016;2016;05;03;Perjantai;3;4;7;0;1;1
89;20.05.2016;2016;05;04;Perjantai;5;10;15;2;1;3
89;20.05.2016;2016;05;05;Perjantai;2;19;21;1;1;2
89;20.05.2016;2016;05;06;Perjantai;26;72;98;3;8;11
89;20.05.2016;2016;05;07;Perjantai;25;159;184;7;20;27
89;20.05.2016;2016;05;08;Perjantai;41;219;260;16;41;57
89;20.05.2016;2016;05;09;Perjantai;39;128;167;20;28;48
89;20.05.2016;2016;05;10;Perjantai;50;126;176;24;39;63
89;20.05.2016;2016;05;11;Perjantai;68;136;204;35;44;79
89;20.05.2016;2016;05;12;Perjantai;108;125;233;43;28;71
89;20.05.2016;2016;05;13;Perjantai;110;114;224;33;45;78
89;20.05.2016;2016;05;14;Perjantai;151;99;250;23;33;56
89;20.05.2016;2016;05;15;Perjantai;213;117;330;42;38;80
89;20.05.2016;2016;05;16;Perjantai;201;132;333;42;28;70
89;20.05.2016;2016;05;17;Perjantai;142;98;240;35;35;70
89;20.05.2016;2016;05;18;Perjantai;118;133;251;33;37;70
89;20.05.2016;2016;05;19;Perjantai;109;94;203;39;39;78
89;20.05.2016;2016;05;20;Perjantai;114;69;183;43;30;73
89;20.05.2016;2016;05;21;Perjantai;63;68;131;29;31;60
89;20.05.2016;2016;05;22;Perjantai;56;68;124;26;40;66
89;20.05.2016;2016;05;23;Perjantai;40;39;79;19;39;58
89;21.05.2016;2016;05;00;Lauantai;32;30;62;7;14;21
89;21.05.2016;2016;05;01;Lauantai;24;15;39;6;7;13
89;21.05.2016;2016;05;02;Lauantai;20;8;28;5;5;10
89;21.05.2016;2016;05;03;Lauantai;17;6;23;8;3;11
89;21.05.2016;2016;05;04;Lauantai;19;2;21;6;2;8
89;21.05.2016;2016;05;05;Lauantai;4;5;9;2;0;2
89;21.05.2016;2016;05;06;Lauantai;7;14;21;2;2;4
89;21.05.2016;2016;05;07;Lauantai;7;17;24;4;4;8
89;21.05.2016;2016;05;08;Lauantai;7;40;47;12;11;23
89;21.05.2016;2016;05;09;Lauantai;26;79;105;10;22;32
89;21.05.2016;2016;05;10;Lauantai;64;132;196;18;44;62
89;21.05.2016;2016;05;11;Lauantai;92;158;250;32;57;89
89;21.05.2016;2016;05;12;Lauantai;90;186;276;27;62;89
89;21.05.2016;2016;05;13;Lauantai;117;199;316;48;39;87
89;21.05.2016;2016;05;14;Lauantai;152;156;308;32;49;81
89;21.05.2016;2016;05;15;Lauantai;192;98;290;36;29;65
89;21.05.2016;2016;05;16;Lauantai;105;61;166;24;22;46
89;21.05.2016;2016;05;17;Lauantai;57;44;101;10;28;38
89;21.05.2016;2016;05;18;Lauantai;70;45;115;21;13;34
89;21.05.2016;2016;05;19;Lauantai;42;64;106;24;27;51
89;21.05.2016;2016;05;20;Lauantai;33;48;81;15;17;32
89;21.05.2016;2016;05;21;Lauantai;32;24;56;9;12;21
89;21.05.2016;2016;05;22;Lauantai;21;26;47;5;7;12
89;21.05.2016;2016;05;23;Lauantai;26;24;50;5;5;10
89;22.05.2016;2016;05;00;Sunnuntai;25;10;35;11;5;16
89;22.05.2016;2016;05;01;Sunnuntai;16;10;26;1;2;3
89;22.05.2016;2016;05;02;Sunnuntai;21;6;27;5;2;7
89;22.05.2016;2016;05;03;Sunnuntai;23;1;24;6;1;7
89;22.05.2016;2016;05;04;Sunnuntai;17;3;20;2;0;2
89;22.05.2016;2016;05;05;Sunnuntai;1;2;3;4;1;5
89;22.05.2016;2016;05;06;Sunnuntai;4;5;9;0;3;3
89;22.05.2016;2016;05;07;Sunnuntai;6;3;9;1;0;1
89;22.05.2016;2016;05;08;Sunnuntai;4;12;16;2;9;11
89;22.05.2016;2016;05;09;Sunnuntai;13;13;26;11;27;38
89;22.05.2016;2016;05;10;Sunnuntai;17;37;54;27;24;51
89;22.05.2016;2016;05;11;Sunnuntai;34;59;93;31;43;74
89;22.05.2016;2016;05;12;Sunnuntai;70;107;177;38;53;91
89;22.05.2016;2016;05;13;Sunnuntai;114;126;240;36;48;84
89;22.05.2016;2016;05;14;Sunnuntai;117;148;265;50;58;108
89;22.05.2016;2016;05;15;Sunnuntai;113;155;268;52;61;113
89;22.05.2016;2016;05;16;Sunnuntai;152;114;266;37;51;88
89;22.05.2016;2016;05;17;Sunnuntai;111;96;207;49;47;96
89;22.05.2016;2016;05;18;Sunnuntai;114;82;196;46;41;87
89;22.05.2016;2016;05;19;Sunnuntai;85;97;182;39;40;79
89;22.05.2016;2016;05;20;Sunnuntai;82;65;147;14;29;43
89;22.05.2016;2016;05;21;Sunnuntai;29;19;48;8;12;20
89;22.05.2016;2016;05;22;Sunnuntai;17;13;30;7;4;11
89;22.05.2016;2016;05;23;Sunnuntai;51;30;81;4;10;14
89;23.05.2016;2016;05;00;Maanantai;10;13;23;1;1;2
89;23.05.2016;2016;05;01;Maanantai;9;10;19;4;7;11
89;23.05.2016;2016;05;02;Maanantai;6;4;10;5;1;6
89;23.05.2016;2016;05;03;Maanantai;6;4;10;1;0;1
89;23.05.2016;2016;05;04;Maanantai;4;8;12;3;1;4
89;23.05.2016;2016;05;05;Maanantai;3;10;13;1;2;3
89;23.05.2016;2016;05;06;Maanantai;22;77;99;3;12;15
89;23.05.2016;2016;05;07;Maanantai;38;204;242;6;18;24
89;23.05.2016;2016;05;08;Maanantai;51;294;345;11;42;53
89;23.05.2016;2016;05;09;Maanantai;58;183;241;18;38;56
89;23.05.2016;2016;05;10;Maanantai;86;129;215;13;25;38
89;23.05.2016;2016;05;11;Maanantai;88;150;238;37;55;92
89;23.05.2016;2016;05;12;Maanantai;117;110;227;34;24;58
89;23.05.2016;2016;05;13;Maanantai;121;131;252;43;28;71
89;23.05.2016;2016;05;14;Maanantai;177;122;299;30;40;70
89;23.05.2016;2016;05;15;Maanantai;243;115;358;30;35;65
89;23.05.2016;2016;05;16;Maanantai;304;160;464;35;25;60
89;23.05.2016;2016;05;17;Maanantai;191;168;359;34;48;82
89;23.05.2016;2016;05;18;Maanantai;170;161;331;65;64;129
89;23.05.2016;2016;05;19;Maanantai;148;105;253;54;45;99
89;23.05.2016;2016;05;20;Maanantai;118;70;188;28;35;63
89;23.05.2016;2016;05;21;Maanantai;91;33;124;24;18;42
89;23.05.2016;2016;05;22;Maanantai;33;13;46;6;10;16
89;23.05.2016;2016;05;23;Maanantai;12;13;25;2;9;11
89;24.05.2016;2016;05;00;Tiistai;7;6;13;2;4;6
89;24.05.2016;2016;05;01;Tiistai;2;3;5;0;0;0
89;24.05.2016;2016;05;02;Tiistai;0;1;1;2;1;3
89;24.05.2016;2016;05;03;Tiistai;1;2;3;1;0;1
89;24.05.2016;2016;05;04;Tiistai;3;10;13;0;1;1
89;24.05.2016;2016;05;05;Tiistai;2;18;20;0;1;1
89;24.05.2016;2016;05;06;Tiistai;22;79;101;3;10;13
89;24.05.2016;2016;05;07;Tiistai;47;208;255;6;24;30
89;24.05.2016;2016;05;08;Tiistai;69;291;360;12;36;48
89;24.05.2016;2016;05;09;Tiistai;54;160;214;16;45;61
89;24.05.2016;2016;05;10;Tiistai;61;119;180;27;42;69
89;24.05.2016;2016;05;11;Tiistai;76;148;224;18;37;55
89;24.05.2016;2016;05;12;Tiistai;137;120;257;33;48;81
89;24.05.2016;2016;05;13;Tiistai;138;107;245;23;23;46
89;24.05.2016;2016;05;14;Tiistai;162;102;264;30;27;57
89;24.05.2016;2016;05;15;Tiistai;236;87;323;26;15;41
89;24.05.2016;2016;05;16;Tiistai;256;81;337;27;19;46
89;24.05.2016;2016;05;17;Tiistai;130;58;188;15;13;28
89;24.05.2016;2016;05;18;Tiistai;99;41;140;21;21;42
89;24.05.2016;2016;05;19;Tiistai;60;40;100;23;25;48
89;24.05.2016;2016;05;20;Tiistai;72;29;101;21;18;39
89;24.05.2016;2016;05;21;Tiistai;39;23;62;19;16;35
89;24.05.2016;2016;05;22;Tiistai;17;16;33;3;5;8
89;24.05.2016;2016;05;23;Tiistai;12;15;27;2;1;3
89;25.05.2016;2016;05;00;Keskiviikko;0;3;3;0;1;1
89;25.05.2016;2016;05;01;Keskiviikko;2;5;7;3;0;3
89;25.05.2016;2016;05;02;Keskiviikko;0;2;2;0;0;0
89;25.05.2016;2016;05;03;Keskiviikko;1;1;2;0;0;0
89;25.05.2016;2016;05;04;Keskiviikko;3;5;8;0;1;1
89;25.05.2016;2016;05;05;Keskiviikko;5;15;20;1;0;1
89;25.05.2016;2016;05;06;Keskiviikko;20;66;86;4;11;15
89;25.05.2016;2016;05;07;Keskiviikko;28;182;210;7;25;32
89;25.05.2016;2016;05;08;Keskiviikko;48;236;284;12;49;61
89;25.05.2016;2016;05;09;Keskiviikko;49;114;163;16;35;51
89;25.05.2016;2016;05;10;Keskiviikko;47;87;134;18;31;49
89;25.05.2016;2016;05;11;Keskiviikko;64;85;149;22;34;56
89;25.05.2016;2016;05;12;Keskiviikko;78;84;162;23;20;43
89;25.05.2016;2016;05;13;Keskiviikko;81;61;142;16;16;32
89;25.05.2016;2016;05;14;Keskiviikko;118;72;190;21;10;31
89;25.05.2016;2016;05;15;Keskiviikko;156;71;227;18;22;40
89;25.05.2016;2016;05;16;Keskiviikko;186;68;254;24;15;39
89;25.05.2016;2016;05;17;Keskiviikko;104;65;169;21;11;32
89;25.05.2016;2016;05;18;Keskiviikko;74;70;144;26;32;58
89;25.05.2016;2016;05;19;Keskiviikko;69;38;107;26;20;46
89;25.05.2016;2016;05;20;Keskiviikko;60;27;87;29;29;58
89;25.05.2016;2016;05;21;Keskiviikko;48;21;69;20;10;30
89;25.05.2016;2016;05;22;Keskiviikko;21;13;34;7;4;11
89;25.05.2016;2016;05;23;Keskiviikko;16;23;39;2;3;5
89;26.05.2016;2016;05;00;Torstai;8;2;10;1;4;5
89;26.05.2016;2016;05;01;Torstai;1;4;5;1;1;2
89;26.05.2016;2016;05;02;Torstai;4;1;5;1;0;1
89;26.05.2016;2016;05;03;Torstai;5;3;8;1;1;2
89;26.05.2016;2016;05;04;Torstai;2;5;7;1;1;2
89;26.05.2016;2016;05;05;Torstai;3;17;20;0;0;0
89;26.05.2016;2016;05;06;Torstai;26;71;97;2;12;14
89;26.05.2016;2016;05;07;Torstai;38;201;239;6;20;26
89;26.05.2016;2016;05;08;Torstai;55;269;324;7;37;44
89;26.05.2016;2016;05;09;Torstai;50;119;169;18;36;54
89;26.05.2016;2016;05;10;Torstai;52;123;175;17;50;67
89;26.05.2016;2016;05;11;Torstai;92;105;197;28;41;69
89;26.05.2016;2016;05;12;Torstai;103;114;217;31;27;58
89;26.05.2016;2016;05;13;Torstai;125;92;217;24;30;54
89;26.05.2016;2016;05;14;Torstai;163;98;261;22;25;47
89;26.05.2016;2016;05;15;Torstai;193;117;310;30;17;47
89;26.05.2016;2016;05;16;Torstai;244;135;379;35;32;67
89;26.05.2016;2016;05;17;Torstai;151;104;255;26;36;62
89;26.05.2016;2016;05;18;Torstai;129;101;230;29;47;76
89;26.05.2016;2016;05;19;Torstai;119;102;221;39;53;92
89;26.05.2016;2016;05;20;Torstai;102;65;167;37;40;77
89;26.05.2016;2016;05;21;Torstai;60;43;103;13;31;44
89;26.05.2016;2016;05;22;Torstai;47;33;80;6;17;23
89;26.05.2016;2016;05;23;Torstai;23;16;39;9;7;16
89;27.05.2016;2016;05;00;Perjantai;20;9;29;2;3;5
89;27.05.2016;2016;05;01;Perjantai;6;9;15;1;1;2
89;27.05.2016;2016;05;02;Perjantai;7;9;16;0;0;0
89;27.05.2016;2016;05;03;Perjantai;8;1;9;1;1;2
89;27.05.2016;2016;05;04;Perjantai;7;8;15;1;2;3
89;27.05.2016;2016;05;05;Perjantai;4;11;15;0;0;0
89;27.05.2016;2016;05;06;Perjantai;24;64;88;2;8;10
89;27.05.2016;2016;05;07;Perjantai;26;176;202;3;22;25
89;27.05.2016;2016;05;08;Perjantai;49;294;343;8;85;93
89;27.05.2016;2016;05;09;Perjantai;56;144;200;37;48;85
89;27.05.2016;2016;05;10;Perjantai;51;115;166;29;43;72
89;27.05.2016;2016;05;11;Perjantai;76;139;215;13;59;72
89;27.05.2016;2016;05;12;Perjantai;159;120;279;35;34;69
89;27.05.2016;2016;05;13;Perjantai;156;131;287;30;29;59
89;27.05.2016;2016;05;14;Perjantai;178;131;309;33;31;64
89;27.05.2016;2016;05;15;Perjantai;215;171;386;49;57;106
89;27.05.2016;2016;05;16;Perjantai;212;162;374;53;49;102
89;27.05.2016;2016;05;17;Perjantai;166;154;320;39;46;85
89;27.05.2016;2016;05;18;Perjantai;159;130;289;53;60;113
89;27.05.2016;2016;05;19;Perjantai;169;142;311;55;48;103
89;27.05.2016;2016;05;20;Perjantai;197;128;325;44;58;102
89;27.05.2016;2016;05;21;Perjantai;98;118;216;34;57;91
89;27.05.2016;2016;05;22;Perjantai;82;76;158;27;43;70
89;27.05.2016;2016;05;23;Perjantai;43;57;100;17;47;64
89;28.05.2016;2016;05;00;Lauantai;50;71;121;14;24;38
89;28.05.2016;2016;05;01;Lauantai;42;43;85;4;28;32
89;28.05.2016;2016;05;02;Lauantai;27;19;46;11;11;22
89;28.05.2016;2016;05;03;Lauantai;23;4;27;8;6;14
89;28.05.2016;2016;05;04;Lauantai;17;6;23;9;5;14
89;28.05.2016;2016;05;05;Lauantai;7;7;14;2;1;3
89;28.05.2016;2016;05;06;Lauantai;4;16;20;2;5;7
89;28.05.2016;2016;05;07;Lauantai;7;22;29;3;9;12
89;28.05.2016;2016;05;08;Lauantai;18;50;68;7;17;24
89;28.05.2016;2016;05;09;Lauantai;30;114;144;10;42;52
89;28.05.2016;2016;05;10;Lauantai;56;187;243;19;51;70
89;28.05.2016;2016;05;11;Lauantai;81;260;341;49;150;199
89;28.05.2016;2016;05;12;Lauantai;100;204;304;63;516;579
89;28.05.2016;2016;05;13;Lauantai;110;248;358;162;742;904
89;28.05.2016;2016;05;14;Lauantai;134;228;362;175;640;815
89;28.05.2016;2016;05;15;Lauantai;196;198;394;63;202;265
89;28.05.2016;2016;05;16;Lauantai;181;192;373;60;135;195
89;28.05.2016;2016;05;17;Lauantai;162;180;342;46;57;103
89;28.05.2016;2016;05;18;Lauantai;160;182;342;43;73;116
89;28.05.2016;2016;05;19;Lauantai;134;149;283;43;43;86
89;28.05.2016;2016;05;20;Lauantai;94;130;224;22;60;82
89;28.05.2016;2016;05;21;Lauantai;99;100;199;24;46;70
89;28.05.2016;2016;05;22;Lauantai;48;53;101;24;34;58
89;28.05.2016;2016;05;23;Lauantai;49;59;108;19;34;53
89;29.05.2016;2016;05;00;Sunnuntai;49;64;113;14;10;24
89;29.05.2016;2016;05;01;Sunnuntai;33;38;71;6;2;8
89;29.05.2016;2016;05;02;Sunnuntai;48;6;54;7;4;11
89;29.05.2016;2016;05;03;Sunnuntai;44;0;44;6;4;10
89;29.05.2016;2016;05;04;Sunnuntai;24;5;29;1;1;2
89;29.05.2016;2016;05;05;Sunnuntai;9;6;15;0;1;1
89;29.05.2016;2016;05;06;Sunnuntai;8;17;25;1;1;2
89;29.05.2016;2016;05;07;Sunnuntai;5;11;16;3;7;10
89;29.05.2016;2016;05;08;Sunnuntai;12;19;31;7;11;18
89;29.05.2016;2016;05;09;Sunnuntai;27;43;70;19;27;46
89;29.05.2016;2016;05;10;Sunnuntai;43;129;172;31;55;86
89;29.05.2016;2016;05;11;Sunnuntai;93;131;224;25;49;74
89;29.05.2016;2016;05;12;Sunnuntai;130;187;317;37;77;114
89;29.05.2016;2016;05;13;Sunnuntai;188;240;428;45;88;133
89;29.05.2016;2016;05;14;Sunnuntai;228;184;412;43;58;101
89;29.05.2016;2016;05;15;Sunnuntai;197;220;417;41;53;94
89;29.05.2016;2016;05;16;Sunnuntai;183;174;357;58;59;117
89;29.05.2016;2016;05;17;Sunnuntai;213;185;398;44;71;115
89;29.05.2016;2016;05;18;Sunnuntai;194;147;341;51;55;106
89;29.05.2016;2016;05;19;Sunnuntai;163;102;265;45;36;81
89;29.05.2016;2016;05;20;Sunnuntai;125;99;224;40;43;83
89;29.05.2016;2016;05;21;Sunnuntai;77;62;139;17;21;38
89;29.05.2016;2016;05;22;Sunnuntai;31;26;57;10;11;21
89;29.05.2016;2016;05;23;Sunnuntai;12;18;30;7;5;12
89;30.05.2016;2016;05;00;Maanantai;10;11;21;3;2;5
89;30.05.2016;2016;05;01;Maanantai;11;8;19;3;0;3
89;30.05.2016;2016;05;02;Maanantai;3;1;4;0;1;1
89;30.05.2016;2016;05;03;Maanantai;2;1;3;1;0;1
89;30.05.2016;2016;05;04;Maanantai;4;6;10;2;0;2
89;30.05.2016;2016;05;05;Maanantai;3;15;18;1;1;2
89;30.05.2016;2016;05;06;Maanantai;19;68;87;2;7;9
89;30.05.2016;2016;05;07;Maanantai;46;212;258;6;17;23
89;30.05.2016;2016;05;08;Maanantai;67;327;394;11;33;44
89;30.05.2016;2016;05;09;Maanantai;62;264;326;11;35;46
89;30.05.2016;2016;05;10;Maanantai;97;166;263;38;65;103
89;30.05.2016;2016;05;11;Maanantai;126;137;263;26;43;69
89;30.05.2016;2016;05;12;Maanantai;162;166;328;54;60;114
89;30.05.2016;2016;05;13;Maanantai;168;155;323;32;39;71
89;30.05.2016;2016;05;14;Maanantai;206;161;367;35;30;65
89;30.05.2016;2016;05;15;Maanantai;295;181;476;36;33;69
89;30.05.2016;2016;05;16;Maanantai;340;201;541;36;31;67
89;30.05.2016;2016;05;17;Maanantai;204;205;409;38;40;78
89;30.05.2016;2016;05;18;Maanantai;195;158;353;56;51;107
89;30.05.2016;2016;05;19;Maanantai;202;120;322;63;56;119
89;30.05.2016;2016;05;20;Maanantai;113;104;217;38;40;78
89;30.05.2016;2016;05;21;Maanantai;85;49;134;23;30;53
89;30.05.2016;2016;05;22;Maanantai;40;27;67;5;20;25
89;30.05.2016;2016;05;23;Maanantai;25;10;35;3;6;9
89;31.05.2016;2016;05;00;Tiistai;8;7;15;3;3;6
89;31.05.2016;2016;05;01;Tiistai;10;4;14;0;1;1
89;31.05.2016;2016;05;02;Tiistai;2;2;4;0;1;1
89;31.05.2016;2016;05;03;Tiistai;1;5;6;0;0;0
89;31.05.2016;2016;05;04;Tiistai;5;8;13;0;0;0
89;31.05.2016;2016;05;05;Tiistai;9;10;19;0;3;3
89;31.05.2016;2016;05;06;Tiistai;35;94;129;2;12;14
89;31.05.2016;2016;05;07;Tiistai;39;209;248;5;18;23
89;31.05.2016;2016;05;08;Tiistai;62;315;377;18;41;59
89;31.05.2016;2016;05;09;Tiistai;65;146;211;17;33;50
89;31.05.2016;2016;05;10;Tiistai;66;142;208;14;53;67
89;31.05.2016;2016;05;11;Tiistai;121;143;264;19;29;48
89;31.05.2016;2016;05;12;Tiistai;146;160;306;39;52;91
89;31.05.2016;2016;05;13;Tiistai;146;153;299;30;37;67
89;31.05.2016;2016;05;14;Tiistai;225;158;383;43;29;72
89;31.05.2016;2016;05;15;Tiistai;308;200;508;84;39;123
89;31.05.2016;2016;05;16;Tiistai;333;178;511;59;42;101
89;31.05.2016;2016;05;17;Tiistai;211;195;406;41;35;76
89;31.05.2016;2016;05;18;Tiistai;217;166;383;34;43;77
89;31.05.2016;2016;05;19;Tiistai;198;175;373;55;81;136
89;31.05.2016;2016;05;20;Tiistai;159;103;262;43;35;78
89;31.05.2016;2016;05;21;Tiistai;99;63;162;24;28;52
89;31.05.2016;2016;05;22;Tiistai;42;41;83;10;12;22
89;31.05.2016;2016;05;23;Tiistai;40;24;64;4;4;8
89;01.06.2016;2016;06;00;Keskiviikko;12;8;20;2;1;3
89;01.06.2016;2016;06;01;Keskiviikko;13;2;15;0;3;3
89;01.06.2016;2016;06;02;Keskiviikko;2;7;9;3;2;5
89;01.06.2016;2016;06;03;Keskiviikko;2;4;6;0;0;0
89;01.06.2016;2016;06;04;Keskiviikko;4;6;10;2;0;2
89;01.06.2016;2016;06;05;Keskiviikko;6;12;18;0;2;2
89;01.06.2016;2016;06;06;Keskiviikko;23;81;104;2;9;11
89;01.06.2016;2016;06;07;Keskiviikko;37;196;233;10;21;31
89;01.06.2016;2016;06;08;Keskiviikko;57;282;339;12;48;60
89;01.06.2016;2016;06;09;Keskiviikko;59;184;243;25;51;76
89;01.06.2016;2016;06;10;Keskiviikko;59;101;160;8;21;29
89;01.06.2016;2016;06;11;Keskiviikko;56;66;122;12;17;29
89;01.06.2016;2016;06;12;Keskiviikko;79;88;167;21;7;28
89;01.06.2016;2016;06;13;Keskiviikko;117;100;217;28;26;54
89;01.06.2016;2016;06;14;Keskiviikko;128;99;227;16;23;39
89;01.06.2016;2016;06;15;Keskiviikko;194;113;307;21;19;40
89;01.06.2016;2016;06;16;Keskiviikko;278;149;427;37;31;68
89;01.06.2016;2016;06;17;Keskiviikko;200;149;349;50;43;93
89;01.06.2016;2016;06;18;Keskiviikko;207;160;367;61;48;109
89;01.06.2016;2016;06;19;Keskiviikko;160;148;308;40;47;87
89;01.06.2016;2016;06;20;Keskiviikko;147;74;221;44;56;100
89;01.06.2016;2016;06;21;Keskiviikko;72;62;134;23;29;52
89;01.06.2016;2016;06;22;Keskiviikko;49;42;91;11;29;40
89;01.06.2016;2016;06;23;Keskiviikko;26;21;47;4;8;12
89;02.06.2016;2016;06;00;Torstai;13;8;21;2;3;5
89;02.06.2016;2016;06;01;Torstai;6;0;6;4;2;6
89;02.06.2016;2016;06;02;Torstai;7;5;12;0;0;0
89;02.06.2016;2016;06;03;Torstai;5;2;7;3;1;4
89;02.06.2016;2016;06;04;Torstai;6;5;11;0;1;1
89;02.06.2016;2016;06;05;Torstai;9;16;25;0;1;1
89;02.06.2016;2016;06;06;Torstai;21;86;107;4;12;16
89;02.06.2016;2016;06;07;Torstai;42;198;240;7;18;25
89;02.06.2016;2016;06;08;Torstai;55;258;313;5;32;37
89;02.06.2016;2016;06;09;Torstai;46;197;243;24;38;62
89;02.06.2016;2016;06;10;Torstai;76;136;212;15;81;96
89;02.06.2016;2016;06;11;Torstai;107;139;246;28;29;57
89;02.06.2016;2016;06;12;Torstai;135;163;298;30;44;74
89;02.06.2016;2016;06;13;Torstai;168;173;341;48;34;82
89;02.06.2016;2016;06;14;Torstai;178;145;323;46;35;81
89;02.06.2016;2016;06;15;Torstai;263;179;442;69;44;113
89;02.06.2016;2016;06;16;Torstai;272;183;455;53;45;98
89;02.06.2016;2016;06;17;Torstai;257;202;459;60;42;102
89;02.06.2016;2016;06;18;Torstai;202;156;358;41;63;104
89;02.06.2016;2016;06;19;Torstai;176;132;308;51;51;102
89;02.06.2016;2016;06;20;Torstai;144;97;241;38;45;83
89;02.06.2016;2016;06;21;Torstai;83;68;151;14;23;37
89;02.06.2016;2016;06;22;Torstai;53;36;89;11;12;23
89;02.06.2016;2016;06;23;Torstai;35;19;54;3;7;10
89;03.06.2016;2016;06;00;Perjantai;14;4;18;5;2;7
89;03.06.2016;2016;06;01;Perjantai;12;0;12;3;2;5
89;03.06.2016;2016;06;02;Perjantai;8;3;11;1;0;1
89;03.06.2016;2016;06;03;Perjantai;13;3;16;0;0;0
89;03.06.2016;2016;06;04;Perjantai;5;7;12;2;1;3
89;03.06.2016;2016;06;05;Perjantai;5;15;20;0;2;2
89;03.06.2016;2016;06;06;Perjantai;20;46;66;3;10;13
89;03.06.2016;2016;06;07;Perjantai;25;138;163;3;17;20
89;03.06.2016;2016;06;08;Perjantai;44;234;278;17;35;52
89;03.06.2016;2016;06;09;Perjantai;39;133;172;18;29;47
89;03.06.2016;2016;06;10;Perjantai;65;112;177;16;51;67
89;03.06.2016;2016;06;11;Perjantai;138;98;236;31;39;70
89;03.06.2016;2016;06;12;Perjantai;132;132;264;27;22;49
89;03.06.2016;2016;06;13;Perjantai;97;147;244;21;36;57
89;03.06.2016;2016;06;14;Perjantai;175;133;308;31;36;67
89;03.06.2016;2016;06;15;Perjantai;185;112;297;24;23;47
89;03.06.2016;2016;06;16;Perjantai;184;109;293;34;18;52
89;03.06.2016;2016;06;17;Perjantai;121;114;235;26;26;52
89;03.06.2016;2016;06;18;Perjantai;120;115;235;39;34;73
89;03.06.2016;2016;06;19;Perjantai;79;72;151;22;30;52
89;03.06.2016;2016;06;20;Perjantai;93;80;173;20;21;41
89;03.06.2016;2016;06;21;Perjantai;57;75;132;13;22;35
89;03.06.2016;2016;06;22;Perjantai;40;42;82;10;18;28
89;03.06.2016;2016;06;23;Perjantai;30;30;60;8;10;18
89;04.06.2016;2016;06;00;Lauantai;37;35;72;5;8;13
89;04.06.2016;2016;06;01;Lauantai;31;5;36;2;5;7
89;04.06.2016;2016;06;02;Lauantai;17;8;25;5;1;6
89;04.06.2016;2016;06;03;Lauantai;22;5;27;4;1;5
89;04.06.2016;2016;06;04;Lauantai;29;2;31;4;0;4
89;04.06.2016;2016;06;05;Lauantai;5;9;14;0;3;3
89;04.06.2016;2016;06;06;Lauantai;3;19;22;4;4;8
89;04.06.2016;2016;06;07;Lauantai;12;20;32;4;7;11
89;04.06.2016;2016;06;08;Lauantai;7;53;60;10;11;21
89;04.06.2016;2016;06;09;Lauantai;28;45;73;22;20;42
89;04.06.2016;2016;06;10;Lauantai;49;81;130;13;29;42
89;04.06.2016;2016;06;11;Lauantai;29;99;128;22;35;57
89;04.06.2016;2016;06;12;Lauantai;71;85;156;14;32;46
89;04.06.2016;2016;06;13;Lauantai;70;86;156;21;26;47
89;04.06.2016;2016;06;14;Lauantai;68;78;146;29;31;60
89;04.06.2016;2016;06;15;Lauantai;78;76;154;28;32;60
89;04.06.2016;2016;06;16;Lauantai;81;61;142;23;26;49
89;04.06.2016;2016;06;17;Lauantai;63;51;114;21;30;51
89;04.06.2016;2016;06;18;Lauantai;68;58;126;21;34;55
89;04.06.2016;2016;06;19;Lauantai;50;75;125;20;25;45
89;04.06.2016;2016;06;20;Lauantai;59;62;121;20;25;45
89;04.06.2016;2016;06;21;Lauantai;41;54;95;14;22;36
89;04.06.2016;2016;06;22;Lauantai;28;52;80;7;15;22
89;04.06.2016;2016;06;23;Lauantai;46;37;83;6;16;22
89;05.06.2016;2016;06;00;Sunnuntai;23;28;51;9;11;20
89;05.06.2016;2016;06;01;Sunnuntai;35;23;58;5;10;15
89;05.06.2016;2016;06;02;Sunnuntai;48;13;61;7;0;7
89;05.06.2016;2016;06;03;Sunnuntai;36;3;39;5;0;5
89;05.06.2016;2016;06;04;Sunnuntai;26;2;28;14;1;15
89;05.06.2016;2016;06;05;Sunnuntai;11;7;18;2;0;2
89;05.06.2016;2016;06;06;Sunnuntai;3;9;12;0;1;1
89;05.06.2016;2016;06;07;Sunnuntai;2;4;6;1;3;4
89;05.06.2016;2016;06;08;Sunnuntai;8;16;24;10;14;24
89;05.06.2016;2016;06;09;Sunnuntai;18;31;49;16;25;41
89;05.06.2016;2016;06;10;Sunnuntai;32;43;75;21;24;45
89;05.06.2016;2016;06;11;Sunnuntai;44;74;118;25;31;56
89;05.06.2016;2016;06;12;Sunnuntai;50;71;121;27;51;78
89;05.06.2016;2016;06;13;Sunnuntai;66;64;130;23;30;53
89;05.06.2016;2016;06;14;Sunnuntai;63;77;140;43;51;94
89;05.06.2016;2016;06;15;Sunnuntai;57;52;109;32;33;65
89;05.06.2016;2016;06;16;Sunnuntai;61;56;117;17;25;42
89;05.06.2016;2016;06;17;Sunnuntai;66;44;110;30;22;52
89;05.06.2016;2016;06;18;Sunnuntai;56;38;94;21;17;38
89;05.06.2016;2016;06;19;Sunnuntai;46;32;78;16;15;31
89;05.06.2016;2016;06;20;Sunnuntai;53;30;83;11;22;33
89;05.06.2016;2016;06;21;Sunnuntai;34;38;72;11;13;24
89;05.06.2016;2016;06;22;Sunnuntai;23;27;50;6;13;19
89;05.06.2016;2016;06;23;Sunnuntai;10;9;19;5;8;13
89;06.06.2016;2016;06;00;Maanantai;3;12;15;2;2;4
89;06.06.2016;2016;06;01;Maanantai;2;2;4;2;0;2
89;06.06.2016;2016;06;02;Maanantai;6;3;9;2;0;2
89;06.06.2016;2016;06;03;Maanantai;7;1;8;1;1;2
89;06.06.2016;2016;06;04;Maanantai;6;3;9;1;0;1
89;06.06.2016;2016;06;05;Maanantai;5;13;18;0;0;0
89;06.06.2016;2016;06;06;Maanantai;21;71;92;5;7;12
89;06.06.2016;2016;06;07;Maanantai;37;164;201;1;19;20
89;06.06.2016;2016;06;08;Maanantai;46;205;251;7;19;26
89;06.06.2016;2016;06;09;Maanantai;29;119;148;11;29;40
89;06.06.2016;2016;06;10;Maanantai;61;97;158;16;31;47
89;06.06.2016;2016;06;11;Maanantai;66;106;172;22;24;46
89;06.06.2016;2016;06;12;Maanantai;73;105;178;19;22;41
89;06.06.2016;2016;06;13;Maanantai;104;87;191;14;27;41
89;06.06.2016;2016;06;14;Maanantai;118;99;217;32;36;68
89;06.06.2016;2016;06;15;Maanantai;206;96;302;43;20;63
89;06.06.2016;2016;06;16;Maanantai;277;102;379;27;23;50
89;06.06.2016;2016;06;17;Maanantai;149;89;238;31;35;66
89;06.06.2016;2016;06;18;Maanantai;133;105;238;24;29;53
89;06.06.2016;2016;06;19;Maanantai;96;70;166;42;44;86
89;06.06.2016;2016;06;20;Maanantai;79;47;126;40;42;82
89;06.06.2016;2016;06;21;Maanantai;50;42;92;19;18;37
89;06.06.2016;2016;06;22;Maanantai;23;19;42;8;7;15
89;06.06.2016;2016;06;23;Maanantai;10;17;27;15;15;30
89;07.06.2016;2016;06;00;Tiistai;5;12;17;4;2;6
89;07.06.2016;2016;06;01;Tiistai;4;1;5;0;0;0
89;07.06.2016;2016;06;02;Tiistai;3;7;10;2;0;2
89;07.06.2016;2016;06;03;Tiistai;2;3;5;0;0;0
89;07.06.2016;2016;06;04;Tiistai;4;4;8;0;0;0
89;07.06.2016;2016;06;05;Tiistai;7;8;15;1;1;2
89;07.06.2016;2016;06;06;Tiistai;19;66;85;2;7;9
89;07.06.2016;2016;06;07;Tiistai;37;185;222;4;21;25
89;07.06.2016;2016;06;08;Tiistai;41;235;276;6;23;29
89;07.06.2016;2016;06;09;Tiistai;37;133;170;11;25;36
89;07.06.2016;2016;06;10;Tiistai;51;94;145;21;28;49
89;07.06.2016;2016;06;11;Tiistai;52;112;164;23;41;64
89;07.06.2016;2016;06;12;Tiistai;79;103;182;25;44;69
89;07.06.2016;2016;06;13;Tiistai;107;125;232;36;42;78
89;07.06.2016;2016;06;14;Tiistai;140;90;230;36;27;63
89;07.06.2016;2016;06;15;Tiistai;185;133;318;34;20;54
89;07.06.2016;2016;06;16;Tiistai;266;129;395;28;21;49
89;07.06.2016;2016;06;17;Tiistai;173;138;311;29;24;53
89;07.06.2016;2016;06;18;Tiistai;122;88;210;39;21;60
89;07.06.2016;2016;06;19;Tiistai;149;57;206;39;23;62
89;07.06.2016;2016;06;20;Tiistai;102;57;159;33;29;62
89;07.06.2016;2016;06;21;Tiistai;60;24;84;16;13;29
89;07.06.2016;2016;06;22;Tiistai;37;12;49;6;7;13
89;07.06.2016;2016;06;23;Tiistai;11;8;19;4;3;7
89;08.06.2016;2016;06;00;Keskiviikko;16;6;22;2;0;2
89;08.06.2016;2016;06;01;Keskiviikko;2;1;3;3;1;4
89;08.06.2016;2016;06;02;Keskiviikko;0;1;1;0;0;0
89;08.06.2016;2016;06;03;Keskiviikko;3;1;4;0;2;2
89;08.06.2016;2016;06;04;Keskiviikko;4;6;10;1;0;1
89;08.06.2016;2016;06;05;Keskiviikko;3;11;14;0;2;2
89;08.06.2016;2016;06;06;Keskiviikko;20;42;62;3;2;5
89;08.06.2016;2016;06;07;Keskiviikko;17;100;117;3;18;21
89;08.06.2016;2016;06;08;Keskiviikko;23;121;144;11;19;30
89;08.06.2016;2016;06;09;Keskiviikko;28;85;113;11;18;29
89;08.06.2016;2016;06;10;Keskiviikko;31;61;92;15;26;41
89;08.06.2016;2016;06;11;Keskiviikko;34;29;63;14;19;33
89;08.06.2016;2016;06;12;Keskiviikko;39;44;83;14;11;25
89;08.06.2016;2016;06;13;Keskiviikko;39;47;86;3;7;10
89;08.06.2016;2016;06;14;Keskiviikko;50;22;72;13;6;19
89;08.06.2016;2016;06;15;Keskiviikko;75;37;112;7;6;13
89;08.06.2016;2016;06;16;Keskiviikko;103;45;148;13;4;17
89;08.06.2016;2016;06;17;Keskiviikko;59;32;91;12;10;22
89;08.06.2016;2016;06;18;Keskiviikko;33;14;47;9;1;10
89;08.06.2016;2016;06;19;Keskiviikko;39;16;55;7;8;15
89;08.06.2016;2016;06;20;Keskiviikko;33;21;54;15;10;25
89;08.06.2016;2016;06;21;Keskiviikko;28;17;45;9;17;26
89;08.06.2016;2016;06;22;Keskiviikko;12;6;18;5;8;13
89;08.06.2016;2016;06;23;Keskiviikko;10;5;15;0;3;3
89;09.06.2016;2016;06;00;Torstai;3;10;13;1;2;3
89;09.06.2016;2016;06;01;Torstai;4;0;4;1;1;2
89;09.06.2016;2016;06;02;Torstai;6;1;7;2;0;2
89;09.06.2016;2016;06;03;Torstai;1;2;3;1;1;2
89;09.06.2016;2016;06;04;Torstai;4;6;10;0;0;0
89;09.06.2016;2016;06;05;Torstai;3;8;11;0;0;0
89;09.06.2016;2016;06;06;Torstai;15;54;69;0;6;6
89;09.06.2016;2016;06;07;Torstai;26;121;147;3;10;13
89;09.06.2016;2016;06;08;Torstai;31;139;170;7;21;28
89;09.06.2016;2016;06;09;Torstai;24;76;100;9;20;29
89;09.06.2016;2016;06;10;Torstai;33;58;91;13;15;28
89;09.06.2016;2016;06;11;Torstai;36;50;86;20;21;41
89;09.06.2016;2016;06;12;Torstai;46;75;121;17;22;39
89;09.06.2016;2016;06;13;Torstai;66;72;138;15;19;34
89;09.06.2016;2016;06;14;Torstai;87;76;163;12;14;26
89;09.06.2016;2016;06;15;Torstai;136;79;215;31;14;45
89;09.06.2016;2016;06;16;Torstai;168;85;253;18;18;36
89;09.06.2016;2016;06;17;Torstai;103;76;179;23;24;47
89;09.06.2016;2016;06;18;Torstai;97;57;154;20;16;36
89;09.06.2016;2016;06;19;Torstai;73;69;142;32;24;56
89;09.06.2016;2016;06;20;Torstai;85;53;138;20;18;38
89;09.06.2016;2016;06;21;Torstai;63;33;96;17;21;38
89;09.06.2016;2016;06;22;Torstai;17;29;46;6;12;18
89;09.06.2016;2016;06;23;Torstai;16;13;29;5;4;9
89;10.06.2016;2016;06;00;Perjantai;11;9;20;2;2;4
89;10.06.2016;2016;06;01;Perjantai;10;2;12;2;3;5
89;10.06.2016;2016;06;02;Perjantai;3;1;4;1;0;1
89;10.06.2016;2016;06;03;Perjantai;4;2;6;2;1;3
89;10.06.2016;2016;06;04;Perjantai;3;4;7;0;0;0
89;10.06.2016;2016;06;05;Perjantai;4;11;15;1;1;2
89;10.06.2016;2016;06;06;Perjantai;20;55;75;1;4;5
89;10.06.2016;2016;06;07;Perjantai;24;131;155;4;11;15
89;10.06.2016;2016;06;08;Perjantai;33;122;155;7;22;29
89;10.06.2016;2016;06;09;Perjantai;28;81;109;13;15;28
89;10.06.2016;2016;06;10;Perjantai;37;69;106;12;39;51
89;10.06.2016;2016;06;11;Perjantai;34;69;103;11;25;36
89;10.06.2016;2016;06;12;Perjantai;62;88;150;12;22;34
89;10.06.2016;2016;06;13;Perjantai;82;91;173;27;36;63
89;10.06.2016;2016;06;14;Perjantai;106;74;180;14;34;48
89;10.06.2016;2016;06;15;Perjantai;148;90;238;28;28;56
89;10.06.2016;2016;06;16;Perjantai;139;94;233;18;21;39
89;10.06.2016;2016;06;17;Perjantai;97;78;175;24;31;55
89;10.06.2016;2016;06;18;Perjantai;77;59;136;16;22;38
89;10.06.2016;2016;06;19;Perjantai;88;56;144;15;20;35
89;10.06.2016;2016;06;20;Perjantai;48;57;105;18;13;31
89;10.06.2016;2016;06;21;Perjantai;52;47;99;18;20;38
89;10.06.2016;2016;06;22;Perjantai;52;26;78;7;10;17
89;10.06.2016;2016;06;23;Perjantai;33;22;55;1;6;7
89;11.06.2016;2016;06;00;Lauantai;27;22;49;5;13;18
89;11.06.2016;2016;06;01;Lauantai;14;7;21;6;5;11
89;11.06.2016;2016;06;02;Lauantai;19;8;27;4;3;7
89;11.06.2016;2016;06;03;Lauantai;31;0;31;7;1;8
89;11.06.2016;2016;06;04;Lauantai;20;6;26;6;0;6
89;11.06.2016;2016;06;05;Lauantai;5;4;9;2;4;6
89;11.06.2016;2016;06;06;Lauantai;10;13;23;3;2;5
89;11.06.2016;2016;06;07;Lauantai;4;11;15;2;5;7
89;11.06.2016;2016;06;08;Lauantai;6;25;31;3;6;9
89;11.06.2016;2016;06;09;Lauantai;17;50;67;8;15;23
89;11.06.2016;2016;06;10;Lauantai;32;81;113;14;30;44
89;11.06.2016;2016;06;11;Lauantai;51;91;142;26;32;58
89;11.06.2016;2016;06;12;Lauantai;62;95;157;17;32;49
89;11.06.2016;2016;06;13;Lauantai;85;103;188;22;32;54
89;11.06.2016;2016;06;14;Lauantai;67;67;134;15;46;61
89;11.06.2016;2016;06;15;Lauantai;89;65;154;22;33;55
89;11.06.2016;2016;06;16;Lauantai;68;61;129;29;28;57
89;11.06.2016;2016;06;17;Lauantai;63;80;143;20;42;62
89;11.06.2016;2016;06;18;Lauantai;59;57;116;13;39;52
89;11.06.2016;2016;06;19;Lauantai;59;55;114;24;34;58
89;11.06.2016;2016;06;20;Lauantai;38;64;102;17;17;34
89;11.06.2016;2016;06;21;Lauantai;52;48;100;13;13;26
89;11.06.2016;2016;06;22;Lauantai;34;49;83;10;22;32
89;11.06.2016;2016;06;23;Lauantai;33;34;67;9;13;22
89;12.06.2016;2016;06;00;Sunnuntai;38;54;92;12;19;31
89;12.06.2016;2016;06;01;Sunnuntai;39;27;66;7;4;11
89;12.06.2016;2016;06;02;Sunnuntai;15;12;27;6;0;6
89;12.06.2016;2016;06;03;Sunnuntai;26;4;30;6;1;7
89;12.06.2016;2016;06;04;Sunnuntai;34;4;38;5;1;6
89;12.06.2016;2016;06;05;Sunnuntai;6;2;8;0;0;0
89;12.06.2016;2016;06;06;Sunnuntai;7;11;18;2;2;4
89;12.06.2016;2016;06;07;Sunnuntai;8;5;13;2;4;6
89;12.06.2016;2016;06;08;Sunnuntai;4;9;13;2;6;8
89;12.06.2016;2016;06;09;Sunnuntai;20;28;48;7;19;26
89;12.06.2016;2016;06;10;Sunnuntai;22;72;94;28;35;63
89;12.06.2016;2016;06;11;Sunnuntai;36;71;107;31;56;87
89;12.06.2016;2016;06;12;Sunnuntai;73;114;187;33;55;88
89;12.06.2016;2016;06;13;Sunnuntai;122;138;260;41;47;88
89;12.06.2016;2016;06;14;Sunnuntai;125;126;251;49;37;86
89;12.06.2016;2016;06;15;Sunnuntai;107;108;215;44;69;113
89;12.06.2016;2016;06;16;Sunnuntai;94;86;180;36;56;92
89;12.06.2016;2016;06;17;Sunnuntai;111;75;186;29;43;72
89;12.06.2016;2016;06;18;Sunnuntai;82;87;169;34;32;66
89;12.06.2016;2016;06;19;Sunnuntai;65;72;137;22;31;53
89;12.06.2016;2016;06;20;Sunnuntai;48;46;94;18;30;48
89;12.06.2016;2016;06;21;Sunnuntai;54;49;103;16;20;36
89;12.06.2016;2016;06;22;Sunnuntai;33;17;50;7;13;20
89;12.06.2016;2016;06;23;Sunnuntai;15;6;21;3;3;6
89;13.06.2016;2016;06;00;Maanantai;7;6;13;4;3;7
89;13.06.2016;2016;06;01;Maanantai;10;7;17;2;1;3
89;13.06.2016;2016;06;02;Maanantai;3;1;4;1;0;1
89;13.06.2016;2016;06;03;Maanantai;2;1;3;2;0;2
89;13.06.2016;2016;06;04;Maanantai;2;7;9;1;0;1
89;13.06.2016;2016;06;05;Maanantai;4;13;17;1;2;3
89;13.06.2016;2016;06;06;Maanantai;25;72;97;2;3;5
89;13.06.2016;2016;06;07;Maanantai;33;174;207;3;14;17
89;13.06.2016;2016;06;08;Maanantai;32;207;239;9;38;47
89;13.06.2016;2016;06;09;Maanantai;36;137;173;14;24;38
89;13.06.2016;2016;06;10;Maanantai;63;125;188;12;32;44
89;13.06.2016;2016;06;11;Maanantai;76;115;191;15;29;44
89;13.06.2016;2016;06;12;Maanantai;79;149;228;18;31;49
89;13.06.2016;2016;06;13;Maanantai;113;115;228;43;39;82
89;13.06.2016;2016;06;14;Maanantai;168;127;295;51;39;90
89;13.06.2016;2016;06;15;Maanantai;206;110;316;41;58;99
89;13.06.2016;2016;06;16;Maanantai;257;142;399;42;22;64
89;13.06.2016;2016;06;17;Maanantai;182;118;300;35;35;70
89;13.06.2016;2016;06;18;Maanantai;135;78;213;22;30;52
89;13.06.2016;2016;06;19;Maanantai;126;75;201;42;41;83
89;13.06.2016;2016;06;20;Maanantai;76;42;118;34;24;58
89;13.06.2016;2016;06;21;Maanantai;80;38;118;30;28;58
89;13.06.2016;2016;06;22;Maanantai;29;23;52;11;13;24
89;13.06.2016;2016;06;23;Maanantai;14;17;31;12;6;18
89;14.06.2016;2016;06;00;Tiistai;16;10;26;4;3;7
89;14.06.2016;2016;06;01;Tiistai;6;3;9;0;2;2
89;14.06.2016;2016;06;02;Tiistai;3;4;7;2;2;4
89;14.06.2016;2016;06;03;Tiistai;2;3;5;0;0;0
89;14.06.2016;2016;06;04;Tiistai;2;6;8;2;0;2
89;14.06.2016;2016;06;05;Tiistai;7;19;26;1;2;3
89;14.06.2016;2016;06;06;Tiistai;25;72;97;3;9;12
89;14.06.2016;2016;06;07;Tiistai;30;164;194;6;10;16
89;14.06.2016;2016;06;08;Tiistai;32;219;251;5;28;33
89;14.06.2016;2016;06;09;Tiistai;34;112;146;11;23;34
89;14.06.2016;2016;06;10;Tiistai;54;96;150;17;38;55
89;14.06.2016;2016;06;11;Tiistai;70;91;161;22;28;50
89;14.06.2016;2016;06;12;Tiistai;87;123;210;32;44;76
89;14.06.2016;2016;06;13;Tiistai;101;108;209;30;47;77
89;14.06.2016;2016;06;14;Tiistai;140;110;250;41;25;66
89;14.06.2016;2016;06;15;Tiistai;202;117;319;47;38;85
89;14.06.2016;2016;06;16;Tiistai;275;132;407;40;31;71
89;14.06.2016;2016;06;17;Tiistai;180;150;330;43;32;75
89;14.06.2016;2016;06;18;Tiistai;151;114;265;40;69;109
89;14.06.2016;2016;06;19;Tiistai;170;72;242;39;44;83
89;14.06.2016;2016;06;20;Tiistai;86;58;144;35;23;58
89;14.06.2016;2016;06;21;Tiistai;67;43;110;19;23;42
89;14.06.2016;2016;06;22;Tiistai;19;21;40;8;13;21
89;14.06.2016;2016;06;23;Tiistai;18;17;35;5;5;10
89;15.06.2016;2016;06;00;Keskiviikko;11;5;16;1;3;4
89;15.06.2016;2016;06;01;Keskiviikko;4;7;11;4;2;6
89;15.06.2016;2016;06;02;Keskiviikko;6;11;17;0;6;6
89;15.06.2016;2016;06;03;Keskiviikko;5;3;8;2;0;2
89;15.06.2016;2016;06;04;Keskiviikko;7;6;13;2;0;2
89;15.06.2016;2016;06;05;Keskiviikko;4;13;17;0;2;2
89;15.06.2016;2016;06;06;Keskiviikko;21;89;110;3;8;11
89;15.06.2016;2016;06;07;Keskiviikko;37;173;210;9;26;35
89;15.06.2016;2016;06;08;Keskiviikko;39;217;256;8;28;36
89;15.06.2016;2016;06;09;Keskiviikko;47;126;173;17;48;65
89;15.06.2016;2016;06;10;Keskiviikko;74;115;189;12;23;35
89;15.06.2016;2016;06;11;Keskiviikko;71;127;198;25;56;81
89;15.06.2016;2016;06;12;Keskiviikko;81;126;207;25;37;62
89;15.06.2016;2016;06;13;Keskiviikko;122;146;268;22;27;49
89;15.06.2016;2016;06;14;Keskiviikko;144;105;249;35;45;80
89;15.06.2016;2016;06;15;Keskiviikko;264;152;416;37;37;74
89;15.06.2016;2016;06;16;Keskiviikko;235;141;376;38;34;72
89;15.06.2016;2016;06;17;Keskiviikko;169;137;306;46;36;82
89;15.06.2016;2016;06;18;Keskiviikko;149;129;278;38;55;93
89;15.06.2016;2016;06;19;Keskiviikko;127;99;226;43;43;86
89;15.06.2016;2016;06;20;Keskiviikko;120;82;202;29;30;59
89;15.06.2016;2016;06;21;Keskiviikko;97;75;172;29;30;59
89;15.06.2016;2016;06;22;Keskiviikko;60;42;102;19;18;37
89;15.06.2016;2016;06;23;Keskiviikko;27;22;49;11;6;17
89;16.06.2016;2016;06;00;Torstai;8;16;24;3;3;6
89;16.06.2016;2016;06;01;Torstai;7;6;13;0;0;0
89;16.06.2016;2016;06;02;Torstai;5;0;5;2;0;2
89;16.06.2016;2016;06;03;Torstai;11;2;13;7;4;11
89;16.06.2016;2016;06;04;Torstai;8;7;15;1;1;2
89;16.06.2016;2016;06;05;Torstai;6;14;20;2;3;5
89;16.06.2016;2016;06;06;Torstai;22;62;84;2;12;14
89;16.06.2016;2016;06;07;Torstai;34;142;176;5;21;26
89;16.06.2016;2016;06;08;Torstai;36;204;240;8;24;32
89;16.06.2016;2016;06;09;Torstai;41;111;152;17;37;54
89;16.06.2016;2016;06;10;Torstai;59;102;161;12;41;53
89;16.06.2016;2016;06;11;Torstai;65;87;152;24;26;50
89;16.06.2016;2016;06;12;Torstai;66;80;146;32;21;53
89;16.06.2016;2016;06;13;Torstai;88;65;153;23;20;43
89;16.06.2016;2016;06;14;Torstai;96;66;162;18;23;41
89;16.06.2016;2016;06;15;Torstai;120;67;187;12;8;20
89;16.06.2016;2016;06;16;Torstai;182;63;245;14;10;24
89;16.06.2016;2016;06;17;Torstai;82;39;121;5;9;14
89;16.06.2016;2016;06;18;Torstai;64;43;107;19;19;38
89;16.06.2016;2016;06;19;Torstai;57;36;93;10;1;11
89;16.06.2016;2016;06;20;Torstai;42;37;79;16;13;29
89;16.06.2016;2016;06;21;Torstai;39;17;56;12;15;27
89;16.06.2016;2016;06;22;Torstai;29;15;44;8;8;16
89;16.06.2016;2016;06;23;Torstai;16;11;27;5;1;6
89;17.06.2016;2016;06;00;Perjantai;7;10;17;3;0;3
89;17.06.2016;2016;06;01;Perjantai;7;3;10;0;0;0
89;17.06.2016;2016;06;02;Perjantai;7;2;9;2;0;2
89;17.06.2016;2016;06;03;Perjantai;5;3;8;2;1;3
89;17.06.2016;2016;06;04;Perjantai;7;1;8;1;1;2
89;17.06.2016;2016;06;05;Perjantai;3;9;12;1;3;4
89;17.06.2016;2016;06;06;Perjantai;15;38;53;2;3;5
89;17.06.2016;2016;06;07;Perjantai;25;94;119;1;13;14
89;17.06.2016;2016;06;08;Perjantai;19;102;121;5;15;20
89;17.06.2016;2016;06;09;Perjantai;18;57;75;17;51;68
89;17.06.2016;2016;06;10;Perjantai;28;62;90;7;24;31
89;17.06.2016;2016;06;11;Perjantai;28;73;101;10;20;30
89;17.06.2016;2016;06;12;Perjantai;40;62;102;19;21;40
89;17.06.2016;2016;06;13;Perjantai;64;46;110;12;18;30
89;17.06.2016;2016;06;14;Perjantai;83;34;117;12;11;23
89;17.06.2016;2016;06;15;Perjantai;107;46;153;8;16;24
89;17.06.2016;2016;06;16;Perjantai;93;63;156;19;24;43
89;17.06.2016;2016;06;17;Perjantai;61;82;143;23;31;54
89;17.06.2016;2016;06;18;Perjantai;81;91;172;41;56;97
89;17.06.2016;2016;06;19;Perjantai;81;93;174;26;38;64
89;17.06.2016;2016;06;20;Perjantai;95;72;167;21;21;42
89;17.06.2016;2016;06;21;Perjantai;60;63;123;20;26;46
89;17.06.2016;2016;06;22;Perjantai;43;43;86;13;14;27
89;17.06.2016;2016;06;23;Perjantai;30;30;60;10;8;18
89;18.06.2016;2016;06;00;Lauantai;22;21;43;8;7;15
89;18.06.2016;2016;06;01;Lauantai;31;18;49;5;4;9
89;18.06.2016;2016;06;02;Lauantai;21;12;33;5;1;6
89;18.06.2016;2016;06;03;Lauantai;24;4;28;4;0;4
89;18.06.2016;2016;06;04;Lauantai;17;1;18;7;1;8
89;18.06.2016;2016;06;05;Lauantai;14;6;20;7;8;15
89;18.06.2016;2016;06;06;Lauantai;8;14;22;1;4;5
89;18.06.2016;2016;06;07;Lauantai;7;19;26;2;3;5
89;18.06.2016;2016;06;08;Lauantai;15;44;59;11;16;27
89;18.06.2016;2016;06;09;Lauantai;31;90;121;10;35;45
89;18.06.2016;2016;06;10;Lauantai;59;110;169;17;35;52
89;18.06.2016;2016;06;11;Lauantai;68;67;135;14;35;49
89;18.06.2016;2016;06;12;Lauantai;39;32;71;8;21;29
89;18.06.2016;2016;06;13;Lauantai;44;24;68;11;14;25
89;18.06.2016;2016;06;14;Lauantai;50;47;97;10;19;29
89;18.06.2016;2016;06;15;Lauantai;46;48;94;13;18;31
89;18.06.2016;2016;06;16;Lauantai;57;46;103;21;12;33
89;18.06.2016;2016;06;17;Lauantai;74;37;111;20;20;40
89;18.06.2016;2016;06;18;Lauantai;57;41;98;8;14;22
89;18.06.2016;2016;06;19;Lauantai;28;18;46;2;11;13
89;18.06.2016;2016;06;20;Lauantai;27;35;62;9;6;15
89;18.06.2016;2016;06;21;Lauantai;23;30;53;11;15;26
89;18.06.2016;2016;06;22;Lauantai;22;38;60;9;12;21
89;18.06.2016;2016;06;23;Lauantai;19;57;76;10;23;33
89;19.06.2016;2016;06;00;Sunnuntai;18;50;68;5;12;17
89;19.06.2016;2016;06;01;Sunnuntai;19;11;30;7;1;8
89;19.06.2016;2016;06;02;Sunnuntai;15;13;28;0;5;5
89;19.06.2016;2016;06;03;Sunnuntai;19;1;20;6;3;9
89;19.06.2016;2016;06;04;Sunnuntai;29;6;35;18;1;19
89;19.06.2016;2016;06;05;Sunnuntai;5;3;8;0;1;1
89;19.06.2016;2016;06;06;Sunnuntai;13;11;24;1;2;3
89;19.06.2016;2016;06;07;Sunnuntai;4;5;9;4;2;6
89;19.06.2016;2016;06;08;Sunnuntai;6;15;21;4;2;6
89;19.06.2016;2016;06;09;Sunnuntai;21;37;58;11;14;25
89;19.06.2016;2016;06;10;Sunnuntai;34;46;80;33;29;62
89;19.06.2016;2016;06;11;Sunnuntai;49;97;146;29;54;83
89;19.06.2016;2016;06;12;Sunnuntai;78;147;225;43;44;87
89;19.06.2016;2016;06;13;Sunnuntai;152;148;300;41;51;92
89;19.06.2016;2016;06;14;Sunnuntai;108;89;197;22;33;55
89;19.06.2016;2016;06;15;Sunnuntai;88;67;155;33;24;57
89;19.06.2016;2016;06;16;Sunnuntai;79;30;109;13;17;30
89;19.06.2016;2016;06;17;Sunnuntai;51;31;82;10;14;24
89;19.06.2016;2016;06;18;Sunnuntai;28;24;52;20;11;31
89;19.06.2016;2016;06;19;Sunnuntai;22;36;58;19;20;39
89;19.06.2016;2016;06;20;Sunnuntai;36;27;63;14;12;26
89;19.06.2016;2016;06;21;Sunnuntai;30;19;49;12;20;32
89;19.06.2016;2016;06;22;Sunnuntai;13;8;21;9;4;13
89;19.06.2016;2016;06;23;Sunnuntai;3;10;13;2;3;5
89;20.06.2016;2016;06;00;Maanantai;4;5;9;0;2;2
89;20.06.2016;2016;06;01;Maanantai;0;1;1;1;1;2
89;20.06.2016;2016;06;02;Maanantai;4;0;4;1;1;2
89;20.06.2016;2016;06;03;Maanantai;6;2;8;0;1;1
89;20.06.2016;2016;06;04;Maanantai;1;4;5;0;1;1
89;20.06.2016;2016;06;05;Maanantai;4;15;19;0;2;2
89;20.06.2016;2016;06;06;Maanantai;21;76;97;4;7;11
89;20.06.2016;2016;06;07;Maanantai;26;151;177;8;20;28
89;20.06.2016;2016;06;08;Maanantai;42;185;227;17;28;45
89;20.06.2016;2016;06;09;Maanantai;50;118;168;24;40;64
89;20.06.2016;2016;06;10;Maanantai;61;99;160;33;49;82
89;20.06.2016;2016;06;11;Maanantai;90;130;220;26;35;61
89;20.06.2016;2016;06;12;Maanantai;86;128;214;31;36;67
89;20.06.2016;2016;06;13;Maanantai;98;105;203;35;55;90
89;20.06.2016;2016;06;14;Maanantai;148;118;266;49;45;94
89;20.06.2016;2016;06;15;Maanantai;193;139;332;65;40;105
89;20.06.2016;2016;06;16;Maanantai;202;129;331;60;42;102
89;20.06.2016;2016;06;17;Maanantai;151;128;279;51;41;92
89;20.06.2016;2016;06;18;Maanantai;131;102;233;34;47;81
89;20.06.2016;2016;06;19;Maanantai;124;80;204;54;43;97
89;20.06.2016;2016;06;20;Maanantai;90;59;149;34;39;73
89;20.06.2016;2016;06;21;Maanantai;72;52;124;17;23;40
89;20.06.2016;2016;06;22;Maanantai;29;27;56;22;9;31
89;20.06.2016;2016;06;23;Maanantai;18;11;29;6;3;9
89;21.06.2016;2016;06;00;Tiistai;16;10;26;2;2;4
89;21.06.2016;2016;06;01;Tiistai;11;10;21;3;2;5
89;21.06.2016;2016;06;02;Tiistai;9;1;10;6;0;6
89;21.06.2016;2016;06;03;Tiistai;2;3;5;4;3;7
89;21.06.2016;2016;06;04;Tiistai;4;6;10;0;0;0
89;21.06.2016;2016;06;05;Tiistai;5;16;21;3;4;7
89;21.06.2016;2016;06;06;Tiistai;23;70;93;7;11;18
89;21.06.2016;2016;06;07;Tiistai;43;150;193;10;16;26
89;21.06.2016;2016;06;08;Tiistai;38;189;227;12;32;44
89;21.06.2016;2016;06;09;Tiistai;42;135;177;14;28;42
89;21.06.2016;2016;06;10;Tiistai;68;109;177;21;46;67
89;21.06.2016;2016;06;11;Tiistai;82;129;211;30;31;61
89;21.06.2016;2016;06;12;Tiistai;122;132;254;36;36;72
89;21.06.2016;2016;06;13;Tiistai;103;137;240;62;56;118
89;21.06.2016;2016;06;14;Tiistai;146;127;273;33;33;66
89;21.06.2016;2016;06;15;Tiistai;201;125;326;42;29;71
89;21.06.2016;2016;06;16;Tiistai;276;161;437;49;58;107
89;21.06.2016;2016;06;17;Tiistai;177;180;357;34;48;82
89;21.06.2016;2016;06;18;Tiistai;146;143;289;44;41;85
89;21.06.2016;2016;06;19;Tiistai;172;99;271;41;52;93
89;21.06.2016;2016;06;20;Tiistai;145;74;219;43;26;69
89;21.06.2016;2016;06;21;Tiistai;73;55;128;25;30;55
89;21.06.2016;2016;06;22;Tiistai;52;39;91;14;15;29
89;21.06.2016;2016;06;23;Tiistai;37;18;55;2;4;6
89;22.06.2016;2016;06;00;Keskiviikko;14;6;20;3;4;7
89;22.06.2016;2016;06;01;Keskiviikko;10;8;18;5;2;7
89;22.06.2016;2016;06;02;Keskiviikko;11;4;15;1;0;1
89;22.06.2016;2016;06;03;Keskiviikko;10;3;13;2;1;3
89;22.06.2016;2016;06;04;Keskiviikko;12;1;13;2;2;4
89;22.06.2016;2016;06;05;Keskiviikko;7;15;22;4;1;5
89;22.06.2016;2016;06;06;Keskiviikko;19;70;89;1;5;6
89;22.06.2016;2016;06;07;Keskiviikko;33;145;178;11;26;37
89;22.06.2016;2016;06;08;Keskiviikko;41;180;221;7;23;30
89;22.06.2016;2016;06;09;Keskiviikko;38;114;152;15;33;48
89;22.06.2016;2016;06;10;Keskiviikko;55;93;148;22;40;62
89;22.06.2016;2016;06;11;Keskiviikko;61;107;168;22;43;65
89;22.06.2016;2016;06;12;Keskiviikko;93;117;210;34;52;86
89;22.06.2016;2016;06;13;Keskiviikko;105;123;228;34;38;72
89;22.06.2016;2016;06;14;Keskiviikko;158;124;282;49;48;97
89;22.06.2016;2016;06;15;Keskiviikko;221;123;344;47;26;73
89;22.06.2016;2016;06;16;Keskiviikko;230;138;368;38;17;55
89;22.06.2016;2016;06;17;Keskiviikko;170;122;292;40;34;74
89;22.06.2016;2016;06;18;Keskiviikko;131;128;259;35;59;94
89;22.06.2016;2016;06;19;Keskiviikko;128;62;190;32;39;71
89;22.06.2016;2016;06;20;Keskiviikko;96;58;154;43;15;58
89;22.06.2016;2016;06;21;Keskiviikko;70;54;124;18;18;36
89;22.06.2016;2016;06;22;Keskiviikko;53;37;90;8;10;18
89;22.06.2016;2016;06;23;Keskiviikko;25;12;37;4;7;11
89;23.06.2016;2016;06;00;Torstai;18;5;23;4;5;9
89;23.06.2016;2016;06;01;Torstai;10;8;18;1;0;1
89;23.06.2016;2016;06;02;Torstai;6;7;13;2;2;4
89;23.06.2016;2016;06;03;Torstai;5;4;9;1;0;1
89;23.06.2016;2016;06;04;Torstai;12;2;14;1;1;2
89;23.06.2016;2016;06;05;Torstai;7;15;22;3;1;4
89;23.06.2016;2016;06;06;Torstai;29;57;86;6;10;16
89;23.06.2016;2016;06;07;Torstai;30;140;170;2;13;15
89;23.06.2016;2016;06;08;Torstai;38;159;197;9;18;27
89;23.06.2016;2016;06;09;Torstai;33;115;148;9;30;39
89;23.06.2016;2016;06;10;Torstai;71;90;161;30;31;61
89;23.06.2016;2016;06;11;Torstai;84;114;198;9;39;48
89;23.06.2016;2016;06;12;Torstai;117;126;243;26;28;54
89;23.06.2016;2016;06;13;Torstai;133;119;252;29;28;57
89;23.06.2016;2016;06;14;Torstai;201;130;331;25;30;55
89;23.06.2016;2016;06;15;Torstai;196;130;326;34;26;60
89;23.06.2016;2016;06;16;Torstai;161;120;281;29;41;70
89;23.06.2016;2016;06;17;Torstai;122;97;219;17;26;43
89;23.06.2016;2016;06;18;Torstai;99;83;182;25;21;46
89;23.06.2016;2016;06;19;Torstai;84;49;133;27;20;47
89;23.06.2016;2016;06;20;Torstai;56;60;116;20;19;39
89;23.06.2016;2016;06;21;Torstai;55;65;120;6;19;25
89;23.06.2016;2016;06;22;Torstai;47;40;87;17;16;33
89;23.06.2016;2016;06;23;Torstai;33;39;72;11;17;28
89;24.06.2016;2016;06;00;Perjantai;27;25;52;10;10;20
89;24.06.2016;2016;06;01;Perjantai;7;6;13;5;2;7
89;24.06.2016;2016;06;02;Perjantai;14;2;16;8;0;8
89;24.06.2016;2016;06;03;Perjantai;16;8;24;4;0;4
89;24.06.2016;2016;06;04;Perjantai;4;3;7;3;1;4
89;24.06.2016;2016;06;05;Perjantai;3;6;9;2;4;6
89;24.06.2016;2016;06;06;Perjantai;4;17;21;1;4;5
89;24.06.2016;2016;06;07;Perjantai;9;23;32;10;4;14
89;24.06.2016;2016;06;08;Perjantai;9;31;40;6;12;18
89;24.06.2016;2016;06;09;Perjantai;30;68;98;14;17;31
89;24.06.2016;2016;06;10;Perjantai;52;77;129;15;25;40
89;24.06.2016;2016;06;11;Perjantai;71;86;157;18;21;39
89;24.06.2016;2016;06;12;Perjantai;90;85;175;22;29;51
89;24.06.2016;2016;06;13;Perjantai;95;99;194;21;27;48
89;24.06.2016;2016;06;14;Perjantai;78;96;174;30;22;52
89;24.06.2016;2016;06;15;Perjantai;84;83;167;36;24;60
89;24.06.2016;2016;06;16;Perjantai;91;111;202;35;29;64
89;24.06.2016;2016;06;17;Perjantai;102;114;216;23;45;68
89;24.06.2016;2016;06;18;Perjantai;75;131;206;32;55;87
89;24.06.2016;2016;06;19;Perjantai;70;102;172;17;29;46
89;24.06.2016;2016;06;20;Perjantai;66;89;155;25;43;68
89;24.06.2016;2016;06;21;Perjantai;100;75;175;28;26;54
89;24.06.2016;2016;06;22;Perjantai;67;62;129;20;22;42
89;24.06.2016;2016;06;23;Perjantai;49;52;101;15;17;32
89;25.06.2016;2016;06;00;Lauantai;36;41;77;11;16;27
89;25.06.2016;2016;06;01;Lauantai;33;44;77;5;15;20
89;25.06.2016;2016;06;02;Lauantai;39;24;63;3;2;5
89;25.06.2016;2016;06;03;Lauantai;36;12;48;12;4;16
89;25.06.2016;2016;06;04;Lauantai;39;4;43;8;3;11
89;25.06.2016;2016;06;05;Lauantai;15;8;23;9;2;11
89;25.06.2016;2016;06;06;Lauantai;3;12;15;0;0;0
89;25.06.2016;2016;06;07;Lauantai;4;5;9;5;1;6
89;25.06.2016;2016;06;08;Lauantai;9;17;26;3;4;7
89;25.06.2016;2016;06;09;Lauantai;10;36;46;10;11;21
89;25.06.2016;2016;06;10;Lauantai;39;46;85;21;18;39
89;25.06.2016;2016;06;11;Lauantai;46;32;78;20;23;43
89;25.06.2016;2016;06;12;Lauantai;13;9;22;9;3;12
89;25.06.2016;2016;06;13;Lauantai;6;5;11;3;3;6
89;25.06.2016;2016;06;14;Lauantai;5;8;13;6;1;7
89;25.06.2016;2016;06;15;Lauantai;15;19;34;6;7;13
89;25.06.2016;2016;06;16;Lauantai;16;25;41;15;25;40
89;25.06.2016;2016;06;17;Lauantai;23;46;69;11;18;29
89;25.06.2016;2016;06;18;Lauantai;57;54;111;23;34;57
89;25.06.2016;2016;06;19;Lauantai;45;55;100;27;29;56
89;25.06.2016;2016;06;20;Lauantai;54;61;115;18;26;44
89;25.06.2016;2016;06;21;Lauantai;56;57;113;16;20;36
89;25.06.2016;2016;06;22;Lauantai;20;45;65;11;6;17
89;25.06.2016;2016;06;23;Lauantai;24;30;54;6;8;14
89;26.06.2016;2016;06;00;Sunnuntai;21;19;40;10;6;16
89;26.06.2016;2016;06;01;Sunnuntai;9;13;22;3;3;6
89;26.06.2016;2016;06;02;Sunnuntai;11;10;21;5;1;6
89;26.06.2016;2016;06;03;Sunnuntai;21;3;24;3;2;5
89;26.06.2016;2016;06;04;Sunnuntai;16;0;16;3;3;6
89;26.06.2016;2016;06;05;Sunnuntai;5;2;7;8;0;8
89;26.06.2016;2016;06;06;Sunnuntai;4;12;16;2;4;6
89;26.06.2016;2016;06;07;Sunnuntai;3;6;9;4;7;11
89;26.06.2016;2016;06;08;Sunnuntai;7;15;22;5;13;18
89;26.06.2016;2016;06;09;Sunnuntai;24;36;60;14;17;31
89;26.06.2016;2016;06;10;Sunnuntai;41;57;98;17;28;45
89;26.06.2016;2016;06;11;Sunnuntai;27;58;85;20;30;50
89;26.06.2016;2016;06;12;Sunnuntai;66;88;154;29;48;77
89;26.06.2016;2016;06;13;Sunnuntai;88;137;225;27;60;87
89;26.06.2016;2016;06;14;Sunnuntai;107;107;214;51;58;109
89;26.06.2016;2016;06;15;Sunnuntai;145;127;272;43;41;84
89;26.06.2016;2016;06;16;Sunnuntai;176;103;279;45;34;79
89;26.06.2016;2016;06;17;Sunnuntai;116;91;207;45;28;73
89;26.06.2016;2016;06;18;Sunnuntai;100;120;220;34;52;86
89;26.06.2016;2016;06;19;Sunnuntai;107;82;189;41;42;83
89;26.06.2016;2016;06;20;Sunnuntai;94;80;174;28;25;53
89;26.06.2016;2016;06;21;Sunnuntai;52;32;84;16;21;37
89;26.06.2016;2016;06;22;Sunnuntai;26;30;56;7;10;17
89;26.06.2016;2016;06;23;Sunnuntai;17;20;37;4;4;8
89;27.06.2016;2016;06;00;Maanantai;14;8;22;8;4;12
89;27.06.2016;2016;06;01;Maanantai;8;4;12;1;0;1
89;27.06.2016;2016;06;02;Maanantai;4;1;5;0;2;2
89;27.06.2016;2016;06;03;Maanantai;5;7;12;3;0;3
89;27.06.2016;2016;06;04;Maanantai;6;1;7;1;0;1
89;27.06.2016;2016;06;05;Maanantai;5;17;22;2;0;2
89;27.06.2016;2016;06;06;Maanantai;20;70;90;8;6;14
89;27.06.2016;2016;06;07;Maanantai;41;124;165;5;8;13
89;27.06.2016;2016;06;08;Maanantai;31;175;206;5;18;23
89;27.06.2016;2016;06;09;Maanantai;43;124;167;12;26;38
89;27.06.2016;2016;06;10;Maanantai;70;128;198;28;32;60
89;27.06.2016;2016;06;11;Maanantai;74;139;213;31;42;73
89;27.06.2016;2016;06;12;Maanantai;107;143;250;29;49;78
89;27.06.2016;2016;06;13;Maanantai;146;173;319;38;40;78
89;27.06.2016;2016;06;14;Maanantai;164;155;319;35;47;82
89;27.06.2016;2016;06;15;Maanantai;231;164;395;36;30;66
89;27.06.2016;2016;06;16;Maanantai;231;144;375;37;16;53
89;27.06.2016;2016;06;17;Maanantai;168;92;260;36;28;64
89;27.06.2016;2016;06;18;Maanantai;130;78;208;46;33;79
89;27.06.2016;2016;06;19;Maanantai;108;66;174;42;27;69
89;27.06.2016;2016;06;20;Maanantai;68;39;107;15;22;37
89;27.06.2016;2016;06;21;Maanantai;62;43;105;29;18;47
89;27.06.2016;2016;06;22;Maanantai;37;16;53;8;7;15
89;27.06.2016;2016;06;23;Maanantai;16;14;30;8;3;11
89;28.06.2016;2016;06;00;Tiistai;12;10;22;4;6;10
89;28.06.2016;2016;06;01;Tiistai;4;1;5;0;0;0
89;28.06.2016;2016;06;02;Tiistai;3;0;3;2;0;2
89;28.06.2016;2016;06;03;Tiistai;2;1;3;2;0;2
89;28.06.2016;2016;06;04;Tiistai;3;4;7;0;0;0
89;28.06.2016;2016;06;05;Tiistai;3;11;14;3;0;3
89;28.06.2016;2016;06;06;Tiistai;20;60;80;1;2;3
89;28.06.2016;2016;06;07;Tiistai;26;94;120;4;7;11
89;28.06.2016;2016;06;08;Tiistai;15;96;111;6;9;15
89;28.06.2016;2016;06;09;Tiistai;21;56;77;5;12;17
89;28.06.2016;2016;06;10;Tiistai;27;46;73;13;17;30
89;28.06.2016;2016;06;11;Tiistai;32;70;102;9;17;26
89;28.06.2016;2016;06;12;Tiistai;36;78;114;12;20;32
89;28.06.2016;2016;06;13;Tiistai;50;76;126;16;18;34
89;28.06.2016;2016;06;14;Tiistai;61;66;127;27;15;42
89;28.06.2016;2016;06;15;Tiistai;132;110;242;21;29;50
89;28.06.2016;2016;06;16;Tiistai;190;129;319;40;35;75
89;28.06.2016;2016;06;17;Tiistai;157;139;296;28;31;59
89;28.06.2016;2016;06;18;Tiistai;117;128;245;32;20;52
89;28.06.2016;2016;06;19;Tiistai;166;103;269;39;43;82
89;28.06.2016;2016;06;20;Tiistai;121;65;186;21;30;51
89;28.06.2016;2016;06;21;Tiistai;71;41;112;14;17;31
89;28.06.2016;2016;06;22;Tiistai;36;30;66;8;15;23
89;28.06.2016;2016;06;23;Tiistai;38;28;66;7;4;11
89;29.06.2016;2016;06;00;Keskiviikko;33;3;36;7;10;17
89;29.06.2016;2016;06;01;Keskiviikko;4;12;16;2;0;2
89;29.06.2016;2016;06;02;Keskiviikko;4;0;4;1;1;2
89;29.06.2016;2016;06;03;Keskiviikko;4;3;7;0;0;0
89;29.06.2016;2016;06;04;Keskiviikko;2;9;11;0;1;1
89;29.06.2016;2016;06;05;Keskiviikko;7;18;25;3;0;3
89;29.06.2016;2016;06;06;Keskiviikko;27;63;90;2;4;6
89;29.06.2016;2016;06;07;Keskiviikko;26;123;149;1;13;14
89;29.06.2016;2016;06;08;Keskiviikko;35;154;189;7;16;23
89;29.06.2016;2016;06;09;Keskiviikko;32;112;144;16;18;34
89;29.06.2016;2016;06;10;Keskiviikko;54;137;191;17;25;42
89;29.06.2016;2016;06;11;Keskiviikko;90;93;183;16;41;57
89;29.06.2016;2016;06;12;Keskiviikko;105;148;253;26;40;66
89;29.06.2016;2016;06;13;Keskiviikko;118;128;246;33;50;83
89;29.06.2016;2016;06;14;Keskiviikko;119;106;225;37;40;77
89;29.06.2016;2016;06;15;Keskiviikko;185;131;316;28;24;52
89;29.06.2016;2016;06;16;Keskiviikko;175;94;269;26;14;40
89;29.06.2016;2016;06;17;Keskiviikko;126;39;165;17;12;29
89;29.06.2016;2016;06;18;Keskiviikko;95;85;180;38;50;88
89;29.06.2016;2016;06;19;Keskiviikko;97;64;161;38;29;67
89;29.06.2016;2016;06;20;Keskiviikko;76;62;138;30;42;72
89;29.06.2016;2016;06;21;Keskiviikko;68;57;125;30;26;56
89;29.06.2016;2016;06;22;Keskiviikko;48;33;81;13;20;33
89;29.06.2016;2016;06;23;Keskiviikko;35;27;62;5;15;20
89;30.06.2016;2016;06;00;Torstai;21;19;40;6;7;13
89;30.06.2016;2016;06;01;Torstai;14;3;17;6;5;11
89;30.06.2016;2016;06;02;Torstai;14;0;14;2;1;3
89;30.06.2016;2016;06;03;Torstai;8;5;13;1;0;1
89;30.06.2016;2016;06;04;Torstai;11;3;14;5;0;5
89;30.06.2016;2016;06;05;Torstai;6;9;15;0;0;0
89;30.06.2016;2016;06;06;Torstai;19;63;82;4;3;7
89;30.06.2016;2016;06;07;Torstai;23;131;154;3;7;10
89;30.06.2016;2016;06;08;Torstai;29;144;173;10;22;32
89;30.06.2016;2016;06;09;Torstai;50;110;160;10;22;32
89;30.06.2016;2016;06;10;Torstai;69;109;178;25;33;58
89;30.06.2016;2016;06;11;Torstai;75;171;246;26;40;66
89;30.06.2016;2016;06;12;Torstai;108;124;232;26;35;61
89;30.06.2016;2016;06;13;Torstai;128;145;273;24;43;67
89;30.06.2016;2016;06;14;Torstai;150;140;290;31;42;73
89;30.06.2016;2016;06;15;Torstai;208;132;340;21;24;45
89;30.06.2016;2016;06;16;Torstai;89;45;134;18;4;22
89;30.06.2016;2016;06;17;Torstai;103;51;154;19;11;30
89;30.06.2016;2016;06;18;Torstai;77;63;140;11;22;33
89;30.06.2016;2016;06;19;Torstai;70;58;128;22;25;47
89;30.06.2016;2016;06;20;Torstai;96;54;150;29;35;64
89;30.06.2016;2016;06;21;Torstai;82;54;136;33;20;53
89;30.06.2016;2016;06;22;Torstai;21;24;45;12;14;26
89;30.06.2016;2016;06;23;Torstai;21;25;46;4;17;21
89;01.07.2016;2016;07;00;Perjantai;12;7;19;7;4;11
89;01.07.2016;2016;07;01;Perjantai;10;9;19;5;2;7
89;01.07.2016;2016;07;02;Perjantai;6;4;10;2;2;4
89;01.07.2016;2016;07;03;Perjantai;5;5;10;1;1;2
89;01.07.2016;2016;07;04;Perjantai;1;4;5;0;0;0
89;01.07.2016;2016;07;05;Perjantai;7;16;23;0;4;4
89;01.07.2016;2016;07;06;Perjantai;9;59;68;3;9;12
89;01.07.2016;2016;07;07;Perjantai;26;104;130;6;13;19
89;01.07.2016;2016;07;08;Perjantai;22;118;140;4;19;23
89;01.07.2016;2016;07;09;Perjantai;45;93;138;13;20;33
89;01.07.2016;2016;07;10;Perjantai;31;86;117;18;21;39
89;01.07.2016;2016;07;11;Perjantai;47;69;116;20;26;46
89;01.07.2016;2016;07;12;Perjantai;79;84;163;13;12;25
89;01.07.2016;2016;07;13;Perjantai;89;83;172;17;29;46
89;01.07.2016;2016;07;14;Perjantai;95;62;157;12;22;34
89;01.07.2016;2016;07;15;Perjantai;126;88;214;14;33;47
89;01.07.2016;2016;07;16;Perjantai;109;55;164;23;12;35
89;01.07.2016;2016;07;17;Perjantai;94;48;142;16;14;30
89;01.07.2016;2016;07;18;Perjantai;79;76;155;12;24;36
89;01.07.2016;2016;07;19;Perjantai;53;54;107;21;18;39
89;01.07.2016;2016;07;20;Perjantai;54;44;98;25;25;50
89;01.07.2016;2016;07;21;Perjantai;76;56;132;24;19;43
89;01.07.2016;2016;07;22;Perjantai;45;53;98;17;12;29
89;01.07.2016;2016;07;23;Perjantai;26;30;56;5;6;11
89;02.07.2016;2016;07;00;Lauantai;31;32;63;4;8;12
89;02.07.2016;2016;07;01;Lauantai;19;9;28;4;2;6
89;02.07.2016;2016;07;02;Lauantai;19;11;30;6;3;9
89;02.07.2016;2016;07;03;Lauantai;18;3;21;2;2;4
89;02.07.2016;2016;07;04;Lauantai;17;4;21;10;2;12
89;02.07.2016;2016;07;05;Lauantai;7;8;15;1;0;1
89;02.07.2016;2016;07;06;Lauantai;8;12;20;0;1;1
89;02.07.2016;2016;07;07;Lauantai;6;11;17;3;3;6
89;02.07.2016;2016;07;08;Lauantai;6;25;31;5;3;8
89;02.07.2016;2016;07;09;Lauantai;24;59;83;10;16;26
89;02.07.2016;2016;07;10;Lauantai;39;100;139;15;39;54
89;02.07.2016;2016;07;11;Lauantai;52;120;172;22;36;58
89;02.07.2016;2016;07;12;Lauantai;86;166;252;23;43;66
89;02.07.2016;2016;07;13;Lauantai;115;152;267;30;55;85
89;02.07.2016;2016;07;14;Lauantai;144;93;237;16;45;61
89;02.07.2016;2016;07;15;Lauantai;120;104;224;23;31;54
89;02.07.2016;2016;07;16;Lauantai;101;88;189;34;26;60
89;02.07.2016;2016;07;17;Lauantai;104;73;177;19;26;45
89;02.07.2016;2016;07;18;Lauantai;92;76;168;18;21;39
89;02.07.2016;2016;07;19;Lauantai;77;75;152;20;20;40
89;02.07.2016;2016;07;20;Lauantai;95;108;203;34;23;57
89;02.07.2016;2016;07;21;Lauantai;100;84;184;18;31;49
89;02.07.2016;2016;07;22;Lauantai;43;73;116;7;14;21
89;02.07.2016;2016;07;23;Lauantai;28;47;75;6;22;28
89;03.07.2016;2016;07;00;Sunnuntai;27;26;53;15;1;16
89;03.07.2016;2016;07;01;Sunnuntai;61;28;89;3;6;9
89;03.07.2016;2016;07;02;Sunnuntai;36;23;59;4;1;5
89;03.07.2016;2016;07;03;Sunnuntai;32;1;33;9;3;12
89;03.07.2016;2016;07;04;Sunnuntai;27;6;33;15;3;18
89;03.07.2016;2016;07;05;Sunnuntai;10;7;17;4;1;5
89;03.07.2016;2016;07;06;Sunnuntai;4;4;8;1;1;2
89;03.07.2016;2016;07;07;Sunnuntai;5;12;17;0;3;3
89;03.07.2016;2016;07;08;Sunnuntai;10;9;19;4;2;6
89;03.07.2016;2016;07;09;Sunnuntai;20;18;38;9;12;21
89;03.07.2016;2016;07;10;Sunnuntai;12;26;38;15;21;36
89;03.07.2016;2016;07;11;Sunnuntai;31;39;70;23;16;39
89;03.07.2016;2016;07;12;Sunnuntai;17;25;42;6;5;11
89;03.07.2016;2016;07;13;Sunnuntai;32;35;67;16;17;33
89;03.07.2016;2016;07;14;Sunnuntai;35;47;82;16;24;40
89;03.07.2016;2016;07;15;Sunnuntai;45;43;88;12;40;52
89;03.07.2016;2016;07;16;Sunnuntai;84;75;159;23;38;61
89;03.07.2016;2016;07;17;Sunnuntai;86;109;195;33;54;87
89;03.07.2016;2016;07;18;Sunnuntai;99;90;189;39;52;91
89;03.07.2016;2016;07;19;Sunnuntai;76;60;136;32;29;61
89;03.07.2016;2016;07;20;Sunnuntai;59;45;104;17;21;38
89;03.07.2016;2016;07;21;Sunnuntai;34;35;69;16;16;32
89;03.07.2016;2016;07;22;Sunnuntai;18;14;32;4;9;13
89;03.07.2016;2016;07;23;Sunnuntai;12;8;20;4;3;7
89;04.07.2016;2016;07;00;Maanantai;9;8;17;4;4;8
89;04.07.2016;2016;07;01;Maanantai;8;7;15;0;1;1
89;04.07.2016;2016;07;02;Maanantai;5;0;5;0;0;0
89;04.07.2016;2016;07;03;Maanantai;2;3;5;4;0;4
89;04.07.2016;2016;07;04;Maanantai;3;6;9;4;0;4
89;04.07.2016;2016;07;05;Maanantai;5;12;17;0;0;0
89;04.07.2016;2016;07;06;Maanantai;17;58;75;1;6;7
89;04.07.2016;2016;07;07;Maanantai;14;80;94;2;5;7
89;04.07.2016;2016;07;08;Maanantai;14;82;96;8;14;22
89;04.07.2016;2016;07;09;Maanantai;29;85;114;13;15;28
89;04.07.2016;2016;07;10;Maanantai;42;58;100;13;22;35
89;04.07.2016;2016;07;11;Maanantai;56;70;126;15;24;39
89;04.07.2016;2016;07;12;Maanantai;48;54;102;17;26;43
89;04.07.2016;2016;07;13;Maanantai;38;40;78;11;12;23
89;04.07.2016;2016;07;14;Maanantai;66;52;118;15;9;24
89;04.07.2016;2016;07;15;Maanantai;83;57;140;13;15;28
89;04.07.2016;2016;07;16;Maanantai;125;53;178;15;15;30
89;04.07.2016;2016;07;17;Maanantai;101;66;167;26;24;50
89;04.07.2016;2016;07;18;Maanantai;69;37;106;22;30;52
89;04.07.2016;2016;07;19;Maanantai;52;42;94;30;35;65
89;04.07.2016;2016;07;20;Maanantai;42;20;62;19;20;39
89;04.07.2016;2016;07;21;Maanantai;25;19;44;5;5;10
89;04.07.2016;2016;07;22;Maanantai;17;12;29;6;9;15
89;04.07.2016;2016;07;23;Maanantai;6;9;15;6;8;14
89;05.07.2016;2016;07;00;Tiistai;4;4;8;1;1;2
89;05.07.2016;2016;07;01;Tiistai;2;3;5;5;0;5
89;05.07.2016;2016;07;02;Tiistai;6;1;7;0;1;1
89;05.07.2016;2016;07;03;Tiistai;0;2;2;0;0;0
89;05.07.2016;2016;07;04;Tiistai;5;5;10;0;0;0
89;05.07.2016;2016;07;05;Tiistai;3;8;11;0;0;0
89;05.07.2016;2016;07;06;Tiistai;6;48;54;1;4;5
89;05.07.2016;2016;07;07;Tiistai;19;71;90;4;8;12
89;05.07.2016;2016;07;08;Tiistai;13;87;100;6;19;25
89;05.07.2016;2016;07;09;Tiistai;25;68;93;5;13;18
89;05.07.2016;2016;07;10;Tiistai;26;51;77;7;20;27
89;05.07.2016;2016;07;11;Tiistai;33;72;105;17;18;35
89;05.07.2016;2016;07;12;Tiistai;29;65;94;16;23;39
89;05.07.2016;2016;07;13;Tiistai;64;65;129;33;32;65
89;05.07.2016;2016;07;14;Tiistai;73;69;142;20;45;65
89;05.07.2016;2016;07;15;Tiistai;113;58;171;27;22;49
89;05.07.2016;2016;07;16;Tiistai;92;40;132;14;13;27
89;05.07.2016;2016;07;17;Tiistai;56;15;71;17;4;21
89;05.07.2016;2016;07;18;Tiistai;38;19;57;5;9;14
89;05.07.2016;2016;07;19;Tiistai;38;36;74;11;13;24
89;05.07.2016;2016;07;20;Tiistai;40;30;70;13;14;27
89;05.07.2016;2016;07;21;Tiistai;32;13;45;8;17;25
89;05.07.2016;2016;07;22;Tiistai;12;21;33;19;12;31
89;05.07.2016;2016;07;23;Tiistai;16;9;25;4;5;9
89;06.07.2016;2016;07;00;Keskiviikko;18;10;28;5;5;10
89;06.07.2016;2016;07;01;Keskiviikko;2;0;2;1;0;1
89;06.07.2016;2016;07;02;Keskiviikko;5;3;8;2;2;4
89;06.07.2016;2016;07;03;Keskiviikko;5;5;10;0;2;2
89;06.07.2016;2016;07;04;Keskiviikko;8;4;12;1;0;1
89;06.07.2016;2016;07;05;Keskiviikko;3;14;17;0;2;2
89;06.07.2016;2016;07;06;Keskiviikko;15;45;60;0;2;2
89;06.07.2016;2016;07;07;Keskiviikko;20;55;75;1;5;6
89;06.07.2016;2016;07;08;Keskiviikko;19;51;70;5;9;14
89;06.07.2016;2016;07;09;Keskiviikko;12;44;56;4;12;16
89;06.07.2016;2016;07;10;Keskiviikko;30;75;105;14;25;39
89;06.07.2016;2016;07;11;Keskiviikko;42;76;118;18;21;39
89;06.07.2016;2016;07;12;Keskiviikko;71;100;171;26;35;61
89;06.07.2016;2016;07;13;Keskiviikko;82;112;194;29;38;67
89;06.07.2016;2016;07;14;Keskiviikko;120;101;221;30;37;67
89;06.07.2016;2016;07;15;Keskiviikko;109;73;182;27;16;43
89;06.07.2016;2016;07;16;Keskiviikko;115;104;219;28;24;52
89;06.07.2016;2016;07;17;Keskiviikko;110;112;222;30;35;65
89;06.07.2016;2016;07;18;Keskiviikko;81;17;98;12;16;28
89;06.07.2016;2016;07;19;Keskiviikko;60;37;97;12;6;18
89;06.07.2016;2016;07;20;Keskiviikko;43;31;74;19;21;40
89;06.07.2016;2016;07;21;Keskiviikko;39;27;66;15;16;31
89;06.07.2016;2016;07;22;Keskiviikko;24;23;47;8;15;23
89;06.07.2016;2016;07;23;Keskiviikko;17;6;23;6;12;18
89;07.07.2016;2016;07;00;Torstai;17;8;25;8;14;22
89;07.07.2016;2016;07;01;Torstai;2;4;6;3;2;5
89;07.07.2016;2016;07;02;Torstai;5;1;6;2;3;5
89;07.07.2016;2016;07;03;Torstai;5;3;8;0;1;1
89;07.07.2016;2016;07;04;Torstai;7;5;12;0;1;1
89;07.07.2016;2016;07;05;Torstai;3;11;14;1;2;3
89;07.07.2016;2016;07;06;Torstai;16;62;78;0;4;4
89;07.07.2016;2016;07;07;Torstai;25;97;122;4;12;16
89;07.07.2016;2016;07;08;Torstai;21;94;115;5;25;30
89;07.07.2016;2016;07;09;Torstai;25;42;67;11;12;23
89;07.07.2016;2016;07;10;Torstai;31;57;88;11;23;34
89;07.07.2016;2016;07;11;Torstai;24;34;58;10;24;34
89;07.07.2016;2016;07;12;Torstai;30;16;46;6;6;12
89;07.07.2016;2016;07;13;Torstai;43;54;97;17;15;32
89;07.07.2016;2016;07;14;Torstai;39;75;114;9;27;36
89;07.07.2016;2016;07;15;Torstai;121;80;201;19;31;50
89;07.07.2016;2016;07;16;Torstai;131;91;222;23;24;47
89;07.07.2016;2016;07;17;Torstai;80;34;114;17;10;27
89;07.07.2016;2016;07;18;Torstai;81;57;138;25;28;53
89;07.07.2016;2016;07;19;Torstai;63;35;98;31;34;65
89;07.07.2016;2016;07;20;Torstai;53;53;106;33;41;74
89;07.07.2016;2016;07;21;Torstai;61;44;105;24;19;43
89;07.07.2016;2016;07;22;Torstai;28;22;50;9;18;27
89;07.07.2016;2016;07;23;Torstai;11;10;21;9;8;17
89;08.07.2016;2016;07;00;Perjantai;16;12;28;10;8;18
89;08.07.2016;2016;07;01;Perjantai;4;6;10;4;2;6
89;08.07.2016;2016;07;02;Perjantai;8;8;16;0;4;4
89;08.07.2016;2016;07;03;Perjantai;10;3;13;1;0;1
89;08.07.2016;2016;07;04;Perjantai;4;6;10;1;0;1
89;08.07.2016;2016;07;05;Perjantai;7;14;21;0;3;3
89;08.07.2016;2016;07;06;Perjantai;17;60;77;1;3;4
89;08.07.2016;2016;07;07;Perjantai;16;87;103;5;15;20
89;08.07.2016;2016;07;08;Perjantai;26;97;123;6;12;18
89;08.07.2016;2016;07;09;Perjantai;26;84;110;10;19;29
89;08.07.2016;2016;07;10;Perjantai;32;113;145;22;30;52
89;08.07.2016;2016;07;11;Perjantai;56;145;201;30;35;65
89;08.07.2016;2016;07;12;Perjantai;113;181;294;11;39;50
89;08.07.2016;2016;07;13;Perjantai;199;155;354;14;29;43
89;08.07.2016;2016;07;14;Perjantai;152;141;293;12;32;44
89;08.07.2016;2016;07;15;Perjantai;179;144;323;28;37;65
89;08.07.2016;2016;07;16;Perjantai;150;136;286;26;48;74
89;08.07.2016;2016;07;17;Perjantai;167;140;307;49;37;86
89;08.07.2016;2016;07;18;Perjantai;126;116;242;40;43;83
89;08.07.2016;2016;07;19;Perjantai;105;119;224;67;54;121
89;08.07.2016;2016;07;20;Perjantai;115;100;215;24;38;62
89;08.07.2016;2016;07;21;Perjantai;79;97;176;19;26;45
89;08.07.2016;2016;07;22;Perjantai;58;80;138;16;17;33
89;08.07.2016;2016;07;23;Perjantai;46;41;87;17;20;37
89;09.07.2016;2016;07;00;Lauantai;39;41;80;11;7;18
89;09.07.2016;2016;07;01;Lauantai;44;35;79;7;29;36
89;09.07.2016;2016;07;02;Lauantai;35;19;54;6;15;21
89;09.07.2016;2016;07;03;Lauantai;35;6;41;11;1;12
89;09.07.2016;2016;07;04;Lauantai;24;7;31;7;1;8
89;09.07.2016;2016;07;05;Lauantai;6;5;11;2;2;4
89;09.07.2016;2016;07;06;Lauantai;5;23;28;1;4;5
89;09.07.2016;2016;07;07;Lauantai;6;11;17;3;7;10
89;09.07.2016;2016;07;08;Lauantai;2;28;30;5;4;9
89;09.07.2016;2016;07;09;Lauantai;23;62;85;9;21;30
89;09.07.2016;2016;07;10;Lauantai;29;80;109;10;26;36
89;09.07.2016;2016;07;11;Lauantai;65;93;158;28;32;60
89;09.07.2016;2016;07;12;Lauantai;95;135;230;32;36;68
89;09.07.2016;2016;07;13;Lauantai;119;165;284;60;43;103
89;09.07.2016;2016;07;14;Lauantai;116;148;264;57;45;102
89;09.07.2016;2016;07;15;Lauantai;153;182;335;46;57;103
89;09.07.2016;2016;07;16;Lauantai;118;113;231;45;47;92
89;09.07.2016;2016;07;17;Lauantai;105;97;202;40;49;89
89;09.07.2016;2016;07;18;Lauantai;102;124;226;36;47;83
89;09.07.2016;2016;07;19;Lauantai;110;109;219;32;53;85
89;09.07.2016;2016;07;20;Lauantai;68;92;160;20;33;53
89;09.07.2016;2016;07;21;Lauantai;71;76;147;19;25;44
89;09.07.2016;2016;07;22;Lauantai;58;47;105;18;24;42
89;09.07.2016;2016;07;23;Lauantai;40;67;107;5;19;24
89;10.07.2016;2016;07;00;Sunnuntai;31;61;92;5;23;28
89;10.07.2016;2016;07;01;Sunnuntai;31;32;63;7;22;29
89;10.07.2016;2016;07;02;Sunnuntai;32;37;69;4;17;21
89;10.07.2016;2016;07;03;Sunnuntai;47;19;66;4;2;6
89;10.07.2016;2016;07;04;Sunnuntai;45;9;54;22;6;28
89;10.07.2016;2016;07;05;Sunnuntai;6;11;17;11;5;16
89;10.07.2016;2016;07;06;Sunnuntai;9;17;26;1;1;2
89;10.07.2016;2016;07;07;Sunnuntai;12;16;28;3;1;4
89;10.07.2016;2016;07;08;Sunnuntai;9;22;31;5;12;17
89;10.07.2016;2016;07;09;Sunnuntai;21;36;57;11;20;31
89;10.07.2016;2016;07;10;Sunnuntai;35;86;121;28;45;73
89;10.07.2016;2016;07;11;Sunnuntai;74;85;159;42;36;78
89;10.07.2016;2016;07;12;Sunnuntai;78;115;193;25;64;89
89;10.07.2016;2016;07;13;Sunnuntai;103;155;258;30;77;107
89;10.07.2016;2016;07;14;Sunnuntai;109;137;246;47;58;105
89;10.07.2016;2016;07;15;Sunnuntai;144;132;276;35;49;84
89;10.07.2016;2016;07;16;Sunnuntai;158;133;291;63;56;119
89;10.07.2016;2016;07;17;Sunnuntai;131;148;279;66;81;147
89;10.07.2016;2016;07;18;Sunnuntai;143;101;244;51;55;106
89;10.07.2016;2016;07;19;Sunnuntai;125;83;208;59;70;129
89;10.07.2016;2016;07;20;Sunnuntai;114;89;203;46;47;93
89;10.07.2016;2016;07;21;Sunnuntai;73;59;132;17;25;42
89;10.07.2016;2016;07;22;Sunnuntai;25;22;47;9;8;17
89;10.07.2016;2016;07;23;Sunnuntai;28;19;47;10;7;17
89;11.07.2016;2016;07;00;Maanantai;13;9;22;2;1;3
89;11.07.2016;2016;07;01;Maanantai;12;10;22;1;0;1
89;11.07.2016;2016;07;02;Maanantai;7;3;10;1;2;3
89;11.07.2016;2016;07;03;Maanantai;8;3;11;0;3;3
89;11.07.2016;2016;07;04;Maanantai;8;2;10;0;2;2
89;11.07.2016;2016;07;05;Maanantai;9;9;18;2;3;5
89;11.07.2016;2016;07;06;Maanantai;19;63;82;0;3;3
89;11.07.2016;2016;07;07;Maanantai;19;83;102;5;13;18
89;11.07.2016;2016;07;08;Maanantai;23;133;156;11;19;30
89;11.07.2016;2016;07;09;Maanantai;39;101;140;15;21;36
89;11.07.2016;2016;07;10;Maanantai;54;127;181;21;40;61
89;11.07.2016;2016;07;11;Maanantai;91;159;250;17;34;51
89;11.07.2016;2016;07;12;Maanantai;131;142;273;18;43;61
89;11.07.2016;2016;07;13;Maanantai;158;156;314;28;42;70
89;11.07.2016;2016;07;14;Maanantai;176;173;349;45;50;95
89;11.07.2016;2016;07;15;Maanantai;254;180;434;152;61;213
89;11.07.2016;2016;07;16;Maanantai;222;179;401;65;46;111
89;11.07.2016;2016;07;17;Maanantai;206;173;379;62;54;116
89;11.07.2016;2016;07;18;Maanantai;166;163;329;55;52;107
89;11.07.2016;2016;07;19;Maanantai;150;122;272;38;37;75
89;11.07.2016;2016;07;20;Maanantai;143;95;238;42;33;75
89;11.07.2016;2016;07;21;Maanantai;83;72;155;32;25;57
89;11.07.2016;2016;07;22;Maanantai;54;32;86;21;35;56
89;11.07.2016;2016;07;23;Maanantai;35;27;62;8;14;22
89;12.07.2016;2016;07;00;Tiistai;22;21;43;3;4;7
89;12.07.2016;2016;07;01;Tiistai;13;8;21;4;3;7
89;12.07.2016;2016;07;02;Tiistai;8;5;13;1;1;2
89;12.07.2016;2016;07;03;Tiistai;4;2;6;2;0;2
89;12.07.2016;2016;07;04;Tiistai;4;7;11;0;1;1
89;12.07.2016;2016;07;05;Tiistai;6;10;16;2;3;5
89;12.07.2016;2016;07;06;Tiistai;12;79;91;1;5;6
89;12.07.2016;2016;07;07;Tiistai;21;92;113;5;14;19
89;12.07.2016;2016;07;08;Tiistai;31;115;146;3;19;22
89;12.07.2016;2016;07;09;Tiistai;38;136;174;9;24;33
89;12.07.2016;2016;07;10;Tiistai;57;141;198;12;35;47
89;12.07.2016;2016;07;11;Tiistai;112;173;285;24;36;60
89;12.07.2016;2016;07;12;Tiistai;152;139;291;21;41;62
89;12.07.2016;2016;07;13;Tiistai;171;142;313;52;39;91
89;12.07.2016;2016;07;14;Tiistai;167;169;336;35;41;76
89;12.07.2016;2016;07;15;Tiistai;219;162;381;36;34;70
89;12.07.2016;2016;07;16;Tiistai;195;163;358;39;42;81
89;12.07.2016;2016;07;17;Tiistai;119;105;224;37;30;67
89;12.07.2016;2016;07;18;Tiistai;120;104;224;43;49;92
89;12.07.2016;2016;07;19;Tiistai;153;104;257;38;38;76
89;12.07.2016;2016;07;20;Tiistai;139;107;246;36;44;80
89;12.07.2016;2016;07;21;Tiistai;86;71;157;23;31;54
89;12.07.2016;2016;07;22;Tiistai;61;37;98;20;17;37
89;12.07.2016;2016;07;23;Tiistai;39;28;67;14;10;24
89;13.07.2016;2016;07;00;Keskiviikko;26;21;47;5;11;16
89;13.07.2016;2016;07;01;Keskiviikko;19;14;33;4;3;7
89;13.07.2016;2016;07;02;Keskiviikko;7;4;11;2;3;5
89;13.07.2016;2016;07;03;Keskiviikko;2;4;6;2;2;4
89;13.07.2016;2016;07;04;Keskiviikko;10;2;12;3;0;3
89;13.07.2016;2016;07;05;Keskiviikko;4;21;25;0;3;3
89;13.07.2016;2016;07;06;Keskiviikko;12;64;76;2;7;9
89;13.07.2016;2016;07;07;Keskiviikko;19;89;108;5;10;15
89;13.07.2016;2016;07;08;Keskiviikko;25;118;143;4;14;18
89;13.07.2016;2016;07;09;Keskiviikko;32;76;108;11;26;37
89;13.07.2016;2016;07;10;Keskiviikko;40;57;97;11;16;27
89;13.07.2016;2016;07;11;Keskiviikko;53;117;170;14;20;34
89;13.07.2016;2016;07;12;Keskiviikko;87;122;209;23;42;65
89;13.07.2016;2016;07;13;Keskiviikko;131;179;310;26;41;67
89;13.07.2016;2016;07;14;Keskiviikko;171;174;345;46;69;115
89;13.07.2016;2016;07;15;Keskiviikko;241;163;404;47;41;88
89;13.07.2016;2016;07;16;Keskiviikko;230;183;413;57;43;100
89;13.07.2016;2016;07;17;Keskiviikko;191;169;360;51;46;97
89;13.07.2016;2016;07;18;Keskiviikko;184;210;394;48;74;122
89;13.07.2016;2016;07;19;Keskiviikko;148;198;346;46;54;100
89;13.07.2016;2016;07;20;Keskiviikko;137;145;282;39;40;79
89;13.07.2016;2016;07;21;Keskiviikko;141;116;257;34;29;63
89;13.07.2016;2016;07;22;Keskiviikko;96;56;152;17;22;39
89;13.07.2016;2016;07;23;Keskiviikko;37;27;64;9;19;28
89;14.07.2016;2016;07;00;Torstai;53;12;65;5;6;11
89;14.07.2016;2016;07;01;Torstai;26;6;32;5;4;9
89;14.07.2016;2016;07;02;Torstai;16;3;19;2;1;3
89;14.07.2016;2016;07;03;Torstai;30;3;33;2;1;3
89;14.07.2016;2016;07;04;Torstai;16;3;19;2;1;3
89;14.07.2016;2016;07;05;Torstai;8;16;24;1;3;4
89;14.07.2016;2016;07;06;Torstai;13;78;91;1;8;9
89;14.07.2016;2016;07;07;Torstai;21;75;96;8;11;19
89;14.07.2016;2016;07;08;Torstai;20;128;148;13;23;36
89;14.07.2016;2016;07;09;Torstai;26;115;141;13;24;37
89;14.07.2016;2016;07;10;Torstai;66;119;185;12;30;42
89;14.07.2016;2016;07;11;Torstai;114;136;250;39;51;90
89;14.07.2016;2016;07;12;Torstai;112;155;267;30;39;69
89;14.07.2016;2016;07;13;Torstai;130;168;298;34;34;68
89;14.07.2016;2016;07;14;Torstai;175;167;342;62;53;115
89;14.07.2016;2016;07;15;Torstai;235;179;414;48;51;99
89;14.07.2016;2016;07;16;Torstai;207;186;393;46;57;103
89;14.07.2016;2016;07;17;Torstai;176;147;323;39;34;73
89;14.07.2016;2016;07;18;Torstai;149;202;351;53;77;130
89;14.07.2016;2016;07;19;Torstai;162;188;350;36;38;74
89;14.07.2016;2016;07;20;Torstai;110;110;220;40;37;77
89;14.07.2016;2016;07;21;Torstai;148;108;256;43;45;88
89;14.07.2016;2016;07;22;Torstai;83;40;123;28;17;45
89;14.07.2016;2016;07;23;Torstai;68;20;88;22;5;27
89;15.07.2016;2016;07;00;Perjantai;53;20;73;9;9;18
89;15.07.2016;2016;07;01;Perjantai;36;6;42;6;5;11
89;15.07.2016;2016;07;02;Perjantai;14;2;16;2;2;4
89;15.07.2016;2016;07;03;Perjantai;14;3;17;1;2;3
89;15.07.2016;2016;07;04;Perjantai;7;4;11;1;1;2
89;15.07.2016;2016;07;05;Perjantai;5;15;20;5;2;7
89;15.07.2016;2016;07;06;Perjantai;10;56;66;0;7;7
89;15.07.2016;2016;07;07;Perjantai;24;73;97;2;7;9
89;15.07.2016;2016;07;08;Perjantai;13;86;99;6;17;23
89;15.07.2016;2016;07;09;Perjantai;27;76;103;9;22;31
89;15.07.2016;2016;07;10;Perjantai;34;83;117;13;23;36
89;15.07.2016;2016;07;11;Perjantai;67;107;174;15;35;50
89;15.07.2016;2016;07;12;Perjantai;78;112;190;22;28;50
89;15.07.2016;2016;07;13;Perjantai;108;168;276;25;56;81
89;15.07.2016;2016;07;14;Perjantai;173;138;311;25;33;58
89;15.07.2016;2016;07;15;Perjantai;149;58;207;17;11;28
89;15.07.2016;2016;07;16;Perjantai;119;74;193;20;16;36
89;15.07.2016;2016;07;17;Perjantai;109;85;194;34;27;61
89;15.07.2016;2016;07;18;Perjantai;87;80;167;34;42;76
89;15.07.2016;2016;07;19;Perjantai;76;126;202;30;33;63
89;15.07.2016;2016;07;20;Perjantai;86;101;187;21;20;41
89;15.07.2016;2016;07;21;Perjantai;61;55;116;21;26;47
89;15.07.2016;2016;07;22;Perjantai;33;74;107;15;21;36
89;15.07.2016;2016;07;23;Perjantai;46;46;92;10;21;31
89;16.07.2016;2016;07;00;Lauantai;67;47;114;10;26;36
89;16.07.2016;2016;07;01;Lauantai;46;43;89;10;32;42
89;16.07.2016;2016;07;02;Lauantai;31;12;43;6;9;15
89;16.07.2016;2016;07;03;Lauantai;30;3;33;4;2;6
89;16.07.2016;2016;07;04;Lauantai;26;6;32;5;2;7
89;16.07.2016;2016;07;05;Lauantai;9;7;16;1;0;1
89;16.07.2016;2016;07;06;Lauantai;6;12;18;1;1;2
89;16.07.2016;2016;07;07;Lauantai;6;8;14;0;2;2
89;16.07.2016;2016;07;08;Lauantai;6;10;16;6;3;9
89;16.07.2016;2016;07;09;Lauantai;2;30;32;5;20;25
89;16.07.2016;2016;07;10;Lauantai;20;40;60;7;12;19
89;16.07.2016;2016;07;11;Lauantai;33;48;81;25;24;49
89;16.07.2016;2016;07;12;Lauantai;26;60;86;9;17;26
89;16.07.2016;2016;07;13;Lauantai;39;32;71;16;13;29
89;16.07.2016;2016;07;14;Lauantai;47;20;67;11;12;23
89;16.07.2016;2016;07;15;Lauantai;34;39;73;24;12;36
89;16.07.2016;2016;07;16;Lauantai;49;45;94;16;14;30
89;16.07.2016;2016;07;17;Lauantai;57;40;97;26;28;54
89;16.07.2016;2016;07;18;Lauantai;39;91;130;20;25;45
89;16.07.2016;2016;07;19;Lauantai;54;86;140;30;31;61
89;16.07.2016;2016;07;20;Lauantai;69;100;169;36;51;87
89;16.07.2016;2016;07;21;Lauantai;64;87;151;16;26;42
89;16.07.2016;2016;07;22;Lauantai;43;76;119;21;33;54
89;16.07.2016;2016;07;23;Lauantai;39;36;75;16;17;33
89;17.07.2016;2016;07;00;Sunnuntai;41;37;78;7;24;31
89;17.07.2016;2016;07;01;Sunnuntai;33;45;78;16;16;32
89;17.07.2016;2016;07;02;Sunnuntai;39;24;63;5;4;9
89;17.07.2016;2016;07;03;Sunnuntai;36;6;42;15;9;24
89;17.07.2016;2016;07;04;Sunnuntai;19;2;21;13;0;13
89;17.07.2016;2016;07;05;Sunnuntai;8;5;13;0;3;3
89;17.07.2016;2016;07;06;Sunnuntai;4;15;19;3;6;9
89;17.07.2016;2016;07;07;Sunnuntai;6;7;13;3;6;9
89;17.07.2016;2016;07;08;Sunnuntai;9;7;16;10;8;18
89;17.07.2016;2016;07;09;Sunnuntai;12;20;32;14;11;25
89;17.07.2016;2016;07;10;Sunnuntai;18;37;55;16;22;38
89;17.07.2016;2016;07;11;Sunnuntai;33;58;91;24;30;54
89;17.07.2016;2016;07;12;Sunnuntai;42;96;138;28;41;69
89;17.07.2016;2016;07;13;Sunnuntai;54;62;116;36;47;83
89;17.07.2016;2016;07;14;Sunnuntai;33;43;76;19;26;45
89;17.07.2016;2016;07;15;Sunnuntai;68;82;150;36;36;72
89;17.07.2016;2016;07;16;Sunnuntai;45;17;62;29;7;36
89;17.07.2016;2016;07;17;Sunnuntai;30;46;76;13;19;32
89;17.07.2016;2016;07;18;Sunnuntai;63;66;129;27;24;51
89;17.07.2016;2016;07;19;Sunnuntai;68;82;150;42;52;94
89;17.07.2016;2016;07;20;Sunnuntai;71;76;147;35;36;71
89;17.07.2016;2016;07;21;Sunnuntai;60;41;101;26;44;70
89;17.07.2016;2016;07;22;Sunnuntai;42;31;73;21;23;44
89;17.07.2016;2016;07;23;Sunnuntai;18;20;38;5;10;15
89;18.07.2016;2016;07;00;Maanantai;7;15;22;5;1;6
89;18.07.2016;2016;07;01;Maanantai;11;9;20;3;4;7
89;18.07.2016;2016;07;02;Maanantai;10;4;14;6;4;10
89;18.07.2016;2016;07;03;Maanantai;7;1;8;1;1;2
89;18.07.2016;2016;07;04;Maanantai;6;6;12;1;0;1
89;18.07.2016;2016;07;05;Maanantai;6;10;16;2;4;6
89;18.07.2016;2016;07;06;Maanantai;20;51;71;2;6;8
89;18.07.2016;2016;07;07;Maanantai;20;95;115;4;8;12
89;18.07.2016;2016;07;08;Maanantai;26;122;148;9;28;37
89;18.07.2016;2016;07;09;Maanantai;24;115;139;16;27;43
89;18.07.2016;2016;07;10;Maanantai;64;119;183;24;38;62
89;18.07.2016;2016;07;11;Maanantai;77;129;206;29;48;77
89;18.07.2016;2016;07;12;Maanantai;113;167;280;25;47;72
89;18.07.2016;2016;07;13;Maanantai;133;161;294;37;46;83
89;18.07.2016;2016;07;14;Maanantai;160;151;311;62;41;103
89;18.07.2016;2016;07;15;Maanantai;199;152;351;65;57;122
89;18.07.2016;2016;07;16;Maanantai;214;164;378;59;62;121
89;18.07.2016;2016;07;17;Maanantai;172;129;301;54;36;90
89;18.07.2016;2016;07;18;Maanantai;180;127;307;60;47;107
89;18.07.2016;2016;07;19;Maanantai;146;111;257;52;71;123
89;18.07.2016;2016;07;20;Maanantai;135;100;235;47;48;95
89;18.07.2016;2016;07;21;Maanantai;104;60;164;53;39;92
89;18.07.2016;2016;07;22;Maanantai;71;45;116;21;21;42
89;18.07.2016;2016;07;23;Maanantai;20;20;40;14;14;28
89;19.07.2016;2016;07;00;Tiistai;17;24;41;18;15;33
89;19.07.2016;2016;07;01;Tiistai;12;6;18;17;11;28
89;19.07.2016;2016;07;02;Tiistai;16;11;27;3;1;4
89;19.07.2016;2016;07;03;Tiistai;3;4;7;2;2;4
89;19.07.2016;2016;07;04;Tiistai;7;2;9;2;1;3
89;19.07.2016;2016;07;05;Tiistai;8;10;18;2;4;6
89;19.07.2016;2016;07;06;Tiistai;17;65;82;1;5;6
89;19.07.2016;2016;07;07;Tiistai;24;109;133;5;14;19
89;19.07.2016;2016;07;08;Tiistai;19;133;152;12;30;42
89;19.07.2016;2016;07;09;Tiistai;36;120;156;14;30;44
89;19.07.2016;2016;07;10;Tiistai;60;140;200;18;44;62
89;19.07.2016;2016;07;11;Tiistai;77;157;234;16;47;63
89;19.07.2016;2016;07;12;Tiistai;142;145;287;37;44;81
89;19.07.2016;2016;07;13;Tiistai;119;137;256;44;61;105
89;19.07.2016;2016;07;14;Tiistai;151;149;300;42;59;101
89;19.07.2016;2016;07;15;Tiistai;208;144;352;44;35;79
89;19.07.2016;2016;07;16;Tiistai;242;173;415;54;46;100
89;19.07.2016;2016;07;17;Tiistai;192;147;339;56;60;116
89;19.07.2016;2016;07;18;Tiistai;182;132;314;63;65;128
89;19.07.2016;2016;07;19;Tiistai;184;145;329;69;65;134
89;19.07.2016;2016;07;20;Tiistai;84;85;169;51;54;105
89;19.07.2016;2016;07;21;Tiistai;109;76;185;57;29;86
89;19.07.2016;2016;07;22;Tiistai;69;53;122;21;24;45
89;19.07.2016;2016;07;23;Tiistai;24;24;48;11;20;31
89;20.07.2016;2016;07;00;Keskiviikko;13;15;28;8;4;12
89;20.07.2016;2016;07;01;Keskiviikko;12;5;17;0;4;4
89;20.07.2016;2016;07;02;Keskiviikko;13;6;19;12;3;15
89;20.07.2016;2016;07;03;Keskiviikko;2;6;8;3;0;3
89;20.07.2016;2016;07;04;Keskiviikko;14;4;18;5;0;5
89;20.07.2016;2016;07;05;Keskiviikko;14;8;22;3;2;5
89;20.07.2016;2016;07;06;Keskiviikko;12;64;76;2;2;4
89;20.07.2016;2016;07;07;Keskiviikko;26;95;121;5;14;19
89;20.07.2016;2016;07;08;Keskiviikko;23;132;155;6;20;26
89;20.07.2016;2016;07;09;Keskiviikko;30;118;148;17;31;48
89;20.07.2016;2016;07;10;Keskiviikko;58;145;203;22;40;62
89;20.07.2016;2016;07;11;Keskiviikko;88;161;249;37;56;93
89;20.07.2016;2016;07;12;Keskiviikko;122;145;267;42;68;110
89;20.07.2016;2016;07;13;Keskiviikko;168;186;354;50;51;101
89;20.07.2016;2016;07;14;Keskiviikko;207;167;374;39;50;89
89;20.07.2016;2016;07;15;Keskiviikko;248;188;436;40;55;95
89;20.07.2016;2016;07;16;Keskiviikko;226;175;401;43;44;87
89;20.07.2016;2016;07;17;Keskiviikko;198;176;374;58;55;113
89;20.07.2016;2016;07;18;Keskiviikko;188;211;399;66;84;150
89;20.07.2016;2016;07;19;Keskiviikko;155;141;296;57;57;114
89;20.07.2016;2016;07;20;Keskiviikko;154;133;287;53;45;98
89;20.07.2016;2016;07;21;Keskiviikko;171;86;257;50;38;88
89;20.07.2016;2016;07;22;Keskiviikko;101;60;161;29;20;49
89;20.07.2016;2016;07;23;Keskiviikko;49;45;94;7;13;20
89;21.07.2016;2016;07;00;Torstai;27;14;41;8;2;10
89;21.07.2016;2016;07;01;Torstai;14;8;22;6;3;9
89;21.07.2016;2016;07;02;Torstai;8;4;12;1;0;1
89;21.07.2016;2016;07;03;Torstai;20;5;25;3;3;6
89;21.07.2016;2016;07;04;Torstai;13;4;17;3;1;4
89;21.07.2016;2016;07;05;Torstai;6;13;19;1;1;2
89;21.07.2016;2016;07;06;Torstai;17;60;77;1;4;5
89;21.07.2016;2016;07;07;Torstai;30;97;127;1;15;16
89;21.07.2016;2016;07;08;Torstai;39;115;154;15;25;40
89;21.07.2016;2016;07;09;Torstai;44;106;150;18;33;51
89;21.07.2016;2016;07;10;Torstai;66;127;193;17;30;47
89;21.07.2016;2016;07;11;Torstai;96;171;267;26;46;72
89;21.07.2016;2016;07;12;Torstai;147;146;293;39;41;80
89;21.07.2016;2016;07;13;Torstai;173;194;367;49;49;98
89;21.07.2016;2016;07;14;Torstai;202;199;401;45;48;93
89;21.07.2016;2016;07;15;Torstai;235;151;386;86;72;158
89;21.07.2016;2016;07;16;Torstai;271;200;471;73;71;144
89;21.07.2016;2016;07;17;Torstai;200;209;409;71;75;146
89;21.07.2016;2016;07;18;Torstai;167;253;420;65;107;172
89;21.07.2016;2016;07;19;Torstai;172;220;392;56;65;121
89;21.07.2016;2016;07;20;Torstai;188;131;319;60;47;107
89;21.07.2016;2016;07;21;Torstai;202;104;306;74;61;135
89;21.07.2016;2016;07;22;Torstai;91;43;134;47;40;87
89;21.07.2016;2016;07;23;Torstai;68;35;103;21;18;39
89;22.07.2016;2016;07;00;Perjantai;18;38;56;11;15;26
89;22.07.2016;2016;07;01;Perjantai;26;22;48;14;10;24
89;22.07.2016;2016;07;02;Perjantai;18;26;44;9;5;14
89;22.07.2016;2016;07;03;Perjantai;11;7;18;1;1;2
89;22.07.2016;2016;07;04;Perjantai;10;6;16;4;1;5
89;22.07.2016;2016;07;05;Perjantai;12;11;23;1;3;4
89;22.07.2016;2016;07;06;Perjantai;14;62;76;2;8;10
89;22.07.2016;2016;07;07;Perjantai;31;94;125;5;10;15
89;22.07.2016;2016;07;08;Perjantai;27;126;153;6;18;24
89;22.07.2016;2016;07;09;Perjantai;44;113;157;15;24;39
89;22.07.2016;2016;07;10;Perjantai;54;129;183;27;37;64
89;22.07.2016;2016;07;11;Perjantai;99;162;261;24;47;71
89;22.07.2016;2016;07;12;Perjantai;129;160;289;36;30;66
89;22.07.2016;2016;07;13;Perjantai;184;199;383;51;50;101
89;22.07.2016;2016;07;14;Perjantai;189;187;376;63;42;105
89;22.07.2016;2016;07;15;Perjantai;244;183;427;72;53;125
89;22.07.2016;2016;07;16;Perjantai;222;194;416;79;49;128
89;22.07.2016;2016;07;17;Perjantai;190;206;396;55;69;124
89;22.07.2016;2016;07;18;Perjantai;178;182;360;49;45;94
89;22.07.2016;2016;07;19;Perjantai;158;148;306;50;61;111
89;22.07.2016;2016;07;20;Perjantai;195;167;362;47;37;84
89;22.07.2016;2016;07;21;Perjantai;186;138;324;52;59;111
89;22.07.2016;2016;07;22;Perjantai;138;142;280;41;51;92
89;22.07.2016;2016;07;23;Perjantai;70;83;153;25;43;68
89;23.07.2016;2016;07;00;Lauantai;58;70;128;23;21;44
89;23.07.2016;2016;07;01;Lauantai;63;26;89;13;14;27
89;23.07.2016;2016;07;02;Lauantai;36;20;56;21;7;28
89;23.07.2016;2016;07;03;Lauantai;39;7;46;13;2;15
89;23.07.2016;2016;07;04;Lauantai;20;5;25;3;0;3
89;23.07.2016;2016;07;05;Lauantai;8;12;20;5;2;7
89;23.07.2016;2016;07;06;Lauantai;11;17;28;1;2;3
89;23.07.2016;2016;07;07;Lauantai;13;17;30;7;8;15
89;23.07.2016;2016;07;08;Lauantai;21;45;66;5;7;12
89;23.07.2016;2016;07;09;Lauantai;23;68;91;9;19;28
89;23.07.2016;2016;07;10;Lauantai;36;92;128;20;51;71
89;23.07.2016;2016;07;11;Lauantai;86;131;217;23;54;77
89;23.07.2016;2016;07;12;Lauantai;123;167;290;38;37;75
89;23.07.2016;2016;07;13;Lauantai;144;217;361;56;76;132
89;23.07.2016;2016;07;14;Lauantai;148;162;310;33;70;103
89;23.07.2016;2016;07;15;Lauantai;187;174;361;45;49;94
89;23.07.2016;2016;07;16;Lauantai;174;150;324;48;57;105
89;23.07.2016;2016;07;17;Lauantai;125;208;333;58;71;129
89;23.07.2016;2016;07;18;Lauantai;135;166;301;56;62;118
89;23.07.2016;2016;07;19;Lauantai;157;149;306;31;66;97
89;23.07.2016;2016;07;20;Lauantai;162;111;273;33;39;72
89;23.07.2016;2016;07;21;Lauantai;129;143;272;36;30;66
89;23.07.2016;2016;07;22;Lauantai;101;112;213;22;41;63
89;23.07.2016;2016;07;23;Lauantai;76;72;148;18;28;46
89;24.07.2016;2016;07;00;Sunnuntai;53;66;119;24;26;50
89;24.07.2016;2016;07;01;Sunnuntai;48;27;75;19;23;42
89;24.07.2016;2016;07;02;Sunnuntai;51;15;66;14;6;20
89;24.07.2016;2016;07;03;Sunnuntai;56;2;58;22;1;23
89;24.07.2016;2016;07;04;Sunnuntai;31;6;37;9;2;11
89;24.07.2016;2016;07;05;Sunnuntai;7;7;14;3;3;6
89;24.07.2016;2016;07;06;Sunnuntai;14;11;25;1;2;3
89;24.07.2016;2016;07;07;Sunnuntai;10;7;17;7;7;14
89;24.07.2016;2016;07;08;Sunnuntai;7;15;22;9;17;26
89;24.07.2016;2016;07;09;Sunnuntai;25;41;66;8;19;27
89;24.07.2016;2016;07;10;Sunnuntai;41;89;130;21;27;48
89;24.07.2016;2016;07;11;Sunnuntai;91;152;243;24;46;70
89;24.07.2016;2016;07;12;Sunnuntai;112;156;268;35;47;82
89;24.07.2016;2016;07;13;Sunnuntai;122;219;341;26;60;86
89;24.07.2016;2016;07;14;Sunnuntai;177;175;352;63;45;108
89;24.07.2016;2016;07;15;Sunnuntai;167;163;330;45;64;109
89;24.07.2016;2016;07;16;Sunnuntai;213;132;345;50;47;97
89;24.07.2016;2016;07;17;Sunnuntai;109;118;227;46;56;102
89;24.07.2016;2016;07;18;Sunnuntai;191;162;353;37;45;82
89;24.07.2016;2016;07;19;Sunnuntai;161;113;274;52;57;109
89;24.07.2016;2016;07;20;Sunnuntai;147;99;246;51;42;93
89;24.07.2016;2016;07;21;Sunnuntai;82;92;174;38;46;84
89;24.07.2016;2016;07;22;Sunnuntai;66;66;132;35;31;66
89;24.07.2016;2016;07;23;Sunnuntai;34;48;82;11;19;30
89;25.07.2016;2016;07;00;Maanantai;18;24;42;17;10;27
89;25.07.2016;2016;07;01;Maanantai;10;12;22;7;4;11
89;25.07.2016;2016;07;02;Maanantai;19;3;22;2;3;5
89;25.07.2016;2016;07;03;Maanantai;8;7;15;1;0;1
89;25.07.2016;2016;07;04;Maanantai;13;3;16;3;1;4
89;25.07.2016;2016;07;05;Maanantai;13;13;26;2;2;4
89;25.07.2016;2016;07;06;Maanantai;17;61;78;4;5;9
89;25.07.2016;2016;07;07;Maanantai;26;115;141;5;11;16
89;25.07.2016;2016;07;08;Maanantai;33;122;155;11;25;36
89;25.07.2016;2016;07;09;Maanantai;43;109;152;18;36;54
89;25.07.2016;2016;07;10;Maanantai;60;121;181;33;38;71
89;25.07.2016;2016;07;11;Maanantai;92;142;234;27;33;60
89;25.07.2016;2016;07;12;Maanantai;112;183;295;27;42;69
89;25.07.2016;2016;07;13;Maanantai;165;213;378;57;62;119
89;25.07.2016;2016;07;14;Maanantai;193;196;389;48;49;97
89;25.07.2016;2016;07;15;Maanantai;265;194;459;62;40;102
89;25.07.2016;2016;07;16;Maanantai;254;211;465;47;46;93
89;25.07.2016;2016;07;17;Maanantai;224;195;419;58;52;110
89;25.07.2016;2016;07;18;Maanantai;203;204;407;51;63;114
89;25.07.2016;2016;07;19;Maanantai;178;167;345;55;63;118
89;25.07.2016;2016;07;20;Maanantai;186;138;324;38;46;84
89;25.07.2016;2016;07;21;Maanantai;141;86;227;54;44;98
89;25.07.2016;2016;07;22;Maanantai;73;84;157;32;34;66
89;25.07.2016;2016;07;23;Maanantai;47;43;90;16;12;28
89;26.07.2016;2016;07;00;Tiistai;35;24;59;14;15;29
89;26.07.2016;2016;07;01;Tiistai;22;15;37;23;9;32
89;26.07.2016;2016;07;02;Tiistai;10;3;13;3;1;4
89;26.07.2016;2016;07;03;Tiistai;6;10;16;1;3;4
89;26.07.2016;2016;07;04;Tiistai;14;4;18;1;0;1
89;26.07.2016;2016;07;05;Tiistai;4;27;31;1;7;8
89;26.07.2016;2016;07;06;Tiistai;13;57;70;5;8;13
89;26.07.2016;2016;07;07;Tiistai;26;118;144;4;20;24
89;26.07.2016;2016;07;08;Tiistai;32;137;169;14;24;38
89;26.07.2016;2016;07;09;Tiistai;43;124;167;15;44;59
89;26.07.2016;2016;07;10;Tiistai;85;177;262;27;44;71
89;26.07.2016;2016;07;11;Tiistai;123;189;312;25;37;62
89;26.07.2016;2016;07;12;Tiistai;161;203;364;31;40;71
89;26.07.2016;2016;07;13;Tiistai;160;209;369;44;49;93
89;26.07.2016;2016;07;14;Tiistai;185;198;383;71;51;122
89;26.07.2016;2016;07;15;Tiistai;286;218;504;67;51;118
89;26.07.2016;2016;07;16;Tiistai;289;196;485;60;43;103
89;26.07.2016;2016;07;17;Tiistai;244;223;467;56;63;119
89;26.07.2016;2016;07;18;Tiistai;242;271;513;46;58;104
89;26.07.2016;2016;07;19;Tiistai;241;216;457;48;72;120
89;26.07.2016;2016;07;20;Tiistai;191;167;358;50;50;100
89;26.07.2016;2016;07;21;Tiistai;164;150;314;37;40;77
89;26.07.2016;2016;07;22;Tiistai;116;84;200;22;23;45
89;26.07.2016;2016;07;23;Tiistai;74;60;134;15;15;30
89;27.07.2016;2016;07;00;Keskiviikko;25;13;38;8;10;18
89;27.07.2016;2016;07;01;Keskiviikko;26;11;37;4;7;11
89;27.07.2016;2016;07;02;Keskiviikko;18;21;39;10;4;14
89;27.07.2016;2016;07;03;Keskiviikko;14;8;22;4;1;5
89;27.07.2016;2016;07;04;Keskiviikko;23;4;27;3;1;4
89;27.07.2016;2016;07;05;Keskiviikko;15;12;27;0;3;3
89;27.07.2016;2016;07;06;Keskiviikko;14;62;76;1;5;6
89;27.07.2016;2016;07;07;Keskiviikko;21;94;115;12;10;22
89;27.07.2016;2016;07;08;Keskiviikko;22;100;122;3;18;21
89;27.07.2016;2016;07;09;Keskiviikko;27;66;93;7;20;27
89;27.07.2016;2016;07;10;Keskiviikko;33;71;104;16;31;47
89;27.07.2016;2016;07;11;Keskiviikko;62;115;177;18;34;52
89;27.07.2016;2016;07;12;Keskiviikko;76;168;244;17;38;55
89;27.07.2016;2016;07;13;Keskiviikko;119;151;270;29;37;66
89;27.07.2016;2016;07;14;Keskiviikko;152;168;320;34;35;69
89;27.07.2016;2016;07;15;Keskiviikko;203;157;360;41;37;78
89;27.07.2016;2016;07;16;Keskiviikko;225;160;385;59;42;101
89;27.07.2016;2016;07;17;Keskiviikko;236;179;415;56;45;101
89;27.07.2016;2016;07;18;Keskiviikko;208;217;425;53;79;132
89;27.07.2016;2016;07;19;Keskiviikko;170;186;356;70;65;135
89;27.07.2016;2016;07;20;Keskiviikko;182;161;343;86;51;137
89;27.07.2016;2016;07;21;Keskiviikko;186;106;292;55;25;80
89;27.07.2016;2016;07;22;Keskiviikko;76;58;134;26;33;59
89;27.07.2016;2016;07;23;Keskiviikko;48;28;76;29;22;51
89;28.07.2016;2016;07;00;Torstai;39;26;65;19;24;43
89;28.07.2016;2016;07;01;Torstai;14;16;30;17;8;25
89;28.07.2016;2016;07;02;Torstai;16;4;20;6;1;7
89;28.07.2016;2016;07;03;Torstai;19;6;25;0;2;2
89;28.07.2016;2016;07;04;Torstai;7;6;13;2;1;3
89;28.07.2016;2016;07;05;Torstai;8;20;28;3;4;7
89;28.07.2016;2016;07;06;Torstai;12;68;80;1;5;6
89;28.07.2016;2016;07;07;Torstai;29;107;136;7;16;23
89;28.07.2016;2016;07;08;Torstai;36;157;193;9;24;33
89;28.07.2016;2016;07;09;Torstai;41;114;155;15;42;57
89;28.07.2016;2016;07;10;Torstai;58;124;182;22;25;47
89;28.07.2016;2016;07;11;Torstai;78;166;244;14;25;39
89;28.07.2016;2016;07;12;Torstai;107;241;348;34;46;80
89;28.07.2016;2016;07;13;Torstai;147;214;361;59;41;100
89;28.07.2016;2016;07;14;Torstai;229;211;440;54;44;98
89;28.07.2016;2016;07;15;Torstai;234;188;422;55;33;88
89;28.07.2016;2016;07;16;Torstai;242;169;411;31;41;72
89;28.07.2016;2016;07;17;Torstai;204;147;351;42;44;86
89;28.07.2016;2016;07;18;Torstai;184;194;378;42;48;90
89;28.07.2016;2016;07;19;Torstai;154;126;280;36;49;85
89;28.07.2016;2016;07;20;Torstai;133;112;245;45;38;83
89;28.07.2016;2016;07;21;Torstai;138;92;230;49;33;82
89;28.07.2016;2016;07;22;Torstai;74;39;113;24;24;48
89;28.07.2016;2016;07;23;Torstai;46;23;69;19;16;35
89;29.07.2016;2016;07;00;Perjantai;32;13;45;16;4;20
89;29.07.2016;2016;07;01;Perjantai;23;7;30;5;5;10
89;29.07.2016;2016;07;02;Perjantai;22;9;31;5;2;7
89;29.07.2016;2016;07;03;Perjantai;4;1;5;1;2;3
89;29.07.2016;2016;07;04;Perjantai;10;5;15;2;0;2
89;29.07.2016;2016;07;05;Perjantai;7;13;20;0;5;5
89;29.07.2016;2016;07;06;Perjantai;11;64;75;3;9;12
89;29.07.2016;2016;07;07;Perjantai;18;106;124;5;13;18
89;29.07.2016;2016;07;08;Perjantai;27;128;155;5;19;24
89;29.07.2016;2016;07;09;Perjantai;35;98;133;16;17;33
89;29.07.2016;2016;07;10;Perjantai;68;149;217;18;42;60
89;29.07.2016;2016;07;11;Perjantai;87;177;264;32;48;80
89;29.07.2016;2016;07;12;Perjantai;124;176;300;43;59;102
89;29.07.2016;2016;07;13;Perjantai;162;181;343;38;34;72
89;29.07.2016;2016;07;14;Perjantai;197;198;395;58;45;103
89;29.07.2016;2016;07;15;Perjantai;185;200;385;35;37;72
89;29.07.2016;2016;07;16;Perjantai;174;234;408;25;47;72
89;29.07.2016;2016;07;17;Perjantai;164;237;401;28;38;66
89;29.07.2016;2016;07;18;Perjantai;129;214;343;37;63;100
89;29.07.2016;2016;07;19;Perjantai;153;254;407;28;48;76
89;29.07.2016;2016;07;20;Perjantai;161;175;336;24;48;72
89;29.07.2016;2016;07;21;Perjantai;99;144;243;39;42;81
89;29.07.2016;2016;07;22;Perjantai;99;89;188;19;34;53
89;29.07.2016;2016;07;23;Perjantai;94;53;147;18;31;49
89;30.07.2016;2016;07;00;Lauantai;182;37;219;26;10;36
89;30.07.2016;2016;07;01;Lauantai;165;14;179;29;2;31
89;30.07.2016;2016;07;02;Lauantai;107;12;119;24;3;27
89;30.07.2016;2016;07;03;Lauantai;56;4;60;25;3;28
89;30.07.2016;2016;07;04;Lauantai;44;7;51;15;2;17
89;30.07.2016;2016;07;05;Lauantai;15;4;19;3;3;6
89;30.07.2016;2016;07;06;Lauantai;13;13;26;2;5;7
89;30.07.2016;2016;07;07;Lauantai;13;16;29;5;12;17
89;30.07.2016;2016;07;08;Lauantai;9;35;44;7;3;10
89;30.07.2016;2016;07;09;Lauantai;34;73;107;7;24;31
89;30.07.2016;2016;07;10;Lauantai;54;128;182;18;38;56
89;30.07.2016;2016;07;11;Lauantai;83;189;272;19;44;63
89;30.07.2016;2016;07;12;Lauantai;146;230;376;27;48;75
89;30.07.2016;2016;07;13;Lauantai;165;260;425;38;50;88
89;30.07.2016;2016;07;14;Lauantai;209;235;444;63;48;111
89;30.07.2016;2016;07;15;Lauantai;140;112;252;29;30;59
89;30.07.2016;2016;07;16;Lauantai;118;84;202;7;28;35
89;30.07.2016;2016;07;17;Lauantai;86;114;200;26;34;60
89;30.07.2016;2016;07;18;Lauantai;83;137;220;40;36;76
89;30.07.2016;2016;07;19;Lauantai;100;113;213;40;38;78
89;30.07.2016;2016;07;20;Lauantai;89;150;239;23;32;55
89;30.07.2016;2016;07;21;Lauantai;86;129;215;17;41;58
89;30.07.2016;2016;07;22;Lauantai;79;93;172;26;34;60
89;30.07.2016;2016;07;23;Lauantai;64;58;122;13;19;32
89;31.07.2016;2016;07;00;Sunnuntai;119;32;151;22;5;27
89;31.07.2016;2016;07;01;Sunnuntai;154;18;172;20;6;26
89;31.07.2016;2016;07;02;Sunnuntai;91;7;98;16;5;21
89;31.07.2016;2016;07;03;Sunnuntai;66;2;68;15;5;20
89;31.07.2016;2016;07;04;Sunnuntai;68;10;78;25;2;27
89;31.07.2016;2016;07;05;Sunnuntai;18;6;24;10;0;10
89;31.07.2016;2016;07;06;Sunnuntai;16;10;26;2;2;4
89;31.07.2016;2016;07;07;Sunnuntai;11;7;18;6;5;11
89;31.07.2016;2016;07;08;Sunnuntai;9;8;17;7;5;12
89;31.07.2016;2016;07;09;Sunnuntai;21;25;46;11;16;27
89;31.07.2016;2016;07;10;Sunnuntai;28;59;87;18;23;41
89;31.07.2016;2016;07;11;Sunnuntai;25;47;72;23;19;42
89;31.07.2016;2016;07;12;Sunnuntai;39;59;98;16;29;45
89;31.07.2016;2016;07;13;Sunnuntai;51;84;135;21;24;45
89;31.07.2016;2016;07;14;Sunnuntai;66;99;165;22;50;72
89;31.07.2016;2016;07;15;Sunnuntai;96;142;238;32;40;72
89;31.07.2016;2016;07;16;Sunnuntai;111;101;212;33;38;71
89;31.07.2016;2016;07;17;Sunnuntai;116;110;226;33;36;69
89;31.07.2016;2016;07;18;Sunnuntai;83;49;132;18;14;32
89;31.07.2016;2016;07;19;Sunnuntai;34;16;50;11;7;18
89;31.07.2016;2016;07;20;Sunnuntai;46;31;77;21;14;35
89;31.07.2016;2016;07;21;Sunnuntai;39;26;65;15;18;33
89;31.07.2016;2016;07;22;Sunnuntai;25;33;58;7;8;15
89;31.07.2016;2016;07;23;Sunnuntai;14;8;22;10;12;22
89;01.08.2016;2016;08;00;Maanantai;4;1;5;9;5;14
89;01.08.2016;2016;08;01;Maanantai;1;3;4;0;0;0
89;01.08.2016;2016;08;02;Maanantai;9;5;14;2;0;2
89;01.08.2016;2016;08;03;Maanantai;7;5;12;0;1;1
89;01.08.2016;2016;08;04;Maanantai;5;8;13;0;1;1
89;01.08.2016;2016;08;05;Maanantai;5;21;26;4;1;5
89;01.08.2016;2016;08;06;Maanantai;17;74;91;2;5;7
89;01.08.2016;2016;08;07;Maanantai;36;153;189;3;12;15
89;01.08.2016;2016;08;08;Maanantai;37;143;180;15;29;44
89;01.08.2016;2016;08;09;Maanantai;31;133;164;24;48;72
89;01.08.2016;2016;08;10;Maanantai;71;119;190;36;46;82
89;01.08.2016;2016;08;11;Maanantai;106;131;237;34;43;77
89;01.08.2016;2016;08;12;Maanantai;93;119;212;36;56;92
89;01.08.2016;2016;08;13;Maanantai;101;145;246;24;42;66
89;01.08.2016;2016;08;14;Maanantai;125;111;236;29;28;57
89;01.08.2016;2016;08;15;Maanantai;208;125;333;39;41;80
89;01.08.2016;2016;08;16;Maanantai;251;146;397;74;44;118
89;01.08.2016;2016;08;17;Maanantai;181;139;320;71;49;120
89;01.08.2016;2016;08;18;Maanantai;163;125;288;55;46;101
89;01.08.2016;2016;08;19;Maanantai;147;104;251;43;53;96
89;01.08.2016;2016;08;20;Maanantai;148;92;240;87;82;169
89;01.08.2016;2016;08;21;Maanantai;99;70;169;39;42;81
89;01.08.2016;2016;08;22;Maanantai;58;40;98;36;23;59
89;01.08.2016;2016;08;23;Maanantai;28;20;48;11;11;22
89;02.08.2016;2016;08;00;Tiistai;9;10;19;2;5;7
89;02.08.2016;2016;08;01;Tiistai;5;5;10;1;6;7
89;02.08.2016;2016;08;02;Tiistai;4;3;7;1;0;1
89;02.08.2016;2016;08;03;Tiistai;13;2;15;2;0;2
89;02.08.2016;2016;08;04;Tiistai;11;4;15;1;4;5
89;02.08.2016;2016;08;05;Tiistai;7;15;22;1;2;3
89;02.08.2016;2016;08;06;Tiistai;11;65;76;1;6;7
89;02.08.2016;2016;08;07;Tiistai;25;126;151;13;15;28
89;02.08.2016;2016;08;08;Tiistai;32;139;171;13;27;40
89;02.08.2016;2016;08;09;Tiistai;32;61;93;7;19;26
89;02.08.2016;2016;08;10;Tiistai;31;69;100;26;42;68
89;02.08.2016;2016;08;11;Tiistai;37;87;124;17;40;57
89;02.08.2016;2016;08;12;Tiistai;83;104;187;38;34;72
89;02.08.2016;2016;08;13;Tiistai;71;49;120;23;26;49
89;02.08.2016;2016;08;14;Tiistai;67;37;104;20;9;29
89;02.08.2016;2016;08;15;Tiistai;120;51;171;17;14;31
89;02.08.2016;2016;08;16;Tiistai;124;52;176;18;10;28
89;02.08.2016;2016;08;17;Tiistai;81;67;148;35;27;62
89;02.08.2016;2016;08;18;Tiistai;81;67;148;26;23;49
89;02.08.2016;2016;08;19;Tiistai;76;71;147;65;83;148
89;02.08.2016;2016;08;20;Tiistai;88;60;148;71;60;131
89;02.08.2016;2016;08;21;Tiistai;75;54;129;52;51;103
89;02.08.2016;2016;08;22;Tiistai;42;32;74;19;13;32
89;02.08.2016;2016;08;23;Tiistai;20;24;44;10;9;19
89;03.08.2016;2016;08;00;Keskiviikko;24;13;37;12;9;21
89;03.08.2016;2016;08;01;Keskiviikko;6;7;13;2;2;4
89;03.08.2016;2016;08;02;Keskiviikko;9;5;14;4;1;5
89;03.08.2016;2016;08;03;Keskiviikko;4;2;6;1;0;1
89;03.08.2016;2016;08;04;Keskiviikko;2;2;4;1;1;2
89;03.08.2016;2016;08;05;Keskiviikko;6;14;20;2;1;3
89;03.08.2016;2016;08;06;Keskiviikko;14;62;76;3;8;11
89;03.08.2016;2016;08;07;Keskiviikko;23;108;131;6;11;17
89;03.08.2016;2016;08;08;Keskiviikko;29;154;183;11;33;44
89;03.08.2016;2016;08;09;Keskiviikko;25;105;130;25;39;64
89;03.08.2016;2016;08;10;Keskiviikko;77;119;196;31;62;93
89;03.08.2016;2016;08;11;Keskiviikko;83;138;221;25;45;70
89;03.08.2016;2016;08;12;Keskiviikko;97;137;234;30;47;77
89;03.08.2016;2016;08;13;Keskiviikko;118;138;256;39;47;86
89;03.08.2016;2016;08;14;Keskiviikko;105;64;169;46;22;68
89;03.08.2016;2016;08;15;Keskiviikko;120;43;163;12;10;22
89;03.08.2016;2016;08;16;Keskiviikko;172;46;218;20;23;43
89;03.08.2016;2016;08;17;Keskiviikko;103;48;151;22;11;33
89;03.08.2016;2016;08;18;Keskiviikko;77;76;153;20;29;49
89;03.08.2016;2016;08;19;Keskiviikko;80;65;145;63;68;131
89;03.08.2016;2016;08;20;Keskiviikko;89;66;155;40;26;66
89;03.08.2016;2016;08;21;Keskiviikko;75;46;121;41;33;74
89;03.08.2016;2016;08;22;Keskiviikko;46;25;71;21;25;46
89;03.08.2016;2016;08;23;Keskiviikko;21;21;42;13;12;25
89;04.08.2016;2016;08;00;Torstai;16;11;27;4;3;7
89;04.08.2016;2016;08;01;Torstai;8;3;11;2;5;7
89;04.08.2016;2016;08;02;Torstai;7;6;13;1;1;2
89;04.08.2016;2016;08;03;Torstai;9;3;12;0;1;1
89;04.08.2016;2016;08;04;Torstai;3;5;8;3;0;3
89;04.08.2016;2016;08;05;Torstai;4;15;19;2;2;4
89;04.08.2016;2016;08;06;Torstai;18;66;84;2;5;7
89;04.08.2016;2016;08;07;Torstai;21;108;129;4;13;17
89;04.08.2016;2016;08;08;Torstai;36;185;221;6;19;25
89;04.08.2016;2016;08;09;Torstai;26;123;149;10;30;40
89;04.08.2016;2016;08;10;Torstai;65;120;185;28;43;71
89;04.08.2016;2016;08;11;Torstai;81;119;200;25;34;59
89;04.08.2016;2016;08;12;Torstai;93;168;261;27;61;88
89;04.08.2016;2016;08;13;Torstai;132;148;280;33;47;80
89;04.08.2016;2016;08;14;Torstai;149;121;270;47;28;75
89;04.08.2016;2016;08;15;Torstai;239;107;346;41;31;72
89;04.08.2016;2016;08;16;Torstai;224;112;336;34;24;58
89;04.08.2016;2016;08;17;Torstai;167;104;271;44;18;62
89;04.08.2016;2016;08;18;Torstai;106;55;161;20;15;35
89;04.08.2016;2016;08;19;Torstai;93;66;159;22;33;55
89;04.08.2016;2016;08;20;Torstai;91;55;146;27;26;53
89;04.08.2016;2016;08;21;Torstai;60;44;104;13;18;31
89;04.08.2016;2016;08;22;Torstai;40;17;57;12;8;20
89;04.08.2016;2016;08;23;Torstai;21;9;30;2;8;10
89;05.08.2016;2016;08;00;Perjantai;10;3;13;4;0;4
89;05.08.2016;2016;08;01;Perjantai;10;1;11;2;0;2
89;05.08.2016;2016;08;02;Perjantai;3;3;6;2;3;5
89;05.08.2016;2016;08;03;Perjantai;3;3;6;0;0;0
89;05.08.2016;2016;08;04;Perjantai;12;3;15;0;1;1
89;05.08.2016;2016;08;05;Perjantai;8;14;22;0;1;1
89;05.08.2016;2016;08;06;Perjantai;15;63;78;2;5;7
89;05.08.2016;2016;08;07;Perjantai;23;105;128;2;10;12
89;05.08.2016;2016;08;08;Perjantai;34;117;151;10;25;35
89;05.08.2016;2016;08;09;Perjantai;45;87;132;16;15;31
89;05.08.2016;2016;08;10;Perjantai;44;85;129;15;24;39
89;05.08.2016;2016;08;11;Perjantai;54;88;142;16;30;46
89;05.08.2016;2016;08;12;Perjantai;77;103;180;20;37;57
89;05.08.2016;2016;08;13;Perjantai;74;125;199;47;56;103
89;05.08.2016;2016;08;14;Perjantai;115;114;229;45;45;90
89;05.08.2016;2016;08;15;Perjantai;174;130;304;34;39;73
89;05.08.2016;2016;08;16;Perjantai;204;142;346;50;25;75
89;05.08.2016;2016;08;17;Perjantai;156;139;295;59;50;109
89;05.08.2016;2016;08;18;Perjantai;124;127;251;57;38;95
89;05.08.2016;2016;08;19;Perjantai;113;120;233;47;58;105
89;05.08.2016;2016;08;20;Perjantai;119;97;216;32;42;74
89;05.08.2016;2016;08;21;Perjantai;77;66;143;37;26;63
89;05.08.2016;2016;08;22;Perjantai;64;74;138;27;45;72
89;05.08.2016;2016;08;23;Perjantai;55;45;100;11;28;39
89;06.08.2016;2016;08;00;Lauantai;25;32;57;6;6;12
89;06.08.2016;2016;08;01;Lauantai;34;14;48;7;8;15
89;06.08.2016;2016;08;02;Lauantai;28;29;57;7;3;10
89;06.08.2016;2016;08;03;Lauantai;25;8;33;6;1;7
89;06.08.2016;2016;08;04;Lauantai;25;3;28;11;0;11
89;06.08.2016;2016;08;05;Lauantai;9;2;11;1;0;1
89;06.08.2016;2016;08;06;Lauantai;5;25;30;2;2;4
89;06.08.2016;2016;08;07;Lauantai;9;13;22;2;2;4
89;06.08.2016;2016;08;08;Lauantai;14;25;39;4;7;11
89;06.08.2016;2016;08;09;Lauantai;23;70;93;20;25;45
89;06.08.2016;2016;08;10;Lauantai;40;124;164;17;50;67
89;06.08.2016;2016;08;11;Lauantai;62;162;224;31;48;79
89;06.08.2016;2016;08;12;Lauantai;139;161;300;35;47;82
89;06.08.2016;2016;08;13;Lauantai;143;123;266;52;52;104
89;06.08.2016;2016;08;14;Lauantai;150;135;285;49;67;116
89;06.08.2016;2016;08;15;Lauantai;146;144;290;34;65;99
89;06.08.2016;2016;08;16;Lauantai;125;117;242;61;32;93
89;06.08.2016;2016;08;17;Lauantai;107;102;209;45;30;75
89;06.08.2016;2016;08;18;Lauantai;150;144;294;64;36;100
89;06.08.2016;2016;08;19;Lauantai;126;113;239;46;75;121
89;06.08.2016;2016;08;20;Lauantai;71;97;168;30;45;75
89;06.08.2016;2016;08;21;Lauantai;64;91;155;26;43;69
89;06.08.2016;2016;08;22;Lauantai;57;53;110;23;22;45
89;06.08.2016;2016;08;23;Lauantai;56;44;100;13;28;41
89;07.08.2016;2016;08;00;Sunnuntai;36;43;79;10;18;28
89;07.08.2016;2016;08;01;Sunnuntai;33;27;60;8;9;17
89;07.08.2016;2016;08;02;Sunnuntai;29;15;44;11;1;12
89;07.08.2016;2016;08;03;Sunnuntai;33;2;35;9;2;11
89;07.08.2016;2016;08;04;Sunnuntai;29;1;30;7;0;7
89;07.08.2016;2016;08;05;Sunnuntai;9;1;10;2;0;2
89;07.08.2016;2016;08;06;Sunnuntai;7;10;17;3;2;5
89;07.08.2016;2016;08;07;Sunnuntai;6;10;16;3;1;4
89;07.08.2016;2016;08;08;Sunnuntai;9;14;23;7;11;18
89;07.08.2016;2016;08;09;Sunnuntai;16;34;50;12;13;25
89;07.08.2016;2016;08;10;Sunnuntai;26;67;93;17;26;43
89;07.08.2016;2016;08;11;Sunnuntai;46;72;118;14;48;62
89;07.08.2016;2016;08;12;Sunnuntai;57;66;123;20;35;55
89;07.08.2016;2016;08;13;Sunnuntai;55;102;157;31;46;77
89;07.08.2016;2016;08;14;Sunnuntai;90;98;188;36;56;92
89;07.08.2016;2016;08;15;Sunnuntai;79;101;180;51;54;105
89;07.08.2016;2016;08;16;Sunnuntai;104;105;209;55;56;111
89;07.08.2016;2016;08;17;Sunnuntai;148;117;265;55;45;100
89;07.08.2016;2016;08;18;Sunnuntai;110;100;210;66;61;127
89;07.08.2016;2016;08;19;Sunnuntai;124;95;219;46;53;99
89;07.08.2016;2016;08;20;Sunnuntai;105;107;212;45;37;82
89;07.08.2016;2016;08;21;Sunnuntai;72;72;144;36;29;65
89;07.08.2016;2016;08;22;Sunnuntai;41;28;69;24;17;41
89;07.08.2016;2016;08;23;Sunnuntai;33;12;45;6;15;21
89;08.08.2016;2016;08;00;Maanantai;15;6;21;3;5;8
89;08.08.2016;2016;08;01;Maanantai;11;7;18;2;3;5
89;08.08.2016;2016;08;02;Maanantai;12;7;19;4;2;6
89;08.08.2016;2016;08;03;Maanantai;4;4;8;1;0;1
89;08.08.2016;2016;08;04;Maanantai;7;2;9;0;0;0
89;08.08.2016;2016;08;05;Maanantai;4;16;20;1;0;1
89;08.08.2016;2016;08;06;Maanantai;16;73;89;1;5;6
89;08.08.2016;2016;08;07;Maanantai;44;138;182;8;17;25
89;08.08.2016;2016;08;08;Maanantai;42;226;268;7;22;29
89;08.08.2016;2016;08;09;Maanantai;60;136;196;17;30;47
89;08.08.2016;2016;08;10;Maanantai;63;106;169;26;32;58
89;08.08.2016;2016;08;11;Maanantai;87;134;221;29;33;62
89;08.08.2016;2016;08;12;Maanantai;94;153;247;26;53;79
89;08.08.2016;2016;08;13;Maanantai;144;137;281;30;51;81
89;08.08.2016;2016;08;14;Maanantai;157;130;287;41;39;80
89;08.08.2016;2016;08;15;Maanantai;209;163;372;44;28;72
89;08.08.2016;2016;08;16;Maanantai;284;141;425;38;34;72
89;08.08.2016;2016;08;17;Maanantai;204;102;306;37;25;62
89;08.08.2016;2016;08;18;Maanantai;132;80;212;32;42;74
89;08.08.2016;2016;08;19;Maanantai;119;99;218;45;34;79
89;08.08.2016;2016;08;20;Maanantai;119;55;174;38;27;65
89;08.08.2016;2016;08;21;Maanantai;60;49;109;26;21;47
89;08.08.2016;2016;08;22;Maanantai;39;27;66;16;18;34
89;08.08.2016;2016;08;23;Maanantai;16;22;38;6;11;17
89;09.08.2016;2016;08;00;Tiistai;10;3;13;12;4;16
89;09.08.2016;2016;08;01;Tiistai;6;4;10;0;0;0
89;09.08.2016;2016;08;02;Tiistai;8;3;11;0;1;1
89;09.08.2016;2016;08;03;Tiistai;2;4;6;3;0;3
89;09.08.2016;2016;08;04;Tiistai;7;3;10;4;0;4
89;09.08.2016;2016;08;05;Tiistai;4;11;15;1;3;4
89;09.08.2016;2016;08;06;Tiistai;17;67;84;3;6;9
89;09.08.2016;2016;08;07;Tiistai;33;137;170;5;12;17
89;09.08.2016;2016;08;08;Tiistai;45;204;249;7;31;38
89;09.08.2016;2016;08;09;Tiistai;46;120;166;11;24;35
89;09.08.2016;2016;08;10;Tiistai;50;113;163;12;36;48
89;09.08.2016;2016;08;11;Tiistai;63;99;162;14;38;52
89;09.08.2016;2016;08;12;Tiistai;69;76;145;25;35;60
89;09.08.2016;2016;08;13;Tiistai;98;103;201;18;26;44
89;09.08.2016;2016;08;14;Tiistai;92;51;143;27;21;48
89;09.08.2016;2016;08;15;Tiistai;159;77;236;15;15;30
89;09.08.2016;2016;08;16;Tiistai;201;125;326;27;16;43
89;09.08.2016;2016;08;17;Tiistai;153;75;228;18;19;37
89;09.08.2016;2016;08;18;Tiistai;90;68;158;26;32;58
89;09.08.2016;2016;08;19;Tiistai;96;64;160;41;36;77
89;09.08.2016;2016;08;20;Tiistai;87;63;150;32;35;67
89;09.08.2016;2016;08;21;Tiistai;47;36;83;16;24;40
89;09.08.2016;2016;08;22;Tiistai;30;20;50;16;14;30
89;09.08.2016;2016;08;23;Tiistai;17;15;32;6;5;11
89;10.08.2016;2016;08;00;Keskiviikko;17;6;23;5;1;6
89;10.08.2016;2016;08;01;Keskiviikko;5;4;9;1;2;3
89;10.08.2016;2016;08;02;Keskiviikko;2;0;2;0;0;0
89;10.08.2016;2016;08;03;Keskiviikko;5;2;7;2;3;5
89;10.08.2016;2016;08;04;Keskiviikko;5;3;8;1;0;1
89;10.08.2016;2016;08;05;Keskiviikko;3;13;16;2;1;3
89;10.08.2016;2016;08;06;Keskiviikko;11;53;64;0;5;5
89;10.08.2016;2016;08;07;Keskiviikko;24;96;120;3;13;16
89;10.08.2016;2016;08;08;Keskiviikko;35;177;212;5;38;43
89;10.08.2016;2016;08;09;Keskiviikko;47;127;174;15;21;36
89;10.08.2016;2016;08;10;Keskiviikko;36;104;140;10;21;31
89;10.08.2016;2016;08;11;Keskiviikko;73;114;187;17;28;45
89;10.08.2016;2016;08;12;Keskiviikko;81;126;207;17;36;53
89;10.08.2016;2016;08;13;Keskiviikko;120;133;253;34;48;82
89;10.08.2016;2016;08;14;Keskiviikko;128;118;246;44;50;94
89;10.08.2016;2016;08;15;Keskiviikko;200;136;336;44;27;71
89;10.08.2016;2016;08;16;Keskiviikko;221;62;283;25;15;40
89;10.08.2016;2016;08;17;Keskiviikko;105;67;172;16;21;37
89;10.08.2016;2016;08;18;Keskiviikko;109;72;181;29;29;58
89;10.08.2016;2016;08;19;Keskiviikko;105;45;150;24;31;55
89;10.08.2016;2016;08;20;Keskiviikko;72;50;122;24;25;49
89;10.08.2016;2016;08;21;Keskiviikko;79;32;111;24;25;49
89;10.08.2016;2016;08;22;Keskiviikko;31;17;48;14;11;25
89;10.08.2016;2016;08;23;Keskiviikko;11;13;24;8;3;11
89;11.08.2016;2016;08;00;Torstai;10;7;17;9;3;12
89;11.08.2016;2016;08;01;Torstai;6;4;10;3;1;4
89;11.08.2016;2016;08;02;Torstai;6;0;6;0;0;0
89;11.08.2016;2016;08;03;Torstai;7;3;10;1;0;1
89;11.08.2016;2016;08;04;Torstai;10;5;15;3;0;3
89;11.08.2016;2016;08;05;Torstai;3;11;14;1;1;2
89;11.08.2016;2016;08;06;Torstai;15;73;88;3;6;9
89;11.08.2016;2016;08;07;Torstai;37;134;171;6;18;24
89;11.08.2016;2016;08;08;Torstai;51;257;308;12;31;43
89;11.08.2016;2016;08;09;Torstai;48;212;260;17;36;53
89;11.08.2016;2016;08;10;Torstai;49;84;133;46;48;94
89;11.08.2016;2016;08;11;Torstai;64;98;162;26;25;51
89;11.08.2016;2016;08;12;Torstai;152;137;289;50;33;83
89;11.08.2016;2016;08;13;Torstai;100;94;194;31;38;69
89;11.08.2016;2016;08;14;Torstai;140;89;229;37;39;76
89;11.08.2016;2016;08;15;Torstai;195;105;300;30;32;62
89;11.08.2016;2016;08;16;Torstai;234;126;360;16;28;44
89;11.08.2016;2016;08;17;Torstai;172;116;288;39;25;64
89;11.08.2016;2016;08;18;Torstai;108;94;202;33;28;61
89;11.08.2016;2016;08;19;Torstai;109;83;192;46;37;83
89;11.08.2016;2016;08;20;Torstai;98;50;148;28;28;56
89;11.08.2016;2016;08;21;Torstai;51;32;83;28;23;51
89;11.08.2016;2016;08;22;Torstai;29;25;54;22;27;49
89;11.08.2016;2016;08;23;Torstai;16;9;25;11;5;16
89;12.08.2016;2016;08;00;Perjantai;13;7;20;8;1;9
89;12.08.2016;2016;08;01;Perjantai;9;4;13;1;3;4
89;12.08.2016;2016;08;02;Perjantai;4;2;6;1;0;1
89;12.08.2016;2016;08;03;Perjantai;6;2;8;0;0;0
89;12.08.2016;2016;08;04;Perjantai;6;5;11;0;4;4
89;12.08.2016;2016;08;05;Perjantai;3;13;16;0;0;0
89;12.08.2016;2016;08;06;Perjantai;9;61;70;3;4;7
89;12.08.2016;2016;08;07;Perjantai;37;119;156;3;20;23
89;12.08.2016;2016;08;08;Perjantai;43;180;223;7;35;42
89;12.08.2016;2016;08;09;Perjantai;31;49;80;6;17;23
89;12.08.2016;2016;08;10;Perjantai;28;31;59;6;9;15
89;12.08.2016;2016;08;11;Perjantai;30;40;70;11;9;20
89;12.08.2016;2016;08;12;Perjantai;57;72;129;6;22;28
89;12.08.2016;2016;08;13;Perjantai;95;77;172;14;20;34
89;12.08.2016;2016;08;14;Perjantai;97;69;166;34;24;58
89;12.08.2016;2016;08;15;Perjantai;122;92;214;25;23;48
89;12.08.2016;2016;08;16;Perjantai;144;111;255;20;26;46
89;12.08.2016;2016;08;17;Perjantai;92;83;175;27;23;50
89;12.08.2016;2016;08;18;Perjantai;80;73;153;28;39;67
89;12.08.2016;2016;08;19;Perjantai;89;61;150;46;30;76
89;12.08.2016;2016;08;20;Perjantai;82;65;147;26;37;63
89;12.08.2016;2016;08;21;Perjantai;50;63;113;32;17;49
89;12.08.2016;2016;08;22;Perjantai;45;46;91;16;16;32
89;12.08.2016;2016;08;23;Perjantai;35;26;61;12;11;23
89;13.08.2016;2016;08;00;Lauantai;18;35;53;11;14;25
89;13.08.2016;2016;08;01;Lauantai;25;7;32;5;5;10
89;13.08.2016;2016;08;02;Lauantai;8;3;11;8;1;9
89;13.08.2016;2016;08;03;Lauantai;17;4;21;7;4;11
89;13.08.2016;2016;08;04;Lauantai;17;3;20;3;0;3
89;13.08.2016;2016;08;05;Lauantai;5;10;15;0;3;3
89;13.08.2016;2016;08;06;Lauantai;4;9;13;3;2;5
89;13.08.2016;2016;08;07;Lauantai;3;14;17;0;8;8
89;13.08.2016;2016;08;08;Lauantai;9;20;29;6;7;13
89;13.08.2016;2016;08;09;Lauantai;13;45;58;9;13;22
89;13.08.2016;2016;08;10;Lauantai;27;32;59;5;15;20
89;13.08.2016;2016;08;11;Lauantai;21;32;53;9;13;22
89;13.08.2016;2016;08;12;Lauantai;24;39;63;13;23;36
89;13.08.2016;2016;08;13;Lauantai;26;23;49;11;11;22
89;13.08.2016;2016;08;14;Lauantai;22;22;44;10;10;20
89;13.08.2016;2016;08;15;Lauantai;34;20;54;9;11;20
89;13.08.2016;2016;08;16;Lauantai;31;19;50;15;13;28
89;13.08.2016;2016;08;17;Lauantai;38;38;76;13;20;33
89;13.08.2016;2016;08;18;Lauantai;22;24;46;22;26;48
89;13.08.2016;2016;08;19;Lauantai;37;26;63;20;28;48
89;13.08.2016;2016;08;20;Lauantai;39;30;69;17;21;38
89;13.08.2016;2016;08;21;Lauantai;37;23;60;12;13;25
89;13.08.2016;2016;08;22;Lauantai;19;23;42;10;17;27
89;13.08.2016;2016;08;23;Lauantai;19;19;38;9;7;16
89;14.08.2016;2016;08;00;Sunnuntai;11;19;30;3;8;11
89;14.08.2016;2016;08;01;Sunnuntai;8;15;23;4;6;10
89;14.08.2016;2016;08;02;Sunnuntai;16;6;22;3;2;5
89;14.08.2016;2016;08;03;Sunnuntai;16;6;22;10;2;12
89;14.08.2016;2016;08;04;Sunnuntai;18;3;21;13;1;14
89;14.08.2016;2016;08;05;Sunnuntai;5;4;9;3;1;4
89;14.08.2016;2016;08;06;Sunnuntai;2;6;8;1;0;1
89;14.08.2016;2016;08;07;Sunnuntai;5;6;11;2;2;4
89;14.08.2016;2016;08;08;Sunnuntai;4;10;14;4;7;11
89;14.08.2016;2016;08;09;Sunnuntai;15;27;42;10;12;22
89;14.08.2016;2016;08;10;Sunnuntai;19;37;56;24;39;63
89;14.08.2016;2016;08;11;Sunnuntai;40;87;127;34;68;102
89;14.08.2016;2016;08;12;Sunnuntai;71;109;180;43;57;100
89;14.08.2016;2016;08;13;Sunnuntai;63;123;186;56;59;115
89;14.08.2016;2016;08;14;Sunnuntai;100;111;211;46;65;111
89;14.08.2016;2016;08;15;Sunnuntai;111;104;215;57;91;148
89;14.08.2016;2016;08;16;Sunnuntai;127;108;235;59;61;120
89;14.08.2016;2016;08;17;Sunnuntai;100;95;195;61;52;113
89;14.08.2016;2016;08;18;Sunnuntai;140;125;265;46;44;90
89;14.08.2016;2016;08;19;Sunnuntai;119;74;193;55;50;105
89;14.08.2016;2016;08;20;Sunnuntai;84;65;149;48;47;95
89;14.08.2016;2016;08;21;Sunnuntai;67;39;106;29;20;49
89;14.08.2016;2016;08;22;Sunnuntai;32;15;47;16;16;32
89;14.08.2016;2016;08;23;Sunnuntai;14;13;27;9;6;15
89;15.08.2016;2016;08;00;Maanantai;11;9;20;2;4;6
89;15.08.2016;2016;08;01;Maanantai;7;6;13;1;1;2
89;15.08.2016;2016;08;02;Maanantai;5;6;11;2;2;4
89;15.08.2016;2016;08;03;Maanantai;8;3;11;2;0;2
89;15.08.2016;2016;08;04;Maanantai;3;5;8;0;1;1
89;15.08.2016;2016;08;05;Maanantai;6;16;22;0;1;1
89;15.08.2016;2016;08;06;Maanantai;18;50;68;3;6;9
89;15.08.2016;2016;08;07;Maanantai;31;179;210;3;22;25
89;15.08.2016;2016;08;08;Maanantai;49;301;350;11;26;37
89;15.08.2016;2016;08;09;Maanantai;52;136;188;9;39;48
89;15.08.2016;2016;08;10;Maanantai;43;87;130;23;25;48
89;15.08.2016;2016;08;11;Maanantai;68;107;175;28;25;53
89;15.08.2016;2016;08;12;Maanantai;85;127;212;17;27;44
89;15.08.2016;2016;08;13;Maanantai;107;98;205;42;27;69
89;15.08.2016;2016;08;14;Maanantai;151;109;260;15;32;47
89;15.08.2016;2016;08;15;Maanantai;178;100;278;23;26;49
89;15.08.2016;2016;08;16;Maanantai;286;131;417;30;16;46
89;15.08.2016;2016;08;17;Maanantai;172;114;286;36;29;65
89;15.08.2016;2016;08;18;Maanantai;109;101;210;46;55;101
89;15.08.2016;2016;08;19;Maanantai;125;61;186;60;55;115
89;15.08.2016;2016;08;20;Maanantai;125;62;187;29;29;58
89;15.08.2016;2016;08;21;Maanantai;63;32;95;17;26;43
89;15.08.2016;2016;08;22;Maanantai;34;21;55;19;10;29
89;15.08.2016;2016;08;23;Maanantai;12;7;19;2;1;3
89;16.08.2016;2016;08;00;Tiistai;10;5;15;3;4;7
89;16.08.2016;2016;08;01;Tiistai;3;6;9;0;0;0
89;16.08.2016;2016;08;02;Tiistai;3;3;6;0;0;0
89;16.08.2016;2016;08;03;Tiistai;9;1;10;0;2;2
89;16.08.2016;2016;08;04;Tiistai;4;2;6;0;0;0
89;16.08.2016;2016;08;05;Tiistai;6;10;16;0;0;0
89;16.08.2016;2016;08;06;Tiistai;15;75;90;2;8;10
89;16.08.2016;2016;08;07;Tiistai;41;168;209;4;18;22
89;16.08.2016;2016;08;08;Tiistai;48;297;345;10;35;45
89;16.08.2016;2016;08;09;Tiistai;41;130;171;15;36;51
89;16.08.2016;2016;08;10;Tiistai;49;79;128;16;50;66
89;16.08.2016;2016;08;11;Tiistai;69;87;156;27;26;53
89;16.08.2016;2016;08;12;Tiistai;61;101;162;28;35;63
89;16.08.2016;2016;08;13;Tiistai;82;88;170;20;19;39
89;16.08.2016;2016;08;14;Tiistai;108;54;162;31;24;55
89;16.08.2016;2016;08;15;Tiistai;170;73;243;20;20;40
89;16.08.2016;2016;08;16;Tiistai;219;103;322;32;16;48
89;16.08.2016;2016;08;17;Tiistai;136;70;206;29;28;57
89;16.08.2016;2016;08;18;Tiistai;87;47;134;30;24;54
89;16.08.2016;2016;08;19;Tiistai;67;49;116;31;21;52
89;16.08.2016;2016;08;20;Tiistai;62;36;98;16;14;30
89;16.08.2016;2016;08;21;Tiistai;29;17;46;15;17;32
89;16.08.2016;2016;08;22;Tiistai;28;12;40;5;5;10
89;16.08.2016;2016;08;23;Tiistai;23;16;39;9;3;12
89;17.08.2016;2016;08;00;Keskiviikko;8;5;13;2;0;2
89;17.08.2016;2016;08;01;Keskiviikko;3;3;6;0;1;1
89;17.08.2016;2016;08;02;Keskiviikko;7;2;9;1;1;2
89;17.08.2016;2016;08;03;Keskiviikko;6;0;6;1;0;1
89;17.08.2016;2016;08;04;Keskiviikko;6;5;11;1;1;2
89;17.08.2016;2016;08;05;Keskiviikko;2;13;15;1;1;2
89;17.08.2016;2016;08;06;Keskiviikko;15;66;81;4;9;13
89;17.08.2016;2016;08;07;Keskiviikko;48;153;201;4;18;22
89;17.08.2016;2016;08;08;Keskiviikko;48;270;318;10;37;47
89;17.08.2016;2016;08;09;Keskiviikko;38;108;146;14;46;60
89;17.08.2016;2016;08;10;Keskiviikko;43;65;108;27;27;54
89;17.08.2016;2016;08;11;Keskiviikko;48;70;118;21;24;45
89;17.08.2016;2016;08;12;Keskiviikko;68;82;150;22;22;44
89;17.08.2016;2016;08;13;Keskiviikko;85;104;189;24;28;52
89;17.08.2016;2016;08;14;Keskiviikko;141;108;249;30;22;52
89;17.08.2016;2016;08;15;Keskiviikko;176;125;301;18;41;59
89;17.08.2016;2016;08;16;Keskiviikko;243;119;362;31;24;55
89;17.08.2016;2016;08;17;Keskiviikko;143;100;243;23;29;52
89;17.08.2016;2016;08;18;Keskiviikko;153;115;268;42;43;85
89;17.08.2016;2016;08;19;Keskiviikko;149;110;259;58;48;106
89;17.08.2016;2016;08;20;Keskiviikko;109;86;195;44;35;79
89;17.08.2016;2016;08;21;Keskiviikko;69;58;127;19;29;48
89;17.08.2016;2016;08;22;Keskiviikko;31;27;58;13;13;26
89;17.08.2016;2016;08;23;Keskiviikko;18;13;31;8;3;11
89;18.08.2016;2016;08;00;Torstai;11;4;15;5;6;11
89;18.08.2016;2016;08;01;Torstai;7;1;8;1;2;3
89;18.08.2016;2016;08;02;Torstai;3;3;6;2;2;4
89;18.08.2016;2016;08;03;Torstai;5;3;8;2;2;4
89;18.08.2016;2016;08;04;Torstai;6;1;7;3;1;4
89;18.08.2016;2016;08;05;Torstai;4;12;16;2;1;3
89;18.08.2016;2016;08;06;Torstai;17;55;72;2;4;6
89;18.08.2016;2016;08;07;Torstai;40;153;193;6;20;26
89;18.08.2016;2016;08;08;Torstai;55;311;366;7;23;30
89;18.08.2016;2016;08;09;Torstai;37;118;155;18;36;54
89;18.08.2016;2016;08;10;Torstai;49;104;153;16;27;43
89;18.08.2016;2016;08;11;Torstai;81;113;194;20;35;55
89;18.08.2016;2016;08;12;Torstai;116;124;240;40;41;81
89;18.08.2016;2016;08;13;Torstai;110;121;231;25;30;55
89;18.08.2016;2016;08;14;Torstai;149;116;265;33;38;71
89;18.08.2016;2016;08;15;Torstai;214;118;332;34;34;68
89;18.08.2016;2016;08;16;Torstai;274;179;453;34;30;64
89;18.08.2016;2016;08;17;Torstai;187;242;429;25;54;79
89;18.08.2016;2016;08;18;Torstai;145;286;431;41;59;100
89;18.08.2016;2016;08;19;Torstai;186;187;373;35;58;93
89;18.08.2016;2016;08;20;Torstai;187;115;302;32;43;75
89;18.08.2016;2016;08;21;Torstai;155;69;224;25;31;56
89;18.08.2016;2016;08;22;Torstai;103;56;159;28;18;46
89;18.08.2016;2016;08;23;Torstai;92;21;113;25;4;29
89;19.08.2016;2016;08;00;Perjantai;47;13;60;14;5;19
89;19.08.2016;2016;08;01;Perjantai;28;7;35;10;5;15
89;19.08.2016;2016;08;02;Perjantai;22;6;28;6;3;9
89;19.08.2016;2016;08;03;Perjantai;15;3;18;7;0;7
89;19.08.2016;2016;08;04;Perjantai;12;1;13;2;0;2
89;19.08.2016;2016;08;05;Perjantai;6;12;18;0;1;1
89;19.08.2016;2016;08;06;Perjantai;11;37;48;4;7;11
89;19.08.2016;2016;08;07;Perjantai;29;114;143;2;14;16
89;19.08.2016;2016;08;08;Perjantai;33;164;197;1;18;19
89;19.08.2016;2016;08;09;Perjantai;28;79;107;7;17;24
89;19.08.2016;2016;08;10;Perjantai;32;49;81;9;14;23
89;19.08.2016;2016;08;11;Perjantai;44;81;125;14;26;40
89;19.08.2016;2016;08;12;Perjantai;67;76;143;18;30;48
89;19.08.2016;2016;08;13;Perjantai;93;92;185;27;27;54
89;19.08.2016;2016;08;14;Perjantai;122;91;213;15;22;37
89;19.08.2016;2016;08;15;Perjantai;145;64;209;22;22;44
89;19.08.2016;2016;08;16;Perjantai;144;88;232;23;15;38
89;19.08.2016;2016;08;17;Perjantai;84;80;164;27;26;53
89;19.08.2016;2016;08;18;Perjantai;85;87;172;30;25;55
89;19.08.2016;2016;08;19;Perjantai;99;57;156;31;39;70
89;19.08.2016;2016;08;20;Perjantai;88;61;149;23;36;59
89;19.08.2016;2016;08;21;Perjantai;54;55;109;26;27;53
89;19.08.2016;2016;08;22;Perjantai;40;48;88;7;16;23
89;19.08.2016;2016;08;23;Perjantai;20;25;45;14;18;32
89;20.08.2016;2016;08;00;Lauantai;27;28;55;5;4;9
89;20.08.2016;2016;08;01;Lauantai;12;14;26;4;12;16
89;20.08.2016;2016;08;02;Lauantai;24;8;32;7;2;9
89;20.08.2016;2016;08;03;Lauantai;18;0;18;4;0;4
89;20.08.2016;2016;08;04;Lauantai;25;3;28;12;1;13
89;20.08.2016;2016;08;05;Lauantai;10;3;13;3;2;5
89;20.08.2016;2016;08;06;Lauantai;3;11;14;1;3;4
89;20.08.2016;2016;08;07;Lauantai;6;12;18;2;3;5
89;20.08.2016;2016;08;08;Lauantai;7;18;25;4;10;14
89;20.08.2016;2016;08;09;Lauantai;21;66;87;14;17;31
89;20.08.2016;2016;08;10;Lauantai;28;87;115;16;33;49
89;20.08.2016;2016;08;11;Lauantai;67;105;172;22;39;61
89;20.08.2016;2016;08;12;Lauantai;98;155;253;29;55;84
89;20.08.2016;2016;08;13;Lauantai;99;121;220;37;32;69
89;20.08.2016;2016;08;14;Lauantai;124;129;253;37;25;62
89;20.08.2016;2016;08;15;Lauantai;118;122;240;21;41;62
89;20.08.2016;2016;08;16;Lauantai;140;98;238;45;37;82
89;20.08.2016;2016;08;17;Lauantai;165;114;279;58;42;100
89;20.08.2016;2016;08;18;Lauantai;67;40;107;27;22;49
89;20.08.2016;2016;08;19;Lauantai;60;40;100;6;11;17
89;20.08.2016;2016;08;20;Lauantai;47;26;73;21;17;38
89;20.08.2016;2016;08;21;Lauantai;42;47;89;4;19;23
89;20.08.2016;2016;08;22;Lauantai;18;31;49;9;18;27
89;20.08.2016;2016;08;23;Lauantai;24;40;64;8;10;18
89;21.08.2016;2016;08;00;Sunnuntai;21;29;50;3;12;15
89;21.08.2016;2016;08;01;Sunnuntai;17;11;28;5;3;8
89;21.08.2016;2016;08;02;Sunnuntai;28;9;37;11;5;16
89;21.08.2016;2016;08;03;Sunnuntai;22;3;25;4;0;4
89;21.08.2016;2016;08;04;Sunnuntai;18;5;23;6;3;9
89;21.08.2016;2016;08;05;Sunnuntai;10;8;18;3;0;3
89;21.08.2016;2016;08;06;Sunnuntai;4;12;16;0;3;3
89;21.08.2016;2016;08;07;Sunnuntai;7;10;17;5;2;7
89;21.08.2016;2016;08;08;Sunnuntai;5;15;20;3;5;8
89;21.08.2016;2016;08;09;Sunnuntai;13;27;40;13;18;31
89;21.08.2016;2016;08;10;Sunnuntai;35;43;78;15;15;30
89;21.08.2016;2016;08;11;Sunnuntai;36;76;112;25;37;62
89;21.08.2016;2016;08;12;Sunnuntai;40;81;121;24;42;66
89;21.08.2016;2016;08;13;Sunnuntai;58;96;154;29;49;78
89;21.08.2016;2016;08;14;Sunnuntai;96;92;188;35;53;88
89;21.08.2016;2016;08;15;Sunnuntai;89;81;170;42;47;89
89;21.08.2016;2016;08;16;Sunnuntai;113;103;216;36;42;78
89;21.08.2016;2016;08;17;Sunnuntai;88;73;161;40;46;86
89;21.08.2016;2016;08;18;Sunnuntai;108;97;205;40;46;86
89;21.08.2016;2016;08;19;Sunnuntai;89;69;158;42;43;85
89;21.08.2016;2016;08;20;Sunnuntai;79;60;139;27;24;51
89;21.08.2016;2016;08;21;Sunnuntai;44;24;68;17;29;46
89;21.08.2016;2016;08;22;Sunnuntai;22;24;46;22;9;31
89;21.08.2016;2016;08;23;Sunnuntai;6;8;14;3;6;9
89;22.08.2016;2016;08;00;Maanantai;4;11;15;6;8;14
89;22.08.2016;2016;08;01;Maanantai;2;3;5;3;2;5
89;22.08.2016;2016;08;02;Maanantai;0;0;0;0;0;0
89;22.08.2016;2016;08;03;Maanantai;3;6;9;1;1;2
89;22.08.2016;2016;08;04;Maanantai;2;2;4;0;0;0
89;22.08.2016;2016;08;05;Maanantai;7;6;13;2;2;4
89;22.08.2016;2016;08;06;Maanantai;25;42;67;3;5;8
89;22.08.2016;2016;08;07;Maanantai;49;88;137;3;9;12
89;22.08.2016;2016;08;08;Maanantai;61;118;179;6;28;34
89;22.08.2016;2016;08;09;Maanantai;40;60;100;8;25;33
89;22.08.2016;2016;08;10;Maanantai;33;41;74;9;10;19
89;22.08.2016;2016;08;11;Maanantai;36;40;76;13;20;33
89;22.08.2016;2016;08;12;Maanantai;48;62;110;25;32;57
89;22.08.2016;2016;08;13;Maanantai;67;60;127;23;29;52
89;22.08.2016;2016;08;14;Maanantai;71;49;120;23;19;42
89;22.08.2016;2016;08;15;Maanantai;120;54;174;23;10;33
89;22.08.2016;2016;08;16;Maanantai;134;69;203;38;14;52
89;22.08.2016;2016;08;17;Maanantai;60;54;114;16;13;29
89;22.08.2016;2016;08;18;Maanantai;78;34;112;21;20;41
89;22.08.2016;2016;08;19;Maanantai;52;44;96;29;20;49
89;22.08.2016;2016;08;20;Maanantai;43;25;68;30;27;57
89;22.08.2016;2016;08;21;Maanantai;34;15;49;17;18;35
89;22.08.2016;2016;08;22;Maanantai;18;14;32;9;8;17
89;22.08.2016;2016;08;23;Maanantai;5;4;9;6;5;11
89;23.08.2016;2016;08;00;Tiistai;5;6;11;3;3;6
89;23.08.2016;2016;08;01;Tiistai;5;3;8;2;1;3
89;23.08.2016;2016;08;02;Tiistai;4;1;5;0;0;0
89;23.08.2016;2016;08;03;Tiistai;4;2;6;1;0;1
89;23.08.2016;2016;08;04;Tiistai;3;1;4;0;0;0
89;23.08.2016;2016;08;05;Tiistai;7;8;15;0;1;1
89;23.08.2016;2016;08;06;Tiistai;18;62;80;2;6;8
89;23.08.2016;2016;08;07;Tiistai;48;157;205;2;18;20
89;23.08.2016;2016;08;08;Tiistai;57;263;320;7;25;32
89;23.08.2016;2016;08;09;Tiistai;57;114;171;10;24;34
89;23.08.2016;2016;08;10;Tiistai;56;76;132;30;33;63
89;23.08.2016;2016;08;11;Tiistai;52;89;141;12;35;47
89;23.08.2016;2016;08;12;Tiistai;78;98;176;22;41;63
89;23.08.2016;2016;08;13;Tiistai;113;89;202;35;27;62
89;23.08.2016;2016;08;14;Tiistai;107;108;215;29;33;62
89;23.08.2016;2016;08;15;Tiistai;204;115;319;25;30;55
89;23.08.2016;2016;08;16;Tiistai;272;161;433;52;32;84
89;23.08.2016;2016;08;17;Tiistai;159;157;316;33;40;73
89;23.08.2016;2016;08;18;Tiistai;163;113;276;48;42;90
89;23.08.2016;2016;08;19;Tiistai;124;108;232;56;48;104
89;23.08.2016;2016;08;20;Tiistai;107;65;172;41;33;74
89;23.08.2016;2016;08;21;Tiistai;99;41;140;28;23;51
89;23.08.2016;2016;08;22;Tiistai;39;20;59;4;11;15
89;23.08.2016;2016;08;23;Tiistai;20;6;26;5;3;8
89;24.08.2016;2016;08;00;Keskiviikko;9;5;14;1;3;4
89;24.08.2016;2016;08;01;Keskiviikko;7;6;13;0;1;1
89;24.08.2016;2016;08;02;Keskiviikko;4;2;6;3;0;3
89;24.08.2016;2016;08;03;Keskiviikko;5;2;7;0;0;0
89;24.08.2016;2016;08;04;Keskiviikko;1;0;1;0;1;1
89;24.08.2016;2016;08;05;Keskiviikko;4;20;24;0;2;2
89;24.08.2016;2016;08;06;Keskiviikko;12;69;81;3;8;11
89;24.08.2016;2016;08;07;Keskiviikko;47;187;234;3;16;19
89;24.08.2016;2016;08;08;Keskiviikko;66;291;357;6;48;54
89;24.08.2016;2016;08;09;Keskiviikko;45;151;196;26;24;50
89;24.08.2016;2016;08;10;Keskiviikko;48;120;168;16;31;47
89;24.08.2016;2016;08;11;Keskiviikko;92;98;190;24;29;53
89;24.08.2016;2016;08;12;Keskiviikko;97;135;232;20;26;46
89;24.08.2016;2016;08;13;Keskiviikko;110;114;224;29;34;63
89;24.08.2016;2016;08;14;Keskiviikko;184;102;286;35;28;63
89;24.08.2016;2016;08;15;Keskiviikko;251;116;367;49;31;80
89;24.08.2016;2016;08;16;Keskiviikko;257;131;388;50;29;79
89;24.08.2016;2016;08;17;Keskiviikko;188;123;311;40;35;75
89;24.08.2016;2016;08;18;Keskiviikko;156;107;263;46;44;90
89;24.08.2016;2016;08;19;Keskiviikko;159;96;255;69;53;122
89;24.08.2016;2016;08;20;Keskiviikko;97;81;178;32;32;64
89;24.08.2016;2016;08;21;Keskiviikko;82;47;129;32;15;47
89;24.08.2016;2016;08;22;Keskiviikko;49;22;71;11;13;24
89;24.08.2016;2016;08;23;Keskiviikko;13;10;23;4;5;9
89;25.08.2016;2016;08;00;Torstai;14;4;18;1;0;1
89;25.08.2016;2016;08;01;Torstai;9;5;14;1;2;3
89;25.08.2016;2016;08;02;Torstai;3;3;6;1;0;1
89;25.08.2016;2016;08;03;Torstai;7;3;10;1;0;1
89;25.08.2016;2016;08;04;Torstai;7;3;10;5;0;5
89;25.08.2016;2016;08;05;Torstai;1;17;18;0;2;2
89;25.08.2016;2016;08;06;Torstai;13;60;73;4;5;9
89;25.08.2016;2016;08;07;Torstai;39;139;178;7;22;29
89;25.08.2016;2016;08;08;Torstai;42;251;293;8;31;39
89;25.08.2016;2016;08;09;Torstai;35;104;139;7;26;33
89;25.08.2016;2016;08;10;Torstai;28;50;78;10;28;38
89;25.08.2016;2016;08;11;Torstai;46;47;93;12;19;31
89;25.08.2016;2016;08;12;Torstai;53;76;129;11;14;25
89;25.08.2016;2016;08;13;Torstai;60;84;144;18;24;42
89;25.08.2016;2016;08;14;Torstai;109;72;181;19;24;43
89;25.08.2016;2016;08;15;Torstai;181;93;274;16;20;36
89;25.08.2016;2016;08;16;Torstai;229;106;335;29;18;47
89;25.08.2016;2016;08;17;Torstai;153;70;223;28;22;50
89;25.08.2016;2016;08;18;Torstai;108;75;183;30;26;56
89;25.08.2016;2016;08;19;Torstai;79;62;141;41;32;73
89;25.08.2016;2016;08;20;Torstai;59;38;97;25;19;44
89;25.08.2016;2016;08;21;Torstai;48;28;76;19;22;41
89;25.08.2016;2016;08;22;Torstai;27;11;38;11;9;20
89;25.08.2016;2016;08;23;Torstai;10;14;24;3;7;10
89;26.08.2016;2016;08;00;Perjantai;6;2;8;7;2;9
89;26.08.2016;2016;08;01;Perjantai;7;6;13;1;0;1
89;26.08.2016;2016;08;02;Perjantai;4;1;5;0;0;0
89;26.08.2016;2016;08;03;Perjantai;8;1;9;2;1;3
89;26.08.2016;2016;08;04;Perjantai;10;1;11;1;0;1
89;26.08.2016;2016;08;05;Perjantai;3;14;17;0;1;1
89;26.08.2016;2016;08;06;Perjantai;11;50;61;7;5;12
89;26.08.2016;2016;08;07;Perjantai;43;160;203;5;21;26
89;26.08.2016;2016;08;08;Perjantai;50;238;288;8;32;40
89;26.08.2016;2016;08;09;Perjantai;45;123;168;18;32;50
89;26.08.2016;2016;08;10;Perjantai;42;124;166;16;48;64
89;26.08.2016;2016;08;11;Perjantai;61;136;197;16;35;51
89;26.08.2016;2016;08;12;Perjantai;108;162;270;26;27;53
89;26.08.2016;2016;08;13;Perjantai;151;147;298;29;33;62
89;26.08.2016;2016;08;14;Perjantai;194;124;318;25;30;55
89;26.08.2016;2016;08;15;Perjantai;273;142;415;47;26;73
89;26.08.2016;2016;08;16;Perjantai;214;152;366;50;32;82
89;26.08.2016;2016;08;17;Perjantai;175;171;346;47;47;94
89;26.08.2016;2016;08;18;Perjantai;132;173;305;35;40;75
89;26.08.2016;2016;08;19;Perjantai;122;122;244;40;40;80
89;26.08.2016;2016;08;20;Perjantai;98;126;224;31;29;60
89;26.08.2016;2016;08;21;Perjantai;113;43;156;22;12;34
89;26.08.2016;2016;08;22;Perjantai;75;36;111;15;6;21
89;26.08.2016;2016;08;23;Perjantai;59;26;85;8;11;19
89;27.08.2016;2016;08;00;Lauantai;26;14;40;4;6;10
89;27.08.2016;2016;08;01;Lauantai;25;7;32;5;3;8
89;27.08.2016;2016;08;02;Lauantai;24;3;27;1;1;2
89;27.08.2016;2016;08;03;Lauantai;13;1;14;6;1;7
89;27.08.2016;2016;08;04;Lauantai;20;3;23;4;0;4
89;27.08.2016;2016;08;05;Lauantai;5;1;6;1;1;2
89;27.08.2016;2016;08;06;Lauantai;7;7;14;0;0;0
89;27.08.2016;2016;08;07;Lauantai;3;9;12;3;3;6
89;27.08.2016;2016;08;08;Lauantai;3;11;14;4;7;11
89;27.08.2016;2016;08;09;Lauantai;13;23;36;11;12;23
89;27.08.2016;2016;08;10;Lauantai;19;54;73;7;22;29
89;27.08.2016;2016;08;11;Lauantai;35;60;95;11;139;150
89;27.08.2016;2016;08;12;Lauantai;50;65;115;16;70;86
89;27.08.2016;2016;08;13;Lauantai;46;58;104;23;41;64
89;27.08.2016;2016;08;14;Lauantai;47;46;93;19;34;53
89;27.08.2016;2016;08;15;Lauantai;32;16;48;18;23;41
89;27.08.2016;2016;08;16;Lauantai;42;23;65;12;14;26
89;27.08.2016;2016;08;17;Lauantai;44;45;89;26;24;50
89;27.08.2016;2016;08;18;Lauantai;48;48;96;15;19;34
89;27.08.2016;2016;08;19;Lauantai;41;37;78;12;21;33
89;27.08.2016;2016;08;20;Lauantai;26;24;50;11;10;21
89;27.08.2016;2016;08;21;Lauantai;25;20;45;12;14;26
89;27.08.2016;2016;08;22;Lauantai;17;18;35;5;10;15
89;27.08.2016;2016;08;23;Lauantai;16;11;27;3;4;7
89;28.08.2016;2016;08;00;Sunnuntai;8;28;36;3;4;7
89;28.08.2016;2016;08;01;Sunnuntai;9;18;27;2;7;9
89;28.08.2016;2016;08;02;Sunnuntai;7;6;13;6;2;8
89;28.08.2016;2016;08;03;Sunnuntai;22;3;25;9;2;11
89;28.08.2016;2016;08;04;Sunnuntai;20;4;24;7;2;9
89;28.08.2016;2016;08;05;Sunnuntai;5;1;6;3;0;3
89;28.08.2016;2016;08;06;Sunnuntai;5;13;18;2;2;4
89;28.08.2016;2016;08;07;Sunnuntai;1;8;9;4;3;7
89;28.08.2016;2016;08;08;Sunnuntai;4;13;17;7;7;14
89;28.08.2016;2016;08;09;Sunnuntai;21;29;50;17;22;39
89;28.08.2016;2016;08;10;Sunnuntai;35;93;128;29;56;85
89;28.08.2016;2016;08;11;Sunnuntai;59;130;189;35;54;89
89;28.08.2016;2016;08;12;Sunnuntai;86;209;295;48;70;118
89;28.08.2016;2016;08;13;Sunnuntai;136;126;262;56;55;111
89;28.08.2016;2016;08;14;Sunnuntai;151;124;275;60;58;118
89;28.08.2016;2016;08;15;Sunnuntai;117;101;218;49;41;90
89;28.08.2016;2016;08;16;Sunnuntai;117;78;195;62;49;111
89;28.08.2016;2016;08;17;Sunnuntai;101;109;210;60;49;109
89;28.08.2016;2016;08;18;Sunnuntai;106;55;161;44;36;80
89;28.08.2016;2016;08;19;Sunnuntai;62;56;118;47;25;72
89;28.08.2016;2016;08;20;Sunnuntai;49;32;81;25;23;48
89;28.08.2016;2016;08;21;Sunnuntai;36;24;60;19;16;35
89;28.08.2016;2016;08;22;Sunnuntai;11;5;16;3;6;9
89;28.08.2016;2016;08;23;Sunnuntai;6;8;14;1;1;2
89;29.08.2016;2016;08;00;Maanantai;3;4;7;1;2;3
89;29.08.2016;2016;08;01;Maanantai;2;4;6;0;1;1
89;29.08.2016;2016;08;02;Maanantai;2;2;4;0;0;0
89;29.08.2016;2016;08;03;Maanantai;3;1;4;0;0;0
89;29.08.2016;2016;08;04;Maanantai;3;1;4;2;1;3
89;29.08.2016;2016;08;05;Maanantai;8;12;20;0;1;1
89;29.08.2016;2016;08;06;Maanantai;14;57;71;4;2;6
89;29.08.2016;2016;08;07;Maanantai;42;150;192;6;16;22
89;29.08.2016;2016;08;08;Maanantai;49;292;341;8;29;37
89;29.08.2016;2016;08;09;Maanantai;51;146;197;19;17;36
89;29.08.2016;2016;08;10;Maanantai;55;77;132;19;34;53
89;29.08.2016;2016;08;11;Maanantai;68;110;178;17;24;41
89;29.08.2016;2016;08;12;Maanantai;83;79;162;15;34;49
89;29.08.2016;2016;08;13;Maanantai;99;76;175;24;33;57
89;29.08.2016;2016;08;14;Maanantai;125;98;223;25;35;60
89;29.08.2016;2016;08;15;Maanantai;209;111;320;32;17;49
89;29.08.2016;2016;08;16;Maanantai;277;130;407;35;28;63
89;29.08.2016;2016;08;17;Maanantai;190;105;295;40;32;72
89;29.08.2016;2016;08;18;Maanantai;118;102;220;44;43;87
89;29.08.2016;2016;08;19;Maanantai;113;68;181;55;42;97
89;29.08.2016;2016;08;20;Maanantai;98;55;153;40;44;84
89;29.08.2016;2016;08;21;Maanantai;40;38;78;21;19;40
89;29.08.2016;2016;08;22;Maanantai;23;21;44;3;10;13
89;29.08.2016;2016;08;23;Maanantai;13;9;22;5;3;8
89;30.08.2016;2016;08;00;Tiistai;11;4;15;2;3;5
89;30.08.2016;2016;08;01;Tiistai;5;3;8;1;1;2
89;30.08.2016;2016;08;02;Tiistai;6;1;7;1;1;2
89;30.08.2016;2016;08;03;Tiistai;7;3;10;0;0;0
89;30.08.2016;2016;08;04;Tiistai;1;1;2;0;0;0
89;30.08.2016;2016;08;05;Tiistai;2;12;14;1;1;2
89;30.08.2016;2016;08;06;Tiistai;12;67;79;2;2;4
89;30.08.2016;2016;08;07;Tiistai;45;175;220;4;21;25
89;30.08.2016;2016;08;08;Tiistai;56;312;368;11;36;47
89;30.08.2016;2016;08;09;Tiistai;51;126;177;21;26;47
89;30.08.2016;2016;08;10;Tiistai;63;119;182;28;42;70
89;30.08.2016;2016;08;11;Tiistai;81;99;180;33;32;65
89;30.08.2016;2016;08;12;Tiistai;106;110;216;27;33;60
89;30.08.2016;2016;08;13;Tiistai;109;95;204;30;27;57
89;30.08.2016;2016;08;14;Tiistai;151;110;261;32;26;58
89;30.08.2016;2016;08;15;Tiistai;180;101;281;29;30;59
89;30.08.2016;2016;08;16;Tiistai;265;127;392;27;15;42
89;30.08.2016;2016;08;17;Tiistai;162;96;258;20;20;40
89;30.08.2016;2016;08;18;Tiistai;130;80;210;39;28;67
89;30.08.2016;2016;08;19;Tiistai;106;54;160;29;26;55
89;30.08.2016;2016;08;20;Tiistai;84;49;133;25;37;62
89;30.08.2016;2016;08;21;Tiistai;40;23;63;18;15;33
89;30.08.2016;2016;08;22;Tiistai;28;23;51;9;5;14
89;30.08.2016;2016;08;23;Tiistai;10;9;19;5;3;8
89;31.08.2016;2016;08;00;Keskiviikko;10;1;11;1;0;1
89;31.08.2016;2016;08;01;Keskiviikko;4;0;4;0;1;1
89;31.08.2016;2016;08;02;Keskiviikko;4;1;5;0;0;0
89;31.08.2016;2016;08;03;Keskiviikko;1;3;4;1;0;1
89;31.08.2016;2016;08;04;Keskiviikko;2;1;3;0;0;0
89;31.08.2016;2016;08;05;Keskiviikko;3;11;14;0;0;0
89;31.08.2016;2016;08;06;Keskiviikko;17;65;82;2;8;10
89;31.08.2016;2016;08;07;Keskiviikko;54;195;249;4;21;25
89;31.08.2016;2016;08;08;Keskiviikko;51;293;344;7;38;45
89;31.08.2016;2016;08;09;Keskiviikko;50;133;183;12;61;73
89;31.08.2016;2016;08;10;Keskiviikko;56;119;175;35;50;85
89;31.08.2016;2016;08;11;Keskiviikko;69;108;177;39;23;62
89;31.08.2016;2016;08;12;Keskiviikko;112;104;216;21;31;52
89;31.08.2016;2016;08;13;Keskiviikko;119;88;207;18;30;48
89;31.08.2016;2016;08;14;Keskiviikko;187;110;297;41;25;66
89;31.08.2016;2016;08;15;Keskiviikko;191;123;314;35;38;73
89;31.08.2016;2016;08;16;Keskiviikko;261;124;385;46;30;76
89;31.08.2016;2016;08;17;Keskiviikko;170;117;287;34;26;60
89;31.08.2016;2016;08;18;Keskiviikko;132;99;231;31;30;61
89;31.08.2016;2016;08;19;Keskiviikko;113;73;186;35;38;73
89;31.08.2016;2016;08;20;Keskiviikko;105;66;171;25;28;53
89;31.08.2016;2016;08;21;Keskiviikko;49;40;89;12;13;25
89;31.08.2016;2016;08;22;Keskiviikko;32;32;64;13;5;18
89;31.08.2016;2016;08;23;Keskiviikko;10;16;26;2;3;5
89;01.09.2016;2016;09;00;Torstai;4;4;8;2;1;3
89;01.09.2016;2016;09;01;Torstai;2;1;3;2;1;3
89;01.09.2016;2016;09;02;Torstai;3;2;5;1;0;1
89;01.09.2016;2016;09;03;Torstai;6;5;11;0;0;0
89;01.09.2016;2016;09;04;Torstai;5;5;10;1;0;1
89;01.09.2016;2016;09;05;Torstai;1;12;13;0;0;0
89;01.09.2016;2016;09;06;Torstai;15;55;70;5;2;7
89;01.09.2016;2016;09;07;Torstai;51;118;169;4;14;18
89;01.09.2016;2016;09;08;Torstai;54;197;251;4;29;33
89;01.09.2016;2016;09;09;Torstai;45;75;120;5;24;29
89;01.09.2016;2016;09;10;Torstai;31;38;69;9;6;15
89;01.09.2016;2016;09;11;Torstai;55;64;119;13;11;24
89;01.09.2016;2016;09;12;Torstai;58;84;142;9;16;25
89;01.09.2016;2016;09;13;Torstai;74;86;160;11;13;24
89;01.09.2016;2016;09;14;Torstai;100;69;169;20;14;34
89;01.09.2016;2016;09;15;Torstai;141;101;242;18;21;39
89;01.09.2016;2016;09;16;Torstai;215;123;338;29;20;49
89;01.09.2016;2016;09;17;Torstai;134;114;248;37;35;72
89;01.09.2016;2016;09;18;Torstai;136;103;239;32;43;75
89;01.09.2016;2016;09;19;Torstai;115;89;204;35;38;73
89;01.09.2016;2016;09;20;Torstai;116;52;168;28;41;69
89;01.09.2016;2016;09;21;Torstai;69;52;121;18;27;45
89;01.09.2016;2016;09;22;Torstai;25;24;49;8;11;19
89;01.09.2016;2016;09;23;Torstai;13;14;27;2;3;5
89;02.09.2016;2016;09;00;Perjantai;16;12;28;2;4;6
89;02.09.2016;2016;09;01;Perjantai;7;5;12;2;2;4
89;02.09.2016;2016;09;02;Perjantai;13;2;15;2;0;2
89;02.09.2016;2016;09;03;Perjantai;7;4;11;1;1;2
89;02.09.2016;2016;09;04;Perjantai;13;2;15;3;0;3
89;02.09.2016;2016;09;05;Perjantai;2;10;12;0;1;1
89;02.09.2016;2016;09;06;Perjantai;12;53;65;2;4;6
89;02.09.2016;2016;09;07;Perjantai;26;122;148;5;21;26
89;02.09.2016;2016;09;08;Perjantai;48;219;267;4;24;28
89;02.09.2016;2016;09;09;Perjantai;52;129;181;22;36;58
89;02.09.2016;2016;09;10;Perjantai;52;72;124;24;28;52
89;02.09.2016;2016;09;11;Perjantai;48;38;86;9;23;32
89;02.09.2016;2016;09;12;Perjantai;68;76;144;18;21;39
89;02.09.2016;2016;09;13;Perjantai;93;102;195;22;21;43
89;02.09.2016;2016;09;14;Perjantai;159;127;286;20;35;55
89;02.09.2016;2016;09;15;Perjantai;170;92;262;26;21;47
89;02.09.2016;2016;09;16;Perjantai;186;130;316;33;30;63
89;02.09.2016;2016;09;17;Perjantai;117;84;201;26;42;68
89;02.09.2016;2016;09;18;Perjantai;110;98;208;33;32;65
89;02.09.2016;2016;09;19;Perjantai;96;57;153;28;16;44
89;02.09.2016;2016;09;20;Perjantai;80;49;129;21;19;40
89;02.09.2016;2016;09;21;Perjantai;54;48;102;16;12;28
89;02.09.2016;2016;09;22;Perjantai;35;30;65;4;15;19
89;02.09.2016;2016;09;23;Perjantai;23;19;42;4;19;23
89;03.09.2016;2016;09;00;Lauantai;25;17;42;0;6;6
89;03.09.2016;2016;09;01;Lauantai;11;13;24;1;3;4
89;03.09.2016;2016;09;02;Lauantai;19;6;25;10;2;12
89;03.09.2016;2016;09;03;Lauantai;16;1;17;2;3;5
89;03.09.2016;2016;09;04;Lauantai;18;4;22;1;0;1
89;03.09.2016;2016;09;05;Lauantai;5;2;7;0;1;1
89;03.09.2016;2016;09;06;Lauantai;1;17;18;2;3;5
89;03.09.2016;2016;09;07;Lauantai;4;12;16;2;4;6
89;03.09.2016;2016;09;08;Lauantai;11;48;59;2;13;15
89;03.09.2016;2016;09;09;Lauantai;20;60;80;9;21;30
89;03.09.2016;2016;09;10;Lauantai;38;105;143;16;32;48
89;03.09.2016;2016;09;11;Lauantai;55;129;184;24;56;80
89;03.09.2016;2016;09;12;Lauantai;75;117;192;28;57;85
89;03.09.2016;2016;09;13;Lauantai;91;147;238;38;56;94
89;03.09.2016;2016;09;14;Lauantai;112;108;220;50;54;104
89;03.09.2016;2016;09;15;Lauantai;156;82;238;48;28;76
89;03.09.2016;2016;09;16;Lauantai;98;82;180;36;45;81
89;03.09.2016;2016;09;17;Lauantai;126;73;199;50;40;90
89;03.09.2016;2016;09;18;Lauantai;78;89;167;46;30;76
89;03.09.2016;2016;09;19;Lauantai;65;66;131;32;42;74
89;03.09.2016;2016;09;20;Lauantai;62;65;127;23;26;49
89;03.09.2016;2016;09;21;Lauantai;42;59;101;11;17;28
89;03.09.2016;2016;09;22;Lauantai;41;26;67;8;6;14
89;03.09.2016;2016;09;23;Lauantai;20;44;64;6;9;15
89;04.09.2016;2016;09;00;Sunnuntai;15;39;54;6;13;19
89;04.09.2016;2016;09;01;Sunnuntai;23;12;35;10;2;12
89;04.09.2016;2016;09;02;Sunnuntai;25;10;35;6;4;10
89;04.09.2016;2016;09;03;Sunnuntai;25;3;28;6;0;6
89;04.09.2016;2016;09;04;Sunnuntai;19;5;24;11;1;12
89;04.09.2016;2016;09;05;Sunnuntai;9;4;13;1;0;1
89;04.09.2016;2016;09;06;Sunnuntai;3;10;13;1;4;5
89;04.09.2016;2016;09;07;Sunnuntai;6;10;16;1;5;6
89;04.09.2016;2016;09;08;Sunnuntai;2;9;11;9;13;22
89;04.09.2016;2016;09;09;Sunnuntai;14;25;39;16;18;34
89;04.09.2016;2016;09;10;Sunnuntai;21;57;78;20;33;53
89;04.09.2016;2016;09;11;Sunnuntai;61;85;146;39;55;94
89;04.09.2016;2016;09;12;Sunnuntai;66;116;182;43;55;98
89;04.09.2016;2016;09;13;Sunnuntai;94;141;235;47;44;91
89;04.09.2016;2016;09;14;Sunnuntai;97;98;195;42;67;109
89;04.09.2016;2016;09;15;Sunnuntai;120;81;201;45;48;93
89;04.09.2016;2016;09;16;Sunnuntai;126;69;195;39;42;81
89;04.09.2016;2016;09;17;Sunnuntai;100;83;183;32;35;67
89;04.09.2016;2016;09;18;Sunnuntai;115;86;201;49;47;96
89;04.09.2016;2016;09;19;Sunnuntai;112;86;198;50;34;84
89;04.09.2016;2016;09;20;Sunnuntai;64;54;118;26;28;54
89;04.09.2016;2016;09;21;Sunnuntai;30;18;48;19;18;37
89;04.09.2016;2016;09;22;Sunnuntai;22;14;36;11;3;14
89;04.09.2016;2016;09;23;Sunnuntai;9;6;15;0;2;2
89;05.09.2016;2016;09;00;Maanantai;3;3;6;5;3;8
89;05.09.2016;2016;09;01;Maanantai;4;2;6;0;0;0
89;05.09.2016;2016;09;02;Maanantai;1;0;1;0;0;0
89;05.09.2016;2016;09;03;Maanantai;2;2;4;0;0;0
89;05.09.2016;2016;09;04;Maanantai;2;2;4;0;0;0
89;05.09.2016;2016;09;05;Maanantai;1;8;9;0;1;1
89;05.09.2016;2016;09;06;Maanantai;15;47;62;1;3;4
89;05.09.2016;2016;09;07;Maanantai;41;163;204;7;15;22
89;05.09.2016;2016;09;08;Maanantai;51;291;342;7;29;36
89;05.09.2016;2016;09;09;Maanantai;41;146;187;11;40;51
89;05.09.2016;2016;09;10;Maanantai;52;96;148;18;27;45
89;05.09.2016;2016;09;11;Maanantai;71;114;185;14;26;40
89;05.09.2016;2016;09;12;Maanantai;86;138;224;43;49;92
89;05.09.2016;2016;09;13;Maanantai;92;86;178;32;35;67
89;05.09.2016;2016;09;14;Maanantai;170;112;282;26;37;63
89;05.09.2016;2016;09;15;Maanantai;238;112;350;70;33;103
89;05.09.2016;2016;09;16;Maanantai;248;155;403;65;36;101
89;05.09.2016;2016;09;17;Maanantai;151;121;272;50;37;87
89;05.09.2016;2016;09;18;Maanantai;117;93;210;26;38;64
89;05.09.2016;2016;09;19;Maanantai;120;70;190;34;48;82
89;05.09.2016;2016;09;20;Maanantai;81;31;112;40;23;63
89;05.09.2016;2016;09;21;Maanantai;52;28;80;9;16;25
89;05.09.2016;2016;09;22;Maanantai;26;12;38;8;3;11
89;05.09.2016;2016;09;23;Maanantai;17;6;23;0;4;4
89;06.09.2016;2016;09;00;Tiistai;5;5;10;0;1;1
89;06.09.2016;2016;09;01;Tiistai;9;0;9;0;1;1
89;06.09.2016;2016;09;02;Tiistai;3;2;5;0;0;0
89;06.09.2016;2016;09;03;Tiistai;3;0;3;0;0;0
89;06.09.2016;2016;09;04;Tiistai;1;1;2;0;1;1
89;06.09.2016;2016;09;05;Tiistai;4;8;12;0;0;0
89;06.09.2016;2016;09;06;Tiistai;16;59;75;3;3;6
89;06.09.2016;2016;09;07;Tiistai;38;167;205;3;23;26
89;06.09.2016;2016;09;08;Tiistai;50;282;332;8;41;49
89;06.09.2016;2016;09;09;Tiistai;51;156;207;15;31;46
89;06.09.2016;2016;09;10;Tiistai;65;92;157;17;22;39
89;06.09.2016;2016;09;11;Tiistai;55;92;147;20;34;54
89;06.09.2016;2016;09;12;Tiistai;89;120;209;26;33;59
89;06.09.2016;2016;09;13;Tiistai;113;101;214;27;28;55
89;06.09.2016;2016;09;14;Tiistai;152;97;249;22;16;38
89;06.09.2016;2016;09;15;Tiistai;199;127;326;22;20;42
89;06.09.2016;2016;09;16;Tiistai;292;143;435;27;22;49
89;06.09.2016;2016;09;17;Tiistai;154;100;254;19;24;43
89;06.09.2016;2016;09;18;Tiistai;142;82;224;29;37;66
89;06.09.2016;2016;09;19;Tiistai;111;69;180;35;26;61
89;06.09.2016;2016;09;20;Tiistai;90;48;138;19;21;40
89;06.09.2016;2016;09;21;Tiistai;39;35;74;5;16;21
89;06.09.2016;2016;09;22;Tiistai;13;20;33;6;7;13
89;06.09.2016;2016;09;23;Tiistai;15;8;23;3;1;4
89;07.09.2016;2016;09;00;Keskiviikko;18;4;22;2;1;3
89;07.09.2016;2016;09;01;Keskiviikko;10;3;13;4;1;5
89;07.09.2016;2016;09;02;Keskiviikko;7;1;8;3;1;4
89;07.09.2016;2016;09;03;Keskiviikko;1;1;2;0;0;0
89;07.09.2016;2016;09;04;Keskiviikko;9;2;11;2;0;2
89;07.09.2016;2016;09;05;Keskiviikko;3;8;11;0;0;0
89;07.09.2016;2016;09;06;Keskiviikko;11;60;71;4;5;9
89;07.09.2016;2016;09;07;Keskiviikko;36;189;225;4;19;23
89;07.09.2016;2016;09;08;Keskiviikko;67;252;319;8;45;53
89;07.09.2016;2016;09;09;Keskiviikko;66;165;231;25;44;69
89;07.09.2016;2016;09;10;Keskiviikko;52;96;148;18;37;55
89;07.09.2016;2016;09;11;Keskiviikko;91;98;189;37;26;63
89;07.09.2016;2016;09;12;Keskiviikko;97;134;231;30;22;52
89;07.09.2016;2016;09;13;Keskiviikko;103;94;197;22;36;58
89;07.09.2016;2016;09;14;Keskiviikko;179;108;287;23;16;39
89;07.09.2016;2016;09;15;Keskiviikko;198;98;296;15;18;33
89;07.09.2016;2016;09;16;Keskiviikko;219;130;349;20;13;33
89;07.09.2016;2016;09;17;Keskiviikko;172;170;342;28;39;67
89;07.09.2016;2016;09;18;Keskiviikko;118;126;244;35;36;71
89;07.09.2016;2016;09;19;Keskiviikko;112;94;206;36;40;76
89;07.09.2016;2016;09;20;Keskiviikko;110;111;221;24;37;61
89;07.09.2016;2016;09;21;Keskiviikko;49;48;97;16;9;25
89;07.09.2016;2016;09;22;Keskiviikko;30;28;58;9;5;14
89;07.09.2016;2016;09;23;Keskiviikko;33;18;51;3;3;6
89;08.09.2016;2016;09;00;Torstai;32;6;38;4;3;7
89;08.09.2016;2016;09;01;Torstai;38;3;41;1;3;4
89;08.09.2016;2016;09;02;Torstai;15;1;16;0;0;0
89;08.09.2016;2016;09;03;Torstai;9;3;12;2;0;2
89;08.09.2016;2016;09;04;Torstai;12;1;13;6;1;7
89;08.09.2016;2016;09;05;Torstai;8;8;16;1;3;4
89;08.09.2016;2016;09;06;Torstai;15;57;72;2;7;9
89;08.09.2016;2016;09;07;Torstai;37;168;205;11;15;26
89;08.09.2016;2016;09;08;Torstai;53;275;328;10;41;51
89;08.09.2016;2016;09;09;Torstai;46;132;178;16;33;49
89;08.09.2016;2016;09;10;Torstai;58;96;154;32;51;83
89;08.09.2016;2016;09;11;Torstai;63;109;172;18;45;63
89;08.09.2016;2016;09;12;Torstai;71;126;197;14;42;56
89;08.09.2016;2016;09;13;Torstai;103;141;244;24;29;53
89;08.09.2016;2016;09;14;Torstai;182;102;284;27;18;45
89;08.09.2016;2016;09;15;Torstai;199;122;321;25;20;45
89;08.09.2016;2016;09;16;Torstai;274;125;399;30;15;45
89;08.09.2016;2016;09;17;Torstai;161;97;258;27;32;59
89;08.09.2016;2016;09;18;Torstai;107;70;177;29;46;75
89;08.09.2016;2016;09;19;Torstai;96;64;160;43;22;65
89;08.09.2016;2016;09;20;Torstai;77;34;111;19;21;40
89;08.09.2016;2016;09;21;Torstai;49;35;84;19;16;35
89;08.09.2016;2016;09;22;Torstai;26;20;46;4;4;8
89;08.09.2016;2016;09;23;Torstai;8;10;18;4;5;9
89;09.09.2016;2016;09;00;Perjantai;7;3;10;1;0;1
89;09.09.2016;2016;09;01;Perjantai;4;1;5;1;0;1
89;09.09.2016;2016;09;02;Perjantai;6;4;10;1;0;1
89;09.09.2016;2016;09;03;Perjantai;4;2;6;1;0;1
89;09.09.2016;2016;09;04;Perjantai;2;3;5;1;0;1
89;09.09.2016;2016;09;05;Perjantai;2;12;14;0;0;0
89;09.09.2016;2016;09;06;Perjantai;12;39;51;3;6;9
89;09.09.2016;2016;09;07;Perjantai;36;128;164;6;20;26
89;09.09.2016;2016;09;08;Perjantai;49;245;294;10;27;37
89;09.09.2016;2016;09;09;Perjantai;45;134;179;18;30;48
89;09.09.2016;2016;09;10;Perjantai;49;87;136;18;18;36
89;09.09.2016;2016;09;11;Perjantai;59;74;133;42;30;72
89;09.09.2016;2016;09;12;Perjantai;95;97;192;20;43;63
89;09.09.2016;2016;09;13;Perjantai;116;104;220;18;43;61
89;09.09.2016;2016;09;14;Perjantai;168;86;254;26;28;54
89;09.09.2016;2016;09;15;Perjantai;188;105;293;20;14;34
89;09.09.2016;2016;09;16;Perjantai;190;98;288;21;26;47
89;09.09.2016;2016;09;17;Perjantai;109;75;184;22;29;51
89;09.09.2016;2016;09;18;Perjantai;107;91;198;29;30;59
89;09.09.2016;2016;09;19;Perjantai;72;65;137;24;24;48
89;09.09.2016;2016;09;20;Perjantai;67;45;112;21;22;43
89;09.09.2016;2016;09;21;Perjantai;52;38;90;14;19;33
89;09.09.2016;2016;09;22;Perjantai;43;31;74;7;8;15
89;09.09.2016;2016;09;23;Perjantai;21;17;38;19;24;43
89;10.09.2016;2016;09;00;Lauantai;16;18;34;4;6;10
89;10.09.2016;2016;09;01;Lauantai;18;4;22;3;2;5
89;10.09.2016;2016;09;02;Lauantai;15;7;22;7;1;8
89;10.09.2016;2016;09;03;Lauantai;14;3;17;3;2;5
89;10.09.2016;2016;09;04;Lauantai;11;4;15;9;1;10
89;10.09.2016;2016;09;05;Lauantai;5;2;7;4;1;5
89;10.09.2016;2016;09;06;Lauantai;2;11;13;2;3;5
89;10.09.2016;2016;09;07;Lauantai;3;15;18;1;4;5
89;10.09.2016;2016;09;08;Lauantai;8;21;29;6;8;14
89;10.09.2016;2016;09;09;Lauantai;12;49;61;7;22;29
89;10.09.2016;2016;09;10;Lauantai;19;103;122;18;29;47
89;10.09.2016;2016;09;11;Lauantai;50;89;139;18;29;47
89;10.09.2016;2016;09;12;Lauantai;67;119;186;29;35;64
89;10.09.2016;2016;09;13;Lauantai;72;98;170;51;40;91
89;10.09.2016;2016;09;14;Lauantai;119;103;222;59;75;134
89;10.09.2016;2016;09;15;Lauantai;88;94;182;94;94;188
89;10.09.2016;2016;09;16;Lauantai;114;77;191;44;45;89
89;10.09.2016;2016;09;17;Lauantai;77;72;149;23;28;51
89;10.09.2016;2016;09;18;Lauantai;74;81;155;43;26;69
89;10.09.2016;2016;09;19;Lauantai;64;46;110;17;22;39
89;10.09.2016;2016;09;20;Lauantai;35;49;84;14;20;34
89;10.09.2016;2016;09;21;Lauantai;37;27;64;12;22;34
89;10.09.2016;2016;09;22;Lauantai;19;32;51;5;12;17
89;10.09.2016;2016;09;23;Lauantai;26;22;48;6;14;20
89;11.09.2016;2016;09;00;Sunnuntai;26;25;51;3;13;16
89;11.09.2016;2016;09;01;Sunnuntai;19;16;35;1;1;2
89;11.09.2016;2016;09;02;Sunnuntai;26;7;33;4;3;7
89;11.09.2016;2016;09;03;Sunnuntai;18;1;19;15;4;19
89;11.09.2016;2016;09;04;Sunnuntai;13;1;14;4;0;4
89;11.09.2016;2016;09;05;Sunnuntai;4;3;7;2;0;2
89;11.09.2016;2016;09;06;Sunnuntai;4;6;10;1;2;3
89;11.09.2016;2016;09;07;Sunnuntai;5;9;14;1;3;4
89;11.09.2016;2016;09;08;Sunnuntai;4;6;10;4;7;11
89;11.09.2016;2016;09;09;Sunnuntai;25;22;47;14;26;40
89;11.09.2016;2016;09;10;Sunnuntai;20;51;71;18;30;48
89;11.09.2016;2016;09;11;Sunnuntai;39;49;88;40;60;100
89;11.09.2016;2016;09;12;Sunnuntai;59;89;148;31;48;79
89;11.09.2016;2016;09;13;Sunnuntai;75;80;155;76;45;121
89;11.09.2016;2016;09;14;Sunnuntai;72;83;155;31;63;94
89;11.09.2016;2016;09;15;Sunnuntai;68;54;122;26;51;77
89;11.09.2016;2016;09;16;Sunnuntai;87;64;151;33;42;75
89;11.09.2016;2016;09;17;Sunnuntai;68;56;124;26;38;64
89;11.09.2016;2016;09;18;Sunnuntai;81;52;133;36;43;79
89;11.09.2016;2016;09;19;Sunnuntai;44;48;92;38;31;69
89;11.09.2016;2016;09;20;Sunnuntai;48;31;79;26;17;43
89;11.09.2016;2016;09;21;Sunnuntai;31;18;49;12;4;16
89;11.09.2016;2016;09;22;Sunnuntai;5;5;10;2;1;3
89;11.09.2016;2016;09;23;Sunnuntai;6;4;10;0;0;0
89;12.09.2016;2016;09;00;Maanantai;2;4;6;0;0;0
89;12.09.2016;2016;09;01;Maanantai;3;1;4;1;1;2
89;12.09.2016;2016;09;02;Maanantai;3;0;3;0;0;0
89;12.09.2016;2016;09;03;Maanantai;1;3;4;1;0;1
89;12.09.2016;2016;09;04;Maanantai;0;3;3;0;1;1
89;12.09.2016;2016;09;05;Maanantai;5;5;10;0;0;0
89;12.09.2016;2016;09;06;Maanantai;14;52;66;2;6;8
89;12.09.2016;2016;09;07;Maanantai;41;145;186;5;20;25
89;12.09.2016;2016;09;08;Maanantai;54;272;326;8;35;43
89;12.09.2016;2016;09;09;Maanantai;46;164;210;18;24;42
89;12.09.2016;2016;09;10;Maanantai;55;77;132;15;24;39
89;12.09.2016;2016;09;11;Maanantai;77;102;179;27;24;51
89;12.09.2016;2016;09;12;Maanantai;87;93;180;31;23;54
89;12.09.2016;2016;09;13;Maanantai;93;90;183;24;34;58
89;12.09.2016;2016;09;14;Maanantai;136;96;232;37;32;69
89;12.09.2016;2016;09;15;Maanantai;195;80;275;39;22;61
89;12.09.2016;2016;09;16;Maanantai;243;118;361;44;26;70
89;12.09.2016;2016;09;17;Maanantai;140;108;248;30;24;54
89;12.09.2016;2016;09;18;Maanantai;99;69;168;24;41;65
89;12.09.2016;2016;09;19;Maanantai;107;58;165;32;48;80
89;12.09.2016;2016;09;20;Maanantai;70;47;117;36;30;66
89;12.09.2016;2016;09;21;Maanantai;46;30;76;14;19;33
89;12.09.2016;2016;09;22;Maanantai;21;12;33;8;6;14
89;12.09.2016;2016;09;23;Maanantai;8;8;16;3;4;7
89;13.09.2016;2016;09;00;Tiistai;12;1;13;2;0;2
89;13.09.2016;2016;09;01;Tiistai;7;3;10;0;2;2
89;13.09.2016;2016;09;02;Tiistai;3;0;3;0;0;0
89;13.09.2016;2016;09;03;Tiistai;1;3;4;0;0;0
89;13.09.2016;2016;09;04;Tiistai;1;2;3;0;1;1
89;13.09.2016;2016;09;05;Tiistai;3;9;12;0;1;1
89;13.09.2016;2016;09;06;Tiistai;14;63;77;4;8;12
89;13.09.2016;2016;09;07;Tiistai;45;159;204;4;28;32
89;13.09.2016;2016;09;08;Tiistai;51;283;334;7;35;42
89;13.09.2016;2016;09;09;Tiistai;62;154;216;15;33;48
89;13.09.2016;2016;09;10;Tiistai;57;119;176;24;53;77
89;13.09.2016;2016;09;11;Tiistai;73;142;215;21;34;55
89;13.09.2016;2016;09;12;Tiistai;126;126;252;37;38;75
89;13.09.2016;2016;09;13;Tiistai;137;110;247;25;26;51
89;13.09.2016;2016;09;14;Tiistai;164;109;273;37;34;71
89;13.09.2016;2016;09;15;Tiistai;224;131;355;62;27;89
89;13.09.2016;2016;09;16;Tiistai;309;166;475;62;33;95
89;13.09.2016;2016;09;17;Tiistai;175;113;288;58;41;99
89;13.09.2016;2016;09;18;Tiistai;148;100;248;43;56;99
89;13.09.2016;2016;09;19;Tiistai;129;90;219;48;47;95
89;13.09.2016;2016;09;20;Tiistai;91;56;147;47;31;78
89;13.09.2016;2016;09;21;Tiistai;45;32;77;13;14;27
89;13.09.2016;2016;09;22;Tiistai;24;17;41;6;8;14
89;13.09.2016;2016;09;23;Tiistai;18;14;32;1;2;3
89;14.09.2016;2016;09;00;Keskiviikko;4;8;12;1;3;4
89;14.09.2016;2016;09;01;Keskiviikko;8;2;10;1;0;1
89;14.09.2016;2016;09;02;Keskiviikko;10;1;11;0;0;0
89;14.09.2016;2016;09;03;Keskiviikko;5;2;7;2;0;2
89;14.09.2016;2016;09;04;Keskiviikko;3;4;7;0;1;1
89;14.09.2016;2016;09;05;Keskiviikko;1;10;11;1;1;2
89;14.09.2016;2016;09;06;Keskiviikko;18;54;72;3;5;8
89;14.09.2016;2016;09;07;Keskiviikko;45;153;198;7;22;29
89;14.09.2016;2016;09;08;Keskiviikko;57;296;353;4;32;36
89;14.09.2016;2016;09;09;Keskiviikko;60;132;192;13;38;51
89;14.09.2016;2016;09;10;Keskiviikko;55;112;167;24;39;63
89;14.09.2016;2016;09;11;Keskiviikko;77;120;197;29;37;66
89;14.09.2016;2016;09;12;Keskiviikko;88;118;206;40;34;74
89;14.09.2016;2016;09;13;Keskiviikko;122;92;214;30;23;53
89;14.09.2016;2016;09;14;Keskiviikko;159;90;249;22;23;45
89;14.09.2016;2016;09;15;Keskiviikko;194;119;313;31;14;45
89;14.09.2016;2016;09;16;Keskiviikko;259;136;395;35;19;54
89;14.09.2016;2016;09;17;Keskiviikko;176;153;329;30;28;58
89;14.09.2016;2016;09;18;Keskiviikko;148;101;249;36;28;64
89;14.09.2016;2016;09;19;Keskiviikko;111;84;195;31;48;79
89;14.09.2016;2016;09;20;Keskiviikko;99;63;162;27;29;56
89;14.09.2016;2016;09;21;Keskiviikko;65;41;106;9;14;23
89;14.09.2016;2016;09;22;Keskiviikko;24;21;45;10;3;13
89;14.09.2016;2016;09;23;Keskiviikko;14;12;26;2;0;2
89;15.09.2016;2016;09;00;Torstai;5;1;6;1;1;2
89;15.09.2016;2016;09;01;Torstai;6;2;8;1;0;1
89;15.09.2016;2016;09;02;Torstai;10;1;11;0;1;1
89;15.09.2016;2016;09;03;Torstai;5;1;6;1;0;1
89;15.09.2016;2016;09;04;Torstai;10;1;11;3;0;3
89;15.09.2016;2016;09;05;Torstai;6;4;10;0;1;1
89;15.09.2016;2016;09;06;Torstai;19;55;74;1;4;5
89;15.09.2016;2016;09;07;Torstai;43;152;195;6;19;25
89;15.09.2016;2016;09;08;Torstai;78;259;337;7;21;28
89;15.09.2016;2016;09;09;Torstai;59;126;185;12;23;35
89;15.09.2016;2016;09;10;Torstai;52;91;143;15;24;39
89;15.09.2016;2016;09;11;Torstai;74;101;175;18;18;36
89;15.09.2016;2016;09;12;Torstai;68;98;166;20;25;45
89;15.09.2016;2016;09;13;Torstai;100;106;206;22;33;55
89;15.09.2016;2016;09;14;Torstai;147;102;249;25;14;39
89;15.09.2016;2016;09;15;Torstai;179;108;287;35;32;67
89;15.09.2016;2016;09;16;Torstai;258;148;406;36;18;54
89;15.09.2016;2016;09;17;Torstai;167;104;271;26;21;47
89;15.09.2016;2016;09;18;Torstai;113;100;213;31;38;69
89;15.09.2016;2016;09;19;Torstai;100;78;178;29;38;67
89;15.09.2016;2016;09;20;Torstai;71;85;156;30;25;55
89;15.09.2016;2016;09;21;Torstai;73;25;98;11;12;23
89;15.09.2016;2016;09;22;Torstai;22;17;39;6;7;13
89;15.09.2016;2016;09;23;Torstai;9;5;14;1;1;2
89;16.09.2016;2016;09;00;Perjantai;10;2;12;1;1;2
89;16.09.2016;2016;09;01;Perjantai;9;2;11;3;0;3
89;16.09.2016;2016;09;02;Perjantai;2;0;2;3;1;4
89;16.09.2016;2016;09;03;Perjantai;11;0;11;3;0;3
89;16.09.2016;2016;09;04;Perjantai;9;3;12;1;0;1
89;16.09.2016;2016;09;05;Perjantai;3;5;8;0;2;2
89;16.09.2016;2016;09;06;Perjantai;14;48;62;3;5;8
89;16.09.2016;2016;09;07;Perjantai;38;142;180;4;18;22
89;16.09.2016;2016;09;08;Perjantai;46;236;282;5;26;31
89;16.09.2016;2016;09;09;Perjantai;39;141;180;11;36;47
89;16.09.2016;2016;09;10;Perjantai;46;74;120;24;26;50
89;16.09.2016;2016;09;11;Perjantai;59;92;151;19;24;43
89;16.09.2016;2016;09;12;Perjantai;75;99;174;14;21;35
89;16.09.2016;2016;09;13;Perjantai;137;107;244;31;18;49
89;16.09.2016;2016;09;14;Perjantai;149;93;242;25;22;47
89;16.09.2016;2016;09;15;Perjantai;178;103;281;36;17;53
89;16.09.2016;2016;09;16;Perjantai;184;111;295;36;24;60
89;16.09.2016;2016;09;17;Perjantai;127;109;236;33;29;62
89;16.09.2016;2016;09;18;Perjantai;86;91;177;20;18;38
89;16.09.2016;2016;09;19;Perjantai;105;80;185;22;26;48
89;16.09.2016;2016;09;20;Perjantai;69;46;115;28;27;55
89;16.09.2016;2016;09;21;Perjantai;39;30;69;13;9;22
89;16.09.2016;2016;09;22;Perjantai;32;20;52;4;10;14
89;16.09.2016;2016;09;23;Perjantai;21;15;36;4;3;7
89;17.09.2016;2016;09;00;Lauantai;18;13;31;10;4;14
89;17.09.2016;2016;09;01;Lauantai;12;8;20;3;0;3
89;17.09.2016;2016;09;02;Lauantai;14;2;16;1;0;1
89;17.09.2016;2016;09;03;Lauantai;13;3;16;2;1;3
89;17.09.2016;2016;09;04;Lauantai;8;1;9;3;1;4
89;17.09.2016;2016;09;05;Lauantai;7;4;11;0;1;1
89;17.09.2016;2016;09;06;Lauantai;3;8;11;3;7;10
89;17.09.2016;2016;09;07;Lauantai;4;19;23;3;6;9
89;17.09.2016;2016;09;08;Lauantai;7;34;41;6;5;11
89;17.09.2016;2016;09;09;Lauantai;15;67;82;12;35;47
89;17.09.2016;2016;09;10;Lauantai;27;64;91;29;30;59
89;17.09.2016;2016;09;11;Lauantai;44;120;164;19;36;55
89;17.09.2016;2016;09;12;Lauantai;56;95;151;16;37;53
89;17.09.2016;2016;09;13;Lauantai;102;91;193;38;42;80
89;17.09.2016;2016;09;14;Lauantai;78;84;162;34;38;72
89;17.09.2016;2016;09;15;Lauantai;86;59;145;26;30;56
89;17.09.2016;2016;09;16;Lauantai;103;63;166;48;33;81
89;17.09.2016;2016;09;17;Lauantai;85;78;163;32;29;61
89;17.09.2016;2016;09;18;Lauantai;65;73;138;33;36;69
89;17.09.2016;2016;09;19;Lauantai;45;68;113;33;28;61
89;17.09.2016;2016;09;20;Lauantai;58;62;120;15;16;31
89;17.09.2016;2016;09;21;Lauantai;35;18;53;20;13;33
89;17.09.2016;2016;09;22;Lauantai;34;33;67;6;8;14
89;17.09.2016;2016;09;23;Lauantai;29;21;50;1;7;8
89;18.09.2016;2016;09;00;Sunnuntai;14;21;35;2;6;8
89;18.09.2016;2016;09;01;Sunnuntai;10;4;14;3;3;6
89;18.09.2016;2016;09;02;Sunnuntai;13;8;21;6;5;11
89;18.09.2016;2016;09;03;Sunnuntai;28;6;34;3;1;4
89;18.09.2016;2016;09;04;Sunnuntai;12;1;13;6;0;6
89;18.09.2016;2016;09;05;Sunnuntai;3;5;8;6;2;8
89;18.09.2016;2016;09;06;Sunnuntai;5;4;9;0;1;1
89;18.09.2016;2016;09;07;Sunnuntai;8;7;15;2;2;4
89;18.09.2016;2016;09;08;Sunnuntai;4;12;16;8;9;17
89;18.09.2016;2016;09;09;Sunnuntai;15;30;45;12;14;26
89;18.09.2016;2016;09;10;Sunnuntai;15;58;73;23;30;53
89;18.09.2016;2016;09;11;Sunnuntai;38;80;118;28;37;65
89;18.09.2016;2016;09;12;Sunnuntai;53;108;161;32;52;84
89;18.09.2016;2016;09;13;Sunnuntai;79;101;180;34;48;82
89;18.09.2016;2016;09;14;Sunnuntai;106;64;170;37;54;91
89;18.09.2016;2016;09;15;Sunnuntai;105;91;196;42;44;86
89;18.09.2016;2016;09;16;Sunnuntai;105;59;164;40;30;70
89;18.09.2016;2016;09;17;Sunnuntai;74;82;156;40;51;91
89;18.09.2016;2016;09;18;Sunnuntai;79;73;152;39;47;86
89;18.09.2016;2016;09;19;Sunnuntai;56;54;110;28;40;68
89;18.09.2016;2016;09;20;Sunnuntai;55;28;83;17;23;40
89;18.09.2016;2016;09;21;Sunnuntai;34;17;51;13;11;24
89;18.09.2016;2016;09;22;Sunnuntai;14;13;27;4;4;8
89;18.09.2016;2016;09;23;Sunnuntai;8;3;11;2;4;6
89;19.09.2016;2016;09;00;Maanantai;5;2;7;2;2;4
89;19.09.2016;2016;09;01;Maanantai;1;2;3;1;1;2
89;19.09.2016;2016;09;02;Maanantai;0;1;1;0;0;0
89;19.09.2016;2016;09;03;Maanantai;6;0;6;2;0;2
89;19.09.2016;2016;09;04;Maanantai;2;3;5;0;1;1
89;19.09.2016;2016;09;05;Maanantai;4;10;14;1;1;2
89;19.09.2016;2016;09;06;Maanantai;9;52;61;2;3;5
89;19.09.2016;2016;09;07;Maanantai;29;148;177;9;13;22
89;19.09.2016;2016;09;08;Maanantai;55;275;330;3;31;34
89;19.09.2016;2016;09;09;Maanantai;53;144;197;13;31;44
89;19.09.2016;2016;09;10;Maanantai;56;97;153;21;21;42
89;19.09.2016;2016;09;11;Maanantai;71;86;157;24;33;57
89;19.09.2016;2016;09;12;Maanantai;82;109;191;20;24;44
89;19.09.2016;2016;09;13;Maanantai;126;88;214;35;51;86
89;19.09.2016;2016;09;14;Maanantai;132;88;220;34;24;58
89;19.09.2016;2016;09;15;Maanantai;201;105;306;37;24;61
89;19.09.2016;2016;09;16;Maanantai;252;147;399;27;22;49
89;19.09.2016;2016;09;17;Maanantai;167;94;261;51;39;90
89;19.09.2016;2016;09;18;Maanantai;109;72;181;49;43;92
89;19.09.2016;2016;09;19;Maanantai;111;65;176;35;38;73
89;19.09.2016;2016;09;20;Maanantai;70;41;111;27;30;57
89;19.09.2016;2016;09;21;Maanantai;46;27;73;13;8;21
89;19.09.2016;2016;09;22;Maanantai;8;13;21;2;4;6
89;19.09.2016;2016;09;23;Maanantai;14;6;20;1;2;3
89;20.09.2016;2016;09;00;Tiistai;5;1;6;0;0;0
89;20.09.2016;2016;09;01;Tiistai;3;1;4;1;2;3
89;20.09.2016;2016;09;02;Tiistai;1;0;1;1;0;1
89;20.09.2016;2016;09;03;Tiistai;1;1;2;0;0;0
89;20.09.2016;2016;09;04;Tiistai;3;5;8;0;1;1
89;20.09.2016;2016;09;05;Tiistai;6;6;12;0;1;1
89;20.09.2016;2016;09;06;Tiistai;11;54;65;4;5;9
89;20.09.2016;2016;09;07;Tiistai;38;161;199;3;17;20
89;20.09.2016;2016;09;08;Tiistai;63;319;382;14;30;44
89;20.09.2016;2016;09;09;Tiistai;49;129;178;17;52;69
89;20.09.2016;2016;09;10;Tiistai;60;72;132;16;23;39
89;20.09.2016;2016;09;11;Tiistai;68;89;157;21;24;45
89;20.09.2016;2016;09;12;Tiistai;90;95;185;14;18;32
89;20.09.2016;2016;09;13;Tiistai;95;95;190;14;17;31
89;20.09.2016;2016;09;14;Tiistai;142;82;224;18;6;24
89;20.09.2016;2016;09;15;Tiistai;170;85;255;25;31;56
89;20.09.2016;2016;09;16;Tiistai;277;131;408;30;16;46
89;20.09.2016;2016;09;17;Tiistai;154;117;271;28;15;43
89;20.09.2016;2016;09;18;Tiistai;127;96;223;29;41;70
89;20.09.2016;2016;09;19;Tiistai;104;51;155;56;46;102
89;20.09.2016;2016;09;20;Tiistai;84;55;139;24;21;45
89;20.09.2016;2016;09;21;Tiistai;56;25;81;18;19;37
89;20.09.2016;2016;09;22;Tiistai;14;9;23;2;4;6
89;20.09.2016;2016;09;23;Tiistai;14;7;21;5;4;9
89;21.09.2016;2016;09;00;Keskiviikko;2;1;3;0;2;2
89;21.09.2016;2016;09;01;Keskiviikko;10;6;16;2;1;3
89;21.09.2016;2016;09;02;Keskiviikko;4;2;6;0;1;1
89;21.09.2016;2016;09;03;Keskiviikko;0;2;2;0;0;0
89;21.09.2016;2016;09;04;Keskiviikko;0;3;3;0;0;0
89;21.09.2016;2016;09;05;Keskiviikko;2;8;10;0;0;0
89;21.09.2016;2016;09;06;Keskiviikko;10;49;59;2;7;9
89;21.09.2016;2016;09;07;Keskiviikko;51;161;212;5;25;30
89;21.09.2016;2016;09;08;Keskiviikko;60;313;373;9;30;39
89;21.09.2016;2016;09;09;Keskiviikko;37;126;163;17;27;44
89;21.09.2016;2016;09;10;Keskiviikko;66;86;152;15;23;38
89;21.09.2016;2016;09;11;Keskiviikko;83;90;173;20;27;47
89;21.09.2016;2016;09;12;Keskiviikko;70;109;179;13;27;40
89;21.09.2016;2016;09;13;Keskiviikko;116;92;208;20;33;53
89;21.09.2016;2016;09;14;Keskiviikko;175;100;275;30;22;52
89;21.09.2016;2016;09;15;Keskiviikko;182;103;285;34;32;66
89;21.09.2016;2016;09;16;Keskiviikko;239;124;363;33;22;55
89;21.09.2016;2016;09;17;Keskiviikko;150;119;269;39;32;71
89;21.09.2016;2016;09;18;Keskiviikko;116;95;211;45;34;79
89;21.09.2016;2016;09;19;Keskiviikko;124;60;184;39;29;68
89;21.09.2016;2016;09;20;Keskiviikko;94;57;151;28;24;52
89;21.09.2016;2016;09;21;Keskiviikko;50;25;75;10;8;18
89;21.09.2016;2016;09;22;Keskiviikko;28;18;46;3;4;7
89;21.09.2016;2016;09;23;Keskiviikko;24;6;30;1;1;2
89;22.09.2016;2016;09;00;Torstai;10;9;19;0;0;0
89;22.09.2016;2016;09;01;Torstai;12;10;22;3;3;6
89;22.09.2016;2016;09;02;Torstai;4;3;7;0;0;0
89;22.09.2016;2016;09;03;Torstai;7;4;11;1;0;1
89;22.09.2016;2016;09;04;Torstai;9;7;16;1;0;1
89;22.09.2016;2016;09;05;Torstai;0;5;5;0;1;1
89;22.09.2016;2016;09;06;Torstai;10;56;66;1;6;7
89;22.09.2016;2016;09;07;Torstai;44;157;201;7;22;29
89;22.09.2016;2016;09;08;Torstai;53;268;321;9;18;27
89;22.09.2016;2016;09;09;Torstai;72;152;224;35;58;93
89;22.09.2016;2016;09;10;Torstai;48;93;141;19;23;42
89;22.09.2016;2016;09;11;Torstai;71;95;166;21;31;52
89;22.09.2016;2016;09;12;Torstai;87;92;179;14;27;41
89;22.09.2016;2016;09;13;Torstai;124;95;219;31;39;70
89;22.09.2016;2016;09;14;Torstai;127;96;223;26;24;50
89;22.09.2016;2016;09;15;Torstai;175;111;286;27;39;66
89;22.09.2016;2016;09;16;Torstai;213;129;342;34;36;70
89;22.09.2016;2016;09;17;Torstai;160;89;249;24;17;41
89;22.09.2016;2016;09;18;Torstai;106;97;203;27;31;58
89;22.09.2016;2016;09;19;Torstai;87;55;142;30;29;59
89;22.09.2016;2016;09;20;Torstai;73;42;115;24;24;48
89;22.09.2016;2016;09;21;Torstai;61;25;86;8;8;16
89;22.09.2016;2016;09;22;Torstai;22;9;31;5;2;7
89;22.09.2016;2016;09;23;Torstai;9;3;12;1;7;8
89;23.09.2016;2016;09;00;Perjantai;4;8;12;3;0;3
89;23.09.2016;2016;09;01;Perjantai;9;2;11;1;1;2
89;23.09.2016;2016;09;02;Perjantai;1;2;3;1;0;1
89;23.09.2016;2016;09;03;Perjantai;3;4;7;0;1;1
89;23.09.2016;2016;09;04;Perjantai;3;5;8;3;0;3
89;23.09.2016;2016;09;05;Perjantai;4;7;11;0;0;0
89;23.09.2016;2016;09;06;Perjantai;8;42;50;3;6;9
89;23.09.2016;2016;09;07;Perjantai;32;136;168;8;18;26
89;23.09.2016;2016;09;08;Perjantai;35;214;249;17;27;44
89;23.09.2016;2016;09;09;Perjantai;51;111;162;23;31;54
89;23.09.2016;2016;09;10;Perjantai;61;94;155;20;20;40
89;23.09.2016;2016;09;11;Perjantai;77;65;142;19;45;64
89;23.09.2016;2016;09;12;Perjantai;73;82;155;40;27;67
89;23.09.2016;2016;09;13;Perjantai;122;105;227;25;21;46
89;23.09.2016;2016;09;14;Perjantai;159;105;264;17;13;30
89;23.09.2016;2016;09;15;Perjantai;186;88;274;24;27;51
89;23.09.2016;2016;09;16;Perjantai;173;94;267;27;27;54
89;23.09.2016;2016;09;17;Perjantai;123;68;191;22;39;61
89;23.09.2016;2016;09;18;Perjantai;78;76;154;32;25;57
89;23.09.2016;2016;09;19;Perjantai;59;54;113;17;19;36
89;23.09.2016;2016;09;20;Perjantai;52;40;92;12;13;25
89;23.09.2016;2016;09;21;Perjantai;40;18;58;7;7;14
89;23.09.2016;2016;09;22;Perjantai;30;21;51;9;4;13
89;23.09.2016;2016;09;23;Perjantai;21;22;43;1;6;7
89;24.09.2016;2016;09;00;Lauantai;14;8;22;0;4;4
89;24.09.2016;2016;09;01;Lauantai;14;18;32;1;2;3
89;24.09.2016;2016;09;02;Lauantai;6;9;15;3;3;6
89;24.09.2016;2016;09;03;Lauantai;13;1;14;7;0;7
89;24.09.2016;2016;09;04;Lauantai;16;1;17;0;0;0
89;24.09.2016;2016;09;05;Lauantai;8;3;11;1;1;2
89;24.09.2016;2016;09;06;Lauantai;3;1;4;0;2;2
89;24.09.2016;2016;09;07;Lauantai;0;13;13;3;8;11
89;24.09.2016;2016;09;08;Lauantai;9;14;23;4;12;16
89;24.09.2016;2016;09;09;Lauantai;17;43;60;12;12;24
89;24.09.2016;2016;09;10;Lauantai;32;62;94;15;23;38
89;24.09.2016;2016;09;11;Lauantai;36;82;118;27;39;66
89;24.09.2016;2016;09;12;Lauantai;52;76;128;35;23;58
89;24.09.2016;2016;09;13;Lauantai;59;73;132;36;43;79
89;24.09.2016;2016;09;14;Lauantai;69;87;156;23;35;58
89;24.09.2016;2016;09;15;Lauantai;100;58;158;30;28;58
89;24.09.2016;2016;09;16;Lauantai;66;63;129;27;35;62
89;24.09.2016;2016;09;17;Lauantai;51;69;120;22;33;55
89;24.09.2016;2016;09;18;Lauantai;48;66;114;22;30;52
89;24.09.2016;2016;09;19;Lauantai;49;36;85;38;22;60
89;24.09.2016;2016;09;20;Lauantai;36;50;86;12;13;25
89;24.09.2016;2016;09;21;Lauantai;43;25;68;16;14;30
89;24.09.2016;2016;09;22;Lauantai;20;19;39;10;9;19
89;24.09.2016;2016;09;23;Lauantai;18;26;44;2;12;14
89;25.09.2016;2016;09;00;Sunnuntai;19;22;41;4;8;12
89;25.09.2016;2016;09;01;Sunnuntai;14;3;17;5;1;6
89;25.09.2016;2016;09;02;Sunnuntai;17;6;23;5;1;6
89;25.09.2016;2016;09;03;Sunnuntai;22;4;26;2;0;2
89;25.09.2016;2016;09;04;Sunnuntai;23;0;23;6;0;6
89;25.09.2016;2016;09;05;Sunnuntai;5;2;7;2;0;2
89;25.09.2016;2016;09;06;Sunnuntai;2;3;5;0;0;0
89;25.09.2016;2016;09;07;Sunnuntai;4;5;9;2;4;6
89;25.09.2016;2016;09;08;Sunnuntai;7;7;14;3;4;7
89;25.09.2016;2016;09;09;Sunnuntai;12;20;32;12;24;36
89;25.09.2016;2016;09;10;Sunnuntai;17;37;54;26;33;59
89;25.09.2016;2016;09;11;Sunnuntai;41;59;100;34;42;76
89;25.09.2016;2016;09;12;Sunnuntai;48;83;131;33;48;81
89;25.09.2016;2016;09;13;Sunnuntai;68;83;151;38;31;69
89;25.09.2016;2016;09;14;Sunnuntai;86;86;172;34;57;91
89;25.09.2016;2016;09;15;Sunnuntai;83;66;149;42;40;82
89;25.09.2016;2016;09;16;Sunnuntai;97;83;180;47;62;109
89;25.09.2016;2016;09;17;Sunnuntai;66;67;133;31;31;62
89;25.09.2016;2016;09;18;Sunnuntai;85;78;163;34;44;78
89;25.09.2016;2016;09;19;Sunnuntai;50;54;104;31;40;71
89;25.09.2016;2016;09;20;Sunnuntai;35;22;57;24;37;61
89;25.09.2016;2016;09;21;Sunnuntai;21;15;36;20;16;36
89;25.09.2016;2016;09;22;Sunnuntai;21;10;31;5;4;9
89;25.09.2016;2016;09;23;Sunnuntai;7;6;13;1;4;5
89;26.09.2016;2016;09;00;Maanantai;9;7;16;1;3;4
89;26.09.2016;2016;09;01;Maanantai;1;3;4;0;0;0
89;26.09.2016;2016;09;02;Maanantai;1;2;3;0;1;1
89;26.09.2016;2016;09;03;Maanantai;5;2;7;0;0;0
89;26.09.2016;2016;09;04;Maanantai;1;1;2;1;0;1
89;26.09.2016;2016;09;05;Maanantai;3;4;7;0;2;2
89;26.09.2016;2016;09;06;Maanantai;18;53;71;3;5;8
89;26.09.2016;2016;09;07;Maanantai;33;139;172;7;20;27
89;26.09.2016;2016;09;08;Maanantai;54;292;346;7;31;38
89;26.09.2016;2016;09;09;Maanantai;63;136;199;9;33;42
89;26.09.2016;2016;09;10;Maanantai;49;98;147;21;40;61
89;26.09.2016;2016;09;11;Maanantai;90;93;183;26;19;45
89;26.09.2016;2016;09;12;Maanantai;100;111;211;15;17;32
89;26.09.2016;2016;09;13;Maanantai;110;113;223;25;32;57
89;26.09.2016;2016;09;14;Maanantai;147;91;238;19;30;49
89;26.09.2016;2016;09;15;Maanantai;198;88;286;24;17;41
89;26.09.2016;2016;09;16;Maanantai;239;118;357;41;20;61
89;26.09.2016;2016;09;17;Maanantai;159;93;252;23;24;47
89;26.09.2016;2016;09;18;Maanantai;111;69;180;22;37;59
89;26.09.2016;2016;09;19;Maanantai;103;49;152;31;46;77
89;26.09.2016;2016;09;20;Maanantai;59;39;98;27;25;52
89;26.09.2016;2016;09;21;Maanantai;40;27;67;19;18;37
89;26.09.2016;2016;09;22;Maanantai;19;14;33;6;4;10
89;26.09.2016;2016;09;23;Maanantai;20;9;29;1;4;5
89;27.09.2016;2016;09;00;Tiistai;2;9;11;1;2;3
89;27.09.2016;2016;09;01;Tiistai;4;3;7;2;1;3
89;27.09.2016;2016;09;02;Tiistai;2;0;2;1;2;3
89;27.09.2016;2016;09;03;Tiistai;2;1;3;0;0;0
89;27.09.2016;2016;09;04;Tiistai;1;3;4;0;0;0
89;27.09.2016;2016;09;05;Tiistai;2;8;10;0;0;0
89;27.09.2016;2016;09;06;Tiistai;12;48;60;2;4;6
89;27.09.2016;2016;09;07;Tiistai;34;174;208;5;20;25
89;27.09.2016;2016;09;08;Tiistai;67;292;359;10;32;42
89;27.09.2016;2016;09;09;Tiistai;60;141;201;8;23;31
89;27.09.2016;2016;09;10;Tiistai;53;104;157;32;37;69
89;27.09.2016;2016;09;11;Tiistai;73;96;169;31;30;61
89;27.09.2016;2016;09;12;Tiistai;70;104;174;17;32;49
89;27.09.2016;2016;09;13;Tiistai;122;126;248;28;33;61
89;27.09.2016;2016;09;14;Tiistai;132;107;239;28;20;48
89;27.09.2016;2016;09;15;Tiistai;219;98;317;38;35;73
89;27.09.2016;2016;09;16;Tiistai;304;177;481;31;35;66
89;27.09.2016;2016;09;17;Tiistai;144;125;269;43;58;101
89;27.09.2016;2016;09;18;Tiistai;126;101;227;44;43;87
89;27.09.2016;2016;09;19;Tiistai;105;51;156;34;36;70
89;27.09.2016;2016;09;20;Tiistai;73;33;106;30;26;56
89;27.09.2016;2016;09;21;Tiistai;57;38;95;17;20;37
89;27.09.2016;2016;09;22;Tiistai;21;15;36;8;10;18
89;27.09.2016;2016;09;23;Tiistai;10;10;20;2;3;5
89;28.09.2016;2016;09;00;Keskiviikko;6;10;16;2;1;3
89;28.09.2016;2016;09;01;Keskiviikko;3;1;4;1;4;5
89;28.09.2016;2016;09;02;Keskiviikko;3;0;3;2;1;3
89;28.09.2016;2016;09;03;Keskiviikko;3;1;4;0;1;1
89;28.09.2016;2016;09;04;Keskiviikko;0;5;5;1;0;1
89;28.09.2016;2016;09;05;Keskiviikko;5;8;13;0;1;1
89;28.09.2016;2016;09;06;Keskiviikko;13;47;60;1;9;10
89;28.09.2016;2016;09;07;Keskiviikko;36;164;200;9;10;19
89;28.09.2016;2016;09;08;Keskiviikko;41;292;333;8;48;56
89;28.09.2016;2016;09;09;Keskiviikko;58;147;205;25;31;56
89;28.09.2016;2016;09;10;Keskiviikko;59;94;153;21;28;49
89;28.09.2016;2016;09;11;Keskiviikko;78;87;165;28;26;54
89;28.09.2016;2016;09;12;Keskiviikko;92;78;170;16;20;36
89;28.09.2016;2016;09;13;Keskiviikko;103;85;188;17;24;41
89;28.09.2016;2016;09;14;Keskiviikko;130;78;208;19;13;32
89;28.09.2016;2016;09;15;Keskiviikko;149;109;258;28;26;54
89;28.09.2016;2016;09;16;Keskiviikko;214;78;292;21;18;39
89;28.09.2016;2016;09;17;Keskiviikko;98;46;144;13;10;23
89;28.09.2016;2016;09;18;Keskiviikko;96;42;138;12;12;24
89;28.09.2016;2016;09;19;Keskiviikko;51;31;82;11;4;15
89;28.09.2016;2016;09;20;Keskiviikko;46;21;67;9;6;15
89;28.09.2016;2016;09;21;Keskiviikko;36;15;51;5;4;9
89;28.09.2016;2016;09;22;Keskiviikko;13;10;23;2;1;3
89;28.09.2016;2016;09;23;Keskiviikko;10;5;15;2;4;6
89;29.09.2016;2016;09;00;Torstai;2;1;3;0;3;3
89;29.09.2016;2016;09;01;Torstai;6;0;6;2;0;2
89;29.09.2016;2016;09;02;Torstai;2;0;2;2;1;3
89;29.09.2016;2016;09;03;Torstai;3;3;6;0;2;2
89;29.09.2016;2016;09;04;Torstai;2;3;5;0;0;0
89;29.09.2016;2016;09;05;Torstai;3;11;14;0;0;0
89;29.09.2016;2016;09;06;Torstai;15;44;59;1;5;6
89;29.09.2016;2016;09;07;Torstai;39;143;182;5;20;25
89;29.09.2016;2016;09;08;Torstai;45;230;275;12;37;49
89;29.09.2016;2016;09;09;Torstai;39;111;150;11;26;37
89;29.09.2016;2016;09;10;Torstai;63;97;160;29;27;56
89;29.09.2016;2016;09;11;Torstai;64;95;159;26;25;51
89;29.09.2016;2016;09;12;Torstai;82;101;183;24;34;58
89;29.09.2016;2016;09;13;Torstai;104;77;181;18;22;40
89;29.09.2016;2016;09;14;Torstai;137;85;222;19;16;35
89;29.09.2016;2016;09;15;Torstai;172;86;258;24;24;48
89;29.09.2016;2016;09;16;Torstai;201;140;341;24;24;48
89;29.09.2016;2016;09;17;Torstai;113;130;243;35;41;76
89;29.09.2016;2016;09;18;Torstai;119;79;198;30;30;60
89;29.09.2016;2016;09;19;Torstai;85;30;115;22;13;35
89;29.09.2016;2016;09;20;Torstai;52;15;67;9;10;19
89;29.09.2016;2016;09;21;Torstai;42;12;54;5;7;12
89;29.09.2016;2016;09;22;Torstai;16;8;24;2;0;2
89;29.09.2016;2016;09;23;Torstai;5;6;11;2;4;6
89;30.09.2016;2016;09;00;Perjantai;3;7;10;2;0;2
89;30.09.2016;2016;09;01;Perjantai;7;3;10;0;0;0
89;30.09.2016;2016;09;02;Perjantai;2;4;6;2;1;3
89;30.09.2016;2016;09;03;Perjantai;3;4;7;0;1;1
89;30.09.2016;2016;09;04;Perjantai;5;2;7;0;0;0
89;30.09.2016;2016;09;05;Perjantai;6;6;12;1;0;1
89;30.09.2016;2016;09;06;Perjantai;12;31;43;2;6;8
89;30.09.2016;2016;09;07;Perjantai;31;110;141;2;14;16
89;30.09.2016;2016;09;08;Perjantai;38;192;230;5;26;31
89;30.09.2016;2016;09;09;Perjantai;47;118;165;15;33;48
89;30.09.2016;2016;09;10;Perjantai;43;96;139;18;31;49
89;30.09.2016;2016;09;11;Perjantai;66;81;147;13;35;48
89;30.09.2016;2016;09;12;Perjantai;64;64;128;23;14;37
89;30.09.2016;2016;09;13;Perjantai;89;90;179;13;21;34
89;30.09.2016;2016;09;14;Perjantai;129;85;214;22;32;54
89;30.09.2016;2016;09;15;Perjantai;183;97;280;23;25;48
89;30.09.2016;2016;09;16;Perjantai;150;93;243;32;22;54
89;30.09.2016;2016;09;17;Perjantai;82;91;173;19;26;45
89;30.09.2016;2016;09;18;Perjantai;96;76;172;17;17;34
89;30.09.2016;2016;09;19;Perjantai;65;50;115;17;21;38
89;30.09.2016;2016;09;20;Perjantai;54;31;85;10;7;17
89;30.09.2016;2016;09;21;Perjantai;35;25;60;11;7;18
89;30.09.2016;2016;09;22;Perjantai;27;19;46;4;14;18
89;30.09.2016;2016;09;23;Perjantai;18;24;42;4;5;9
89;01.10.2016;2016;10;00;Lauantai;17;13;30;3;3;6
89;01.10.2016;2016;10;01;Lauantai;10;9;19;4;2;6
89;01.10.2016;2016;10;02;Lauantai;21;5;26;4;2;6
89;01.10.2016;2016;10;03;Lauantai;20;3;23;4;3;7
89;01.10.2016;2016;10;04;Lauantai;19;7;26;10;5;15
89;01.10.2016;2016;10;05;Lauantai;10;1;11;3;1;4
89;01.10.2016;2016;10;06;Lauantai;3;11;14;0;2;2
89;01.10.2016;2016;10;07;Lauantai;3;23;26;6;6;12
89;01.10.2016;2016;10;08;Lauantai;5;24;29;3;10;13
89;01.10.2016;2016;10;09;Lauantai;18;48;66;14;30;44
89;01.10.2016;2016;10;10;Lauantai;34;83;117;16;37;53
89;01.10.2016;2016;10;11;Lauantai;48;77;125;30;54;84
89;01.10.2016;2016;10;12;Lauantai;74;102;176;35;26;61
89;01.10.2016;2016;10;13;Lauantai;72;102;174;20;35;55
89;01.10.2016;2016;10;14;Lauantai;100;95;195;25;37;62
89;01.10.2016;2016;10;15;Lauantai;108;62;170;27;20;47
89;01.10.2016;2016;10;16;Lauantai;91;52;143;23;35;58
89;01.10.2016;2016;10;17;Lauantai;88;76;164;27;28;55
89;01.10.2016;2016;10;18;Lauantai;72;57;129;30;31;61
89;01.10.2016;2016;10;19;Lauantai;68;37;105;22;15;37
89;01.10.2016;2016;10;20;Lauantai;37;42;79;13;19;32
89;01.10.2016;2016;10;21;Lauantai;35;23;58;7;5;12
89;01.10.2016;2016;10;22;Lauantai;23;22;45;6;9;15
89;01.10.2016;2016;10;23;Lauantai;16;26;42;3;3;6
89;02.10.2016;2016;10;00;Sunnuntai;19;22;41;3;8;11
89;02.10.2016;2016;10;01;Sunnuntai;12;15;27;2;0;2
89;02.10.2016;2016;10;02;Sunnuntai;10;3;13;4;1;5
89;02.10.2016;2016;10;03;Sunnuntai;17;2;19;5;3;8
89;02.10.2016;2016;10;04;Sunnuntai;25;1;26;5;0;5
89;02.10.2016;2016;10;05;Sunnuntai;7;3;10;0;2;2
89;02.10.2016;2016;10;06;Sunnuntai;2;9;11;0;0;0
89;02.10.2016;2016;10;07;Sunnuntai;5;4;9;3;4;7
89;02.10.2016;2016;10;08;Sunnuntai;6;8;14;7;12;19
89;02.10.2016;2016;10;09;Sunnuntai;17;27;44;16;15;31
89;02.10.2016;2016;10;10;Sunnuntai;26;59;85;25;59;84
89;02.10.2016;2016;10;11;Sunnuntai;44;62;106;45;55;100
89;02.10.2016;2016;10;12;Sunnuntai;46;89;135;48;69;117
89;02.10.2016;2016;10;13;Sunnuntai;64;100;164;49;54;103
89;02.10.2016;2016;10;14;Sunnuntai;111;112;223;42;54;96
89;02.10.2016;2016;10;15;Sunnuntai;85;91;176;98;87;185
89;02.10.2016;2016;10;16;Sunnuntai;86;88;174;45;71;116
89;02.10.2016;2016;10;17;Sunnuntai;82;79;161;44;62;106
89;02.10.2016;2016;10;18;Sunnuntai;83;54;137;46;60;106
89;02.10.2016;2016;10;19;Sunnuntai;55;29;84;35;34;69
89;02.10.2016;2016;10;20;Sunnuntai;31;20;51;32;23;55
89;02.10.2016;2016;10;21;Sunnuntai;22;13;35;9;8;17
89;02.10.2016;2016;10;22;Sunnuntai;20;11;31;7;8;15
89;02.10.2016;2016;10;23;Sunnuntai;4;3;7;0;2;2
89;03.10.2016;2016;10;00;Maanantai;10;3;13;2;4;6
89;03.10.2016;2016;10;01;Maanantai;3;2;5;0;1;1
89;03.10.2016;2016;10;02;Maanantai;3;2;5;1;1;2
89;03.10.2016;2016;10;03;Maanantai;2;2;4;0;0;0
89;03.10.2016;2016;10;04;Maanantai;3;0;3;0;0;0
89;03.10.2016;2016;10;05;Maanantai;4;11;15;0;2;2
89;03.10.2016;2016;10;06;Maanantai;14;42;56;2;3;5
89;03.10.2016;2016;10;07;Maanantai;30;136;166;3;21;24
89;03.10.2016;2016;10;08;Maanantai;49;275;324;5;28;33
89;03.10.2016;2016;10;09;Maanantai;55;144;199;8;40;48
89;03.10.2016;2016;10;10;Maanantai;49;97;146;20;30;50
89;03.10.2016;2016;10;11;Maanantai;89;82;171;29;32;61
89;03.10.2016;2016;10;12;Maanantai;88;81;169;26;37;63
89;03.10.2016;2016;10;13;Maanantai;91;95;186;25;52;77
89;03.10.2016;2016;10;14;Maanantai;136;88;224;25;27;52
89;03.10.2016;2016;10;15;Maanantai;204;88;292;28;19;47
89;03.10.2016;2016;10;16;Maanantai;224;137;361;41;18;59
89;03.10.2016;2016;10;17;Maanantai;154;90;244;36;22;58
89;03.10.2016;2016;10;18;Maanantai;92;65;157;40;36;76
89;03.10.2016;2016;10;19;Maanantai;84;49;133;40;32;72
89;03.10.2016;2016;10;20;Maanantai;46;16;62;26;24;50
89;03.10.2016;2016;10;21;Maanantai;47;28;75;11;17;28
89;03.10.2016;2016;10;22;Maanantai;16;9;25;7;6;13
89;03.10.2016;2016;10;23;Maanantai;10;5;15;4;1;5
89;04.10.2016;2016;10;00;Tiistai;5;3;8;1;1;2
89;04.10.2016;2016;10;01;Tiistai;1;2;3;0;0;0
89;04.10.2016;2016;10;02;Tiistai;6;0;6;0;2;2
89;04.10.2016;2016;10;03;Tiistai;2;3;5;0;0;0
89;04.10.2016;2016;10;04;Tiistai;2;1;3;0;0;0
89;04.10.2016;2016;10;05;Tiistai;3;9;12;1;0;1
89;04.10.2016;2016;10;06;Tiistai;16;44;60;2;2;4
89;04.10.2016;2016;10;07;Tiistai;37;153;190;8;20;28
89;04.10.2016;2016;10;08;Tiistai;60;289;349;12;25;37
89;04.10.2016;2016;10;09;Tiistai;44;163;207;16;32;48
89;04.10.2016;2016;10;10;Tiistai;47;92;139;28;85;113
89;04.10.2016;2016;10;11;Tiistai;50;81;131;40;32;72
89;04.10.2016;2016;10;12;Tiistai;60;90;150;15;25;40
89;04.10.2016;2016;10;13;Tiistai;101;84;185;18;31;49
89;04.10.2016;2016;10;14;Tiistai;118;91;209;28;23;51
89;04.10.2016;2016;10;15;Tiistai;165;100;265;36;24;60
89;04.10.2016;2016;10;16;Tiistai;267;149;416;29;27;56
89;04.10.2016;2016;10;17;Tiistai;155;94;249;29;29;58
89;04.10.2016;2016;10;18;Tiistai;122;84;206;33;57;90
89;04.10.2016;2016;10;19;Tiistai;108;55;163;35;24;59
89;04.10.2016;2016;10;20;Tiistai;74;36;110;13;19;32
89;04.10.2016;2016;10;21;Tiistai;50;22;72;9;8;17
89;04.10.2016;2016;10;22;Tiistai;18;12;30;0;4;4
89;04.10.2016;2016;10;23;Tiistai;7;6;13;1;3;4
89;05.10.2016;2016;10;00;Keskiviikko;5;3;8;1;0;1
89;05.10.2016;2016;10;01;Keskiviikko;4;2;6;0;0;0
89;05.10.2016;2016;10;02;Keskiviikko;4;0;4;2;0;2
89;05.10.2016;2016;10;03;Keskiviikko;2;4;6;0;0;0
89;05.10.2016;2016;10;04;Keskiviikko;0;1;1;1;0;1
89;05.10.2016;2016;10;05;Keskiviikko;5;7;12;0;2;2
89;05.10.2016;2016;10;06;Keskiviikko;10;37;47;3;5;8
89;05.10.2016;2016;10;07;Keskiviikko;30;144;174;3;17;20
89;05.10.2016;2016;10;08;Keskiviikko;45;284;329;3;54;57
89;05.10.2016;2016;10;09;Keskiviikko;43;121;164;20;30;50
89;05.10.2016;2016;10;10;Keskiviikko;60;73;133;16;30;46
89;05.10.2016;2016;10;11;Keskiviikko;68;95;163;24;42;66
89;05.10.2016;2016;10;12;Keskiviikko;69;105;174;25;30;55
89;05.10.2016;2016;10;13;Keskiviikko;106;83;189;28;19;47
89;05.10.2016;2016;10;14;Keskiviikko;148;89;237;31;29;60
89;05.10.2016;2016;10;15;Keskiviikko;162;84;246;33;25;58
89;05.10.2016;2016;10;16;Keskiviikko;241;117;358;34;19;53
89;05.10.2016;2016;10;17;Keskiviikko;147;111;258;36;26;62
89;05.10.2016;2016;10;18;Keskiviikko;112;80;192;38;35;73
89;05.10.2016;2016;10;19;Keskiviikko;111;54;165;35;25;60
89;05.10.2016;2016;10;20;Keskiviikko;48;34;82;20;29;49
89;05.10.2016;2016;10;21;Keskiviikko;53;29;82;12;9;21
89;05.10.2016;2016;10;22;Keskiviikko;22;15;37;8;7;15
89;05.10.2016;2016;10;23;Keskiviikko;12;13;25;0;0;0
89;06.10.2016;2016;10;00;Torstai;3;5;8;2;0;2
89;06.10.2016;2016;10;01;Torstai;5;1;6;1;0;1
89;06.10.2016;2016;10;02;Torstai;2;1;3;1;2;3
89;06.10.2016;2016;10;03;Torstai;1;2;3;0;0;0
89;06.10.2016;2016;10;04;Torstai;6;2;8;2;0;2
89;06.10.2016;2016;10;05;Torstai;2;7;9;0;0;0
89;06.10.2016;2016;10;06;Torstai;15;31;46;4;4;8
89;06.10.2016;2016;10;07;Torstai;23;130;153;4;19;23
89;06.10.2016;2016;10;08;Torstai;54;266;320;6;27;33
89;06.10.2016;2016;10;09;Torstai;50;140;190;11;35;46
89;06.10.2016;2016;10;10;Torstai;48;78;126;11;28;39
89;06.10.2016;2016;10;11;Torstai;41;104;145;26;37;63
89;06.10.2016;2016;10;12;Torstai;66;75;141;17;22;39
89;06.10.2016;2016;10;13;Torstai;92;67;159;33;29;62
89;06.10.2016;2016;10;14;Torstai;96;78;174;26;24;50
89;06.10.2016;2016;10;15;Torstai;182;90;272;16;19;35
89;06.10.2016;2016;10;16;Torstai;206;115;321;35;20;55
89;06.10.2016;2016;10;17;Torstai;146;119;265;30;34;64
89;06.10.2016;2016;10;18;Torstai;120;88;208;34;36;70
89;06.10.2016;2016;10;19;Torstai;109;65;174;31;30;61
89;06.10.2016;2016;10;20;Torstai;54;25;79;26;21;47
89;06.10.2016;2016;10;21;Torstai;67;26;93;26;14;40
89;06.10.2016;2016;10;22;Torstai;27;35;62;11;2;13
89;06.10.2016;2016;10;23;Torstai;11;12;23;4;2;6
89;07.10.2016;2016;10;00;Perjantai;9;12;21;1;0;1
89;07.10.2016;2016;10;01;Perjantai;11;0;11;1;1;2
89;07.10.2016;2016;10;02;Perjantai;8;1;9;1;0;1
89;07.10.2016;2016;10;03;Perjantai;11;2;13;1;1;2
89;07.10.2016;2016;10;04;Perjantai;8;6;14;1;0;1
89;07.10.2016;2016;10;05;Perjantai;5;8;13;1;1;2
89;07.10.2016;2016;10;06;Perjantai;12;31;43;3;7;10
89;07.10.2016;2016;10;07;Perjantai;27;145;172;6;19;25
89;07.10.2016;2016;10;08;Perjantai;36;226;262;7;28;35
89;07.10.2016;2016;10;09;Perjantai;41;100;141;16;29;45
89;07.10.2016;2016;10;10;Perjantai;30;96;126;20;28;48
89;07.10.2016;2016;10;11;Perjantai;67;87;154;20;28;48
89;07.10.2016;2016;10;12;Perjantai;80;90;170;28;40;68
89;07.10.2016;2016;10;13;Perjantai;125;97;222;29;31;60
89;07.10.2016;2016;10;14;Perjantai;134;94;228;22;22;44
89;07.10.2016;2016;10;15;Perjantai;168;94;262;13;22;35
89;07.10.2016;2016;10;16;Perjantai;174;102;276;26;26;52
89;07.10.2016;2016;10;17;Perjantai;109;72;181;20;28;48
89;07.10.2016;2016;10;18;Perjantai;65;75;140;21;25;46
89;07.10.2016;2016;10;19;Perjantai;62;43;105;19;23;42
89;07.10.2016;2016;10;20;Perjantai;73;26;99;11;21;32
89;07.10.2016;2016;10;21;Perjantai;34;32;66;4;7;11
89;07.10.2016;2016;10;22;Perjantai;17;25;42;5;10;15
89;07.10.2016;2016;10;23;Perjantai;26;15;41;7;7;14
89;08.10.2016;2016;10;00;Lauantai;13;17;30;4;7;11
89;08.10.2016;2016;10;01;Lauantai;10;9;19;2;3;5
89;08.10.2016;2016;10;02;Lauantai;11;7;18;3;2;5
89;08.10.2016;2016;10;03;Lauantai;7;2;9;7;2;9
89;08.10.2016;2016;10;04;Lauantai;9;2;11;7;0;7
89;08.10.2016;2016;10;05;Lauantai;5;4;9;1;3;4
89;08.10.2016;2016;10;06;Lauantai;3;7;10;1;2;3
89;08.10.2016;2016;10;07;Lauantai;4;12;16;4;3;7
89;08.10.2016;2016;10;08;Lauantai;7;26;33;6;10;16
89;08.10.2016;2016;10;09;Lauantai;21;51;72;6;18;24
89;08.10.2016;2016;10;10;Lauantai;26;54;80;27;20;47
89;08.10.2016;2016;10;11;Lauantai;48;80;128;21;51;72
89;08.10.2016;2016;10;12;Lauantai;42;106;148;23;43;66
89;08.10.2016;2016;10;13;Lauantai;58;101;159;27;42;69
89;08.10.2016;2016;10;14;Lauantai;71;86;157;42;35;77
89;08.10.2016;2016;10;15;Lauantai;77;82;159;34;59;93
89;08.10.2016;2016;10;16;Lauantai;97;71;168;34;42;76
89;08.10.2016;2016;10;17;Lauantai;84;68;152;23;31;54
89;08.10.2016;2016;10;18;Lauantai;60;53;113;27;27;54
89;08.10.2016;2016;10;19;Lauantai;56;41;97;23;15;38
89;08.10.2016;2016;10;20;Lauantai;39;37;76;13;16;29
89;08.10.2016;2016;10;21;Lauantai;27;26;53;9;12;21
89;08.10.2016;2016;10;22;Lauantai;22;22;44;9;6;15
89;08.10.2016;2016;10;23;Lauantai;13;26;39;5;10;15
89;09.10.2016;2016;10;00;Sunnuntai;23;43;66;2;10;12
89;09.10.2016;2016;10;01;Sunnuntai;10;5;15;2;4;6
89;09.10.2016;2016;10;02;Sunnuntai;9;3;12;6;0;6
89;09.10.2016;2016;10;03;Sunnuntai;19;2;21;3;0;3
89;09.10.2016;2016;10;04;Sunnuntai;21;1;22;11;1;12
89;09.10.2016;2016;10;05;Sunnuntai;3;2;5;2;3;5
89;09.10.2016;2016;10;06;Sunnuntai;2;2;4;3;2;5
89;09.10.2016;2016;10;07;Sunnuntai;3;4;7;4;4;8
89;09.10.2016;2016;10;08;Sunnuntai;5;4;9;2;7;9
89;09.10.2016;2016;10;09;Sunnuntai;4;21;25;16;24;40
89;09.10.2016;2016;10;10;Sunnuntai;22;37;59;33;41;74
89;09.10.2016;2016;10;11;Sunnuntai;29;50;79;38;61;99
89;09.10.2016;2016;10;12;Sunnuntai;50;70;120;34;53;87
89;09.10.2016;2016;10;13;Sunnuntai;61;70;131;43;61;104
89;09.10.2016;2016;10;14;Sunnuntai;73;73;146;31;44;75
89;09.10.2016;2016;10;15;Sunnuntai;67;74;141;45;66;111
89;09.10.2016;2016;10;16;Sunnuntai;82;65;147;36;35;71
89;09.10.2016;2016;10;17;Sunnuntai;92;60;152;50;50;100
89;09.10.2016;2016;10;18;Sunnuntai;51;34;85;31;36;67
89;09.10.2016;2016;10;19;Sunnuntai;49;31;80;18;29;47
89;09.10.2016;2016;10;20;Sunnuntai;34;27;61;17;12;29
89;09.10.2016;2016;10;21;Sunnuntai;28;13;41;11;6;17
89;09.10.2016;2016;10;22;Sunnuntai;13;8;21;6;2;8
89;09.10.2016;2016;10;23;Sunnuntai;6;6;12;1;0;1
89;10.10.2016;2016;10;00;Maanantai;7;1;8;0;0;0
89;10.10.2016;2016;10;01;Maanantai;0;0;0;0;2;2
89;10.10.2016;2016;10;02;Maanantai;5;1;6;0;0;0
89;10.10.2016;2016;10;03;Maanantai;1;2;3;0;0;0
89;10.10.2016;2016;10;04;Maanantai;0;1;1;0;0;0
89;10.10.2016;2016;10;05;Maanantai;4;9;13;1;1;2
89;10.10.2016;2016;10;06;Maanantai;11;47;58;2;5;7
89;10.10.2016;2016;10;07;Maanantai;38;148;186;4;13;17
89;10.10.2016;2016;10;08;Maanantai;43;266;309;7;30;37
89;10.10.2016;2016;10;09;Maanantai;36;155;191;14;45;59
89;10.10.2016;2016;10;10;Maanantai;61;84;145;13;30;43
89;10.10.2016;2016;10;11;Maanantai;84;82;166;36;27;63
89;10.10.2016;2016;10;12;Maanantai;68;92;160;19;32;51
89;10.10.2016;2016;10;13;Maanantai;102;71;173;28;27;55
89;10.10.2016;2016;10;14;Maanantai;124;88;212;18;21;39
89;10.10.2016;2016;10;15;Maanantai;187;75;262;31;21;52
89;10.10.2016;2016;10;16;Maanantai;244;127;371;35;28;63
89;10.10.2016;2016;10;17;Maanantai;136;69;205;43;30;73
89;10.10.2016;2016;10;18;Maanantai;98;61;159;37;39;76
89;10.10.2016;2016;10;19;Maanantai;73;39;112;50;40;90
89;10.10.2016;2016;10;20;Maanantai;46;28;74;28;17;45
89;10.10.2016;2016;10;21;Maanantai;45;30;75;14;14;28
89;10.10.2016;2016;10;22;Maanantai;18;9;27;5;6;11
89;10.10.2016;2016;10;23;Maanantai;16;5;21;0;2;2
89;11.10.2016;2016;10;00;Tiistai;4;1;5;0;1;1
89;11.10.2016;2016;10;01;Tiistai;2;2;4;1;2;3
89;11.10.2016;2016;10;02;Tiistai;6;2;8;0;0;0
89;11.10.2016;2016;10;03;Tiistai;6;0;6;1;1;2
89;11.10.2016;2016;10;04;Tiistai;1;3;4;0;0;0
89;11.10.2016;2016;10;05;Tiistai;3;10;13;0;1;1
89;11.10.2016;2016;10;06;Tiistai;15;51;66;2;4;6
89;11.10.2016;2016;10;07;Tiistai;47;147;194;1;16;17
89;11.10.2016;2016;10;08;Tiistai;51;275;326;16;38;54
89;11.10.2016;2016;10;09;Tiistai;38;132;170;18;24;42
89;11.10.2016;2016;10;10;Tiistai;60;95;155;16;33;49
89;11.10.2016;2016;10;11;Tiistai;64;84;148;25;30;55
89;11.10.2016;2016;10;12;Tiistai;75;105;180;21;24;45
89;11.10.2016;2016;10;13;Tiistai;76;76;152;35;16;51
89;11.10.2016;2016;10;14;Tiistai;136;83;219;21;20;41
89;11.10.2016;2016;10;15;Tiistai;204;69;273;33;20;53
89;11.10.2016;2016;10;16;Tiistai;242;106;348;31;22;53
89;11.10.2016;2016;10;17;Tiistai;134;81;215;36;36;72
89;11.10.2016;2016;10;18;Tiistai;103;71;174;40;48;88
89;11.10.2016;2016;10;19;Tiistai;73;46;119;42;36;78
89;11.10.2016;2016;10;20;Tiistai;53;30;83;22;25;47
89;11.10.2016;2016;10;21;Tiistai;54;19;73;15;10;25
89;11.10.2016;2016;10;22;Tiistai;24;3;27;7;3;10
89;11.10.2016;2016;10;23;Tiistai;8;5;13;4;4;8
89;12.10.2016;2016;10;00;Keskiviikko;4;2;6;0;0;0
89;12.10.2016;2016;10;01;Keskiviikko;5;3;8;0;0;0
89;12.10.2016;2016;10;02;Keskiviikko;5;2;7;0;0;0
89;12.10.2016;2016;10;03;Keskiviikko;2;4;6;0;1;1
89;12.10.2016;2016;10;04;Keskiviikko;4;1;5;0;0;0
89;12.10.2016;2016;10;05;Keskiviikko;6;12;18;0;1;1
89;12.10.2016;2016;10;06;Keskiviikko;16;82;98;2;6;8
89;12.10.2016;2016;10;07;Keskiviikko;49;215;264;9;25;34
89;12.10.2016;2016;10;08;Keskiviikko;50;215;265;10;77;87
89;12.10.2016;2016;10;09;Keskiviikko;53;126;179;23;35;58
89;12.10.2016;2016;10;10;Keskiviikko;49;116;165;15;32;47
89;12.10.2016;2016;10;11;Keskiviikko;66;92;158;25;31;56
89;12.10.2016;2016;10;12;Keskiviikko;83;101;184;49;34;83
89;12.10.2016;2016;10;13;Keskiviikko;109;79;188;21;20;41
89;12.10.2016;2016;10;14;Keskiviikko;151;106;257;19;24;43
89;12.10.2016;2016;10;15;Keskiviikko;197;102;299;29;31;60
89;12.10.2016;2016;10;16;Keskiviikko;194;101;295;32;20;52
89;12.10.2016;2016;10;17;Keskiviikko;134;91;225;22;24;46
89;12.10.2016;2016;10;18;Keskiviikko;100;70;170;48;32;80
89;12.10.2016;2016;10;19;Keskiviikko;97;53;150;26;24;50
89;12.10.2016;2016;10;20;Keskiviikko;73;31;104;20;15;35
89;12.10.2016;2016;10;21;Keskiviikko;35;22;57;13;6;19
89;12.10.2016;2016;10;22;Keskiviikko;15;16;31;4;5;9
89;12.10.2016;2016;10;23;Keskiviikko;12;11;23;3;6;9
89;13.10.2016;2016;10;00;Torstai;9;2;11;2;3;5
89;13.10.2016;2016;10;01;Torstai;3;0;3;1;1;2
89;13.10.2016;2016;10;02;Torstai;1;3;4;1;0;1
89;13.10.2016;2016;10;03;Torstai;7;1;8;0;0;0
89;13.10.2016;2016;10;04;Torstai;1;2;3;0;2;2
89;13.10.2016;2016;10;05;Torstai;1;10;11;3;0;3
89;13.10.2016;2016;10;06;Torstai;18;45;63;4;5;9
89;13.10.2016;2016;10;07;Torstai;34;154;188;8;22;30
89;13.10.2016;2016;10;08;Torstai;60;280;340;11;31;42
89;13.10.2016;2016;10;09;Torstai;58;126;184;13;42;55
89;13.10.2016;2016;10;10;Torstai;45;118;163;12;30;42
89;13.10.2016;2016;10;11;Torstai;57;99;156;23;28;51
89;13.10.2016;2016;10;12;Torstai;76;108;184;25;35;60
89;13.10.2016;2016;10;13;Torstai;117;77;194;21;16;37
89;13.10.2016;2016;10;14;Torstai;111;80;191;26;29;55
89;13.10.2016;2016;10;15;Torstai;169;104;273;21;23;44
89;13.10.2016;2016;10;16;Torstai;236;131;367;36;21;57
89;13.10.2016;2016;10;17;Torstai;130;105;235;40;44;84
89;13.10.2016;2016;10;18;Torstai;107;107;214;35;39;74
89;13.10.2016;2016;10;19;Torstai;95;35;130;38;37;75
89;13.10.2016;2016;10;20;Torstai;83;18;101;25;16;41
89;13.10.2016;2016;10;21;Torstai;60;13;73;15;6;21
89;13.10.2016;2016;10;22;Torstai;24;18;42;4;4;8
89;13.10.2016;2016;10;23;Torstai;22;7;29;3;4;7
89;14.10.2016;2016;10;00;Perjantai;5;7;12;1;1;2
89;14.10.2016;2016;10;01;Perjantai;10;3;13;4;0;4
89;14.10.2016;2016;10;02;Perjantai;2;3;5;1;0;1
89;14.10.2016;2016;10;03;Perjantai;5;1;6;1;0;1
89;14.10.2016;2016;10;04;Perjantai;4;4;8;2;0;2
89;14.10.2016;2016;10;05;Perjantai;3;15;18;1;0;1
89;14.10.2016;2016;10;06;Perjantai;13;47;60;4;4;8
89;14.10.2016;2016;10;07;Perjantai;36;133;169;2;17;19
89;14.10.2016;2016;10;08;Perjantai;36;226;262;16;25;41
89;14.10.2016;2016;10;09;Perjantai;43;125;168;11;56;67
89;14.10.2016;2016;10;10;Perjantai;52;83;135;30;38;68
89;14.10.2016;2016;10;11;Perjantai;54;85;139;23;22;45
89;14.10.2016;2016;10;12;Perjantai;83;117;200;23;27;50
89;14.10.2016;2016;10;13;Perjantai;100;101;201;30;31;61
89;14.10.2016;2016;10;14;Perjantai;142;116;258;26;26;52
89;14.10.2016;2016;10;15;Perjantai;167;97;264;27;31;58
89;14.10.2016;2016;10;16;Perjantai;166;107;273;32;20;52
89;14.10.2016;2016;10;17;Perjantai;129;95;224;27;18;45
89;14.10.2016;2016;10;18;Perjantai;84;62;146;34;35;69
89;14.10.2016;2016;10;19;Perjantai;60;57;117;21;24;45
89;14.10.2016;2016;10;20;Perjantai;69;37;106;9;12;21
89;14.10.2016;2016;10;21;Perjantai;43;27;70;11;8;19
89;14.10.2016;2016;10;22;Perjantai;36;26;62;4;7;11
89;14.10.2016;2016;10;23;Perjantai;23;21;44;5;7;12
89;15.10.2016;2016;10;00;Lauantai;16;10;26;1;2;3
89;15.10.2016;2016;10;01;Lauantai;7;8;15;6;6;12
89;15.10.2016;2016;10;02;Lauantai;13;9;22;8;1;9
89;15.10.2016;2016;10;03;Lauantai;11;1;12;10;0;10
89;15.10.2016;2016;10;04;Lauantai;11;2;13;5;0;5
89;15.10.2016;2016;10;05;Lauantai;5;7;12;3;2;5
89;15.10.2016;2016;10;06;Lauantai;3;12;15;1;1;2
89;15.10.2016;2016;10;07;Lauantai;8;12;20;5;2;7
89;15.10.2016;2016;10;08;Lauantai;1;29;30;7;12;19
89;15.10.2016;2016;10;09;Lauantai;14;72;86;6;24;30
89;15.10.2016;2016;10;10;Lauantai;21;51;72;19;39;58
89;15.10.2016;2016;10;11;Lauantai;52;76;128;30;47;77
89;15.10.2016;2016;10;12;Lauantai;48;94;142;27;43;70
89;15.10.2016;2016;10;13;Lauantai;74;86;160;23;39;62
89;15.10.2016;2016;10;14;Lauantai;71;75;146;29;35;64
89;15.10.2016;2016;10;15;Lauantai;89;70;159;33;44;77
89;15.10.2016;2016;10;16;Lauantai;63;54;117;33;38;71
89;15.10.2016;2016;10;17;Lauantai;83;47;130;25;38;63
89;15.10.2016;2016;10;18;Lauantai;66;37;103;34;32;66
89;15.10.2016;2016;10;19;Lauantai;36;34;70;21;24;45
89;15.10.2016;2016;10;20;Lauantai;33;21;54;11;13;24
89;15.10.2016;2016;10;21;Lauantai;29;18;47;8;9;17
89;15.10.2016;2016;10;22;Lauantai;22;25;47;9;4;13
89;15.10.2016;2016;10;23;Lauantai;10;23;33;5;6;11
89;16.10.2016;2016;10;00;Sunnuntai;18;26;44;5;4;9
89;16.10.2016;2016;10;01;Sunnuntai;14;10;24;6;5;11
89;16.10.2016;2016;10;02;Sunnuntai;17;3;20;4;3;7
89;16.10.2016;2016;10;03;Sunnuntai;14;2;16;5;0;5
89;16.10.2016;2016;10;04;Sunnuntai;16;1;17;8;0;8
89;16.10.2016;2016;10;05;Sunnuntai;8;4;12;0;0;0
89;16.10.2016;2016;10;06;Sunnuntai;3;5;8;3;1;4
89;16.10.2016;2016;10;07;Sunnuntai;4;7;11;4;2;6
89;16.10.2016;2016;10;08;Sunnuntai;3;11;14;6;7;13
89;16.10.2016;2016;10;09;Sunnuntai;8;18;26;9;16;25
89;16.10.2016;2016;10;10;Sunnuntai;6;34;40;14;33;47
89;16.10.2016;2016;10;11;Sunnuntai;21;46;67;31;40;71
89;16.10.2016;2016;10;12;Sunnuntai;44;62;106;37;40;77
89;16.10.2016;2016;10;13;Sunnuntai;38;65;103;34;41;75
89;16.10.2016;2016;10;14;Sunnuntai;61;62;123;32;42;74
89;16.10.2016;2016;10;15;Sunnuntai;59;59;118;41;52;93
89;16.10.2016;2016;10;16;Sunnuntai;64;50;114;39;35;74
89;16.10.2016;2016;10;17;Sunnuntai;54;62;116;30;27;57
89;16.10.2016;2016;10;18;Sunnuntai;57;28;85;32;26;58
89;16.10.2016;2016;10;19;Sunnuntai;43;13;56;27;22;49
89;16.10.2016;2016;10;20;Sunnuntai;32;16;48;25;16;41
89;16.10.2016;2016;10;21;Sunnuntai;22;15;37;10;12;22
89;16.10.2016;2016;10;22;Sunnuntai;13;5;18;3;3;6
89;16.10.2016;2016;10;23;Sunnuntai;6;2;8;3;3;6
89;17.10.2016;2016;10;00;Maanantai;4;2;6;2;2;4
89;17.10.2016;2016;10;01;Maanantai;0;0;0;0;1;1
89;17.10.2016;2016;10;02;Maanantai;2;1;3;2;2;4
89;17.10.2016;2016;10;03;Maanantai;3;0;3;0;1;1
89;17.10.2016;2016;10;04;Maanantai;4;2;6;0;0;0
89;17.10.2016;2016;10;05;Maanantai;2;9;11;0;2;2
89;17.10.2016;2016;10;06;Maanantai;12;36;48;3;5;8
89;17.10.2016;2016;10;07;Maanantai;33;129;162;5;16;21
89;17.10.2016;2016;10;08;Maanantai;36;251;287;6;31;37
89;17.10.2016;2016;10;09;Maanantai;45;135;180;14;30;44
89;17.10.2016;2016;10;10;Maanantai;46;82;128;26;30;56
89;17.10.2016;2016;10;11;Maanantai;64;69;133;28;35;63
89;17.10.2016;2016;10;12;Maanantai;91;101;192;17;25;42
89;17.10.2016;2016;10;13;Maanantai;70;63;133;23;32;55
89;17.10.2016;2016;10;14;Maanantai;111;78;189;25;24;49
89;17.10.2016;2016;10;15;Maanantai;164;78;242;33;16;49
89;17.10.2016;2016;10;16;Maanantai;243;120;363;36;19;55
89;17.10.2016;2016;10;17;Maanantai;106;71;177;32;25;57
89;17.10.2016;2016;10;18;Maanantai;101;43;144;42;33;75
89;17.10.2016;2016;10;19;Maanantai;68;39;107;29;47;76
89;17.10.2016;2016;10;20;Maanantai;50;30;80;29;26;55
89;17.10.2016;2016;10;21;Maanantai;49;19;68;22;13;35
89;17.10.2016;2016;10;22;Maanantai;17;12;29;6;7;13
89;17.10.2016;2016;10;23;Maanantai;10;10;20;1;2;3
89;18.10.2016;2016;10;00;Tiistai;6;4;10;1;3;4
89;18.10.2016;2016;10;01;Tiistai;0;0;0;2;1;3
89;18.10.2016;2016;10;02;Tiistai;5;0;5;0;0;0
89;18.10.2016;2016;10;03;Tiistai;3;0;3;1;0;1
89;18.10.2016;2016;10;04;Tiistai;1;3;4;1;0;1
89;18.10.2016;2016;10;05;Tiistai;1;11;12;0;1;1
89;18.10.2016;2016;10;06;Tiistai;10;43;53;0;5;5
89;18.10.2016;2016;10;07;Tiistai;28;142;170;2;12;14
89;18.10.2016;2016;10;08;Tiistai;54;267;321;12;39;51
89;18.10.2016;2016;10;09;Tiistai;36;162;198;14;28;42
89;18.10.2016;2016;10;10;Tiistai;69;101;170;19;27;46
89;18.10.2016;2016;10;11;Tiistai;73;76;149;18;19;37
89;18.10.2016;2016;10;12;Tiistai;78;86;164;23;23;46
89;18.10.2016;2016;10;13;Tiistai;93;72;165;25;29;54
89;18.10.2016;2016;10;14;Tiistai;113;85;198;33;26;59
89;18.10.2016;2016;10;15;Tiistai;182;87;269;34;36;70
89;18.10.2016;2016;10;16;Tiistai;235;126;361;44;26;70
89;18.10.2016;2016;10;17;Tiistai;138;115;253;32;18;50
89;18.10.2016;2016;10;18;Tiistai;108;67;175;60;66;126
89;18.10.2016;2016;10;19;Tiistai;83;39;122;41;29;70
89;18.10.2016;2016;10;20;Tiistai;57;27;84;22;24;46
89;18.10.2016;2016;10;21;Tiistai;39;19;58;15;12;27
89;18.10.2016;2016;10;22;Tiistai;25;4;29;2;3;5
89;18.10.2016;2016;10;23;Tiistai;8;1;9;1;5;6
89;19.10.2016;2016;10;00;Keskiviikko;7;6;13;1;1;2
89;19.10.2016;2016;10;01;Keskiviikko;2;4;6;0;1;1
89;19.10.2016;2016;10;02;Keskiviikko;3;1;4;0;0;0
89;19.10.2016;2016;10;03;Keskiviikko;0;1;1;0;0;0
89;19.10.2016;2016;10;04;Keskiviikko;0;4;4;0;0;0
89;19.10.2016;2016;10;05;Keskiviikko;5;7;12;0;1;1
89;19.10.2016;2016;10;06;Keskiviikko;18;60;78;3;10;13
89;19.10.2016;2016;10;07;Keskiviikko;25;192;217;2;30;32
89;19.10.2016;2016;10;08;Keskiviikko;54;223;277;12;43;55
89;19.10.2016;2016;10;09;Keskiviikko;48;114;162;17;38;55
89;19.10.2016;2016;10;10;Keskiviikko;43;78;121;24;27;51
89;19.10.2016;2016;10;11;Keskiviikko;70;85;155;19;31;50
89;19.10.2016;2016;10;12;Keskiviikko;69;109;178;24;32;56
89;19.10.2016;2016;10;13;Keskiviikko;105;67;172;26;20;46
89;19.10.2016;2016;10;14;Keskiviikko;134;86;220;21;26;47
89;19.10.2016;2016;10;15;Keskiviikko;162;93;255;24;21;45
89;19.10.2016;2016;10;16;Keskiviikko;223;103;326;29;35;64
89;19.10.2016;2016;10;17;Keskiviikko;127;84;211;34;31;65
89;19.10.2016;2016;10;18;Keskiviikko;95;61;156;34;39;73
89;19.10.2016;2016;10;19;Keskiviikko;90;45;135;28;34;62
89;19.10.2016;2016;10;20;Keskiviikko;53;33;86;19;23;42
89;19.10.2016;2016;10;21;Keskiviikko;43;16;59;15;4;19
89;19.10.2016;2016;10;22;Keskiviikko;15;8;23;2;7;9
89;19.10.2016;2016;10;23;Keskiviikko;15;4;19;2;1;3
89;20.10.2016;2016;10;00;Torstai;4;2;6;4;0;4
89;20.10.2016;2016;10;01;Torstai;0;2;2;0;0;0
89;20.10.2016;2016;10;02;Torstai;4;0;4;1;1;2
89;20.10.2016;2016;10;03;Torstai;3;1;4;3;0;3
89;20.10.2016;2016;10;04;Torstai;2;3;5;0;1;1
89;20.10.2016;2016;10;05;Torstai;2;11;13;2;0;2
89;20.10.2016;2016;10;06;Torstai;21;50;71;2;12;14
89;20.10.2016;2016;10;07;Torstai;32;180;212;5;21;26
89;20.10.2016;2016;10;08;Torstai;42;219;261;10;25;35
89;20.10.2016;2016;10;09;Torstai;46;107;153;22;28;50
89;20.10.2016;2016;10;10;Torstai;43;80;123;21;31;52
89;20.10.2016;2016;10;11;Torstai;80;96;176;26;42;68
89;20.10.2016;2016;10;12;Torstai;70;89;159;36;39;75
89;20.10.2016;2016;10;13;Torstai;99;73;172;22;25;47
89;20.10.2016;2016;10;14;Torstai;126;91;217;34;19;53
89;20.10.2016;2016;10;15;Torstai;183;101;284;30;33;63
89;20.10.2016;2016;10;16;Torstai;208;122;330;39;26;65
89;20.10.2016;2016;10;17;Torstai;107;96;203;27;31;58
89;20.10.2016;2016;10;18;Torstai;77;79;156;35;38;73
89;20.10.2016;2016;10;19;Torstai;85;37;122;34;33;67
89;20.10.2016;2016;10;20;Torstai;55;41;96;19;18;37
89;20.10.2016;2016;10;21;Torstai;46;18;64;16;11;27
89;20.10.2016;2016;10;22;Torstai;30;23;53;7;9;16
89;20.10.2016;2016;10;23;Torstai;15;10;25;2;3;5
89;21.10.2016;2016;10;00;Perjantai;7;5;12;3;2;5
89;21.10.2016;2016;10;01;Perjantai;11;6;17;1;0;1
89;21.10.2016;2016;10;02;Perjantai;11;9;20;2;0;2
89;21.10.2016;2016;10;03;Perjantai;12;0;12;4;0;4
89;21.10.2016;2016;10;04;Perjantai;3;3;6;2;3;5
89;21.10.2016;2016;10;05;Perjantai;2;11;13;0;1;1
89;21.10.2016;2016;10;06;Perjantai;8;56;64;0;9;9
89;21.10.2016;2016;10;07;Perjantai;26;148;174;8;26;34
89;21.10.2016;2016;10;08;Perjantai;27;162;189;9;25;34
89;21.10.2016;2016;10;09;Perjantai;36;110;146;8;33;41
89;21.10.2016;2016;10;10;Perjantai;34;88;122;19;23;42
89;21.10.2016;2016;10;11;Perjantai;76;82;158;20;36;56
89;21.10.2016;2016;10;12;Perjantai;90;92;182;30;31;61
89;21.10.2016;2016;10;13;Perjantai;115;93;208;32;35;67
89;21.10.2016;2016;10;14;Perjantai;161;87;248;37;39;76
89;21.10.2016;2016;10;15;Perjantai;167;84;251;23;37;60
89;21.10.2016;2016;10;16;Perjantai;155;77;232;23;39;62
89;21.10.2016;2016;10;17;Perjantai;81;58;139;47;56;103
89;21.10.2016;2016;10;18;Perjantai;74;57;131;39;42;81
89;21.10.2016;2016;10;19;Perjantai;57;45;102;21;38;59
89;21.10.2016;2016;10;20;Perjantai;56;30;86;17;17;34
89;21.10.2016;2016;10;21;Perjantai;30;28;58;13;10;23
89;21.10.2016;2016;10;22;Perjantai;27;21;48;8;16;24
89;21.10.2016;2016;10;23;Perjantai;19;11;30;9;18;27
89;22.10.2016;2016;10;00;Lauantai;14;21;35;6;3;9
89;22.10.2016;2016;10;01;Lauantai;7;7;14;0;2;2
89;22.10.2016;2016;10;02;Lauantai;10;4;14;6;3;9
89;22.10.2016;2016;10;03;Lauantai;13;5;18;3;4;7
89;22.10.2016;2016;10;04;Lauantai;16;2;18;2;2;4
89;22.10.2016;2016;10;05;Lauantai;3;5;8;0;7;7
89;22.10.2016;2016;10;06;Lauantai;4;14;18;2;2;4
89;22.10.2016;2016;10;07;Lauantai;8;12;20;7;5;12
89;22.10.2016;2016;10;08;Lauantai;6;27;33;6;12;18
89;22.10.2016;2016;10;09;Lauantai;17;46;63;9;21;30
89;22.10.2016;2016;10;10;Lauantai;31;57;88;30;44;74
89;22.10.2016;2016;10;11;Lauantai;39;77;116;21;39;60
89;22.10.2016;2016;10;12;Lauantai;40;75;115;10;51;61
89;22.10.2016;2016;10;13;Lauantai;58;73;131;34;51;85
89;22.10.2016;2016;10;14;Lauantai;68;87;155;27;38;65
89;22.10.2016;2016;10;15;Lauantai;91;50;141;36;32;68
89;22.10.2016;2016;10;16;Lauantai;62;62;124;36;50;86
89;22.10.2016;2016;10;17;Lauantai;55;59;114;36;38;74
89;22.10.2016;2016;10;18;Lauantai;48;41;89;17;37;54
89;22.10.2016;2016;10;19;Lauantai;44;29;73;15;22;37
89;22.10.2016;2016;10;20;Lauantai;33;25;58;13;17;30
89;22.10.2016;2016;10;21;Lauantai;29;33;62;9;12;21
89;22.10.2016;2016;10;22;Lauantai;11;21;32;7;7;14
89;22.10.2016;2016;10;23;Lauantai;20;21;41;4;5;9
89;23.10.2016;2016;10;00;Sunnuntai;14;12;26;2;3;5
89;23.10.2016;2016;10;01;Sunnuntai;12;8;20;7;1;8
89;23.10.2016;2016;10;02;Sunnuntai;20;8;28;5;0;5
89;23.10.2016;2016;10;03;Sunnuntai;15;2;17;1;0;1
89;23.10.2016;2016;10;04;Sunnuntai;17;3;20;7;0;7
89;23.10.2016;2016;10;05;Sunnuntai;1;4;5;5;1;6
89;23.10.2016;2016;10;06;Sunnuntai;2;8;10;4;1;5
89;23.10.2016;2016;10;07;Sunnuntai;5;6;11;4;4;8
89;23.10.2016;2016;10;08;Sunnuntai;4;4;8;4;4;8
89;23.10.2016;2016;10;09;Sunnuntai;15;21;36;15;23;38
89;23.10.2016;2016;10;10;Sunnuntai;9;35;44;37;41;78
89;23.10.2016;2016;10;11;Sunnuntai;28;35;63;24;60;84
89;23.10.2016;2016;10;12;Sunnuntai;42;57;99;35;51;86
89;23.10.2016;2016;10;13;Sunnuntai;52;56;108;37;47;84
89;23.10.2016;2016;10;14;Sunnuntai;54;47;101;35;37;72
89;23.10.2016;2016;10;15;Sunnuntai;61;50;111;37;39;76
89;23.10.2016;2016;10;16;Sunnuntai;60;43;103;27;26;53
89;23.10.2016;2016;10;17;Sunnuntai;45;50;95;44;40;84
89;23.10.2016;2016;10;18;Sunnuntai;40;26;66;23;29;52
89;23.10.2016;2016;10;19;Sunnuntai;27;18;45;25;19;44
89;23.10.2016;2016;10;20;Sunnuntai;21;22;43;16;13;29
89;23.10.2016;2016;10;21;Sunnuntai;18;16;34;14;11;25
89;23.10.2016;2016;10;22;Sunnuntai;8;9;17;5;4;9
89;23.10.2016;2016;10;23;Sunnuntai;14;8;22;3;13;16
89;24.10.2016;2016;10;00;Maanantai;5;1;6;1;2;3
89;24.10.2016;2016;10;01;Maanantai;3;3;6;1;5;6
89;24.10.2016;2016;10;02;Maanantai;3;4;7;1;0;1
89;24.10.2016;2016;10;03;Maanantai;1;1;2;2;1;3
89;24.10.2016;2016;10;04;Maanantai;4;4;8;1;1;2
89;24.10.2016;2016;10;05;Maanantai;4;11;15;0;2;2
89;24.10.2016;2016;10;06;Maanantai;9;50;59;1;4;5
89;24.10.2016;2016;10;07;Maanantai;27;128;155;13;10;23
89;24.10.2016;2016;10;08;Maanantai;18;138;156;2;17;19
89;24.10.2016;2016;10;09;Maanantai;33;82;115;8;28;36
89;24.10.2016;2016;10;10;Maanantai;50;53;103;16;28;44
89;24.10.2016;2016;10;11;Maanantai;55;68;123;19;26;45
89;24.10.2016;2016;10;12;Maanantai;57;82;139;28;47;75
89;24.10.2016;2016;10;13;Maanantai;51;67;118;31;34;65
89;24.10.2016;2016;10;14;Maanantai;96;58;154;28;23;51
89;24.10.2016;2016;10;15;Maanantai;145;67;212;25;28;53
89;24.10.2016;2016;10;16;Maanantai;167;61;228;39;34;73
89;24.10.2016;2016;10;17;Maanantai;86;59;145;29;36;65
89;24.10.2016;2016;10;18;Maanantai;65;39;104;42;48;90
89;24.10.2016;2016;10;19;Maanantai;48;43;91;41;49;90
89;24.10.2016;2016;10;20;Maanantai;50;19;69;20;14;34
89;24.10.2016;2016;10;21;Maanantai;19;25;44;9;10;19
89;24.10.2016;2016;10;22;Maanantai;16;6;22;4;5;9
89;24.10.2016;2016;10;23;Maanantai;8;2;10;4;2;6
89;25.10.2016;2016;10;00;Tiistai;3;3;6;0;3;3
89;25.10.2016;2016;10;01;Tiistai;6;0;6;1;0;1
89;25.10.2016;2016;10;02;Tiistai;2;7;9;0;0;0
89;25.10.2016;2016;10;03;Tiistai;1;4;5;0;0;0
89;25.10.2016;2016;10;04;Tiistai;0;4;4;1;1;2
89;25.10.2016;2016;10;05;Tiistai;4;8;12;0;0;0
89;25.10.2016;2016;10;06;Tiistai;19;56;75;2;13;15
89;25.10.2016;2016;10;07;Tiistai;31;120;151;3;16;19
89;25.10.2016;2016;10;08;Tiistai;23;143;166;3;20;23
89;25.10.2016;2016;10;09;Tiistai;42;67;109;21;29;50
89;25.10.2016;2016;10;10;Tiistai;32;47;79;20;38;58
89;25.10.2016;2016;10;11;Tiistai;45;79;124;23;39;62
89;25.10.2016;2016;10;12;Tiistai;55;58;113;20;36;56
89;25.10.2016;2016;10;13;Tiistai;58;66;124;25;23;48
89;25.10.2016;2016;10;14;Tiistai;70;50;120;29;30;59
89;25.10.2016;2016;10;15;Tiistai;132;85;217;27;25;52
89;25.10.2016;2016;10;16;Tiistai;154;82;236;29;14;43
89;25.10.2016;2016;10;17;Tiistai;102;50;152;37;30;67
89;25.10.2016;2016;10;18;Tiistai;60;44;104;35;28;63
89;25.10.2016;2016;10;19;Tiistai;51;31;82;29;38;67
89;25.10.2016;2016;10;20;Tiistai;45;32;77;31;17;48
89;25.10.2016;2016;10;21;Tiistai;31;17;48;39;25;64
89;25.10.2016;2016;10;22;Tiistai;23;9;32;7;3;10
89;25.10.2016;2016;10;23;Tiistai;10;12;22;6;5;11
89;26.10.2016;2016;10;00;Keskiviikko;11;5;16;3;4;7
89;26.10.2016;2016;10;01;Keskiviikko;6;3;9;2;0;2
89;26.10.2016;2016;10;02;Keskiviikko;3;2;5;0;1;1
89;26.10.2016;2016;10;03;Keskiviikko;5;0;5;1;0;1
89;26.10.2016;2016;10;04;Keskiviikko;1;4;5;2;2;4
89;26.10.2016;2016;10;05;Keskiviikko;6;5;11;0;0;0
89;26.10.2016;2016;10;06;Keskiviikko;18;53;71;2;6;8
89;26.10.2016;2016;10;07;Keskiviikko;19;112;131;6;19;25
89;26.10.2016;2016;10;08;Keskiviikko;21;142;163;4;19;23
89;26.10.2016;2016;10;09;Keskiviikko;34;67;101;11;37;48
89;26.10.2016;2016;10;10;Keskiviikko;20;42;62;15;37;52
89;26.10.2016;2016;10;11;Keskiviikko;34;65;99;24;34;58
89;26.10.2016;2016;10;12;Keskiviikko;44;74;118;46;36;82
89;26.10.2016;2016;10;13;Keskiviikko;45;78;123;36;53;89
89;26.10.2016;2016;10;14;Keskiviikko;67;58;125;34;47;81
89;26.10.2016;2016;10;15;Keskiviikko;119;56;175;36;39;75
89;26.10.2016;2016;10;16;Keskiviikko;134;59;193;40;28;68
89;26.10.2016;2016;10;17;Keskiviikko;86;69;155;62;74;136
89;26.10.2016;2016;10;18;Keskiviikko;65;44;109;34;43;77
89;26.10.2016;2016;10;19;Keskiviikko;44;33;77;53;37;90
89;26.10.2016;2016;10;20;Keskiviikko;45;31;76;32;21;53
89;26.10.2016;2016;10;21;Keskiviikko;37;15;52;22;20;42
89;26.10.2016;2016;10;22;Keskiviikko;20;16;36;14;18;32
89;26.10.2016;2016;10;23;Keskiviikko;7;8;15;6;9;15
89;27.10.2016;2016;10;00;Torstai;2;2;4;6;0;6
89;27.10.2016;2016;10;01;Torstai;1;1;2;0;0;0
89;27.10.2016;2016;10;02;Torstai;0;0;0;0;0;0
89;27.10.2016;2016;10;03;Torstai;3;3;6;3;0;3
89;27.10.2016;2016;10;04;Torstai;0;5;5;1;1;2
89;27.10.2016;2016;10;05;Torstai;6;7;13;1;0;1
89;27.10.2016;2016;10;06;Torstai;12;40;52;1;6;7
89;27.10.2016;2016;10;07;Torstai;18;89;107;5;17;22
89;27.10.2016;2016;10;08;Torstai;18;94;112;4;22;26
89;27.10.2016;2016;10;09;Torstai;27;53;80;18;31;49
89;27.10.2016;2016;10;10;Torstai;21;42;63;22;30;52
89;27.10.2016;2016;10;11;Torstai;39;44;83;23;35;58
89;27.10.2016;2016;10;12;Torstai;49;62;111;38;45;83
89;27.10.2016;2016;10;13;Torstai;54;58;112;31;39;70
89;27.10.2016;2016;10;14;Torstai;58;50;108;38;36;74
89;27.10.2016;2016;10;15;Torstai;102;76;178;38;31;69
89;27.10.2016;2016;10;16;Torstai;112;56;168;64;58;122
89;27.10.2016;2016;10;17;Torstai;78;55;133;35;47;82
89;27.10.2016;2016;10;18;Torstai;55;35;90;28;30;58
89;27.10.2016;2016;10;19;Torstai;48;28;76;24;25;49
89;27.10.2016;2016;10;20;Torstai;46;31;77;24;5;29
89;27.10.2016;2016;10;21;Torstai;28;17;45;13;9;22
89;27.10.2016;2016;10;22;Torstai;16;11;27;7;5;12
89;27.10.2016;2016;10;23;Torstai;8;6;14;3;6;9
89;28.10.2016;2016;10;00;Perjantai;10;6;16;2;0;2
89;28.10.2016;2016;10;01;Perjantai;1;4;5;2;1;3
89;28.10.2016;2016;10;02;Perjantai;7;3;10;2;0;2
89;28.10.2016;2016;10;03;Perjantai;3;0;3;0;0;0
89;28.10.2016;2016;10;04;Perjantai;2;3;5;0;2;2
89;28.10.2016;2016;10;05;Perjantai;8;6;14;1;1;2
89;28.10.2016;2016;10;06;Perjantai;10;41;51;1;11;12
89;28.10.2016;2016;10;07;Perjantai;15;49;64;2;9;11
89;28.10.2016;2016;10;08;Perjantai;19;72;91;10;17;27
89;28.10.2016;2016;10;09;Perjantai;20;45;65;13;22;35
89;28.10.2016;2016;10;10;Perjantai;20;45;65;10;27;37
89;28.10.2016;2016;10;11;Perjantai;33;63;96;16;25;41
89;28.10.2016;2016;10;12;Perjantai;55;76;131;29;45;74
89;28.10.2016;2016;10;13;Perjantai;74;51;125;29;35;64
89;28.10.2016;2016;10;14;Perjantai;79;80;159;26;35;61
89;28.10.2016;2016;10;15;Perjantai;109;59;168;39;32;71
89;28.10.2016;2016;10;16;Perjantai;97;56;153;33;35;68
89;28.10.2016;2016;10;17;Perjantai;75;50;125;22;36;58
89;28.10.2016;2016;10;18;Perjantai;54;45;99;29;32;61
89;28.10.2016;2016;10;19;Perjantai;51;25;76;21;30;51
89;28.10.2016;2016;10;20;Perjantai;28;25;53;23;28;51
89;28.10.2016;2016;10;21;Perjantai;33;21;54;25;18;43
89;28.10.2016;2016;10;22;Perjantai;24;26;50;14;11;25
89;28.10.2016;2016;10;23;Perjantai;18;20;38;4;9;13
89;29.10.2016;2016;10;00;Lauantai;14;18;32;9;5;14
89;29.10.2016;2016;10;01;Lauantai;8;10;18;3;1;4
89;29.10.2016;2016;10;02;Lauantai;10;3;13;4;1;5
89;29.10.2016;2016;10;03;Lauantai;19;2;21;6;0;6
89;29.10.2016;2016;10;04;Lauantai;18;2;20;4;0;4
89;29.10.2016;2016;10;05;Lauantai;1;4;5;0;0;0
89;29.10.2016;2016;10;06;Lauantai;6;8;14;0;4;4
89;29.10.2016;2016;10;07;Lauantai;1;14;15;4;6;10
89;29.10.2016;2016;10;08;Lauantai;6;27;33;5;9;14
89;29.10.2016;2016;10;09;Lauantai;19;29;48;12;19;31
89;29.10.2016;2016;10;10;Lauantai;30;64;94;23;28;51
89;29.10.2016;2016;10;11;Lauantai;46;74;120;29;54;83
89;29.10.2016;2016;10;12;Lauantai;33;78;111;39;30;69
89;29.10.2016;2016;10;13;Lauantai;64;64;128;40;45;85
89;29.10.2016;2016;10;14;Lauantai;68;52;120;39;45;84
89;29.10.2016;2016;10;15;Lauantai;75;56;131;43;43;86
89;29.10.2016;2016;10;16;Lauantai;44;48;92;37;49;86
89;29.10.2016;2016;10;17;Lauantai;43;50;93;39;46;85
89;29.10.2016;2016;10;18;Lauantai;43;35;78;42;36;78
89;29.10.2016;2016;10;19;Lauantai;50;28;78;26;24;50
89;29.10.2016;2016;10;20;Lauantai;32;17;49;23;18;41
89;29.10.2016;2016;10;21;Lauantai;28;19;47;13;10;23
89;29.10.2016;2016;10;22;Lauantai;17;16;33;5;8;13
89;29.10.2016;2016;10;23;Lauantai;13;18;31;4;14;18
89;30.10.2016;2016;10;00;Sunnuntai;14;23;37;3;10;13
89;30.10.2016;2016;10;01;Sunnuntai;12;9;21;3;5;8
89;30.10.2016;2016;10;02;Sunnuntai;8;1;9;8;2;10
89;30.10.2016;2016;10;03;Sunnuntai;18;1;19;8;3;11
89;30.10.2016;2016;10;04;Sunnuntai;7;5;12;2;1;3
89;30.10.2016;2016;10;05;Sunnuntai;2;4;6;0;0;0
89;30.10.2016;2016;10;06;Sunnuntai;4;6;10;3;2;5
89;30.10.2016;2016;10;07;Sunnuntai;1;10;11;7;4;11
89;30.10.2016;2016;10;08;Sunnuntai;3;6;9;5;15;20
89;30.10.2016;2016;10;09;Sunnuntai;14;29;43;15;28;43
89;30.10.2016;2016;10;10;Sunnuntai;16;47;63;40;44;84
89;30.10.2016;2016;10;11;Sunnuntai;30;51;81;48;51;99
89;30.10.2016;2016;10;12;Sunnuntai;49;65;114;39;66;105
89;30.10.2016;2016;10;13;Sunnuntai;58;59;117;65;41;106
89;30.10.2016;2016;10;14;Sunnuntai;62;67;129;47;68;115
89;30.10.2016;2016;10;15;Sunnuntai;52;29;81;47;61;108
89;30.10.2016;2016;10;16;Sunnuntai;60;42;102;53;47;100
89;30.10.2016;2016;10;17;Sunnuntai;45;30;75;38;45;83
89;30.10.2016;2016;10;18;Sunnuntai;37;26;63;31;43;74
89;30.10.2016;2016;10;19;Sunnuntai;33;18;51;40;34;74
89;30.10.2016;2016;10;20;Sunnuntai;26;12;38;14;16;30
89;30.10.2016;2016;10;21;Sunnuntai;19;12;31;13;11;24
89;30.10.2016;2016;10;22;Sunnuntai;17;9;26;10;7;17
89;30.10.2016;2016;10;23;Sunnuntai;8;7;15;1;3;4
89;31.10.2016;2016;10;00;Maanantai;0;0;0;2;0;2
89;31.10.2016;2016;10;01;Maanantai;3;2;5;0;0;0
89;31.10.2016;2016;10;02;Maanantai;2;1;3;0;1;1
89;31.10.2016;2016;10;03;Maanantai;0;0;0;0;2;2
89;31.10.2016;2016;10;04;Maanantai;2;3;5;1;0;1
89;31.10.2016;2016;10;05;Maanantai;5;7;12;0;1;1
89;31.10.2016;2016;10;06;Maanantai;21;50;71;0;7;7
89;31.10.2016;2016;10;07;Maanantai;36;190;226;12;26;38
89;31.10.2016;2016;10;08;Maanantai;33;184;217;7;25;32
89;31.10.2016;2016;10;09;Maanantai;49;109;158;18;31;49
89;31.10.2016;2016;10;10;Maanantai;39;64;103;18;33;51
89;31.10.2016;2016;10;11;Maanantai;56;63;119;20;36;56
89;31.10.2016;2016;10;12;Maanantai;59;62;121;25;27;52
89;31.10.2016;2016;10;13;Maanantai;82;70;152;27;28;55
89;31.10.2016;2016;10;14;Maanantai;120;67;187;36;31;67
89;31.10.2016;2016;10;15;Maanantai;161;80;241;42;31;73
89;31.10.2016;2016;10;16;Maanantai;187;92;279;25;35;60
89;31.10.2016;2016;10;17;Maanantai;87;71;158;37;30;67
89;31.10.2016;2016;10;18;Maanantai;67;49;116;39;47;86
89;31.10.2016;2016;10;19;Maanantai;45;45;90;30;31;61
89;31.10.2016;2016;10;20;Maanantai;45;22;67;25;27;52
89;31.10.2016;2016;10;21;Maanantai;38;14;52;12;11;23
89;31.10.2016;2016;10;22;Maanantai;12;17;29;7;5;12
89;31.10.2016;2016;10;23;Maanantai;7;3;10;4;6;10
89;01.11.2016;2016;11;00;Tiistai;5;1;6;7;1;8
89;01.11.2016;2016;11;01;Tiistai;9;2;11;0;0;0
89;01.11.2016;2016;11;02;Tiistai;5;1;6;2;0;2
89;01.11.2016;2016;11;03;Tiistai;1;0;1;0;0;0
89;01.11.2016;2016;11;04;Tiistai;0;3;3;0;0;0
89;01.11.2016;2016;11;05;Tiistai;3;13;16;0;1;1
89;01.11.2016;2016;11;06;Tiistai;21;61;82;0;6;6
89;01.11.2016;2016;11;07;Tiistai;37;171;208;7;30;37
89;01.11.2016;2016;11;08;Tiistai;44;185;229;17;33;50
89;01.11.2016;2016;11;09;Tiistai;45;77;122;10;48;58
89;01.11.2016;2016;11;10;Tiistai;38;50;88;15;36;51
89;01.11.2016;2016;11;11;Tiistai;34;58;92;35;17;52
89;01.11.2016;2016;11;12;Tiistai;50;69;119;26;28;54
89;01.11.2016;2016;11;13;Tiistai;87;55;142;23;26;49
89;01.11.2016;2016;11;14;Tiistai;106;45;151;21;16;37
89;01.11.2016;2016;11;15;Tiistai;154;63;217;29;15;44
89;01.11.2016;2016;11;16;Tiistai;141;68;209;25;18;43
89;01.11.2016;2016;11;17;Tiistai;76;42;118;23;42;65
89;01.11.2016;2016;11;18;Tiistai;57;43;100;44;39;83
89;01.11.2016;2016;11;19;Tiistai;51;35;86;38;32;70
89;01.11.2016;2016;11;20;Tiistai;53;32;85;16;11;27
89;01.11.2016;2016;11;21;Tiistai;30;14;44;8;12;20
89;01.11.2016;2016;11;22;Tiistai;14;9;23;8;6;14
89;01.11.2016;2016;11;23;Tiistai;13;4;17;2;2;4
89;02.11.2016;2016;11;00;Keskiviikko;5;5;10;0;2;2
89;02.11.2016;2016;11;01;Keskiviikko;3;4;7;0;2;2
89;02.11.2016;2016;11;02;Keskiviikko;1;1;2;0;0;0
89;02.11.2016;2016;11;03;Keskiviikko;0;1;1;0;1;1
89;02.11.2016;2016;11;04;Keskiviikko;4;4;8;2;2;4
89;02.11.2016;2016;11;05;Keskiviikko;3;13;16;2;0;2
89;02.11.2016;2016;11;06;Keskiviikko;13;47;60;2;7;9
89;02.11.2016;2016;11;07;Keskiviikko;33;161;194;6;32;38
89;02.11.2016;2016;11;08;Keskiviikko;36;187;223;11;48;59
89;02.11.2016;2016;11;09;Keskiviikko;43;102;145;13;30;43
89;02.11.2016;2016;11;10;Keskiviikko;27;57;84;12;36;48
89;02.11.2016;2016;11;11;Keskiviikko;65;61;126;20;28;48
89;02.11.2016;2016;11;12;Keskiviikko;57;67;124;24;27;51
89;02.11.2016;2016;11;13;Keskiviikko;81;68;149;38;30;68
89;02.11.2016;2016;11;14;Keskiviikko;112;68;180;31;29;60
89;02.11.2016;2016;11;15;Keskiviikko;132;80;212;36;24;60
89;02.11.2016;2016;11;16;Keskiviikko;170;85;255;49;35;84
89;02.11.2016;2016;11;17;Keskiviikko;103;80;183;41;29;70
89;02.11.2016;2016;11;18;Keskiviikko;68;38;106;35;37;72
89;02.11.2016;2016;11;19;Keskiviikko;53;38;91;49;33;82
89;02.11.2016;2016;11;20;Keskiviikko;55;27;82;20;22;42
89;02.11.2016;2016;11;21;Keskiviikko;38;16;54;18;17;35
89;02.11.2016;2016;11;22;Keskiviikko;16;12;28;5;5;10
89;02.11.2016;2016;11;23;Keskiviikko;7;4;11;2;0;2
89;03.11.2016;2016;11;00;Torstai;2;6;8;2;6;8
89;03.11.2016;2016;11;01;Torstai;5;1;6;0;2;2
89;03.11.2016;2016;11;02;Torstai;0;2;2;0;0;0
89;03.11.2016;2016;11;03;Torstai;0;0;0;0;0;0
89;03.11.2016;2016;11;04;Torstai;1;7;8;0;1;1
89;03.11.2016;2016;11;05;Torstai;1;10;11;1;0;1
89;03.11.2016;2016;11;06;Torstai;22;54;76;3;10;13
89;03.11.2016;2016;11;07;Torstai;31;146;177;7;22;29
89;03.11.2016;2016;11;08;Torstai;33;176;209;14;34;48
89;03.11.2016;2016;11;09;Torstai;37;90;127;15;41;56
89;03.11.2016;2016;11;10;Torstai;34;70;104;18;36;54
89;03.11.2016;2016;11;11;Torstai;63;78;141;28;31;59
89;03.11.2016;2016;11;12;Torstai;57;59;116;26;32;58
89;03.11.2016;2016;11;13;Torstai;74;56;130;29;39;68
89;03.11.2016;2016;11;14;Torstai;100;65;165;26;28;54
89;03.11.2016;2016;11;15;Torstai;147;84;231;30;25;55
89;03.11.2016;2016;11;16;Torstai;139;88;227;31;30;61
89;03.11.2016;2016;11;17;Torstai;85;71;156;30;39;69
89;03.11.2016;2016;11;18;Torstai;64;53;117;22;32;54
89;03.11.2016;2016;11;19;Torstai;50;24;74;29;25;54
89;03.11.2016;2016;11;20;Torstai;47;21;68;23;12;35
89;03.11.2016;2016;11;21;Torstai;36;15;51;5;5;10
89;03.11.2016;2016;11;22;Torstai;20;9;29;7;1;8
89;03.11.2016;2016;11;23;Torstai;8;5;13;3;2;5
89;04.11.2016;2016;11;00;Perjantai;3;2;5;2;2;4
89;04.11.2016;2016;11;01;Perjantai;2;2;4;0;0;0
89;04.11.2016;2016;11;02;Perjantai;1;0;1;0;0;0
89;04.11.2016;2016;11;03;Perjantai;1;1;2;0;0;0
89;04.11.2016;2016;11;04;Perjantai;3;4;7;0;0;0
89;04.11.2016;2016;11;05;Perjantai;2;15;17;2;0;2
89;04.11.2016;2016;11;06;Perjantai;13;45;58;2;12;14
89;04.11.2016;2016;11;07;Perjantai;28;129;157;7;28;35
89;04.11.2016;2016;11;08;Perjantai;21;153;174;13;41;54
89;04.11.2016;2016;11;09;Perjantai;37;75;112;14;37;51
89;04.11.2016;2016;11;10;Perjantai;37;60;97;23;30;53
89;04.11.2016;2016;11;11;Perjantai;53;68;121;19;36;55
89;04.11.2016;2016;11;12;Perjantai;47;67;114;31;30;61
89;04.11.2016;2016;11;13;Perjantai;93;64;157;36;38;74
89;04.11.2016;2016;11;14;Perjantai;100;65;165;32;27;59
89;04.11.2016;2016;11;15;Perjantai;127;78;205;23;29;52
89;04.11.2016;2016;11;16;Perjantai;116;61;177;26;22;48
89;04.11.2016;2016;11;17;Perjantai;62;43;105;22;30;52
89;04.11.2016;2016;11;18;Perjantai;40;31;71;15;31;46
89;04.11.2016;2016;11;19;Perjantai;30;28;58;8;17;25
89;04.11.2016;2016;11;20;Perjantai;40;23;63;16;13;29
89;04.11.2016;2016;11;21;Perjantai;29;20;49;14;4;18
89;04.11.2016;2016;11;22;Perjantai;21;17;38;11;4;15
89;04.11.2016;2016;11;23;Perjantai;11;10;21;3;5;8
89;05.11.2016;2016;11;00;Lauantai;14;12;26;2;2;4
89;05.11.2016;2016;11;01;Lauantai;8;11;19;5;5;10
89;05.11.2016;2016;11;02;Lauantai;7;4;11;1;0;1
89;05.11.2016;2016;11;03;Lauantai;12;2;14;7;0;7
89;05.11.2016;2016;11;04;Lauantai;3;0;3;5;0;5
89;05.11.2016;2016;11;05;Lauantai;4;4;8;0;3;3
89;05.11.2016;2016;11;06;Lauantai;0;6;6;1;3;4
89;05.11.2016;2016;11;07;Lauantai;2;5;7;1;6;7
89;05.11.2016;2016;11;08;Lauantai;6;14;20;6;7;13
89;05.11.2016;2016;11;09;Lauantai;11;23;34;12;19;31
89;05.11.2016;2016;11;10;Lauantai;13;24;37;24;48;72
89;05.11.2016;2016;11;11;Lauantai;27;41;68;25;51;76
89;05.11.2016;2016;11;12;Lauantai;31;38;69;23;57;80
89;05.11.2016;2016;11;13;Lauantai;43;40;83;35;54;89
89;05.11.2016;2016;11;14;Lauantai;45;46;91;53;60;113
89;05.11.2016;2016;11;15;Lauantai;40;36;76;27;51;78
89;05.11.2016;2016;11;16;Lauantai;37;32;69;23;38;61
89;05.11.2016;2016;11;17;Lauantai;35;29;64;30;26;56
89;05.11.2016;2016;11;18;Lauantai;27;23;50;17;28;45
89;05.11.2016;2016;11;19;Lauantai;21;28;49;18;25;43
89;05.11.2016;2016;11;20;Lauantai;21;20;41;9;18;27
89;05.11.2016;2016;11;21;Lauantai;21;18;39;10;7;17
89;05.11.2016;2016;11;22;Lauantai;13;17;30;2;6;8
89;05.11.2016;2016;11;23;Lauantai;15;25;40;5;6;11
89;06.11.2016;2016;11;00;Sunnuntai;12;15;27;2;2;4
89;06.11.2016;2016;11;01;Sunnuntai;8;4;12;2;1;3
89;06.11.2016;2016;11;02;Sunnuntai;11;9;20;8;1;9
89;06.11.2016;2016;11;03;Sunnuntai;13;1;14;11;0;11
89;06.11.2016;2016;11;04;Sunnuntai;12;3;15;6;1;7
89;06.11.2016;2016;11;05;Sunnuntai;2;0;2;0;0;0
89;06.11.2016;2016;11;06;Sunnuntai;2;5;7;0;3;3
89;06.11.2016;2016;11;07;Sunnuntai;4;3;7;7;3;10
89;06.11.2016;2016;11;08;Sunnuntai;2;9;11;11;3;14
89;06.11.2016;2016;11;09;Sunnuntai;7;16;23;11;13;24
89;06.11.2016;2016;11;10;Sunnuntai;3;22;25;18;39;57
89;06.11.2016;2016;11;11;Sunnuntai;17;35;52;36;46;82
89;06.11.2016;2016;11;12;Sunnuntai;34;29;63;34;76;110
89;06.11.2016;2016;11;13;Sunnuntai;32;41;73;52;59;111
89;06.11.2016;2016;11;14;Sunnuntai;39;30;69;49;45;94
89;06.11.2016;2016;11;15;Sunnuntai;38;29;67;33;50;83
89;06.11.2016;2016;11;16;Sunnuntai;24;24;48;29;34;63
89;06.11.2016;2016;11;17;Sunnuntai;18;16;34;28;30;58
89;06.11.2016;2016;11;18;Sunnuntai;25;15;40;17;23;40
89;06.11.2016;2016;11;19;Sunnuntai;11;17;28;23;18;41
89;06.11.2016;2016;11;20;Sunnuntai;25;19;44;21;14;35
89;06.11.2016;2016;11;21;Sunnuntai;15;11;26;8;9;17
89;06.11.2016;2016;11;22;Sunnuntai;7;6;13;3;2;5
89;06.11.2016;2016;11;23;Sunnuntai;1;4;5;2;2;4
89;07.11.2016;2016;11;00;Maanantai;6;0;6;0;0;0
89;07.11.2016;2016;11;01;Maanantai;2;0;2;0;0;0
89;07.11.2016;2016;11;02;Maanantai;1;1;2;2;0;2
89;07.11.2016;2016;11;03;Maanantai;2;1;3;0;0;0
89;07.11.2016;2016;11;04;Maanantai;2;4;6;0;0;0
89;07.11.2016;2016;11;05;Maanantai;4;13;17;1;2;3
89;07.11.2016;2016;11;06;Maanantai;11;51;62;3;6;9
89;07.11.2016;2016;11;07;Maanantai;25;127;152;7;38;45
89;07.11.2016;2016;11;08;Maanantai;24;155;179;6;32;38
89;07.11.2016;2016;11;09;Maanantai;33;85;118;10;30;40
89;07.11.2016;2016;11;10;Maanantai;32;49;81;23;20;43
89;07.11.2016;2016;11;11;Maanantai;41;54;95;16;30;46
89;07.11.2016;2016;11;12;Maanantai;54;48;102;25;26;51
89;07.11.2016;2016;11;13;Maanantai;54;50;104;23;27;50
89;07.11.2016;2016;11;14;Maanantai;80;65;145;27;25;52
89;07.11.2016;2016;11;15;Maanantai;131;50;181;29;26;55
89;07.11.2016;2016;11;16;Maanantai;147;51;198;37;24;61
89;07.11.2016;2016;11;17;Maanantai;70;40;110;28;26;54
89;07.11.2016;2016;11;18;Maanantai;53;30;83;24;22;46
89;07.11.2016;2016;11;19;Maanantai;37;24;61;21;25;46
89;07.11.2016;2016;11;20;Maanantai;37;19;56;26;14;40
89;07.11.2016;2016;11;21;Maanantai;20;13;33;6;9;15
89;07.11.2016;2016;11;22;Maanantai;11;4;15;0;2;2
89;07.11.2016;2016;11;23;Maanantai;3;4;7;0;1;1
89;08.11.2016;2016;11;00;Tiistai;6;3;9;1;0;1
89;08.11.2016;2016;11;01;Tiistai;0;0;0;0;2;2
89;08.11.2016;2016;11;02;Tiistai;1;0;1;1;0;1
89;08.11.2016;2016;11;03;Tiistai;0;3;3;1;0;1
89;08.11.2016;2016;11;04;Tiistai;1;2;3;1;1;2
89;08.11.2016;2016;11;05;Tiistai;4;10;14;1;2;3
89;08.11.2016;2016;11;06;Tiistai;13;46;59;5;11;16
89;08.11.2016;2016;11;07;Tiistai;30;144;174;4;26;30
89;08.11.2016;2016;11;08;Tiistai;29;184;213;10;36;46
89;08.11.2016;2016;11;09;Tiistai;29;65;94;10;34;44
89;08.11.2016;2016;11;10;Tiistai;30;49;79;21;38;59
89;08.11.2016;2016;11;11;Tiistai;38;62;100;17;17;34
89;08.11.2016;2016;11;12;Tiistai;44;57;101;23;37;60
89;08.11.2016;2016;11;13;Tiistai;57;47;104;20;28;48
89;08.11.2016;2016;11;14;Tiistai;73;55;128;35;25;60
89;08.11.2016;2016;11;15;Tiistai;145;53;198;16;22;38
89;08.11.2016;2016;11;16;Tiistai;155;66;221;29;26;55
89;08.11.2016;2016;11;17;Tiistai;68;28;96;35;35;70
89;08.11.2016;2016;11;18;Tiistai;53;37;90;21;33;54
89;08.11.2016;2016;11;19;Tiistai;51;27;78;16;25;41
89;08.11.2016;2016;11;20;Tiistai;38;13;51;29;13;42
89;08.11.2016;2016;11;21;Tiistai;25;15;40;8;6;14
89;08.11.2016;2016;11;22;Tiistai;11;5;16;1;2;3
89;08.11.2016;2016;11;23;Tiistai;5;4;9;0;1;1
89;09.11.2016;2016;11;00;Keskiviikko;5;8;13;1;3;4
89;09.11.2016;2016;11;01;Keskiviikko;3;0;3;0;0;0
89;09.11.2016;2016;11;02;Keskiviikko;3;0;3;0;1;1
89;09.11.2016;2016;11;03;Keskiviikko;4;1;5;3;0;3
89;09.11.2016;2016;11;04;Keskiviikko;0;2;2;1;0;1
89;09.11.2016;2016;11;05;Keskiviikko;5;10;15;1;2;3
89;09.11.2016;2016;11;06;Keskiviikko;15;46;61;2;6;8
89;09.11.2016;2016;11;07;Keskiviikko;24;138;162;8;32;40
89;09.11.2016;2016;11;08;Keskiviikko;27;178;205;8;41;49
89;09.11.2016;2016;11;09;Keskiviikko;35;78;113;7;36;43
89;09.11.2016;2016;11;10;Keskiviikko;26;59;85;24;45;69
89;09.11.2016;2016;11;11;Keskiviikko;47;51;98;27;39;66
89;09.11.2016;2016;11;12;Keskiviikko;38;45;83;29;45;74
89;09.11.2016;2016;11;13;Keskiviikko;67;50;117;20;17;37
89;09.11.2016;2016;11;14;Keskiviikko;87;75;162;17;25;42
89;09.11.2016;2016;11;15;Keskiviikko;140;65;205;31;17;48
89;09.11.2016;2016;11;16;Keskiviikko;133;64;197;43;18;61
89;09.11.2016;2016;11;17;Keskiviikko;77;61;138;31;19;50
89;09.11.2016;2016;11;18;Keskiviikko;51;31;82;21;19;40
89;09.11.2016;2016;11;19;Keskiviikko;43;22;65;27;23;50
89;09.11.2016;2016;11;20;Keskiviikko;31;21;52;13;18;31
89;09.11.2016;2016;11;21;Keskiviikko;29;13;42;14;14;28
89;09.11.2016;2016;11;22;Keskiviikko;9;6;15;2;4;6
89;09.11.2016;2016;11;23;Keskiviikko;5;5;10;4;2;6
89;10.11.2016;2016;11;00;Torstai;0;2;2;0;1;1
89;10.11.2016;2016;11;01;Torstai;3;1;4;2;0;2
89;10.11.2016;2016;11;02;Torstai;0;1;1;1;0;1
89;10.11.2016;2016;11;03;Torstai;2;1;3;0;0;0
89;10.11.2016;2016;11;04;Torstai;2;2;4;0;0;0
89;10.11.2016;2016;11;05;Torstai;3;9;12;1;3;4
89;10.11.2016;2016;11;06;Torstai;14;47;61;2;12;14
89;10.11.2016;2016;11;07;Torstai;25;129;154;6;35;41
89;10.11.2016;2016;11;08;Torstai;26;143;169;7;33;40
89;10.11.2016;2016;11;09;Torstai;26;83;109;6;34;40
89;10.11.2016;2016;11;10;Torstai;36;57;93;18;26;44
89;10.11.2016;2016;11;11;Torstai;36;70;106;18;31;49
89;10.11.2016;2016;11;12;Torstai;40;76;116;14;29;43
89;10.11.2016;2016;11;13;Torstai;64;51;115;25;26;51
89;10.11.2016;2016;11;14;Torstai;89;63;152;27;22;49
89;10.11.2016;2016;11;15;Torstai;132;62;194;27;24;51
89;10.11.2016;2016;11;16;Torstai;151;60;211;25;28;53
89;10.11.2016;2016;11;17;Torstai;69;64;133;21;32;53
89;10.11.2016;2016;11;18;Torstai;62;43;105;24;34;58
89;10.11.2016;2016;11;19;Torstai;42;20;62;19;20;39
89;10.11.2016;2016;11;20;Torstai;32;9;41;16;11;27
89;10.11.2016;2016;11;21;Torstai;26;9;35;17;7;24
89;10.11.2016;2016;11;22;Torstai;18;18;36;3;2;5
89;10.11.2016;2016;11;23;Torstai;9;3;12;4;5;9
89;11.11.2016;2016;11;00;Perjantai;3;3;6;0;1;1
89;11.11.2016;2016;11;01;Perjantai;3;3;6;1;0;1
89;11.11.2016;2016;11;02;Perjantai;6;1;7;0;1;1
89;11.11.2016;2016;11;03;Perjantai;5;1;6;3;1;4
89;11.11.2016;2016;11;04;Perjantai;2;1;3;0;1;1
89;11.11.2016;2016;11;05;Perjantai;3;6;9;1;2;3
89;11.11.2016;2016;11;06;Perjantai;11;37;48;3;11;14
89;11.11.2016;2016;11;07;Perjantai;20;119;139;4;32;36
89;11.11.2016;2016;11;08;Perjantai;16;116;132;6;30;36
89;11.11.2016;2016;11;09;Perjantai;23;83;106;12;28;40
89;11.11.2016;2016;11;10;Perjantai;21;52;73;29;32;61
89;11.11.2016;2016;11;11;Perjantai;46;43;89;30;33;63
89;11.11.2016;2016;11;12;Perjantai;42;47;89;23;21;44
89;11.11.2016;2016;11;13;Perjantai;61;67;128;58;27;85
89;11.11.2016;2016;11;14;Perjantai;89;65;154;32;33;65
89;11.11.2016;2016;11;15;Perjantai;118;51;169;33;30;63
89;11.11.2016;2016;11;16;Perjantai;92;49;141;29;15;44
89;11.11.2016;2016;11;17;Perjantai;55;26;81;32;32;64
89;11.11.2016;2016;11;18;Perjantai;37;25;62;30;34;64
89;11.11.2016;2016;11;19;Perjantai;33;30;63;29;26;55
89;11.11.2016;2016;11;20;Perjantai;22;16;38;24;14;38
89;11.11.2016;2016;11;21;Perjantai;20;15;35;15;17;32
89;11.11.2016;2016;11;22;Perjantai;16;7;23;10;5;15
89;11.11.2016;2016;11;23;Perjantai;10;4;14;9;6;15
89;12.11.2016;2016;11;00;Lauantai;11;21;32;3;6;9
89;12.11.2016;2016;11;01;Lauantai;16;9;25;4;2;6
89;12.11.2016;2016;11;02;Lauantai;10;2;12;1;1;2
89;12.11.2016;2016;11;03;Lauantai;7;5;12;6;3;9
89;12.11.2016;2016;11;04;Lauantai;4;4;8;5;0;5
89;12.11.2016;2016;11;05;Lauantai;5;1;6;0;0;0
89;12.11.2016;2016;11;06;Lauantai;1;6;7;2;2;4
89;12.11.2016;2016;11;07;Lauantai;3;19;22;5;7;12
89;12.11.2016;2016;11;08;Lauantai;4;22;26;12;7;19
89;12.11.2016;2016;11;09;Lauantai;8;29;37;8;24;32
89;12.11.2016;2016;11;10;Lauantai;15;44;59;20;51;71
89;12.11.2016;2016;11;11;Lauantai;20;61;81;37;37;74
89;12.11.2016;2016;11;12;Lauantai;45;58;103;46;56;102
89;12.11.2016;2016;11;13;Lauantai;34;51;85;40;51;91
89;12.11.2016;2016;11;14;Lauantai;48;46;94;42;42;84
89;12.11.2016;2016;11;15;Lauantai;52;31;83;47;39;86
89;12.11.2016;2016;11;16;Lauantai;30;17;47;33;22;55
89;12.11.2016;2016;11;17;Lauantai;32;33;65;24;26;50
89;12.11.2016;2016;11;18;Lauantai;22;22;44;18;16;34
89;12.11.2016;2016;11;19;Lauantai;26;24;50;18;26;44
89;12.11.2016;2016;11;20;Lauantai;14;15;29;16;11;27
89;12.11.2016;2016;11;21;Lauantai;16;17;33;6;10;16
89;12.11.2016;2016;11;22;Lauantai;8;14;22;7;8;15
89;12.11.2016;2016;11;23;Lauantai;11;16;27;2;4;6
89;13.11.2016;2016;11;00;Sunnuntai;12;17;29;5;9;14
89;13.11.2016;2016;11;01;Sunnuntai;11;5;16;6;4;10
89;13.11.2016;2016;11;02;Sunnuntai;5;4;9;2;1;3
89;13.11.2016;2016;11;03;Sunnuntai;9;0;9;6;1;7
89;13.11.2016;2016;11;04;Sunnuntai;8;1;9;2;1;3
89;13.11.2016;2016;11;05;Sunnuntai;6;2;8;1;0;1
89;13.11.2016;2016;11;06;Sunnuntai;1;6;7;0;4;4
89;13.11.2016;2016;11;07;Sunnuntai;2;5;7;5;6;11
89;13.11.2016;2016;11;08;Sunnuntai;3;6;9;7;12;19
89;13.11.2016;2016;11;09;Sunnuntai;11;23;34;24;18;42
89;13.11.2016;2016;11;10;Sunnuntai;9;19;28;27;37;64
89;13.11.2016;2016;11;11;Sunnuntai;14;21;35;37;57;94
89;13.11.2016;2016;11;12;Sunnuntai;30;36;66;35;61;96
89;13.11.2016;2016;11;13;Sunnuntai;39;39;78;52;67;119
89;13.11.2016;2016;11;14;Sunnuntai;30;33;63;42;37;79
89;13.11.2016;2016;11;15;Sunnuntai;40;26;66;32;45;77
89;13.11.2016;2016;11;16;Sunnuntai;33;35;68;28;33;61
89;13.11.2016;2016;11;17;Sunnuntai;24;15;39;21;25;46
89;13.11.2016;2016;11;18;Sunnuntai;28;18;46;35;38;73
89;13.11.2016;2016;11;19;Sunnuntai;18;11;29;24;21;45
89;13.11.2016;2016;11;20;Sunnuntai;7;6;13;23;11;34
89;13.11.2016;2016;11;21;Sunnuntai;12;5;17;8;13;21
89;13.11.2016;2016;11;22;Sunnuntai;8;5;13;5;7;12
89;13.11.2016;2016;11;23;Sunnuntai;2;3;5;0;3;3
89;14.11.2016;2016;11;00;Maanantai;4;2;6;1;0;1
89;14.11.2016;2016;11;01;Maanantai;1;0;1;1;0;1
89;14.11.2016;2016;11;02;Maanantai;3;0;3;0;1;1
89;14.11.2016;2016;11;03;Maanantai;0;1;1;0;0;0
89;14.11.2016;2016;11;04;Maanantai;3;4;7;2;1;3
89;14.11.2016;2016;11;05;Maanantai;2;11;13;1;2;3
89;14.11.2016;2016;11;06;Maanantai;10;54;64;2;6;8
89;14.11.2016;2016;11;07;Maanantai;20;129;149;11;42;53
89;14.11.2016;2016;11;08;Maanantai;22;156;178;7;46;53
89;14.11.2016;2016;11;09;Maanantai;27;73;100;11;39;50
89;14.11.2016;2016;11;10;Maanantai;39;55;94;21;29;50
89;14.11.2016;2016;11;11;Maanantai;36;67;103;31;37;68
89;14.11.2016;2016;11;12;Maanantai;38;54;92;20;37;57
89;14.11.2016;2016;11;13;Maanantai;73;59;132;26;27;53
89;14.11.2016;2016;11;14;Maanantai;82;41;123;36;24;60
89;14.11.2016;2016;11;15;Maanantai;128;47;175;40;24;64
89;14.11.2016;2016;11;16;Maanantai;138;58;196;46;28;74
89;14.11.2016;2016;11;17;Maanantai;76;35;111;35;21;56
89;14.11.2016;2016;11;18;Maanantai;47;34;81;32;30;62
89;14.11.2016;2016;11;19;Maanantai;41;30;71;26;18;44
89;14.11.2016;2016;11;20;Maanantai;34;18;52;29;27;56
89;14.11.2016;2016;11;21;Maanantai;28;8;36;8;12;20
89;14.11.2016;2016;11;22;Maanantai;8;10;18;3;7;10
89;14.11.2016;2016;11;23;Maanantai;3;3;6;0;1;1
89;15.11.2016;2016;11;00;Tiistai;1;2;3;3;1;4
89;15.11.2016;2016;11;01;Tiistai;2;1;3;0;0;0
89;15.11.2016;2016;11;02;Tiistai;3;4;7;0;0;0
89;15.11.2016;2016;11;03;Tiistai;1;3;4;0;0;0
89;15.11.2016;2016;11;04;Tiistai;1;5;6;1;0;1
89;15.11.2016;2016;11;05;Tiistai;3;8;11;2;1;3
89;15.11.2016;2016;11;06;Tiistai;15;45;60;4;10;14
89;15.11.2016;2016;11;07;Tiistai;32;141;173;15;39;54
89;15.11.2016;2016;11;08;Tiistai;29;159;188;10;64;74
89;15.11.2016;2016;11;09;Tiistai;38;89;127;28;50;78
89;15.11.2016;2016;11;10;Tiistai;20;48;68;48;57;105
89;15.11.2016;2016;11;11;Tiistai;38;53;91;26;42;68
89;15.11.2016;2016;11;12;Tiistai;33;45;78;25;27;52
89;15.11.2016;2016;11;13;Tiistai;53;46;99;25;20;45
89;15.11.2016;2016;11;14;Tiistai;67;48;115;32;18;50
89;15.11.2016;2016;11;15;Tiistai;140;55;195;38;15;53
89;15.11.2016;2016;11;16;Tiistai;125;50;175;37;18;55
89;15.11.2016;2016;11;17;Tiistai;79;43;122;32;34;66
89;15.11.2016;2016;11;18;Tiistai;59;35;94;28;28;56
89;15.11.2016;2016;11;19;Tiistai;42;23;65;27;24;51
89;15.11.2016;2016;11;20;Tiistai;46;20;66;16;19;35
89;15.11.2016;2016;11;21;Tiistai;32;4;36;12;8;20
89;15.11.2016;2016;11;22;Tiistai;9;6;15;5;5;10
89;15.11.2016;2016;11;23;Tiistai;13;3;16;1;2;3
89;16.11.2016;2016;11;00;Keskiviikko;0;5;5;2;1;3
89;16.11.2016;2016;11;01;Keskiviikko;3;1;4;0;0;0
89;16.11.2016;2016;11;02;Keskiviikko;1;2;3;0;0;0
89;16.11.2016;2016;11;03;Keskiviikko;2;0;2;0;0;0
89;16.11.2016;2016;11;04;Keskiviikko;1;7;8;2;1;3
89;16.11.2016;2016;11;05;Keskiviikko;3;8;11;1;1;2
89;16.11.2016;2016;11;06;Keskiviikko;10;42;52;3;7;10
89;16.11.2016;2016;11;07;Keskiviikko;19;121;140;8;36;44
89;16.11.2016;2016;11;08;Keskiviikko;35;164;199;24;78;102
89;16.11.2016;2016;11;09;Keskiviikko;33;82;115;18;42;60
89;16.11.2016;2016;11;10;Keskiviikko;30;62;92;24;37;61
89;16.11.2016;2016;11;11;Keskiviikko;47;71;118;35;32;67
89;16.11.2016;2016;11;12;Keskiviikko;48;60;108;25;38;63
89;16.11.2016;2016;11;13;Keskiviikko;61;53;114;27;19;46
89;16.11.2016;2016;11;14;Keskiviikko;76;41;117;40;24;64
89;16.11.2016;2016;11;15;Keskiviikko;124;45;169;24;31;55
89;16.11.2016;2016;11;16;Keskiviikko;148;64;212;53;33;86
89;16.11.2016;2016;11;17;Keskiviikko;64;47;111;42;30;72
89;16.11.2016;2016;11;18;Keskiviikko;59;31;90;48;22;70
89;16.11.2016;2016;11;19;Keskiviikko;51;18;69;36;30;66
89;16.11.2016;2016;11;20;Keskiviikko;38;21;59;29;28;57
89;16.11.2016;2016;11;21;Keskiviikko;38;15;53;15;4;19
89;16.11.2016;2016;11;22;Keskiviikko;19;4;23;5;2;7
89;16.11.2016;2016;11;23;Keskiviikko;11;4;15;1;3;4
89;17.11.2016;2016;11;00;Torstai;4;6;10;1;2;3
89;17.11.2016;2016;11;01;Torstai;3;9;12;0;2;2
89;17.11.2016;2016;11;02;Torstai;3;1;4;0;0;0
89;17.11.2016;2016;11;03;Torstai;3;6;9;2;0;2
89;17.11.2016;2016;11;04;Torstai;3;1;4;1;0;1
89;17.11.2016;2016;11;05;Torstai;3;6;9;1;2;3
89;17.11.2016;2016;11;06;Torstai;11;43;54;1;7;8
89;17.11.2016;2016;11;07;Torstai;21;106;127;7;36;43
89;17.11.2016;2016;11;08;Torstai;37;167;204;15;40;55
89;17.11.2016;2016;11;09;Torstai;26;93;119;21;47;68
89;17.11.2016;2016;11;10;Torstai;34;64;98;26;37;63
89;17.11.2016;2016;11;11;Torstai;53;72;125;21;27;48
89;17.11.2016;2016;11;12;Torstai;40;63;103;21;32;53
89;17.11.2016;2016;11;13;Torstai;64;59;123;24;24;48
89;17.11.2016;2016;11;14;Torstai;77;46;123;39;23;62
89;17.11.2016;2016;11;15;Torstai;125;54;179;31;20;51
89;17.11.2016;2016;11;16;Torstai;140;56;196;47;24;71
89;17.11.2016;2016;11;17;Torstai;67;38;105;24;28;52
89;17.11.2016;2016;11;18;Torstai;55;46;101;26;26;52
89;17.11.2016;2016;11;19;Torstai;51;13;64;20;21;41
89;17.11.2016;2016;11;20;Torstai;42;22;64;15;8;23
89;17.11.2016;2016;11;21;Torstai;36;13;49;7;8;15
89;17.11.2016;2016;11;22;Torstai;14;10;24;1;3;4
89;17.11.2016;2016;11;23;Torstai;9;2;11;1;6;7
89;18.11.2016;2016;11;00;Perjantai;7;5;12;3;1;4
89;18.11.2016;2016;11;01;Perjantai;8;1;9;0;0;0
89;18.11.2016;2016;11;02;Perjantai;9;3;12;0;0;0
89;18.11.2016;2016;11;03;Perjantai;7;1;8;1;0;1
89;18.11.2016;2016;11;04;Perjantai;0;4;4;1;0;1
89;18.11.2016;2016;11;05;Perjantai;3;11;14;0;1;1
89;18.11.2016;2016;11;06;Perjantai;11;38;49;2;6;8
89;18.11.2016;2016;11;07;Perjantai;20;110;130;9;38;47
89;18.11.2016;2016;11;08;Perjantai;25;136;161;8;36;44
89;18.11.2016;2016;11;09;Perjantai;26;92;118;15;31;46
89;18.11.2016;2016;11;10;Perjantai;27;66;93;26;33;59
89;18.11.2016;2016;11;11;Perjantai;48;69;117;21;32;53
89;18.11.2016;2016;11;12;Perjantai;64;61;125;29;27;56
89;18.11.2016;2016;11;13;Perjantai;68;52;120;26;20;46
89;18.11.2016;2016;11;14;Perjantai;80;54;134;18;23;41
89;18.11.2016;2016;11;15;Perjantai;104;51;155;34;25;59
89;18.11.2016;2016;11;16;Perjantai;80;76;156;35;42;77
89;18.11.2016;2016;11;17;Perjantai;58;55;113;27;45;72
89;18.11.2016;2016;11;18;Perjantai;38;49;87;22;30;52
89;18.11.2016;2016;11;19;Perjantai;52;32;84;30;18;48
89;18.11.2016;2016;11;20;Perjantai;40;22;62;21;8;29
89;18.11.2016;2016;11;21;Perjantai;19;12;31;6;4;10
89;18.11.2016;2016;11;22;Perjantai;19;19;38;7;8;15
89;18.11.2016;2016;11;23;Perjantai;11;5;16;1;5;6
89;19.11.2016;2016;11;00;Lauantai;19;8;27;3;0;3
89;19.11.2016;2016;11;01;Lauantai;11;2;13;4;0;4
89;19.11.2016;2016;11;02;Lauantai;10;2;12;3;0;3
89;19.11.2016;2016;11;03;Lauantai;10;5;15;5;1;6
89;19.11.2016;2016;11;04;Lauantai;11;1;12;3;2;5
89;19.11.2016;2016;11;05;Lauantai;2;3;5;3;0;3
89;19.11.2016;2016;11;06;Lauantai;3;4;7;1;2;3
89;19.11.2016;2016;11;07;Lauantai;0;11;11;4;3;7
89;19.11.2016;2016;11;08;Lauantai;5;8;13;9;11;20
89;19.11.2016;2016;11;09;Lauantai;7;23;30;9;18;27
89;19.11.2016;2016;11;10;Lauantai;16;46;62;9;21;30
89;19.11.2016;2016;11;11;Lauantai;22;48;70;22;28;50
89;19.11.2016;2016;11;12;Lauantai;37;43;80;19;34;53
89;19.11.2016;2016;11;13;Lauantai;37;32;69;19;16;35
89;19.11.2016;2016;11;14;Lauantai;23;21;44;22;15;37
89;19.11.2016;2016;11;15;Lauantai;33;24;57;13;26;39
89;19.11.2016;2016;11;16;Lauantai;31;28;59;11;11;22
89;19.11.2016;2016;11;17;Lauantai;40;26;66;22;19;41
89;19.11.2016;2016;11;18;Lauantai;34;35;69;27;17;44
89;19.11.2016;2016;11;19;Lauantai;20;17;37;11;7;18
89;19.11.2016;2016;11;20;Lauantai;20;14;34;15;19;34
89;19.11.2016;2016;11;21;Lauantai;15;10;25;12;11;23
89;19.11.2016;2016;11;22;Lauantai;18;17;35;2;8;10
89;19.11.2016;2016;11;23;Lauantai;17;16;33;7;1;8
89;20.11.2016;2016;11;00;Sunnuntai;7;14;21;3;10;13
89;20.11.2016;2016;11;01;Sunnuntai;13;7;20;6;3;9
89;20.11.2016;2016;11;02;Sunnuntai;16;2;18;6;2;8
89;20.11.2016;2016;11;03;Sunnuntai;12;1;13;7;1;8
89;20.11.2016;2016;11;04;Sunnuntai;10;3;13;4;2;6
89;20.11.2016;2016;11;05;Sunnuntai;6;1;7;2;2;4
89;20.11.2016;2016;11;06;Sunnuntai;1;4;5;1;2;3
89;20.11.2016;2016;11;07;Sunnuntai;1;0;1;4;3;7
89;20.11.2016;2016;11;08;Sunnuntai;4;8;12;7;8;15
89;20.11.2016;2016;11;09;Sunnuntai;8;20;28;10;22;32
89;20.11.2016;2016;11;10;Sunnuntai;8;25;33;23;34;57
89;20.11.2016;2016;11;11;Sunnuntai;19;36;55;29;47;76
89;20.11.2016;2016;11;12;Sunnuntai;35;63;98;38;43;81
89;20.11.2016;2016;11;13;Sunnuntai;45;46;91;49;44;93
89;20.11.2016;2016;11;14;Sunnuntai;46;61;107;39;62;101
89;20.11.2016;2016;11;15;Sunnuntai;39;35;74;49;46;95
89;20.11.2016;2016;11;16;Sunnuntai;35;20;55;46;48;94
89;20.11.2016;2016;11;17;Sunnuntai;44;30;74;29;38;67
89;20.11.2016;2016;11;18;Sunnuntai;33;18;51;45;27;72
89;20.11.2016;2016;11;19;Sunnuntai;28;18;46;31;44;75
89;20.11.2016;2016;11;20;Sunnuntai;19;7;26;19;9;28
89;20.11.2016;2016;11;21;Sunnuntai;17;7;24;9;9;18
89;20.11.2016;2016;11;22;Sunnuntai;3;5;8;6;2;8
89;20.11.2016;2016;11;23;Sunnuntai;3;1;4;1;0;1
89;21.11.2016;2016;11;00;Maanantai;5;2;7;3;1;4
89;21.11.2016;2016;11;01;Maanantai;5;0;5;1;0;1
89;21.11.2016;2016;11;02;Maanantai;3;0;3;0;0;0
89;21.11.2016;2016;11;03;Maanantai;4;1;5;0;0;0
89;21.11.2016;2016;11;04;Maanantai;0;2;2;1;1;2
89;21.11.2016;2016;11;05;Maanantai;3;12;15;1;2;3
89;21.11.2016;2016;11;06;Maanantai;9;45;54;6;13;19
89;21.11.2016;2016;11;07;Maanantai;32;122;154;8;44;52
89;21.11.2016;2016;11;08;Maanantai;31;166;197;11;36;47
89;21.11.2016;2016;11;09;Maanantai;31;80;111;22;37;59
89;21.11.2016;2016;11;10;Maanantai;28;38;66;25;29;54
89;21.11.2016;2016;11;11;Maanantai;65;51;116;13;33;46
89;21.11.2016;2016;11;12;Maanantai;54;48;102;25;24;49
89;21.11.2016;2016;11;13;Maanantai;57;62;119;30;30;60
89;21.11.2016;2016;11;14;Maanantai;86;48;134;23;15;38
89;21.11.2016;2016;11;15;Maanantai;135;48;183;26;15;41
89;21.11.2016;2016;11;16;Maanantai;122;48;170;29;18;47
89;21.11.2016;2016;11;17;Maanantai;72;36;108;21;16;37
89;21.11.2016;2016;11;18;Maanantai;44;30;74;19;10;29
89;21.11.2016;2016;11;19;Maanantai;26;19;45;20;15;35
89;21.11.2016;2016;11;20;Maanantai;26;14;40;22;17;39
89;21.11.2016;2016;11;21;Maanantai;23;2;25;14;4;18
89;21.11.2016;2016;11;22;Maanantai;8;3;11;6;6;12
89;21.11.2016;2016;11;23;Maanantai;5;5;10;2;1;3
89;22.11.2016;2016;11;00;Tiistai;4;2;6;2;3;5
89;22.11.2016;2016;11;01;Tiistai;1;0;1;1;0;1
89;22.11.2016;2016;11;02;Tiistai;1;2;3;1;1;2
89;22.11.2016;2016;11;03;Tiistai;2;1;3;0;0;0
89;22.11.2016;2016;11;04;Tiistai;3;6;9;0;1;1
89;22.11.2016;2016;11;05;Tiistai;2;13;15;2;0;2
89;22.11.2016;2016;11;06;Tiistai;13;40;53;3;11;14
89;22.11.2016;2016;11;07;Tiistai;27;146;173;9;23;32
89;22.11.2016;2016;11;08;Tiistai;30;141;171;9;51;60
89;22.11.2016;2016;11;09;Tiistai;25;66;91;17;40;57
89;22.11.2016;2016;11;10;Tiistai;29;52;81;28;40;68
89;22.11.2016;2016;11;11;Tiistai;51;70;121;25;36;61
89;22.11.2016;2016;11;12;Tiistai;70;54;124;23;42;65
89;22.11.2016;2016;11;13;Tiistai;63;53;116;23;32;55
89;22.11.2016;2016;11;14;Tiistai;106;56;162;42;21;63
89;22.11.2016;2016;11;15;Tiistai;142;61;203;39;29;68
89;22.11.2016;2016;11;16;Tiistai;128;74;202;44;22;66
89;22.11.2016;2016;11;17;Tiistai;84;49;133;28;26;54
89;22.11.2016;2016;11;18;Tiistai;66;67;133;25;28;53
89;22.11.2016;2016;11;19;Tiistai;52;23;75;12;9;21
89;22.11.2016;2016;11;20;Tiistai;39;36;75;0;0;0
89;22.11.2016;2016;11;21;Tiistai;17;15;32;0;0;0
89;22.11.2016;2016;11;22;Tiistai;10;9;19;0;0;0
89;22.11.2016;2016;11;23;Tiistai;7;5;12;0;0;0
89;23.11.2016;2016;11;00;Keskiviikko;2;1;3;0;0;0
89;23.11.2016;2016;11;01;Keskiviikko;3;2;5;0;0;0
89;23.11.2016;2016;11;02;Keskiviikko;2;2;4;0;0;0
89;23.11.2016;2016;11;03;Keskiviikko;3;1;4;0;0;0
89;23.11.2016;2016;11;04;Keskiviikko;3;1;4;0;0;0
89;23.11.2016;2016;11;05;Keskiviikko;9;6;15;0;0;0
89;23.11.2016;2016;11;06;Keskiviikko;12;20;32;2;6;8
89;23.11.2016;2016;11;07;Keskiviikko;25;97;122;4;27;31
89;23.11.2016;2016;11;08;Keskiviikko;40;155;195;14;41;55
89;23.11.2016;2016;11;09;Keskiviikko;31;95;126;16;30;46
89;23.11.2016;2016;11;10;Keskiviikko;42;51;93;20;22;42
89;23.11.2016;2016;11;11;Keskiviikko;44;45;89;15;18;33
89;23.11.2016;2016;11;12;Keskiviikko;45;41;86;22;19;41
89;23.11.2016;2016;11;13;Keskiviikko;54;44;98;22;18;40
89;23.11.2016;2016;11;14;Keskiviikko;84;40;124;29;28;57
89;23.11.2016;2016;11;15;Keskiviikko;108;51;159;20;23;43
89;23.11.2016;2016;11;16;Keskiviikko;116;61;177;34;25;59
89;23.11.2016;2016;11;17;Keskiviikko;91;57;148;30;26;56
89;23.11.2016;2016;11;18;Keskiviikko;67;32;99;33;33;66
89;23.11.2016;2016;11;19;Keskiviikko;46;33;79;28;32;60
89;23.11.2016;2016;11;20;Keskiviikko;46;27;73;23;21;44
89;23.11.2016;2016;11;21;Keskiviikko;21;14;35;21;9;30
89;23.11.2016;2016;11;22;Keskiviikko;12;11;23;6;6;12
89;23.11.2016;2016;11;23;Keskiviikko;13;6;19;3;6;9
89;24.11.2016;2016;11;00;Torstai;4;1;5;1;2;3
89;24.11.2016;2016;11;01;Torstai;5;0;5;0;0;0
89;24.11.2016;2016;11;02;Torstai;3;3;6;1;1;2
89;24.11.2016;2016;11;03;Torstai;4;6;10;1;0;1
89;24.11.2016;2016;11;04;Torstai;8;4;12;17;15;32
89;24.11.2016;2016;11;05;Torstai;4;6;10;1;1;2
89;24.11.2016;2016;11;06;Torstai;11;41;52;1;12;13
89;24.11.2016;2016;11;07;Torstai;25;111;136;7;43;50
89;24.11.2016;2016;11;08;Torstai;36;134;170;17;32;49
89;24.11.2016;2016;11;09;Torstai;40;60;100;9;32;41
89;24.11.2016;2016;11;10;Torstai;23;64;87;27;38;65
89;24.11.2016;2016;11;11;Torstai;52;43;95;23;40;63
89;24.11.2016;2016;11;12;Torstai;39;46;85;30;28;58
89;24.11.2016;2016;11;13;Torstai;53;56;109;29;29;58
89;24.11.2016;2016;11;14;Torstai;61;50;111;27;18;45
89;24.11.2016;2016;11;15;Torstai;128;67;195;41;38;79
89;24.11.2016;2016;11;16;Torstai;106;60;166;43;26;69
89;24.11.2016;2016;11;17;Torstai;62;68;130;39;41;80
89;24.11.2016;2016;11;18;Torstai;50;34;84;36;37;73
89;24.11.2016;2016;11;19;Torstai;62;23;85;39;22;61
89;24.11.2016;2016;11;20;Torstai;43;19;62;21;16;37
89;24.11.2016;2016;11;21;Torstai;31;14;45;12;6;18
89;24.11.2016;2016;11;22;Torstai;8;13;21;8;0;8
89;24.11.2016;2016;11;23;Torstai;9;4;13;7;6;13
89;25.11.2016;2016;11;00;Perjantai;7;3;10;1;1;2
89;25.11.2016;2016;11;01;Perjantai;1;0;1;1;0;1
89;25.11.2016;2016;11;02;Perjantai;3;0;3;1;1;2
89;25.11.2016;2016;11;03;Perjantai;6;2;8;0;0;0
89;25.11.2016;2016;11;04;Perjantai;4;5;9;0;1;1
89;25.11.2016;2016;11;05;Perjantai;3;7;10;2;1;3
89;25.11.2016;2016;11;06;Perjantai;14;40;54;4;15;19
89;25.11.2016;2016;11;07;Perjantai;28;114;142;8;31;39
89;25.11.2016;2016;11;08;Perjantai;27;123;150;8;31;39
89;25.11.2016;2016;11;09;Perjantai;30;72;102;11;31;42
89;25.11.2016;2016;11;10;Perjantai;36;61;97;18;27;45
89;25.11.2016;2016;11;11;Perjantai;43;71;114;23;32;55
89;25.11.2016;2016;11;12;Perjantai;52;57;109;21;24;45
89;25.11.2016;2016;11;13;Perjantai;75;49;124;25;24;49
89;25.11.2016;2016;11;14;Perjantai;73;38;111;23;19;42
89;25.11.2016;2016;11;15;Perjantai;94;54;148;25;38;63
89;25.11.2016;2016;11;16;Perjantai;83;53;136;44;29;73
89;25.11.2016;2016;11;17;Perjantai;74;54;128;29;25;54
89;25.11.2016;2016;11;18;Perjantai;39;32;71;30;28;58
89;25.11.2016;2016;11;19;Perjantai;43;37;80;26;22;48
89;25.11.2016;2016;11;20;Perjantai;34;11;45;24;10;34
89;25.11.2016;2016;11;21;Perjantai;33;27;60;12;4;16
89;25.11.2016;2016;11;22;Perjantai;13;11;24;9;3;12
89;25.11.2016;2016;11;23;Perjantai;31;8;39;4;2;6
89;26.11.2016;2016;11;00;Lauantai;24;0;24;12;0;12
89;26.11.2016;2016;11;01;Lauantai;21;0;21;19;0;19
89;26.11.2016;2016;11;02;Lauantai;12;0;12;11;0;11
89;26.11.2016;2016;11;03;Lauantai;7;0;7;7;0;7
89;26.11.2016;2016;11;04;Lauantai;9;0;9;3;0;3
89;26.11.2016;2016;11;05;Lauantai;9;0;9;2;0;2
89;26.11.2016;2016;11;06;Lauantai;8;0;8;9;0;9
89;26.11.2016;2016;11;07;Lauantai;23;0;23;15;0;15
89;26.11.2016;2016;11;08;Lauantai;19;0;19;25;0;25
89;26.11.2016;2016;11;09;Lauantai;43;0;43;49;0;49
89;26.11.2016;2016;11;10;Lauantai;52;0;52;72;1;73
89;26.11.2016;2016;11;11;Lauantai;62;1;63;100;0;100
89;26.11.2016;2016;11;12;Lauantai;67;0;67;125;0;125
89;26.11.2016;2016;11;13;Lauantai;68;2;70;92;1;93
89;26.11.2016;2016;11;14;Lauantai;75;1;76;128;0;128
89;26.11.2016;2016;11;15;Lauantai;55;0;55;102;0;102
89;26.11.2016;2016;11;16;Lauantai;75;0;75;97;0;97
89;26.11.2016;2016;11;17;Lauantai;53;0;53;104;0;104
89;26.11.2016;2016;11;18;Lauantai;58;1;59;90;0;90
89;26.11.2016;2016;11;19;Lauantai;55;0;55;60;0;60
89;26.11.2016;2016;11;20;Lauantai;41;0;41;52;0;52
89;26.11.2016;2016;11;21;Lauantai;44;0;44;29;0;29
89;26.11.2016;2016;11;22;Lauantai;32;0;32;24;0;24
89;26.11.2016;2016;11;23;Lauantai;17;0;17;27;0;27
89;27.11.2016;2016;11;00;Sunnuntai;20;0;20;12;0;12
89;27.11.2016;2016;11;01;Sunnuntai;18;0;18;13;0;13
89;27.11.2016;2016;11;02;Sunnuntai;14;0;14;20;0;20
89;27.11.2016;2016;11;03;Sunnuntai;16;0;16;18;0;18
89;27.11.2016;2016;11;04;Sunnuntai;11;0;11;14;0;14
89;27.11.2016;2016;11;05;Sunnuntai;7;0;7;1;0;1
89;27.11.2016;2016;11;06;Sunnuntai;7;0;7;4;0;4
89;27.11.2016;2016;11;07;Sunnuntai;6;0;6;11;0;11
89;27.11.2016;2016;11;08;Sunnuntai;13;0;13;22;0;22
89;27.11.2016;2016;11;09;Sunnuntai;25;0;25;35;0;35
89;27.11.2016;2016;11;10;Sunnuntai;51;0;51;62;0;62
89;27.11.2016;2016;11;11;Sunnuntai;48;0;48;101;0;101
89;27.11.2016;2016;11;12;Sunnuntai;46;1;47;131;0;131
89;27.11.2016;2016;11;13;Sunnuntai;59;0;59;142;0;142
89;27.11.2016;2016;11;14;Sunnuntai;51;0;51;102;0;102
89;27.11.2016;2016;11;15;Sunnuntai;66;1;67;79;0;79
89;27.11.2016;2016;11;16;Sunnuntai;51;1;52;83;0;83
89;27.11.2016;2016;11;17;Sunnuntai;51;0;51;56;0;56
89;27.11.2016;2016;11;18;Sunnuntai;57;0;57;90;0;90
89;27.11.2016;2016;11;19;Sunnuntai;40;1;41;63;0;63
89;27.11.2016;2016;11;20;Sunnuntai;52;0;52;43;0;43
89;27.11.2016;2016;11;21;Sunnuntai;29;1;30;12;0;12
89;27.11.2016;2016;11;22;Sunnuntai;20;0;20;8;2;10
89;27.11.2016;2016;11;23;Sunnuntai;10;0;10;7;0;7
89;28.11.2016;2016;11;00;Maanantai;3;0;3;5;0;5
89;28.11.2016;2016;11;01;Maanantai;2;0;2;1;0;1
89;28.11.2016;2016;11;02;Maanantai;2;0;2;0;0;0
89;28.11.2016;2016;11;03;Maanantai;3;0;3;0;0;0
89;28.11.2016;2016;11;04;Maanantai;6;0;6;0;0;0
89;28.11.2016;2016;11;05;Maanantai;15;0;15;3;0;3
89;28.11.2016;2016;11;06;Maanantai;53;0;53;17;0;17
89;28.11.2016;2016;11;07;Maanantai;122;0;122;48;0;48
89;28.11.2016;2016;11;08;Maanantai;177;1;178;55;0;55
89;28.11.2016;2016;11;09;Maanantai;96;2;98;56;0;56
89;28.11.2016;2016;11;10;Maanantai;76;1;77;59;0;59
89;28.11.2016;2016;11;11;Maanantai;84;1;85;86;0;86
89;28.11.2016;2016;11;12;Maanantai;90;0;90;85;0;85
89;28.11.2016;2016;11;13;Maanantai;107;1;108;69;0;69
89;28.11.2016;2016;11;14;Maanantai;114;4;118;75;0;75
89;28.11.2016;2016;11;15;Maanantai;180;0;180;85;0;85
89;28.11.2016;2016;11;16;Maanantai;170;0;170;94;0;94
89;28.11.2016;2016;11;17;Maanantai;112;0;112;69;0;69
89;28.11.2016;2016;11;18;Maanantai;76;1;77;58;0;58
89;28.11.2016;2016;11;19;Maanantai;60;0;60;73;0;73
89;28.11.2016;2016;11;20;Maanantai;48;0;48;42;0;42
89;28.11.2016;2016;11;21;Maanantai;31;0;31;20;0;20
89;28.11.2016;2016;11;22;Maanantai;13;0;13;10;0;10
89;28.11.2016;2016;11;23;Maanantai;10;0;10;4;0;4
89;29.11.2016;2016;11;00;Tiistai;2;0;2;0;0;0
89;29.11.2016;2016;11;01;Tiistai;2;0;2;1;0;1
89;29.11.2016;2016;11;02;Tiistai;1;0;1;1;0;1
89;29.11.2016;2016;11;03;Tiistai;7;0;7;0;0;0
89;29.11.2016;2016;11;04;Tiistai;6;0;6;0;0;0
89;29.11.2016;2016;11;05;Tiistai;8;0;8;2;0;2
89;29.11.2016;2016;11;06;Tiistai;52;1;53;19;0;19
89;29.11.2016;2016;11;07;Tiistai;155;0;155;48;0;48
89;29.11.2016;2016;11;08;Tiistai;180;0;180;51;0;51
89;29.11.2016;2016;11;09;Tiistai;94;1;95;15;25;40
89;29.11.2016;2016;11;10;Tiistai;46;29;75;20;30;50
89;29.11.2016;2016;11;11;Tiistai;41;61;102;25;29;54
89;29.11.2016;2016;11;12;Tiistai;57;45;102;23;27;50
89;29.11.2016;2016;11;13;Tiistai;56;36;92;18;26;44
89;29.11.2016;2016;11;14;Tiistai;68;27;95;21;19;40
89;29.11.2016;2016;11;15;Tiistai;120;40;160;21;14;35
89;29.11.2016;2016;11;16;Tiistai;123;57;180;59;23;82
89;29.11.2016;2016;11;17;Tiistai;69;33;102;37;31;68
89;29.11.2016;2016;11;18;Tiistai;44;25;69;28;22;50
89;29.11.2016;2016;11;19;Tiistai;47;25;72;34;29;63
89;29.11.2016;2016;11;20;Tiistai;33;14;47;24;22;46
89;29.11.2016;2016;11;21;Tiistai;18;8;26;9;12;21
89;29.11.2016;2016;11;22;Tiistai;7;2;9;4;3;7
89;29.11.2016;2016;11;23;Tiistai;9;3;12;6;3;9
89;30.11.2016;2016;11;00;Keskiviikko;3;2;5;1;2;3
89;30.11.2016;2016;11;01;Keskiviikko;0;0;0;0;0;0
89;30.11.2016;2016;11;02;Keskiviikko;0;0;0;0;0;0
89;30.11.2016;2016;11;03;Keskiviikko;4;1;5;0;0;0
89;30.11.2016;2016;11;04;Keskiviikko;7;2;9;1;0;1
89;30.11.2016;2016;11;05;Keskiviikko;3;4;7;1;0;1
89;30.11.2016;2016;11;06;Keskiviikko;14;23;37;4;12;16
89;30.11.2016;2016;11;07;Keskiviikko;47;78;125;5;28;33
89;30.11.2016;2016;11;08;Keskiviikko;49;128;177;9;37;46
89;30.11.2016;2016;11;09;Keskiviikko;43;86;129;16;34;50
89;30.11.2016;2016;11;10;Keskiviikko;44;66;110;22;37;59
89;30.11.2016;2016;11;11;Keskiviikko;46;44;90;31;32;63
89;30.11.2016;2016;11;12;Keskiviikko;61;53;114;17;22;39
89;30.11.2016;2016;11;13;Keskiviikko;66;41;107;26;16;42
89;30.11.2016;2016;11;14;Keskiviikko;77;31;108;23;18;41
89;30.11.2016;2016;11;15;Keskiviikko;98;57;155;28;17;45
89;30.11.2016;2016;11;16;Keskiviikko;135;71;206;40;22;62
89;30.11.2016;2016;11;17;Keskiviikko;87;49;136;31;26;57
89;30.11.2016;2016;11;18;Keskiviikko;65;37;102;34;38;72
89;30.11.2016;2016;11;19;Keskiviikko;62;23;85;30;37;67
89;30.11.2016;2016;11;20;Keskiviikko;40;22;62;39;25;64
89;30.11.2016;2016;11;21;Keskiviikko;26;21;47;16;9;25
89;30.11.2016;2016;11;22;Keskiviikko;17;8;25;5;6;11
89;30.11.2016;2016;11;23;Keskiviikko;10;2;12;2;5;7
89;01.12.2016;2016;12;00;Torstai;2;6;8;0;0;0
89;01.12.2016;2016;12;01;Torstai;4;3;7;2;1;3
89;01.12.2016;2016;12;02;Torstai;2;1;3;0;1;1
89;01.12.2016;2016;12;03;Torstai;4;2;6;4;0;4
89;01.12.2016;2016;12;04;Torstai;4;1;5;2;3;5
89;01.12.2016;2016;12;05;Torstai;10;10;20;2;3;5
89;01.12.2016;2016;12;06;Torstai;16;52;68;2;7;9
89;01.12.2016;2016;12;07;Torstai;40;98;138;6;32;38
89;01.12.2016;2016;12;08;Torstai;36;151;187;8;41;49
89;01.12.2016;2016;12;09;Torstai;37;77;114;22;39;61
89;01.12.2016;2016;12;10;Torstai;22;49;71;20;39;59
89;01.12.2016;2016;12;11;Torstai;45;42;87;20;42;62
89;01.12.2016;2016;12;12;Torstai;44;50;94;37;60;97
89;01.12.2016;2016;12;13;Torstai;64;55;119;22;39;61
89;01.12.2016;2016;12;14;Torstai;75;54;129;36;30;66
89;01.12.2016;2016;12;15;Torstai;131;47;178;35;23;58
89;01.12.2016;2016;12;16;Torstai;124;56;180;51;30;81
89;01.12.2016;2016;12;17;Torstai;62;57;119;31;32;63
89;01.12.2016;2016;12;18;Torstai;62;38;100;23;26;49
89;01.12.2016;2016;12;19;Torstai;43;19;62;44;28;72
89;01.12.2016;2016;12;20;Torstai;33;17;50;32;14;46
89;01.12.2016;2016;12;21;Torstai;25;26;51;17;14;31
89;01.12.2016;2016;12;22;Torstai;13;10;23;7;9;16
89;01.12.2016;2016;12;23;Torstai;7;9;16;3;2;5
89;02.12.2016;2016;12;00;Perjantai;9;4;13;1;1;2
89;02.12.2016;2016;12;01;Perjantai;5;1;6;1;0;1
89;02.12.2016;2016;12;02;Perjantai;8;0;8;1;1;2
89;02.12.2016;2016;12;03;Perjantai;4;4;8;0;0;0
89;02.12.2016;2016;12;04;Perjantai;2;3;5;1;1;2
89;02.12.2016;2016;12;05;Perjantai;6;6;12;1;3;4
89;02.12.2016;2016;12;06;Perjantai;9;37;46;2;11;13
89;02.12.2016;2016;12;07;Perjantai;20;111;131;7;35;42
89;02.12.2016;2016;12;08;Perjantai;31;102;133;18;40;58
89;02.12.2016;2016;12;09;Perjantai;28;73;101;10;30;40
89;02.12.2016;2016;12;10;Perjantai;19;41;60;18;29;47
89;02.12.2016;2016;12;11;Perjantai;29;51;80;15;30;45
89;02.12.2016;2016;12;12;Perjantai;33;54;87;29;53;82
89;02.12.2016;2016;12;13;Perjantai;67;58;125;21;21;42
89;02.12.2016;2016;12;14;Perjantai;81;43;124;38;24;62
89;02.12.2016;2016;12;15;Perjantai;122;57;179;29;17;46
89;02.12.2016;2016;12;16;Perjantai;86;36;122;39;25;64
89;02.12.2016;2016;12;17;Perjantai;58;36;94;27;22;49
89;02.12.2016;2016;12;18;Perjantai;28;35;63;14;24;38
89;02.12.2016;2016;12;19;Perjantai;25;15;40;16;26;42
89;02.12.2016;2016;12;20;Perjantai;21;12;33;16;16;32
89;02.12.2016;2016;12;21;Perjantai;25;18;43;13;6;19
89;02.12.2016;2016;12;22;Perjantai;11;16;27;10;4;14
89;02.12.2016;2016;12;23;Perjantai;15;10;25;4;3;7
89;03.12.2016;2016;12;00;Lauantai;8;9;17;3;3;6
89;03.12.2016;2016;12;01;Lauantai;12;2;14;2;0;2
89;03.12.2016;2016;12;02;Lauantai;6;2;8;7;1;8
89;03.12.2016;2016;12;03;Lauantai;17;4;21;16;0;16
89;03.12.2016;2016;12;04;Lauantai;14;1;15;6;1;7
89;03.12.2016;2016;12;05;Lauantai;4;4;8;1;2;3
89;03.12.2016;2016;12;06;Lauantai;5;9;14;0;2;2
89;03.12.2016;2016;12;07;Lauantai;3;7;10;7;6;13
89;03.12.2016;2016;12;08;Lauantai;5;20;25;8;9;17
89;03.12.2016;2016;12;09;Lauantai;10;25;35;11;14;25
89;03.12.2016;2016;12;10;Lauantai;15;33;48;18;32;50
89;03.12.2016;2016;12;11;Lauantai;19;30;49;21;40;61
89;03.12.2016;2016;12;12;Lauantai;29;39;68;36;52;88
89;03.12.2016;2016;12;13;Lauantai;33;36;69;37;50;87
89;03.12.2016;2016;12;14;Lauantai;22;31;53;19;32;51
89;03.12.2016;2016;12;15;Lauantai;34;25;59;27;15;42
89;03.12.2016;2016;12;16;Lauantai;26;31;57;17;15;32
89;03.12.2016;2016;12;17;Lauantai;23;21;44;25;14;39
89;03.12.2016;2016;12;18;Lauantai;24;10;34;13;13;26
89;03.12.2016;2016;12;19;Lauantai;13;9;22;20;13;33
89;03.12.2016;2016;12;20;Lauantai;18;10;28;11;3;14
89;03.12.2016;2016;12;21;Lauantai;7;5;12;11;10;21
89;03.12.2016;2016;12;22;Lauantai;11;12;23;3;8;11
89;03.12.2016;2016;12;23;Lauantai;8;11;19;5;3;8
89;04.12.2016;2016;12;00;Sunnuntai;4;13;17;2;5;7
89;04.12.2016;2016;12;01;Sunnuntai;11;4;15;5;5;10
89;04.12.2016;2016;12;02;Sunnuntai;3;2;5;6;1;7
89;04.12.2016;2016;12;03;Sunnuntai;8;2;10;7;0;7
89;04.12.2016;2016;12;04;Sunnuntai;1;0;1;7;1;8
89;04.12.2016;2016;12;05;Sunnuntai;3;1;4;2;0;2
89;04.12.2016;2016;12;06;Sunnuntai;1;4;5;1;1;2
89;04.12.2016;2016;12;07;Sunnuntai;1;4;5;2;0;2
89;04.12.2016;2016;12;08;Sunnuntai;1;3;4;4;3;7
89;04.12.2016;2016;12;09;Sunnuntai;5;7;12;4;9;13
89;04.12.2016;2016;12;10;Sunnuntai;7;20;27;14;28;42
89;04.12.2016;2016;12;11;Sunnuntai;8;16;24;16;27;43
89;04.12.2016;2016;12;12;Sunnuntai;11;29;40;15;41;56
89;04.12.2016;2016;12;13;Sunnuntai;25;22;47;33;33;66
89;04.12.2016;2016;12;14;Sunnuntai;23;22;45;21;25;46
89;04.12.2016;2016;12;15;Sunnuntai;25;17;42;28;19;47
89;04.12.2016;2016;12;16;Sunnuntai;15;10;25;24;15;39
89;04.12.2016;2016;12;17;Sunnuntai;22;13;35;17;20;37
89;04.12.2016;2016;12;18;Sunnuntai;19;13;32;19;17;36
89;04.12.2016;2016;12;19;Sunnuntai;7;5;12;14;11;25
89;04.12.2016;2016;12;20;Sunnuntai;9;8;17;15;11;26
89;04.12.2016;2016;12;21;Sunnuntai;8;3;11;9;5;14
89;04.12.2016;2016;12;22;Sunnuntai;6;3;9;3;5;8
89;04.12.2016;2016;12;23;Sunnuntai;4;0;4;0;1;1
89;05.12.2016;2016;12;00;Maanantai;1;2;3;1;1;2
89;05.12.2016;2016;12;01;Maanantai;6;2;8;0;1;1
89;05.12.2016;2016;12;02;Maanantai;2;2;4;2;2;4
89;05.12.2016;2016;12;03;Maanantai;0;3;3;3;1;4
89;05.12.2016;2016;12;04;Maanantai;0;3;3;1;3;4
89;05.12.2016;2016;12;05;Maanantai;3;18;21;1;1;2
89;05.12.2016;2016;12;06;Maanantai;3;24;27;2;1;3
89;05.12.2016;2016;12;07;Maanantai;13;58;71;4;24;28
89;05.12.2016;2016;12;08;Maanantai;17;72;89;8;19;27
89;05.12.2016;2016;12;09;Maanantai;29;39;68;5;26;31
89;05.12.2016;2016;12;10;Maanantai;23;32;55;24;39;63
89;05.12.2016;2016;12;11;Maanantai;25;36;61;18;43;61
89;05.12.2016;2016;12;12;Maanantai;34;42;76;24;37;61
89;05.12.2016;2016;12;13;Maanantai;34;33;67;40;45;85
89;05.12.2016;2016;12;14;Maanantai;46;36;82;34;33;67
89;05.12.2016;2016;12;15;Maanantai;72;50;122;30;24;54
89;05.12.2016;2016;12;16;Maanantai;67;48;115;20;14;34
89;05.12.2016;2016;12;17;Maanantai;46;37;83;23;24;47
89;05.12.2016;2016;12;18;Maanantai;36;17;53;12;13;25
89;05.12.2016;2016;12;19;Maanantai;34;23;57;32;16;48
89;05.12.2016;2016;12;20;Maanantai;21;10;31;10;10;20
89;05.12.2016;2016;12;21;Maanantai;19;15;34;11;7;18
89;05.12.2016;2016;12;22;Maanantai;5;9;14;5;4;9
89;05.12.2016;2016;12;23;Maanantai;9;5;14;1;3;4
89;06.12.2016;2016;12;00;Tiistai;10;5;15;5;0;5
89;06.12.2016;2016;12;01;Tiistai;5;1;6;1;3;4
89;06.12.2016;2016;12;02;Tiistai;7;1;8;2;1;3
89;06.12.2016;2016;12;03;Tiistai;3;0;3;3;1;4
89;06.12.2016;2016;12;04;Tiistai;4;0;4;3;0;3
89;06.12.2016;2016;12;05;Tiistai;1;2;3;2;1;3
89;06.12.2016;2016;12;06;Tiistai;3;3;6;0;2;2
89;06.12.2016;2016;12;07;Tiistai;2;3;5;5;1;6
89;06.12.2016;2016;12;08;Tiistai;0;7;7;1;6;7
89;06.12.2016;2016;12;09;Tiistai;4;3;7;8;6;14
89;06.12.2016;2016;12;10;Tiistai;7;10;17;17;19;36
89;06.12.2016;2016;12;11;Tiistai;9;14;23;24;23;47
89;06.12.2016;2016;12;12;Tiistai;7;11;18;25;30;55
89;06.12.2016;2016;12;13;Tiistai;9;18;27;34;26;60
89;06.12.2016;2016;12;14;Tiistai;11;20;31;26;23;49
89;06.12.2016;2016;12;15;Tiistai;19;19;38;15;22;37
89;06.12.2016;2016;12;16;Tiistai;19;11;30;11;11;22
89;06.12.2016;2016;12;17;Tiistai;19;13;32;16;25;41
89;06.12.2016;2016;12;18;Tiistai;26;7;33;20;15;35
89;06.12.2016;2016;12;19;Tiistai;14;2;16;11;9;20
89;06.12.2016;2016;12;20;Tiistai;7;8;15;6;10;16
89;06.12.2016;2016;12;21;Tiistai;8;13;21;10;7;17
89;06.12.2016;2016;12;22;Tiistai;5;5;10;6;1;7
89;06.12.2016;2016;12;23;Tiistai;2;4;6;3;3;6
89;07.12.2016;2016;12;00;Keskiviikko;4;0;4;1;0;1
89;07.12.2016;2016;12;01;Keskiviikko;1;1;2;0;1;1
89;07.12.2016;2016;12;02;Keskiviikko;1;0;1;0;1;1
89;07.12.2016;2016;12;03;Keskiviikko;2;0;2;0;0;0
89;07.12.2016;2016;12;04;Keskiviikko;1;1;2;0;0;0
89;07.12.2016;2016;12;05;Keskiviikko;5;6;11;2;1;3
89;07.12.2016;2016;12;06;Keskiviikko;16;30;46;4;6;10
89;07.12.2016;2016;12;07;Keskiviikko;39;99;138;6;32;38
89;07.12.2016;2016;12;08;Keskiviikko;34;118;152;16;37;53
89;07.12.2016;2016;12;09;Keskiviikko;41;75;116;18;39;57
89;07.12.2016;2016;12;10;Keskiviikko;37;33;70;22;32;54
89;07.12.2016;2016;12;11;Keskiviikko;37;37;74;28;27;55
89;07.12.2016;2016;12;12;Keskiviikko;43;43;86;31;29;60
89;07.12.2016;2016;12;13;Keskiviikko;67;54;121;38;34;72
89;07.12.2016;2016;12;14;Keskiviikko;74;55;129;35;20;55
89;07.12.2016;2016;12;15;Keskiviikko;105;44;149;40;28;68
89;07.12.2016;2016;12;16;Keskiviikko;117;57;174;40;30;70
89;07.12.2016;2016;12;17;Keskiviikko;76;46;122;28;19;47
89;07.12.2016;2016;12;18;Keskiviikko;58;28;86;34;38;72
89;07.12.2016;2016;12;19;Keskiviikko;40;18;58;32;37;69
89;07.12.2016;2016;12;20;Keskiviikko;25;15;40;24;14;38
89;07.12.2016;2016;12;21;Keskiviikko;27;9;36;21;8;29
89;07.12.2016;2016;12;22;Keskiviikko;9;9;18;2;6;8
89;07.12.2016;2016;12;23;Keskiviikko;8;3;11;4;1;5
89;08.12.2016;2016;12;00;Torstai;3;3;6;2;3;5
89;08.12.2016;2016;12;01;Torstai;3;5;8;0;2;2
89;08.12.2016;2016;12;02;Torstai;10;1;11;1;1;2
89;08.12.2016;2016;12;03;Torstai;4;1;5;1;0;1
89;08.12.2016;2016;12;04;Torstai;3;0;3;1;0;1
89;08.12.2016;2016;12;05;Torstai;4;6;10;3;0;3
89;08.12.2016;2016;12;06;Torstai;15;30;45;6;6;12
89;08.12.2016;2016;12;07;Torstai;32;110;142;11;32;43
89;08.12.2016;2016;12;08;Torstai;33;140;173;12;30;42
89;08.12.2016;2016;12;09;Torstai;29;73;102;24;41;65
89;08.12.2016;2016;12;10;Torstai;26;53;79;28;28;56
89;08.12.2016;2016;12;11;Torstai;33;61;94;27;32;59
89;08.12.2016;2016;12;12;Torstai;51;36;87;27;29;56
89;08.12.2016;2016;12;13;Torstai;65;55;120;24;26;50
89;08.12.2016;2016;12;14;Torstai;69;55;124;19;31;50
89;08.12.2016;2016;12;15;Torstai;111;49;160;37;30;67
89;08.12.2016;2016;12;16;Torstai;131;53;184;46;38;84
89;08.12.2016;2016;12;17;Torstai;71;46;117;24;17;41
89;08.12.2016;2016;12;18;Torstai;59;31;90;28;29;57
89;08.12.2016;2016;12;19;Torstai;48;27;75;22;22;44
89;08.12.2016;2016;12;20;Torstai;47;26;73;18;15;33
89;08.12.2016;2016;12;21;Torstai;22;8;30;13;3;16
89;08.12.2016;2016;12;22;Torstai;19;11;30;2;7;9
89;08.12.2016;2016;12;23;Torstai;13;9;22;3;4;7
89;09.12.2016;2016;12;00;Perjantai;4;1;5;3;0;3
89;09.12.2016;2016;12;01;Perjantai;2;1;3;1;1;2
89;09.12.2016;2016;12;02;Perjantai;5;3;8;1;0;1
89;09.12.2016;2016;12;03;Perjantai;8;1;9;1;1;2
89;09.12.2016;2016;12;04;Perjantai;2;4;6;1;1;2
89;09.12.2016;2016;12;05;Perjantai;9;4;13;1;3;4
89;09.12.2016;2016;12;06;Perjantai;9;34;43;2;11;13
89;09.12.2016;2016;12;07;Perjantai;27;108;135;9;34;43
89;09.12.2016;2016;12;08;Perjantai;17;124;141;8;35;43
89;09.12.2016;2016;12;09;Perjantai;19;81;100;17;35;52
89;09.12.2016;2016;12;10;Perjantai;30;67;97;22;37;59
89;09.12.2016;2016;12;11;Perjantai;37;57;94;31;32;63
89;09.12.2016;2016;12;12;Perjantai;48;56;104;26;35;61
89;09.12.2016;2016;12;13;Perjantai;78;50;128;32;25;57
89;09.12.2016;2016;12;14;Perjantai;78;61;139;26;27;53
89;09.12.2016;2016;12;15;Perjantai;99;50;149;36;33;69
89;09.12.2016;2016;12;16;Perjantai;89;44;133;29;21;50
89;09.12.2016;2016;12;17;Perjantai;65;36;101;27;20;47
89;09.12.2016;2016;12;18;Perjantai;38;40;78;10;20;30
89;09.12.2016;2016;12;19;Perjantai;36;29;65;10;11;21
89;09.12.2016;2016;12;20;Perjantai;31;17;48;7;9;16
89;09.12.2016;2016;12;21;Perjantai;36;16;52;8;4;12
89;09.12.2016;2016;12;22;Perjantai;11;20;31;1;7;8
89;09.12.2016;2016;12;23;Perjantai;12;13;25;6;2;8
89;10.12.2016;2016;12;00;Lauantai;18;7;25;8;5;13
89;10.12.2016;2016;12;01;Lauantai;18;1;19;5;1;6
89;10.12.2016;2016;12;02;Lauantai;11;3;14;3;1;4
89;10.12.2016;2016;12;03;Lauantai;15;2;17;5;1;6
89;10.12.2016;2016;12;04;Lauantai;14;1;15;3;0;3
89;10.12.2016;2016;12;05;Lauantai;1;2;3;2;0;2
89;10.12.2016;2016;12;06;Lauantai;4;9;13;2;3;5
89;10.12.2016;2016;12;07;Lauantai;3;10;13;2;6;8
89;10.12.2016;2016;12;08;Lauantai;2;12;14;8;14;22
89;10.12.2016;2016;12;09;Lauantai;6;27;33;13;10;23
89;10.12.2016;2016;12;10;Lauantai;7;35;42;15;23;38
89;10.12.2016;2016;12;11;Lauantai;15;46;61;25;37;62
89;10.12.2016;2016;12;12;Lauantai;26;35;61;27;38;65
89;10.12.2016;2016;12;13;Lauantai;34;40;74;20;37;57
89;10.12.2016;2016;12;14;Lauantai;42;43;85;29;33;62
89;10.12.2016;2016;12;15;Lauantai;39;25;64;35;27;62
89;10.12.2016;2016;12;16;Lauantai;48;27;75;28;24;52
89;10.12.2016;2016;12;17;Lauantai;27;20;47;25;25;50
89;10.12.2016;2016;12;18;Lauantai;33;33;66;23;17;40
89;10.12.2016;2016;12;19;Lauantai;21;19;40;12;17;29
89;10.12.2016;2016;12;20;Lauantai;15;16;31;12;19;31
89;10.12.2016;2016;12;21;Lauantai;26;9;35;5;3;8
89;10.12.2016;2016;12;22;Lauantai;11;12;23;2;6;8
89;10.12.2016;2016;12;23;Lauantai;9;14;23;6;8;14
89;11.12.2016;2016;12;00;Sunnuntai;19;8;27;7;13;20
89;11.12.2016;2016;12;01;Sunnuntai;11;5;16;1;0;1
89;11.12.2016;2016;12;02;Sunnuntai;11;2;13;5;1;6
89;11.12.2016;2016;12;03;Sunnuntai;9;1;10;7;3;10
89;11.12.2016;2016;12;04;Sunnuntai;13;4;17;10;0;10
89;11.12.2016;2016;12;05;Sunnuntai;2;3;5;5;0;5
89;11.12.2016;2016;12;06;Sunnuntai;1;7;8;2;4;6
89;11.12.2016;2016;12;07;Sunnuntai;5;4;9;0;3;3
89;11.12.2016;2016;12;08;Sunnuntai;1;6;7;6;6;12
89;11.12.2016;2016;12;09;Sunnuntai;2;8;10;6;8;14
89;11.12.2016;2016;12;10;Sunnuntai;9;12;21;21;13;34
89;11.12.2016;2016;12;11;Sunnuntai;7;27;34;28;38;66
89;11.12.2016;2016;12;12;Sunnuntai;17;22;39;35;48;83
89;11.12.2016;2016;12;13;Sunnuntai;18;26;44;37;52;89
89;11.12.2016;2016;12;14;Sunnuntai;24;37;61;41;47;88
89;11.12.2016;2016;12;15;Sunnuntai;27;26;53;26;20;46
89;11.12.2016;2016;12;16;Sunnuntai;38;20;58;14;35;49
89;11.12.2016;2016;12;17;Sunnuntai;33;15;48;32;19;51
89;11.12.2016;2016;12;18;Sunnuntai;28;15;43;32;18;50
89;11.12.2016;2016;12;19;Sunnuntai;8;7;15;20;25;45
89;11.12.2016;2016;12;20;Sunnuntai;11;12;23;15;14;29
89;11.12.2016;2016;12;21;Sunnuntai;15;17;32;9;9;18
89;11.12.2016;2016;12;22;Sunnuntai;9;4;13;6;2;8
89;11.12.2016;2016;12;23;Sunnuntai;3;2;5;1;2;3
89;12.12.2016;2016;12;00;Maanantai;3;2;5;3;2;5
89;12.12.2016;2016;12;01;Maanantai;0;4;4;1;1;2
89;12.12.2016;2016;12;02;Maanantai;1;0;1;1;0;1
89;12.12.2016;2016;12;03;Maanantai;3;0;3;0;0;0
89;12.12.2016;2016;12;04;Maanantai;5;3;8;2;0;2
89;12.12.2016;2016;12;05;Maanantai;4;12;16;1;1;2
89;12.12.2016;2016;12;06;Maanantai;8;18;26;1;4;5
89;12.12.2016;2016;12;07;Maanantai;14;90;104;4;30;34
89;12.12.2016;2016;12;08;Maanantai;22;143;165;10;43;53
89;12.12.2016;2016;12;09;Maanantai;23;81;104;12;33;45
89;12.12.2016;2016;12;10;Maanantai;22;54;76;14;47;61
89;12.12.2016;2016;12;11;Maanantai;28;40;68;18;35;53
89;12.12.2016;2016;12;12;Maanantai;41;49;90;26;34;60
89;12.12.2016;2016;12;13;Maanantai;40;50;90;30;39;69
89;12.12.2016;2016;12;14;Maanantai;48;24;72;30;23;53
89;12.12.2016;2016;12;15;Maanantai;115;27;142;32;23;55
89;12.12.2016;2016;12;16;Maanantai;116;34;150;37;25;62
89;12.12.2016;2016;12;17;Maanantai;74;28;102;23;20;43
89;12.12.2016;2016;12;18;Maanantai;45;23;68;23;18;41
89;12.12.2016;2016;12;19;Maanantai;29;18;47;29;19;48
89;12.12.2016;2016;12;20;Maanantai;28;11;39;19;12;31
89;12.12.2016;2016;12;21;Maanantai;25;12;37;13;10;23
89;12.12.2016;2016;12;22;Maanantai;8;8;16;4;4;8
89;12.12.2016;2016;12;23;Maanantai;3;4;7;0;1;1
89;13.12.2016;2016;12;00;Tiistai;2;1;3;2;0;2
89;13.12.2016;2016;12;01;Tiistai;1;1;2;0;0;0
89;13.12.2016;2016;12;02;Tiistai;0;1;1;2;2;4
89;13.12.2016;2016;12;03;Tiistai;1;2;3;0;0;0
89;13.12.2016;2016;12;04;Tiistai;2;2;4;1;0;1
89;13.12.2016;2016;12;05;Tiistai;2;7;9;1;0;1
89;13.12.2016;2016;12;06;Tiistai;5;27;32;2;6;8
89;13.12.2016;2016;12;07;Tiistai;17;81;98;8;27;35
89;13.12.2016;2016;12;08;Tiistai;32;127;159;10;43;53
89;13.12.2016;2016;12;09;Tiistai;22;59;81;13;32;45
89;13.12.2016;2016;12;10;Tiistai;21;52;73;19;48;67
89;13.12.2016;2016;12;11;Tiistai;24;40;64;32;25;57
89;13.12.2016;2016;12;12;Tiistai;32;48;80;26;28;54
89;13.12.2016;2016;12;13;Tiistai;55;45;100;24;39;63
89;13.12.2016;2016;12;14;Tiistai;62;53;115;37;30;67
89;13.12.2016;2016;12;15;Tiistai;113;38;151;46;30;76
89;13.12.2016;2016;12;16;Tiistai;120;60;180;38;23;61
89;13.12.2016;2016;12;17;Tiistai;82;30;112;35;20;55
89;13.12.2016;2016;12;18;Tiistai;70;27;97;24;31;55
89;13.12.2016;2016;12;19;Tiistai;37;34;71;27;29;56
89;13.12.2016;2016;12;20;Tiistai;27;15;42;32;17;49
89;13.12.2016;2016;12;21;Tiistai;26;8;34;20;14;34
89;13.12.2016;2016;12;22;Tiistai;19;8;27;5;1;6
89;13.12.2016;2016;12;23;Tiistai;8;5;13;4;4;8
89;14.12.2016;2016;12;00;Keskiviikko;7;3;10;1;3;4
89;14.12.2016;2016;12;01;Keskiviikko;2;4;6;0;2;2
89;14.12.2016;2016;12;02;Keskiviikko;2;0;2;0;1;1
89;14.12.2016;2016;12;03;Keskiviikko;6;0;6;0;0;0
89;14.12.2016;2016;12;04;Keskiviikko;5;4;9;2;3;5
89;14.12.2016;2016;12;05;Keskiviikko;4;9;13;2;4;6
89;14.12.2016;2016;12;06;Keskiviikko;7;24;31;2;7;9
89;14.12.2016;2016;12;07;Keskiviikko;21;88;109;3;26;29
89;14.12.2016;2016;12;08;Keskiviikko;23;149;172;19;59;78
89;14.12.2016;2016;12;09;Keskiviikko;28;84;112;19;34;53
89;14.12.2016;2016;12;10;Keskiviikko;28;47;75;14;53;67
89;14.12.2016;2016;12;11;Keskiviikko;41;54;95;39;32;71
89;14.12.2016;2016;12;12;Keskiviikko;38;53;91;28;32;60
89;14.12.2016;2016;12;13;Keskiviikko;46;48;94;33;28;61
89;14.12.2016;2016;12;14;Keskiviikko;86;45;131;35;20;55
89;14.12.2016;2016;12;15;Keskiviikko;102;49;151;37;26;63
89;14.12.2016;2016;12;16;Keskiviikko;122;54;176;51;35;86
89;14.12.2016;2016;12;17;Keskiviikko;76;38;114;35;23;58
89;14.12.2016;2016;12;18;Keskiviikko;61;44;105;33;17;50
89;14.12.2016;2016;12;19;Keskiviikko;58;23;81;25;27;52
89;14.12.2016;2016;12;20;Keskiviikko;43;21;64;21;11;32
89;14.12.2016;2016;12;21;Keskiviikko;40;24;64;14;9;23
89;14.12.2016;2016;12;22;Keskiviikko;25;10;35;13;4;17
89;14.12.2016;2016;12;23;Keskiviikko;7;10;17;1;1;2
89;15.12.2016;2016;12;00;Torstai;5;5;10;1;2;3
89;15.12.2016;2016;12;01;Torstai;5;5;10;0;0;0
89;15.12.2016;2016;12;02;Torstai;5;5;10;0;0;0
89;15.12.2016;2016;12;03;Torstai;3;1;4;0;0;0
89;15.12.2016;2016;12;04;Torstai;4;4;8;1;1;2
89;15.12.2016;2016;12;05;Torstai;1;8;9;3;1;4
89;15.12.2016;2016;12;06;Torstai;10;28;38;1;6;7
89;15.12.2016;2016;12;07;Torstai;24;99;123;4;29;33
89;15.12.2016;2016;12;08;Torstai;31;116;147;12;43;55
89;15.12.2016;2016;12;09;Torstai;24;74;98;25;32;57
89;15.12.2016;2016;12;10;Torstai;28;57;85;23;44;67
89;15.12.2016;2016;12;11;Torstai;40;55;95;19;33;52
89;15.12.2016;2016;12;12;Torstai;49;54;103;22;29;51
89;15.12.2016;2016;12;13;Torstai;53;67;120;28;32;60
89;15.12.2016;2016;12;14;Torstai;66;36;102;38;29;67
89;15.12.2016;2016;12;15;Torstai;120;52;172;32;23;55
89;15.12.2016;2016;12;16;Torstai;128;48;176;51;28;79
89;15.12.2016;2016;12;17;Torstai;91;53;144;27;45;72
89;15.12.2016;2016;12;18;Torstai;64;43;107;23;25;48
89;15.12.2016;2016;12;19;Torstai;61;26;87;38;36;74
89;15.12.2016;2016;12;20;Torstai;58;18;76;32;24;56
89;15.12.2016;2016;12;21;Torstai;48;13;61;16;9;25
89;15.12.2016;2016;12;22;Torstai;21;11;32;6;9;15
89;15.12.2016;2016;12;23;Torstai;9;5;14;4;1;5
89;16.12.2016;2016;12;00;Perjantai;7;3;10;0;5;5
89;16.12.2016;2016;12;01;Perjantai;1;2;3;1;1;2
89;16.12.2016;2016;12;02;Perjantai;4;1;5;3;0;3
89;16.12.2016;2016;12;03;Perjantai;5;1;6;1;0;1
89;16.12.2016;2016;12;04;Perjantai;2;2;4;1;0;1
89;16.12.2016;2016;12;05;Perjantai;3;10;13;1;1;2
89;16.12.2016;2016;12;06;Perjantai;7;27;34;0;6;6
89;16.12.2016;2016;12;07;Perjantai;17;74;91;3;33;36
89;16.12.2016;2016;12;08;Perjantai;27;112;139;12;44;56
89;16.12.2016;2016;12;09;Perjantai;30;83;113;11;26;37
89;16.12.2016;2016;12;10;Perjantai;27;53;80;19;37;56
89;16.12.2016;2016;12;11;Perjantai;41;58;99;15;31;46
89;16.12.2016;2016;12;12;Perjantai;42;54;96;27;46;73
89;16.12.2016;2016;12;13;Perjantai;58;58;116;36;40;76
89;16.12.2016;2016;12;14;Perjantai;83;42;125;41;31;72
89;16.12.2016;2016;12;15;Perjantai;99;43;142;48;25;73
89;16.12.2016;2016;12;16;Perjantai;99;40;139;28;19;47
89;16.12.2016;2016;12;17;Perjantai;76;57;133;22;23;45
89;16.12.2016;2016;12;18;Perjantai;48;42;90;31;26;57
89;16.12.2016;2016;12;19;Perjantai;39;22;61;22;12;34
89;16.12.2016;2016;12;20;Perjantai;25;26;51;13;16;29
89;16.12.2016;2016;12;21;Perjantai;38;20;58;21;15;36
89;16.12.2016;2016;12;22;Perjantai;21;13;34;10;7;17
89;16.12.2016;2016;12;23;Perjantai;10;23;33;7;8;15
89;17.12.2016;2016;12;00;Lauantai;12;7;19;4;11;15
89;17.12.2016;2016;12;01;Lauantai;14;7;21;4;1;5
89;17.12.2016;2016;12;02;Lauantai;9;4;13;10;3;13
89;17.12.2016;2016;12;03;Lauantai;4;0;4;9;0;9
89;17.12.2016;2016;12;04;Lauantai;11;1;12;8;1;9
89;17.12.2016;2016;12;05;Lauantai;5;3;8;2;2;4
89;17.12.2016;2016;12;06;Lauantai;1;9;10;0;4;4
89;17.12.2016;2016;12;07;Lauantai;1;8;9;4;6;10
89;17.12.2016;2016;12;08;Lauantai;6;19;25;3;7;10
89;17.12.2016;2016;12;09;Lauantai;12;37;49;13;21;34
89;17.12.2016;2016;12;10;Lauantai;17;39;56;15;32;47
89;17.12.2016;2016;12;11;Lauantai;22;50;72;16;43;59
89;17.12.2016;2016;12;12;Lauantai;36;43;79;32;39;71
89;17.12.2016;2016;12;13;Lauantai;38;63;101;18;44;62
89;17.12.2016;2016;12;14;Lauantai;43;56;99;41;73;114
89;17.12.2016;2016;12;15;Lauantai;50;42;92;52;58;110
89;17.12.2016;2016;12;16;Lauantai;51;35;86;50;27;77
89;17.12.2016;2016;12;17;Lauantai;38;22;60;31;19;50
89;17.12.2016;2016;12;18;Lauantai;42;13;55;17;25;42
89;17.12.2016;2016;12;19;Lauantai;20;21;41;16;21;37
89;17.12.2016;2016;12;20;Lauantai;30;25;55;14;17;31
89;17.12.2016;2016;12;21;Lauantai;26;13;39;12;7;19
89;17.12.2016;2016;12;22;Lauantai;14;15;29;8;10;18
89;17.12.2016;2016;12;23;Lauantai;8;25;33;3;7;10
89;18.12.2016;2016;12;00;Sunnuntai;9;22;31;5;13;18
89;18.12.2016;2016;12;01;Sunnuntai;8;8;16;2;3;5
89;18.12.2016;2016;12;02;Sunnuntai;13;2;15;6;2;8
89;18.12.2016;2016;12;03;Sunnuntai;13;0;13;6;1;7
89;18.12.2016;2016;12;04;Sunnuntai;10;0;10;6;2;8
89;18.12.2016;2016;12;05;Sunnuntai;4;2;6;2;0;2
89;18.12.2016;2016;12;06;Sunnuntai;3;2;5;1;3;4
89;18.12.2016;2016;12;07;Sunnuntai;1;1;2;2;2;4
89;18.12.2016;2016;12;08;Sunnuntai;1;3;4;6;6;12
89;18.12.2016;2016;12;09;Sunnuntai;7;10;17;10;11;21
89;18.12.2016;2016;12;10;Sunnuntai;13;27;40;23;22;45
89;18.12.2016;2016;12;11;Sunnuntai;13;39;52;32;43;75
89;18.12.2016;2016;12;12;Sunnuntai;21;40;61;34;50;84
89;18.12.2016;2016;12;13;Sunnuntai;35;28;63;42;46;88
89;18.12.2016;2016;12;14;Sunnuntai;31;46;77;29;52;81
89;18.12.2016;2016;12;15;Sunnuntai;32;41;73;28;34;62
89;18.12.2016;2016;12;16;Sunnuntai;37;34;71;30;28;58
89;18.12.2016;2016;12;17;Sunnuntai;31;27;58;21;16;37
89;18.12.2016;2016;12;18;Sunnuntai;36;18;54;30;20;50
89;18.12.2016;2016;12;19;Sunnuntai;20;15;35;28;25;53
89;18.12.2016;2016;12;20;Sunnuntai;20;15;35;23;17;40
89;18.12.2016;2016;12;21;Sunnuntai;22;14;36;17;12;29
89;18.12.2016;2016;12;22;Sunnuntai;7;3;10;6;7;13
89;18.12.2016;2016;12;23;Sunnuntai;3;3;6;1;1;2
89;19.12.2016;2016;12;00;Maanantai;3;1;4;1;1;2
89;19.12.2016;2016;12;01;Maanantai;2;3;5;1;1;2
89;19.12.2016;2016;12;02;Maanantai;1;1;2;1;0;1
89;19.12.2016;2016;12;03;Maanantai;3;2;5;0;1;1
89;19.12.2016;2016;12;04;Maanantai;3;3;6;1;0;1
89;19.12.2016;2016;12;05;Maanantai;9;14;23;2;1;3
89;19.12.2016;2016;12;06;Maanantai;10;24;34;2;6;8
89;19.12.2016;2016;12;07;Maanantai;19;85;104;5;23;28
89;19.12.2016;2016;12;08;Maanantai;19;134;153;11;32;43
89;19.12.2016;2016;12;09;Maanantai;24;69;93;7;30;37
89;19.12.2016;2016;12;10;Maanantai;25;51;76;17;35;52
89;19.12.2016;2016;12;11;Maanantai;25;59;84;17;33;50
89;19.12.2016;2016;12;12;Maanantai;50;48;98;19;29;48
89;19.12.2016;2016;12;13;Maanantai;69;43;112;30;24;54
89;19.12.2016;2016;12;14;Maanantai;77;41;118;27;19;46
89;19.12.2016;2016;12;15;Maanantai;117;40;157;33;17;50
89;19.12.2016;2016;12;16;Maanantai;116;41;157;26;27;53
89;19.12.2016;2016;12;17;Maanantai;67;32;99;29;17;46
89;19.12.2016;2016;12;18;Maanantai;54;33;87;28;17;45
89;19.12.2016;2016;12;19;Maanantai;53;22;75;24;21;45
89;19.12.2016;2016;12;20;Maanantai;25;18;43;20;16;36
89;19.12.2016;2016;12;21;Maanantai;24;11;35;14;5;19
89;19.12.2016;2016;12;22;Maanantai;8;10;18;7;6;13
89;19.12.2016;2016;12;23;Maanantai;14;4;18;2;3;5
89;20.12.2016;2016;12;00;Tiistai;4;0;4;1;2;3
89;20.12.2016;2016;12;01;Tiistai;7;0;7;3;1;4
89;20.12.2016;2016;12;02;Tiistai;1;0;1;1;1;2
89;20.12.2016;2016;12;03;Tiistai;0;1;1;0;0;0
89;20.12.2016;2016;12;04;Tiistai;3;1;4;1;0;1
89;20.12.2016;2016;12;05;Tiistai;9;11;20;0;1;1
89;20.12.2016;2016;12;06;Tiistai;9;27;36;2;6;8
89;20.12.2016;2016;12;07;Tiistai;18;65;83;3;21;24
89;20.12.2016;2016;12;08;Tiistai;20;90;110;6;35;41
89;20.12.2016;2016;12;09;Tiistai;16;67;83;6;24;30
89;20.12.2016;2016;12;10;Tiistai;28;41;69;8;31;39
89;20.12.2016;2016;12;11;Tiistai;28;52;80;15;21;36
89;20.12.2016;2016;12;12;Tiistai;36;56;92;18;20;38
89;20.12.2016;2016;12;13;Tiistai;51;45;96;21;26;47
89;20.12.2016;2016;12;14;Tiistai;85;47;132;22;27;49
89;20.12.2016;2016;12;15;Tiistai;81;47;128;13;14;27
89;20.12.2016;2016;12;16;Tiistai;91;33;124;35;13;48
89;20.12.2016;2016;12;17;Tiistai;68;30;98;18;8;26
89;20.12.2016;2016;12;18;Tiistai;49;29;78;26;19;45
89;20.12.2016;2016;12;19;Tiistai;40;25;65;30;7;37
89;20.12.2016;2016;12;20;Tiistai;37;5;42;9;10;19
89;20.12.2016;2016;12;21;Tiistai;25;8;33;13;9;22
89;20.12.2016;2016;12;22;Tiistai;11;5;16;7;6;13
89;20.12.2016;2016;12;23;Tiistai;8;4;12;4;4;8
89;21.12.2016;2016;12;00;Keskiviikko;4;1;5;3;2;5
89;21.12.2016;2016;12;01;Keskiviikko;3;0;3;0;2;2
89;21.12.2016;2016;12;02;Keskiviikko;1;0;1;5;1;6
89;21.12.2016;2016;12;03;Keskiviikko;0;0;0;0;0;0
89;21.12.2016;2016;12;04;Keskiviikko;4;0;4;0;1;1
89;21.12.2016;2016;12;05;Keskiviikko;9;4;13;1;2;3
89;21.12.2016;2016;12;06;Keskiviikko;12;20;32;2;3;5
89;21.12.2016;2016;12;07;Keskiviikko;39;68;107;3;15;18
89;21.12.2016;2016;12;08;Keskiviikko;30;93;123;5;31;36
89;21.12.2016;2016;12;09;Keskiviikko;16;57;73;8;33;41
89;21.12.2016;2016;12;10;Keskiviikko;20;54;74;9;25;34
89;21.12.2016;2016;12;11;Keskiviikko;34;41;75;22;25;47
89;21.12.2016;2016;12;12;Keskiviikko;37;48;85;22;22;44
89;21.12.2016;2016;12;13;Keskiviikko;46;58;104;26;24;50
89;21.12.2016;2016;12;14;Keskiviikko;69;32;101;36;55;91
89;21.12.2016;2016;12;15;Keskiviikko;75;29;104;19;25;44
89;21.12.2016;2016;12;16;Keskiviikko;93;37;130;22;16;38
89;21.12.2016;2016;12;17;Keskiviikko;64;31;95;17;16;33
89;21.12.2016;2016;12;18;Keskiviikko;36;21;57;23;21;44
89;21.12.2016;2016;12;19;Keskiviikko;40;15;55;18;17;35
89;21.12.2016;2016;12;20;Keskiviikko;28;14;42;23;5;28
89;21.12.2016;2016;12;21;Keskiviikko;20;5;25;12;14;26
89;21.12.2016;2016;12;22;Keskiviikko;10;13;23;4;10;14
89;21.12.2016;2016;12;23;Keskiviikko;6;7;13;3;1;4
89;22.12.2016;2016;12;00;Torstai;7;11;18;3;3;6
89;22.12.2016;2016;12;01;Torstai;7;1;8;3;1;4
89;22.12.2016;2016;12;02;Torstai;4;1;5;1;2;3
89;22.12.2016;2016;12;03;Torstai;2;1;3;3;0;3
89;22.12.2016;2016;12;04;Torstai;11;2;13;1;0;1
89;22.12.2016;2016;12;05;Torstai;8;2;10;2;1;3
89;22.12.2016;2016;12;06;Torstai;5;23;28;2;4;6
89;22.12.2016;2016;12;07;Torstai;12;62;74;4;18;22
89;22.12.2016;2016;12;08;Torstai;14;68;82;5;27;32
89;22.12.2016;2016;12;09;Torstai;18;52;70;5;29;34
89;22.12.2016;2016;12;10;Torstai;19;38;57;15;21;36
89;22.12.2016;2016;12;11;Torstai;25;53;78;23;24;47
89;22.12.2016;2016;12;12;Torstai;34;45;79;20;33;53
89;22.12.2016;2016;12;13;Torstai;39;52;91;16;27;43
89;22.12.2016;2016;12;14;Torstai;42;42;84;38;27;65
89;22.12.2016;2016;12;15;Torstai;70;31;101;27;23;50
89;22.12.2016;2016;12;16;Torstai;72;47;119;36;19;55
89;22.12.2016;2016;12;17;Torstai;53;27;80;19;14;33
89;22.12.2016;2016;12;18;Torstai;37;19;56;15;14;29
89;22.12.2016;2016;12;19;Torstai;32;26;58;17;11;28
89;22.12.2016;2016;12;20;Torstai;28;9;37;18;4;22
89;22.12.2016;2016;12;21;Torstai;18;7;25;11;12;23
89;22.12.2016;2016;12;22;Torstai;8;8;16;5;5;10
89;22.12.2016;2016;12;23;Torstai;10;8;18;4;3;7
89;23.12.2016;2016;12;00;Perjantai;2;3;5;4;4;8
89;23.12.2016;2016;12;01;Perjantai;0;0;0;2;0;2
89;23.12.2016;2016;12;02;Perjantai;3;0;3;2;1;3
89;23.12.2016;2016;12;03;Perjantai;1;3;4;5;0;5
89;23.12.2016;2016;12;04;Perjantai;6;3;9;1;1;2
89;23.12.2016;2016;12;05;Perjantai;6;3;9;1;1;2
89;23.12.2016;2016;12;06;Perjantai;5;19;24;2;5;7
89;23.12.2016;2016;12;07;Perjantai;10;41;51;6;16;22
89;23.12.2016;2016;12;08;Perjantai;12;45;57;7;18;25
89;23.12.2016;2016;12;09;Perjantai;15;29;44;4;22;26
89;23.12.2016;2016;12;10;Perjantai;19;35;54;14;29;43
89;23.12.2016;2016;12;11;Perjantai;20;42;62;21;36;57
89;23.12.2016;2016;12;12;Perjantai;25;50;75;24;40;64
89;23.12.2016;2016;12;13;Perjantai;31;44;75;27;25;52
89;23.12.2016;2016;12;14;Perjantai;59;34;93;35;20;55
89;23.12.2016;2016;12;15;Perjantai;48;38;86;22;22;44
89;23.12.2016;2016;12;16;Perjantai;48;27;75;22;22;44
89;23.12.2016;2016;12;17;Perjantai;20;19;39;21;13;34
89;23.12.2016;2016;12;18;Perjantai;25;14;39;14;13;27
89;23.12.2016;2016;12;19;Perjantai;20;10;30;22;20;42
89;23.12.2016;2016;12;20;Perjantai;15;11;26;12;13;25
89;23.12.2016;2016;12;21;Perjantai;21;10;31;5;6;11
89;23.12.2016;2016;12;22;Perjantai;5;3;8;11;4;15
89;23.12.2016;2016;12;23;Perjantai;4;6;10;2;4;6
89;24.12.2016;2016;12;00;Lauantai;6;3;9;1;0;1
89;24.12.2016;2016;12;01;Lauantai;0;0;0;0;0;0
89;24.12.2016;2016;12;02;Lauantai;2;2;4;2;3;5
89;24.12.2016;2016;12;03;Lauantai;4;2;6;0;0;0
89;24.12.2016;2016;12;04;Lauantai;2;2;4;2;1;3
89;24.12.2016;2016;12;05;Lauantai;3;2;5;0;1;1
89;24.12.2016;2016;12;06;Lauantai;2;3;5;1;5;6
89;24.12.2016;2016;12;07;Lauantai;1;5;6;2;2;4
89;24.12.2016;2016;12;08;Lauantai;0;4;4;6;7;13
89;24.12.2016;2016;12;09;Lauantai;10;7;17;7;18;25
89;24.12.2016;2016;12;10;Lauantai;7;15;22;20;21;41
89;24.12.2016;2016;12;11;Lauantai;11;22;33;19;14;33
89;24.12.2016;2016;12;12;Lauantai;17;12;29;10;14;24
89;24.12.2016;2016;12;13;Lauantai;19;7;26;15;16;31
89;24.12.2016;2016;12;14;Lauantai;9;6;15;23;11;34
89;24.12.2016;2016;12;15;Lauantai;12;4;16;9;2;11
89;24.12.2016;2016;12;16;Lauantai;2;2;4;11;7;18
89;24.12.2016;2016;12;17;Lauantai;0;4;4;10;0;10
89;24.12.2016;2016;12;18;Lauantai;2;1;3;13;2;15
89;24.12.2016;2016;12;19;Lauantai;4;1;5;12;0;12
89;24.12.2016;2016;12;20;Lauantai;1;2;3;10;2;12
89;24.12.2016;2016;12;21;Lauantai;5;0;5;8;3;11
89;24.12.2016;2016;12;22;Lauantai;6;1;7;9;0;9
89;24.12.2016;2016;12;23;Lauantai;4;1;5;2;0;2
89;25.12.2016;2016;12;00;Sunnuntai;2;0;2;4;1;5
89;25.12.2016;2016;12;01;Sunnuntai;0;1;1;1;1;2
89;25.12.2016;2016;12;02;Sunnuntai;3;0;3;3;1;4
89;25.12.2016;2016;12;03;Sunnuntai;2;0;2;2;0;2
89;25.12.2016;2016;12;04;Sunnuntai;0;0;0;4;0;4
89;25.12.2016;2016;12;05;Sunnuntai;0;0;0;0;0;0
89;25.12.2016;2016;12;06;Sunnuntai;4;2;6;0;2;2
89;25.12.2016;2016;12;07;Sunnuntai;5;1;6;9;3;12
89;25.12.2016;2016;12;08;Sunnuntai;4;1;5;7;4;11
89;25.12.2016;2016;12;09;Sunnuntai;8;2;10;14;2;16
89;25.12.2016;2016;12;10;Sunnuntai;11;1;12;25;4;29
89;25.12.2016;2016;12;11;Sunnuntai;5;6;11;41;15;56
89;25.12.2016;2016;12;12;Sunnuntai;23;6;29;51;14;65
89;25.12.2016;2016;12;13;Sunnuntai;25;10;35;55;25;80
89;25.12.2016;2016;12;14;Sunnuntai;16;7;23;56;20;76
89;25.12.2016;2016;12;15;Sunnuntai;13;9;22;45;14;59
89;25.12.2016;2016;12;16;Sunnuntai;8;0;8;32;27;59
89;25.12.2016;2016;12;17;Sunnuntai;15;6;21;29;18;47
89;25.12.2016;2016;12;18;Sunnuntai;13;8;21;21;5;26
89;25.12.2016;2016;12;19;Sunnuntai;11;9;20;21;14;35
89;25.12.2016;2016;12;20;Sunnuntai;14;10;24;26;15;41
89;25.12.2016;2016;12;21;Sunnuntai;7;5;12;10;3;13
89;25.12.2016;2016;12;22;Sunnuntai;7;4;11;6;2;8
89;25.12.2016;2016;12;23;Sunnuntai;5;2;7;3;1;4
89;26.12.2016;2016;12;00;Maanantai;3;6;9;2;4;6
89;26.12.2016;2016;12;01;Maanantai;4;4;8;0;0;0
89;26.12.2016;2016;12;02;Maanantai;4;2;6;1;0;1
89;26.12.2016;2016;12;03;Maanantai;0;0;0;0;0;0
89;26.12.2016;2016;12;04;Maanantai;2;1;3;1;0;1
89;26.12.2016;2016;12;05;Maanantai;0;1;1;3;2;5
89;26.12.2016;2016;12;06;Maanantai;3;1;4;3;1;4
89;26.12.2016;2016;12;07;Maanantai;2;1;3;1;3;4
89;26.12.2016;2016;12;08;Maanantai;3;2;5;3;5;8
89;26.12.2016;2016;12;09;Maanantai;6;4;10;24;7;31
89;26.12.2016;2016;12;10;Maanantai;8;8;16;40;14;54
89;26.12.2016;2016;12;11;Maanantai;15;8;23;33;27;60
89;26.12.2016;2016;12;12;Maanantai;18;8;26;36;37;73
89;26.12.2016;2016;12;13;Maanantai;18;13;31;40;33;73
89;26.12.2016;2016;12;14;Maanantai;18;24;42;48;32;80
89;26.12.2016;2016;12;15;Maanantai;26;15;41;33;23;56
89;26.12.2016;2016;12;16;Maanantai;31;11;42;20;15;35
89;26.12.2016;2016;12;17;Maanantai;15;13;28;30;28;58
89;26.12.2016;2016;12;18;Maanantai;15;11;26;25;12;37
89;26.12.2016;2016;12;19;Maanantai;9;8;17;24;21;45
89;26.12.2016;2016;12;20;Maanantai;11;10;21;23;8;31
89;26.12.2016;2016;12;21;Maanantai;10;2;12;7;3;10
89;26.12.2016;2016;12;22;Maanantai;4;4;8;5;7;12
89;26.12.2016;2016;12;23;Maanantai;7;6;13;7;3;10
89;27.12.2016;2016;12;00;Tiistai;3;7;10;6;6;12
89;27.12.2016;2016;12;01;Tiistai;0;2;2;4;0;4
89;27.12.2016;2016;12;02;Tiistai;5;1;6;3;1;4
89;27.12.2016;2016;12;03;Tiistai;6;0;6;2;0;2
89;27.12.2016;2016;12;04;Tiistai;11;1;12;8;0;8
89;27.12.2016;2016;12;05;Tiistai;7;6;13;6;7;13
89;27.12.2016;2016;12;06;Tiistai;20;18;38;1;5;6
89;27.12.2016;2016;12;07;Tiistai;28;31;59;7;14;21
89;27.12.2016;2016;12;08;Tiistai;15;27;42;15;10;25
89;27.12.2016;2016;12;09;Tiistai;23;20;43;18;21;39
89;27.12.2016;2016;12;10;Tiistai;30;14;44;26;23;49
89;27.12.2016;2016;12;11;Tiistai;28;27;55;45;15;60
89;27.12.2016;2016;12;12;Tiistai;36;29;65;59;21;80
89;27.12.2016;2016;12;13;Tiistai;44;19;63;48;29;77
89;27.12.2016;2016;12;14;Tiistai;63;29;92;46;19;65
89;27.12.2016;2016;12;15;Tiistai;73;19;92;36;23;59
89;27.12.2016;2016;12;16;Tiistai;56;23;79;53;10;63
89;27.12.2016;2016;12;17;Tiistai;37;16;53;44;21;65
89;27.12.2016;2016;12;18;Tiistai;28;20;48;26;19;45
89;27.12.2016;2016;12;19;Tiistai;25;11;36;21;8;29
89;27.12.2016;2016;12;20;Tiistai;11;6;17;21;11;32
89;27.12.2016;2016;12;21;Tiistai;16;5;21;19;8;27
89;27.12.2016;2016;12;22;Tiistai;5;3;8;6;2;8
89;27.12.2016;2016;12;23;Tiistai;3;3;6;7;1;8
89;28.12.2016;2016;12;00;Keskiviikko;5;2;7;4;1;5
89;28.12.2016;2016;12;01;Keskiviikko;0;0;0;1;0;1
89;28.12.2016;2016;12;02;Keskiviikko;3;2;5;2;2;4
89;28.12.2016;2016;12;03;Keskiviikko;0;1;1;1;0;1
89;28.12.2016;2016;12;04;Keskiviikko;2;0;2;2;0;2
89;28.12.2016;2016;12;05;Keskiviikko;9;3;12;1;0;1
89;28.12.2016;2016;12;06;Keskiviikko;30;19;49;4;5;9
89;28.12.2016;2016;12;07;Keskiviikko;35;23;58;8;15;23
89;28.12.2016;2016;12;08;Keskiviikko;21;30;51;9;14;23
89;28.12.2016;2016;12;09;Keskiviikko;24;14;38;20;14;34
89;28.12.2016;2016;12;10;Keskiviikko;23;26;49;37;39;76
89;28.12.2016;2016;12;11;Keskiviikko;32;19;51;41;23;64
89;28.12.2016;2016;12;12;Keskiviikko;41;35;76;59;61;120
89;28.12.2016;2016;12;13;Keskiviikko;36;34;70;35;45;80
89;28.12.2016;2016;12;14;Keskiviikko;35;28;63;53;39;92
89;28.12.2016;2016;12;15;Keskiviikko;66;33;99;37;32;69
89;28.12.2016;2016;12;16;Keskiviikko;63;37;100;41;22;63
89;28.12.2016;2016;12;17;Keskiviikko;50;25;75;24;33;57
89;28.12.2016;2016;12;18;Keskiviikko;52;35;87;27;48;75
89;28.12.2016;2016;12;19;Keskiviikko;42;13;55;26;21;47
89;28.12.2016;2016;12;20;Keskiviikko;42;19;61;54;13;67
89;28.12.2016;2016;12;21;Keskiviikko;16;10;26;16;7;23
89;28.12.2016;2016;12;22;Keskiviikko;12;4;16;6;2;8
89;28.12.2016;2016;12;23;Keskiviikko;13;5;18;1;2;3
89;29.12.2016;2016;12;00;Torstai;6;1;7;5;2;7
89;29.12.2016;2016;12;01;Torstai;3;1;4;1;0;1
89;29.12.2016;2016;12;02;Torstai;1;0;1;4;0;4
89;29.12.2016;2016;12;03;Torstai;4;3;7;1;0;1
89;29.12.2016;2016;12;04;Torstai;1;3;4;2;1;3
89;29.12.2016;2016;12;05;Torstai;5;3;8;2;1;3
89;29.12.2016;2016;12;06;Torstai;19;11;30;3;5;8
89;29.12.2016;2016;12;07;Torstai;26;32;58;3;3;6
89;29.12.2016;2016;12;08;Torstai;21;36;57;7;13;20
89;29.12.2016;2016;12;09;Torstai;16;30;46;5;22;27
89;29.12.2016;2016;12;10;Torstai;21;36;57;18;15;33
89;29.12.2016;2016;12;11;Torstai;42;28;70;27;42;69
89;29.12.2016;2016;12;12;Torstai;42;51;93;30;38;68
89;29.12.2016;2016;12;13;Torstai;38;39;77;40;40;80
89;29.12.2016;2016;12;14;Torstai;38;31;69;46;33;79
89;29.12.2016;2016;12;15;Torstai;70;35;105;45;20;65
89;29.12.2016;2016;12;16;Torstai;61;38;99;31;20;51
89;29.12.2016;2016;12;17;Torstai;43;32;75;39;22;61
89;29.12.2016;2016;12;18;Torstai;48;16;64;29;21;50
89;29.12.2016;2016;12;19;Torstai;33;11;44;39;17;56
89;29.12.2016;2016;12;20;Torstai;28;9;37;32;21;53
89;29.12.2016;2016;12;21;Torstai;22;9;31;14;12;26
89;29.12.2016;2016;12;22;Torstai;11;11;22;6;7;13
89;29.12.2016;2016;12;23;Torstai;9;5;14;5;8;13
89;30.12.2016;2016;12;00;Perjantai;7;3;10;3;0;3
89;30.12.2016;2016;12;01;Perjantai;3;1;4;1;2;3
89;30.12.2016;2016;12;02;Perjantai;0;4;4;3;2;5
89;30.12.2016;2016;12;03;Perjantai;4;2;6;2;0;2
89;30.12.2016;2016;12;04;Perjantai;6;0;6;3;0;3
89;30.12.2016;2016;12;05;Perjantai;2;3;5;0;1;1
89;30.12.2016;2016;12;06;Perjantai;13;18;31;0;6;6
89;30.12.2016;2016;12;07;Perjantai;24;24;48;2;12;14
89;30.12.2016;2016;12;08;Perjantai;30;41;71;4;15;19
89;30.12.2016;2016;12;09;Perjantai;10;32;42;21;15;36
89;30.12.2016;2016;12;10;Perjantai;20;34;54;9;26;35
89;30.12.2016;2016;12;11;Perjantai;28;26;54;20;23;43
89;30.12.2016;2016;12;12;Perjantai;26;30;56;26;27;53
89;30.12.2016;2016;12;13;Perjantai;35;26;61;33;30;63
89;30.12.2016;2016;12;14;Perjantai;49;24;73;22;21;43
89;30.12.2016;2016;12;15;Perjantai;56;30;86;24;22;46
89;30.12.2016;2016;12;16;Perjantai;39;23;62;25;13;38
89;30.12.2016;2016;12;17;Perjantai;40;23;63;20;12;32
89;30.12.2016;2016;12;18;Perjantai;38;14;52;20;11;31
89;30.12.2016;2016;12;19;Perjantai;23;19;42;14;21;35
89;30.12.2016;2016;12;20;Perjantai;26;10;36;8;6;14
89;30.12.2016;2016;12;21;Perjantai;19;14;33;15;8;23
89;30.12.2016;2016;12;22;Perjantai;14;6;20;4;1;5
89;30.12.2016;2016;12;23;Perjantai;7;8;15;3;7;10
89;31.12.2016;2016;12;00;Lauantai;4;5;9;3;4;7
89;31.12.2016;2016;12;01;Lauantai;3;1;4;2;2;4
89;31.12.2016;2016;12;02;Lauantai;6;0;6;1;0;1
89;31.12.2016;2016;12;03;Lauantai;2;0;2;0;0;0
89;31.12.2016;2016;12;04;Lauantai;8;0;8;3;0;3
89;31.12.2016;2016;12;05;Lauantai;5;1;6;0;0;0
89;31.12.2016;2016;12;06;Lauantai;2;4;6;2;1;3
89;31.12.2016;2016;12;07;Lauantai;4;7;11;1;4;5
89;31.12.2016;2016;12;08;Lauantai;5;10;15;2;4;6
89;31.12.2016;2016;12;09;Lauantai;3;7;10;3;7;10
89;31.12.2016;2016;12;10;Lauantai;8;16;24;13;17;30
89;31.12.2016;2016;12;11;Lauantai;9;19;28;15;29;44
89;31.12.2016;2016;12;12;Lauantai;15;17;32;36;21;57
89;31.12.2016;2016;12;13;Lauantai;11;18;29;31;33;64
89;31.12.2016;2016;12;14;Lauantai;11;14;25;28;23;51
89;31.12.2016;2016;12;15;Lauantai;25;18;43;20;21;41
89;31.12.2016;2016;12;16;Lauantai;11;27;38;20;23;43
89;31.12.2016;2016;12;17;Lauantai;22;18;40;12;24;36
89;31.12.2016;2016;12;18;Lauantai;16;19;35;9;27;36
89;31.12.2016;2016;12;19;Lauantai;10;28;38;21;71;92
89;31.12.2016;2016;12;20;Lauantai;17;23;40;25;61;86
89;31.12.2016;2016;12;21;Lauantai;48;8;56;113;17;130
89;31.12.2016;2016;12;22;Lauantai;8;6;14;16;15;31
89;31.12.2016;2016;12;23;Lauantai;3;18;21;9;30;39
89;01.01.2017;2017;01;00;Sunnuntai;7;8;15;23;20;43
89;01.01.2017;2017;01;01;Sunnuntai;4;6;10;14;11;25
89;01.01.2017;2017;01;02;Sunnuntai;9;6;15;14;1;15
89;01.01.2017;2017;01;03;Sunnuntai;9;4;13;28;4;32
89;01.01.2017;2017;01;04;Sunnuntai;22;4;26;41;1;42
89;01.01.2017;2017;01;05;Sunnuntai;6;2;8;20;5;25
89;01.01.2017;2017;01;06;Sunnuntai;5;4;9;2;2;4
89;01.01.2017;2017;01;07;Sunnuntai;1;1;2;0;1;1
89;01.01.2017;2017;01;08;Sunnuntai;2;3;5;1;7;8
89;01.01.2017;2017;01;09;Sunnuntai;3;6;9;7;9;16
89;01.01.2017;2017;01;10;Sunnuntai;4;7;11;12;21;33
89;01.01.2017;2017;01;11;Sunnuntai;6;20;26;26;37;63
89;01.01.2017;2017;01;12;Sunnuntai;8;12;20;37;50;87
89;01.01.2017;2017;01;13;Sunnuntai;18;16;34;44;45;89
89;01.01.2017;2017;01;14;Sunnuntai;12;14;26;53;58;111
89;01.01.2017;2017;01;15;Sunnuntai;17;16;33;31;38;69
89;01.01.2017;2017;01;16;Sunnuntai;11;18;29;27;35;62
89;01.01.2017;2017;01;17;Sunnuntai;17;12;29;30;21;51
89;01.01.2017;2017;01;18;Sunnuntai;12;8;20;21;15;36
89;01.01.2017;2017;01;19;Sunnuntai;9;8;17;20;25;45
89;01.01.2017;2017;01;20;Sunnuntai;8;5;13;14;12;26
89;01.01.2017;2017;01;21;Sunnuntai;11;5;16;6;8;14
89;01.01.2017;2017;01;22;Sunnuntai;9;2;11;3;3;6
89;01.01.2017;2017;01;23;Sunnuntai;3;2;5;2;3;5
89;02.01.2017;2017;01;00;Maanantai;4;2;6;1;0;1
89;02.01.2017;2017;01;01;Maanantai;1;1;2;2;0;2
89;02.01.2017;2017;01;02;Maanantai;0;1;1;0;0;0
89;02.01.2017;2017;01;03;Maanantai;0;1;1;1;0;1
89;02.01.2017;2017;01;04;Maanantai;3;2;5;0;0;0
89;02.01.2017;2017;01;05;Maanantai;9;3;12;2;1;3
89;02.01.2017;2017;01;06;Maanantai;5;27;32;0;5;5
89;02.01.2017;2017;01;07;Maanantai;12;76;88;3;19;22
89;02.01.2017;2017;01;08;Maanantai;13;81;94;5;25;30
89;02.01.2017;2017;01;09;Maanantai;13;54;67;10;17;27
89;02.01.2017;2017;01;10;Maanantai;20;39;59;16;26;42
89;02.01.2017;2017;01;11;Maanantai;21;58;79;13;34;47
89;02.01.2017;2017;01;12;Maanantai;28;27;55;27;32;59
89;02.01.2017;2017;01;13;Maanantai;27;35;62;33;30;63
89;02.01.2017;2017;01;14;Maanantai;33;29;62;51;35;86
89;02.01.2017;2017;01;15;Maanantai;72;32;104;37;20;57
89;02.01.2017;2017;01;16;Maanantai;84;39;123;32;26;58
89;02.01.2017;2017;01;17;Maanantai;56;29;85;38;26;64
89;02.01.2017;2017;01;18;Maanantai;36;19;55;18;13;31
89;02.01.2017;2017;01;19;Maanantai;30;11;41;32;23;55
89;02.01.2017;2017;01;20;Maanantai;22;11;33;19;14;33
89;02.01.2017;2017;01;21;Maanantai;23;11;34;21;9;30
89;02.01.2017;2017;01;22;Maanantai;14;12;26;4;6;10
89;02.01.2017;2017;01;23;Maanantai;7;4;11;3;2;5
89;03.01.2017;2017;01;00;Tiistai;5;4;9;1;2;3
89;03.01.2017;2017;01;01;Tiistai;2;0;2;0;2;2
89;03.01.2017;2017;01;02;Tiistai;3;0;3;1;0;1
89;03.01.2017;2017;01;03;Tiistai;4;2;6;1;0;1
89;03.01.2017;2017;01;04;Tiistai;0;3;3;2;0;2
89;03.01.2017;2017;01;05;Tiistai;2;9;11;2;0;2
89;03.01.2017;2017;01;06;Tiistai;10;24;34;0;8;8
89;03.01.2017;2017;01;07;Tiistai;13;61;74;6;21;27
89;03.01.2017;2017;01;08;Tiistai;9;97;106;7;31;38
89;03.01.2017;2017;01;09;Tiistai;16;30;46;10;13;23
89;03.01.2017;2017;01;10;Tiistai;15;29;44;12;33;45
89;03.01.2017;2017;01;11;Tiistai;14;28;42;16;31;47
89;03.01.2017;2017;01;12;Tiistai;22;33;55;23;39;62
89;03.01.2017;2017;01;13;Tiistai;21;36;57;29;32;61
89;03.01.2017;2017;01;14;Tiistai;37;28;65;42;34;76
89;03.01.2017;2017;01;15;Tiistai;63;30;93;51;28;79
89;03.01.2017;2017;01;16;Tiistai;77;34;111;38;31;69
89;03.01.2017;2017;01;17;Tiistai;70;26;96;23;26;49
89;03.01.2017;2017;01;18;Tiistai;32;20;52;23;18;41
89;03.01.2017;2017;01;19;Tiistai;29;14;43;19;12;31
89;03.01.2017;2017;01;20;Tiistai;22;11;33;16;15;31
89;03.01.2017;2017;01;21;Tiistai;17;6;23;7;7;14
89;03.01.2017;2017;01;22;Tiistai;7;3;10;2;1;3
89;03.01.2017;2017;01;23;Tiistai;7;9;16;0;0;0
89;04.01.2017;2017;01;00;Keskiviikko;2;3;5;0;0;0
89;04.01.2017;2017;01;01;Keskiviikko;1;2;3;1;1;2
89;04.01.2017;2017;01;02;Keskiviikko;1;0;1;0;0;0
89;04.01.2017;2017;01;03;Keskiviikko;1;0;1;1;0;1
89;04.01.2017;2017;01;04;Keskiviikko;0;2;2;0;0;0
89;04.01.2017;2017;01;05;Keskiviikko;5;3;8;1;1;2
89;04.01.2017;2017;01;06;Keskiviikko;5;21;26;2;10;12
89;04.01.2017;2017;01;07;Keskiviikko;10;50;60;6;24;30
89;04.01.2017;2017;01;08;Keskiviikko;6;64;70;5;28;33
89;04.01.2017;2017;01;09;Keskiviikko;8;34;42;9;21;30
89;04.01.2017;2017;01;10;Keskiviikko;11;21;32;10;25;35
89;04.01.2017;2017;01;11;Keskiviikko;18;27;45;14;25;39
89;04.01.2017;2017;01;12;Keskiviikko;11;28;39;21;31;52
89;04.01.2017;2017;01;13;Keskiviikko;21;14;35;22;25;47
89;04.01.2017;2017;01;14;Keskiviikko;21;20;41;26;21;47
89;04.01.2017;2017;01;15;Keskiviikko;52;12;64;29;20;49
89;04.01.2017;2017;01;16;Keskiviikko;64;27;91;37;14;51
89;04.01.2017;2017;01;17;Keskiviikko;33;16;49;21;16;37
89;04.01.2017;2017;01;18;Keskiviikko;19;21;40;20;13;33
89;04.01.2017;2017;01;19;Keskiviikko;24;10;34;21;6;27
89;04.01.2017;2017;01;20;Keskiviikko;16;7;23;15;11;26
89;04.01.2017;2017;01;21;Keskiviikko;17;4;21;8;11;19
89;04.01.2017;2017;01;22;Keskiviikko;7;0;7;3;3;6
89;04.01.2017;2017;01;23;Keskiviikko;6;0;6;1;1;2
89;05.01.2017;2017;01;00;Torstai;2;1;3;2;0;2
89;05.01.2017;2017;01;01;Torstai;0;2;2;0;1;1
89;05.01.2017;2017;01;02;Torstai;0;0;0;0;3;3
89;05.01.2017;2017;01;03;Torstai;1;1;2;0;0;0
89;05.01.2017;2017;01;04;Torstai;0;3;3;1;0;1
89;05.01.2017;2017;01;05;Torstai;3;6;9;1;2;3
89;05.01.2017;2017;01;06;Torstai;6;16;22;2;9;11
89;05.01.2017;2017;01;07;Torstai;4;32;36;3;20;23
89;05.01.2017;2017;01;08;Torstai;5;45;50;11;36;47
89;05.01.2017;2017;01;09;Torstai;7;19;26;8;17;25
89;05.01.2017;2017;01;10;Torstai;6;17;23;9;21;30
89;05.01.2017;2017;01;11;Torstai;13;15;28;10;19;29
89;05.01.2017;2017;01;12;Torstai;7;25;32;5;24;29
89;05.01.2017;2017;01;13;Torstai;18;19;37;18;30;48
89;05.01.2017;2017;01;14;Torstai;20;13;33;22;23;45
89;05.01.2017;2017;01;15;Torstai;44;11;55;26;20;46
89;05.01.2017;2017;01;16;Torstai;34;12;46;39;13;52
89;05.01.2017;2017;01;17;Torstai;20;18;38;20;11;31
89;05.01.2017;2017;01;18;Torstai;19;10;29;13;10;23
89;05.01.2017;2017;01;19;Torstai;8;7;15;10;10;20
89;05.01.2017;2017;01;20;Torstai;10;9;19;9;9;18
89;05.01.2017;2017;01;21;Torstai;15;5;20;10;4;14
89;05.01.2017;2017;01;22;Torstai;6;4;10;2;5;7
89;05.01.2017;2017;01;23;Torstai;8;2;10;5;10;15
89;06.01.2017;2017;01;00;Perjantai;5;5;10;0;1;1
89;06.01.2017;2017;01;01;Perjantai;1;1;2;2;1;3
89;06.01.2017;2017;01;02;Perjantai;1;0;1;0;0;0
89;06.01.2017;2017;01;03;Perjantai;5;1;6;4;4;8
89;06.01.2017;2017;01;04;Perjantai;5;1;6;0;0;0
89;06.01.2017;2017;01;05;Perjantai;1;2;3;0;0;0
89;06.01.2017;2017;01;06;Perjantai;1;2;3;1;3;4
89;06.01.2017;2017;01;07;Perjantai;2;5;7;1;0;1
89;06.01.2017;2017;01;08;Perjantai;0;7;7;3;5;8
89;06.01.2017;2017;01;09;Perjantai;2;11;13;9;8;17
89;06.01.2017;2017;01;10;Perjantai;8;8;16;9;15;24
89;06.01.2017;2017;01;11;Perjantai;12;13;25;10;22;32
89;06.01.2017;2017;01;12;Perjantai;7;24;31;18;33;51
89;06.01.2017;2017;01;13;Perjantai;13;28;41;25;41;66
89;06.01.2017;2017;01;14;Perjantai;18;15;33;30;31;61
89;06.01.2017;2017;01;15;Perjantai;22;13;35;25;29;54
89;06.01.2017;2017;01;16;Perjantai;15;8;23;20;16;36
89;06.01.2017;2017;01;17;Perjantai;19;22;41;18;25;43
89;06.01.2017;2017;01;18;Perjantai;19;11;30;18;20;38
89;06.01.2017;2017;01;19;Perjantai;12;13;25;24;10;34
89;06.01.2017;2017;01;20;Perjantai;9;13;22;11;9;20
89;06.01.2017;2017;01;21;Perjantai;10;11;21;7;12;19
89;06.01.2017;2017;01;22;Perjantai;5;4;9;5;10;15
89;06.01.2017;2017;01;23;Perjantai;9;5;14;3;3;6
89;07.01.2017;2017;01;00;Lauantai;2;6;8;3;1;4
89;07.01.2017;2017;01;01;Lauantai;6;1;7;0;3;3
89;07.01.2017;2017;01;02;Lauantai;3;1;4;2;1;3
89;07.01.2017;2017;01;03;Lauantai;2;0;2;1;1;2
89;07.01.2017;2017;01;04;Lauantai;11;0;11;4;0;4
89;07.01.2017;2017;01;05;Lauantai;2;2;4;1;1;2
89;07.01.2017;2017;01;06;Lauantai;2;5;7;4;2;6
89;07.01.2017;2017;01;07;Lauantai;2;5;7;0;2;2
89;07.01.2017;2017;01;08;Lauantai;4;7;11;6;4;10
89;07.01.2017;2017;01;09;Lauantai;2;9;11;10;17;27
89;07.01.2017;2017;01;10;Lauantai;5;36;41;20;22;42
89;07.01.2017;2017;01;11;Lauantai;11;33;44;16;38;54
89;07.01.2017;2017;01;12;Lauantai;21;29;50;45;59;104
89;07.01.2017;2017;01;13;Lauantai;31;50;81;59;46;105
89;07.01.2017;2017;01;14;Lauantai;31;33;64;43;58;101
89;07.01.2017;2017;01;15;Lauantai;55;24;79;43;45;88
89;07.01.2017;2017;01;16;Lauantai;20;27;47;26;32;58
89;07.01.2017;2017;01;17;Lauantai;40;21;61;34;23;57
89;07.01.2017;2017;01;18;Lauantai;25;19;44;22;18;40
89;07.01.2017;2017;01;19;Lauantai;23;17;40;29;37;66
89;07.01.2017;2017;01;20;Lauantai;17;16;33;17;13;30
89;07.01.2017;2017;01;21;Lauantai;8;14;22;9;10;19
89;07.01.2017;2017;01;22;Lauantai;6;11;17;15;10;25
89;07.01.2017;2017;01;23;Lauantai;6;4;10;5;6;11
89;08.01.2017;2017;01;00;Sunnuntai;2;7;9;3;9;12
89;08.01.2017;2017;01;01;Sunnuntai;10;3;13;2;1;3
89;08.01.2017;2017;01;02;Sunnuntai;6;5;11;4;1;5
89;08.01.2017;2017;01;03;Sunnuntai;6;2;8;2;1;3
89;08.01.2017;2017;01;04;Sunnuntai;4;0;4;5;0;5
89;08.01.2017;2017;01;05;Sunnuntai;6;0;6;0;1;1
89;08.01.2017;2017;01;06;Sunnuntai;0;2;2;1;1;2
89;08.01.2017;2017;01;07;Sunnuntai;5;4;9;2;3;5
89;08.01.2017;2017;01;08;Sunnuntai;4;3;7;4;6;10
89;08.01.2017;2017;01;09;Sunnuntai;8;5;13;12;13;25
89;08.01.2017;2017;01;10;Sunnuntai;13;14;27;21;27;48
89;08.01.2017;2017;01;11;Sunnuntai;8;15;23;33;49;82
89;08.01.2017;2017;01;12;Sunnuntai;13;21;34;39;56;95
89;08.01.2017;2017;01;13;Sunnuntai;35;25;60;65;46;111
89;08.01.2017;2017;01;14;Sunnuntai;28;23;51;54;56;110
89;08.01.2017;2017;01;15;Sunnuntai;29;20;49;35;37;72
89;08.01.2017;2017;01;16;Sunnuntai;21;26;47;42;28;70
89;08.01.2017;2017;01;17;Sunnuntai;27;18;45;26;21;47
89;08.01.2017;2017;01;18;Sunnuntai;24;11;35;31;13;44
89;08.01.2017;2017;01;19;Sunnuntai;14;8;22;20;13;33
89;08.01.2017;2017;01;20;Sunnuntai;12;17;29;19;19;38
89;08.01.2017;2017;01;21;Sunnuntai;12;6;18;14;8;22
89;08.01.2017;2017;01;22;Sunnuntai;6;8;14;2;5;7
89;08.01.2017;2017;01;23;Sunnuntai;6;1;7;2;1;3
89;09.01.2017;2017;01;00;Maanantai;3;1;4;0;2;2
89;09.01.2017;2017;01;01;Maanantai;0;0;0;1;1;2
89;09.01.2017;2017;01;02;Maanantai;1;0;1;1;0;1
89;09.01.2017;2017;01;03;Maanantai;2;0;2;0;0;0
89;09.01.2017;2017;01;04;Maanantai;5;1;6;0;2;2
89;09.01.2017;2017;01;05;Maanantai;2;8;10;1;2;3
89;09.01.2017;2017;01;06;Maanantai;11;29;40;3;2;5
89;09.01.2017;2017;01;07;Maanantai;20;97;117;5;26;31
89;09.01.2017;2017;01;08;Maanantai;33;135;168;15;37;52
89;09.01.2017;2017;01;09;Maanantai;27;61;88;9;32;41
89;09.01.2017;2017;01;10;Maanantai;24;50;74;11;29;40
89;09.01.2017;2017;01;11;Maanantai;35;49;84;22;37;59
89;09.01.2017;2017;01;12;Maanantai;46;48;94;23;28;51
89;09.01.2017;2017;01;13;Maanantai;52;39;91;27;22;49
89;09.01.2017;2017;01;14;Maanantai;79;36;115;27;23;50
89;09.01.2017;2017;01;15;Maanantai;130;39;169;43;33;76
89;09.01.2017;2017;01;16;Maanantai;117;53;170;46;24;70
89;09.01.2017;2017;01;17;Maanantai;61;41;102;32;25;57
89;09.01.2017;2017;01;18;Maanantai;55;32;87;35;39;74
89;09.01.2017;2017;01;19;Maanantai;43;27;70;29;36;65
89;09.01.2017;2017;01;20;Maanantai;38;10;48;21;10;31
89;09.01.2017;2017;01;21;Maanantai;36;16;52;21;14;35
89;09.01.2017;2017;01;22;Maanantai;10;10;20;6;12;18
89;09.01.2017;2017;01;23;Maanantai;6;4;10;4;1;5
89;10.01.2017;2017;01;00;Tiistai;1;1;2;2;0;2
89;10.01.2017;2017;01;01;Tiistai;0;3;3;1;1;2
89;10.01.2017;2017;01;02;Tiistai;2;0;2;0;0;0
89;10.01.2017;2017;01;03;Tiistai;1;0;1;0;0;0
89;10.01.2017;2017;01;04;Tiistai;2;4;6;1;1;2
89;10.01.2017;2017;01;05;Tiistai;2;6;8;1;2;3
89;10.01.2017;2017;01;06;Tiistai;8;28;36;2;5;7
89;10.01.2017;2017;01;07;Tiistai;21;98;119;9;23;32
89;10.01.2017;2017;01;08;Tiistai;31;158;189;10;50;60
89;10.01.2017;2017;01;09;Tiistai;20;81;101;23;45;68
89;10.01.2017;2017;01;10;Tiistai;23;51;74;22;48;70
89;10.01.2017;2017;01;11;Tiistai;24;35;59;20;34;54
89;10.01.2017;2017;01;12;Tiistai;34;62;96;34;34;68
89;10.01.2017;2017;01;13;Tiistai;39;42;81;25;31;56
89;10.01.2017;2017;01;14;Tiistai;68;36;104;48;25;73
89;10.01.2017;2017;01;15;Tiistai;94;32;126;37;22;59
89;10.01.2017;2017;01;16;Tiistai;132;52;184;50;27;77
89;10.01.2017;2017;01;17;Tiistai;80;48;128;35;31;66
89;10.01.2017;2017;01;18;Tiistai;57;34;91;32;30;62
89;10.01.2017;2017;01;19;Tiistai;44;7;51;37;20;57
89;10.01.2017;2017;01;20;Tiistai;34;12;46;36;19;55
89;10.01.2017;2017;01;21;Tiistai;17;10;27;13;7;20
89;10.01.2017;2017;01;22;Tiistai;15;6;21;6;6;12
89;10.01.2017;2017;01;23;Tiistai;6;2;8;4;2;6
89;11.01.2017;2017;01;00;Keskiviikko;1;1;2;2;1;3
89;11.01.2017;2017;01;01;Keskiviikko;0;0;0;2;0;2
89;11.01.2017;2017;01;02;Keskiviikko;0;0;0;0;1;1
89;11.01.2017;2017;01;03;Keskiviikko;2;1;3;0;0;0
89;11.01.2017;2017;01;04;Keskiviikko;1;3;4;0;0;0
89;11.01.2017;2017;01;05;Keskiviikko;7;5;12;2;4;6
89;11.01.2017;2017;01;06;Keskiviikko;9;26;35;0;8;8
89;11.01.2017;2017;01;07;Keskiviikko;13;72;85;11;21;32
89;11.01.2017;2017;01;08;Keskiviikko;25;125;150;13;56;69
89;11.01.2017;2017;01;09;Keskiviikko;19;66;85;15;44;59
89;11.01.2017;2017;01;10;Keskiviikko;21;43;64;8;40;48
89;11.01.2017;2017;01;11;Keskiviikko;34;28;62;34;31;65
89;11.01.2017;2017;01;12;Keskiviikko;30;40;70;38;32;70
89;11.01.2017;2017;01;13;Keskiviikko;39;49;88;28;25;53
89;11.01.2017;2017;01;14;Keskiviikko;59;32;91;34;16;50
89;11.01.2017;2017;01;15;Keskiviikko;93;36;129;38;26;64
89;11.01.2017;2017;01;16;Keskiviikko;99;47;146;33;25;58
89;11.01.2017;2017;01;17;Keskiviikko;77;43;120;46;27;73
89;11.01.2017;2017;01;18;Keskiviikko;56;30;86;37;30;67
89;11.01.2017;2017;01;19;Keskiviikko;34;20;54;26;24;50
89;11.01.2017;2017;01;20;Keskiviikko;40;10;50;26;11;37
89;11.01.2017;2017;01;21;Keskiviikko;34;14;48;15;11;26
89;11.01.2017;2017;01;22;Keskiviikko;11;5;16;9;10;19
89;11.01.2017;2017;01;23;Keskiviikko;5;7;12;1;3;4
89;12.01.2017;2017;01;00;Torstai;5;4;9;1;4;5
89;12.01.2017;2017;01;01;Torstai;3;2;5;1;1;2
89;12.01.2017;2017;01;02;Torstai;0;1;1;1;0;1
89;12.01.2017;2017;01;03;Torstai;0;1;1;0;0;0
89;12.01.2017;2017;01;04;Torstai;3;2;5;2;0;2
89;12.01.2017;2017;01;05;Torstai;3;8;11;3;1;4
89;12.01.2017;2017;01;06;Torstai;10;26;36;4;9;13
89;12.01.2017;2017;01;07;Torstai;17;77;94;5;30;35
89;12.01.2017;2017;01;08;Torstai;26;115;141;18;34;52
89;12.01.2017;2017;01;09;Torstai;16;65;81;15;39;54
89;12.01.2017;2017;01;10;Torstai;14;47;61;14;39;53
89;12.01.2017;2017;01;11;Torstai;26;37;63;22;27;49
89;12.01.2017;2017;01;12;Torstai;18;25;43;31;25;56
89;12.01.2017;2017;01;13;Torstai;46;30;76;28;20;48
89;12.01.2017;2017;01;14;Torstai;44;35;79;33;17;50
89;12.01.2017;2017;01;15;Torstai;82;32;114;30;20;50
89;12.01.2017;2017;01;16;Torstai;99;42;141;48;21;69
89;12.01.2017;2017;01;17;Torstai;76;22;98;22;26;48
89;12.01.2017;2017;01;18;Torstai;46;21;67;30;19;49
89;12.01.2017;2017;01;19;Torstai;36;14;50;27;15;42
89;12.01.2017;2017;01;20;Torstai;25;12;37;21;14;35
89;12.01.2017;2017;01;21;Torstai;28;9;37;12;3;15
89;12.01.2017;2017;01;22;Torstai;10;5;15;5;7;12
89;12.01.2017;2017;01;23;Torstai;8;5;13;6;1;7
89;13.01.2017;2017;01;00;Perjantai;2;2;4;0;5;5
89;13.01.2017;2017;01;01;Perjantai;0;3;3;0;2;2
89;13.01.2017;2017;01;02;Perjantai;1;0;1;1;0;1
89;13.01.2017;2017;01;03;Perjantai;8;0;8;3;1;4
89;13.01.2017;2017;01;04;Perjantai;4;2;6;2;2;4
89;13.01.2017;2017;01;05;Perjantai;4;4;8;2;0;2
89;13.01.2017;2017;01;06;Perjantai;6;32;38;2;8;10
89;13.01.2017;2017;01;07;Perjantai;13;67;80;6;24;30
89;13.01.2017;2017;01;08;Perjantai;22;91;113;14;50;64
89;13.01.2017;2017;01;09;Perjantai;11;79;90;12;32;44
89;13.01.2017;2017;01;10;Perjantai;24;38;62;21;37;58
89;13.01.2017;2017;01;11;Perjantai;33;44;77;24;36;60
89;13.01.2017;2017;01;12;Perjantai;27;49;76;31;34;65
89;13.01.2017;2017;01;13;Perjantai;51;48;99;30;31;61
89;13.01.2017;2017;01;14;Perjantai;56;46;102;32;23;55
89;13.01.2017;2017;01;15;Perjantai;95;28;123;39;18;57
89;13.01.2017;2017;01;16;Perjantai;97;47;144;38;27;65
89;13.01.2017;2017;01;17;Perjantai;58;23;81;26;19;45
89;13.01.2017;2017;01;18;Perjantai;33;33;66;29;17;46
89;13.01.2017;2017;01;19;Perjantai;26;15;41;22;21;43
89;13.01.2017;2017;01;20;Perjantai;38;7;45;27;10;37
89;13.01.2017;2017;01;21;Perjantai;33;9;42;12;6;18
89;13.01.2017;2017;01;22;Perjantai;11;15;26;10;4;14
89;13.01.2017;2017;01;23;Perjantai;16;23;39;6;6;12
89;14.01.2017;2017;01;00;Lauantai;10;11;21;3;3;6
89;14.01.2017;2017;01;01;Lauantai;9;17;26;7;3;10
89;14.01.2017;2017;01;02;Lauantai;7;6;13;2;0;2
89;14.01.2017;2017;01;03;Lauantai;9;0;9;4;2;6
89;14.01.2017;2017;01;04;Lauantai;7;2;9;7;1;8
89;14.01.2017;2017;01;05;Lauantai;4;5;9;2;1;3
89;14.01.2017;2017;01;06;Lauantai;5;7;12;0;3;3
89;14.01.2017;2017;01;07;Lauantai;2;7;9;5;3;8
89;14.01.2017;2017;01;08;Lauantai;4;8;12;4;9;13
89;14.01.2017;2017;01;09;Lauantai;4;17;21;12;16;28
89;14.01.2017;2017;01;10;Lauantai;2;17;19;15;33;48
89;14.01.2017;2017;01;11;Lauantai;16;22;38;32;32;64
89;14.01.2017;2017;01;12;Lauantai;22;34;56;40;40;80
89;14.01.2017;2017;01;13;Lauantai;38;51;89;37;48;85
89;14.01.2017;2017;01;14;Lauantai;33;39;72;61;35;96
89;14.01.2017;2017;01;15;Lauantai;35;32;67;47;55;102
89;14.01.2017;2017;01;16;Lauantai;35;38;73;42;32;74
89;14.01.2017;2017;01;17;Lauantai;22;21;43;40;35;75
89;14.01.2017;2017;01;18;Lauantai;28;15;43;26;22;48
89;14.01.2017;2017;01;19;Lauantai;19;17;36;29;17;46
89;14.01.2017;2017;01;20;Lauantai;21;20;41;16;25;41
89;14.01.2017;2017;01;21;Lauantai;20;32;52;8;7;15
89;14.01.2017;2017;01;22;Lauantai;14;10;24;9;12;21
89;14.01.2017;2017;01;23;Lauantai;11;16;27;3;16;19
89;15.01.2017;2017;01;00;Sunnuntai;9;4;13;4;5;9
89;15.01.2017;2017;01;01;Sunnuntai;10;6;16;2;6;8
89;15.01.2017;2017;01;02;Sunnuntai;12;6;18;3;1;4
89;15.01.2017;2017;01;03;Sunnuntai;13;4;17;5;0;5
89;15.01.2017;2017;01;04;Sunnuntai;12;0;12;11;2;13
89;15.01.2017;2017;01;05;Sunnuntai;3;1;4;2;1;3
89;15.01.2017;2017;01;06;Sunnuntai;1;2;3;2;3;5
89;15.01.2017;2017;01;07;Sunnuntai;3;3;6;4;3;7
89;15.01.2017;2017;01;08;Sunnuntai;2;4;6;4;2;6
89;15.01.2017;2017;01;09;Sunnuntai;2;2;4;15;12;27
89;15.01.2017;2017;01;10;Sunnuntai;5;12;17;25;23;48
89;15.01.2017;2017;01;11;Sunnuntai;8;26;34;40;40;80
89;15.01.2017;2017;01;12;Sunnuntai;17;24;41;48;58;106
89;15.01.2017;2017;01;13;Sunnuntai;21;28;49;56;43;99
89;15.01.2017;2017;01;14;Sunnuntai;33;29;62;50;63;113
89;15.01.2017;2017;01;15;Sunnuntai;26;24;50;41;50;91
89;15.01.2017;2017;01;16;Sunnuntai;26;30;56;33;36;69
89;15.01.2017;2017;01;17;Sunnuntai;30;26;56;28;24;52
89;15.01.2017;2017;01;18;Sunnuntai;26;15;41;28;25;53
89;15.01.2017;2017;01;19;Sunnuntai;16;14;30;26;16;42
89;15.01.2017;2017;01;20;Sunnuntai;20;14;34;22;28;50
89;15.01.2017;2017;01;21;Sunnuntai;16;11;27;13;6;19
89;15.01.2017;2017;01;22;Sunnuntai;15;3;18;1;1;2
89;15.01.2017;2017;01;23;Sunnuntai;3;2;5;4;3;7
89;16.01.2017;2017;01;00;Maanantai;3;1;4;5;8;13
89;16.01.2017;2017;01;01;Maanantai;0;0;0;0;0;0
89;16.01.2017;2017;01;02;Maanantai;2;1;3;0;0;0
89;16.01.2017;2017;01;03;Maanantai;0;0;0;0;0;0
89;16.01.2017;2017;01;04;Maanantai;1;5;6;1;1;2
89;16.01.2017;2017;01;05;Maanantai;3;5;8;1;2;3
89;16.01.2017;2017;01;06;Maanantai;7;30;37;6;8;14
89;16.01.2017;2017;01;07;Maanantai;16;80;96;8;22;30
89;16.01.2017;2017;01;08;Maanantai;19;142;161;8;43;51
89;16.01.2017;2017;01;09;Maanantai;20;86;106;8;38;46
89;16.01.2017;2017;01;10;Maanantai;21;46;67;13;26;39
89;16.01.2017;2017;01;11;Maanantai;33;44;77;30;40;70
89;16.01.2017;2017;01;12;Maanantai;44;46;90;39;33;72
89;16.01.2017;2017;01;13;Maanantai;36;32;68;33;37;70
89;16.01.2017;2017;01;14;Maanantai;68;44;112;22;27;49
89;16.01.2017;2017;01;15;Maanantai;105;45;150;50;42;92
89;16.01.2017;2017;01;16;Maanantai;135;47;182;55;24;79
89;16.01.2017;2017;01;17;Maanantai;54;44;98;29;20;49
89;16.01.2017;2017;01;18;Maanantai;60;25;85;39;19;58
89;16.01.2017;2017;01;19;Maanantai;35;17;52;25;30;55
89;16.01.2017;2017;01;20;Maanantai;22;21;43;28;26;54
89;16.01.2017;2017;01;21;Maanantai;27;16;43;11;13;24
89;16.01.2017;2017;01;22;Maanantai;14;7;21;3;5;8
89;16.01.2017;2017;01;23;Maanantai;5;2;7;2;2;4
89;17.01.2017;2017;01;00;Tiistai;2;1;3;0;1;1
89;17.01.2017;2017;01;01;Tiistai;0;1;1;0;1;1
89;17.01.2017;2017;01;02;Tiistai;0;1;1;0;0;0
89;17.01.2017;2017;01;03;Tiistai;2;2;4;0;0;0
89;17.01.2017;2017;01;04;Tiistai;1;3;4;0;1;1
89;17.01.2017;2017;01;05;Tiistai;2;4;6;1;1;2
89;17.01.2017;2017;01;06;Tiistai;7;33;40;4;7;11
89;17.01.2017;2017;01;07;Tiistai;21;87;108;13;25;38
89;17.01.2017;2017;01;08;Tiistai;28;153;181;13;54;67
89;17.01.2017;2017;01;09;Tiistai;18;78;96;16;44;60
89;17.01.2017;2017;01;10;Tiistai;28;34;62;18;41;59
89;17.01.2017;2017;01;11;Tiistai;30;46;76;29;40;69
89;17.01.2017;2017;01;12;Tiistai;30;32;62;29;35;64
89;17.01.2017;2017;01;13;Tiistai;37;38;75;29;27;56
89;17.01.2017;2017;01;14;Tiistai;54;44;98;35;25;60
89;17.01.2017;2017;01;15;Tiistai;101;33;134;30;33;63
89;17.01.2017;2017;01;16;Tiistai;118;63;181;44;22;66
89;17.01.2017;2017;01;17;Tiistai;85;49;134;36;25;61
89;17.01.2017;2017;01;18;Tiistai;53;31;84;44;43;87
89;17.01.2017;2017;01;19;Tiistai;50;23;73;32;26;58
89;17.01.2017;2017;01;20;Tiistai;30;18;48;23;20;43
89;17.01.2017;2017;01;21;Tiistai;25;17;42;8;10;18
89;17.01.2017;2017;01;22;Tiistai;18;5;23;5;4;9
89;17.01.2017;2017;01;23;Tiistai;12;4;16;4;4;8
89;18.01.2017;2017;01;00;Keskiviikko;4;2;6;1;0;1
89;18.01.2017;2017;01;01;Keskiviikko;1;1;2;1;2;3
89;18.01.2017;2017;01;02;Keskiviikko;2;1;3;0;0;0
89;18.01.2017;2017;01;03;Keskiviikko;0;2;2;1;0;1
89;18.01.2017;2017;01;04;Keskiviikko;0;2;2;0;0;0
89;18.01.2017;2017;01;05;Keskiviikko;3;4;7;1;1;2
89;18.01.2017;2017;01;06;Keskiviikko;8;27;35;3;6;9
89;18.01.2017;2017;01;07;Keskiviikko;20;85;105;9;26;35
89;18.01.2017;2017;01;08;Keskiviikko;17;141;158;12;65;77
89;18.01.2017;2017;01;09;Keskiviikko;22;84;106;18;34;52
89;18.01.2017;2017;01;10;Keskiviikko;29;56;85;20;32;52
89;18.01.2017;2017;01;11;Keskiviikko;29;54;83;35;43;78
89;18.01.2017;2017;01;12;Keskiviikko;40;54;94;27;40;67
89;18.01.2017;2017;01;13;Keskiviikko;46;53;99;27;30;57
89;18.01.2017;2017;01;14;Keskiviikko;62;32;94;51;21;72
89;18.01.2017;2017;01;15;Keskiviikko;110;30;140;29;21;50
89;18.01.2017;2017;01;16;Keskiviikko;98;50;148;45;21;66
89;18.01.2017;2017;01;17;Keskiviikko;67;51;118;31;30;61
89;18.01.2017;2017;01;18;Keskiviikko;57;39;96;37;32;69
89;18.01.2017;2017;01;19;Keskiviikko;47;23;70;43;23;66
89;18.01.2017;2017;01;20;Keskiviikko;46;13;59;16;16;32
89;18.01.2017;2017;01;21;Keskiviikko;33;10;43;26;9;35
89;18.01.2017;2017;01;22;Keskiviikko;13;6;19;3;3;6
89;18.01.2017;2017;01;23;Keskiviikko;3;9;12;3;1;4
89;19.01.2017;2017;01;00;Torstai;1;3;4;0;3;3
89;19.01.2017;2017;01;01;Torstai;4;0;4;0;2;2
89;19.01.2017;2017;01;02;Torstai;3;1;4;1;0;1
89;19.01.2017;2017;01;03;Torstai;1;2;3;1;0;1
89;19.01.2017;2017;01;04;Torstai;2;3;5;0;0;0
89;19.01.2017;2017;01;05;Torstai;1;5;6;1;0;1
89;19.01.2017;2017;01;06;Torstai;7;23;30;12;14;26
89;19.01.2017;2017;01;07;Torstai;18;70;88;9;26;35
89;19.01.2017;2017;01;08;Torstai;28;122;150;11;42;53
89;19.01.2017;2017;01;09;Torstai;18;71;89;22;35;57
89;19.01.2017;2017;01;10;Torstai;20;54;74;19;30;49
89;19.01.2017;2017;01;11;Torstai;31;38;69;18;28;46
89;19.01.2017;2017;01;12;Torstai;36;51;87;19;30;49
89;19.01.2017;2017;01;13;Torstai;40;33;73;29;56;85
89;19.01.2017;2017;01;14;Torstai;58;35;93;18;23;41
89;19.01.2017;2017;01;15;Torstai;92;41;133;25;19;44
89;19.01.2017;2017;01;16;Torstai;99;36;135;35;14;49
89;19.01.2017;2017;01;17;Torstai;62;34;96;20;21;41
89;19.01.2017;2017;01;18;Torstai;52;43;95;14;7;21
89;19.01.2017;2017;01;19;Torstai;36;16;52;12;7;19
89;19.01.2017;2017;01;20;Torstai;29;13;42;15;9;24
89;19.01.2017;2017;01;21;Torstai;36;9;45;11;5;16
89;19.01.2017;2017;01;22;Torstai;15;2;17;2;1;3
89;19.01.2017;2017;01;23;Torstai;9;5;14;4;2;6
89;20.01.2017;2017;01;00;Perjantai;4;2;6;0;1;1
89;20.01.2017;2017;01;01;Perjantai;0;0;0;1;1;2
89;20.01.2017;2017;01;02;Perjantai;2;2;4;1;1;2
89;20.01.2017;2017;01;03;Perjantai;3;4;7;0;0;0
89;20.01.2017;2017;01;04;Perjantai;1;1;2;2;0;2
89;20.01.2017;2017;01;05;Perjantai;7;11;18;1;2;3
89;20.01.2017;2017;01;06;Perjantai;5;44;49;3;6;9
89;20.01.2017;2017;01;07;Perjantai;27;91;118;6;29;35
89;20.01.2017;2017;01;08;Perjantai;14;101;115;10;39;49
89;20.01.2017;2017;01;09;Perjantai;17;78;95;12;30;42
89;20.01.2017;2017;01;10;Perjantai;20;34;54;16;25;41
89;20.01.2017;2017;01;11;Perjantai;32;51;83;15;32;47
89;20.01.2017;2017;01;12;Perjantai;24;36;60;25;25;50
89;20.01.2017;2017;01;13;Perjantai;57;43;100;37;35;72
89;20.01.2017;2017;01;14;Perjantai;84;51;135;28;31;59
89;20.01.2017;2017;01;15;Perjantai;94;35;129;34;26;60
89;20.01.2017;2017;01;16;Perjantai;72;43;115;26;26;52
89;20.01.2017;2017;01;17;Perjantai;62;28;90;25;17;42
89;20.01.2017;2017;01;18;Perjantai;45;26;71;27;22;49
89;20.01.2017;2017;01;19;Perjantai;35;17;52;12;26;38
89;20.01.2017;2017;01;20;Perjantai;29;23;52;10;10;20
89;20.01.2017;2017;01;21;Perjantai;16;14;30;12;4;16
89;20.01.2017;2017;01;22;Perjantai;13;10;23;7;3;10
89;20.01.2017;2017;01;23;Perjantai;12;10;22;4;2;6
89;21.01.2017;2017;01;00;Lauantai;7;11;18;4;3;7
89;21.01.2017;2017;01;01;Lauantai;8;2;10;2;0;2
89;21.01.2017;2017;01;02;Lauantai;4;2;6;3;1;4
89;21.01.2017;2017;01;03;Lauantai;5;2;7;5;0;5
89;21.01.2017;2017;01;04;Lauantai;11;0;11;7;1;8
89;21.01.2017;2017;01;05;Lauantai;4;4;8;2;2;4
89;21.01.2017;2017;01;06;Lauantai;4;6;10;2;1;3
89;21.01.2017;2017;01;07;Lauantai;2;5;7;6;3;9
89;21.01.2017;2017;01;08;Lauantai;4;21;25;7;10;17
89;21.01.2017;2017;01;09;Lauantai;3;30;33;9;14;23
89;21.01.2017;2017;01;10;Lauantai;12;20;32;20;24;44
89;21.01.2017;2017;01;11;Lauantai;19;32;51;25;63;88
89;21.01.2017;2017;01;12;Lauantai;18;46;64;45;61;106
89;21.01.2017;2017;01;13;Lauantai;30;50;80;53;66;119
89;21.01.2017;2017;01;14;Lauantai;36;28;64;44;57;101
89;21.01.2017;2017;01;15;Lauantai;35;23;58;43;41;84
89;21.01.2017;2017;01;16;Lauantai;47;29;76;44;31;75
89;21.01.2017;2017;01;17;Lauantai;26;17;43;25;24;49
89;21.01.2017;2017;01;18;Lauantai;20;16;36;32;20;52
89;21.01.2017;2017;01;19;Lauantai;22;18;40;16;13;29
89;21.01.2017;2017;01;20;Lauantai;16;12;28;11;8;19
89;21.01.2017;2017;01;21;Lauantai;21;13;34;12;10;22
89;21.01.2017;2017;01;22;Lauantai;11;13;24;7;8;15
89;21.01.2017;2017;01;23;Lauantai;8;15;23;4;8;12
89;22.01.2017;2017;01;00;Sunnuntai;15;19;34;5;11;16
89;22.01.2017;2017;01;01;Sunnuntai;9;10;19;7;2;9
89;22.01.2017;2017;01;02;Sunnuntai;8;2;10;3;4;7
89;22.01.2017;2017;01;03;Sunnuntai;13;1;14;1;1;2
89;22.01.2017;2017;01;04;Sunnuntai;5;3;8;13;0;13
89;22.01.2017;2017;01;05;Sunnuntai;4;2;6;0;1;1
89;22.01.2017;2017;01;06;Sunnuntai;2;6;8;3;4;7
89;22.01.2017;2017;01;07;Sunnuntai;1;4;5;3;1;4
89;22.01.2017;2017;01;08;Sunnuntai;6;1;7;3;11;14
89;22.01.2017;2017;01;09;Sunnuntai;5;5;10;11;12;23
89;22.01.2017;2017;01;10;Sunnuntai;7;19;26;35;46;81
89;22.01.2017;2017;01;11;Sunnuntai;16;16;32;44;42;86
89;22.01.2017;2017;01;12;Sunnuntai;22;27;49;45;57;102
89;22.01.2017;2017;01;13;Sunnuntai;32;19;51;43;57;100
89;22.01.2017;2017;01;14;Sunnuntai;25;30;55;31;35;66
89;22.01.2017;2017;01;15;Sunnuntai;39;40;79;44;54;98
89;22.01.2017;2017;01;16;Sunnuntai;28;14;42;35;31;66
89;22.01.2017;2017;01;17;Sunnuntai;23;22;45;38;24;62
89;22.01.2017;2017;01;18;Sunnuntai;28;25;53;27;25;52
89;22.01.2017;2017;01;19;Sunnuntai;18;25;43;20;21;41
89;22.01.2017;2017;01;20;Sunnuntai;23;15;38;9;16;25
89;22.01.2017;2017;01;21;Sunnuntai;13;7;20;16;13;29
89;22.01.2017;2017;01;22;Sunnuntai;7;7;14;5;1;6
89;22.01.2017;2017;01;23;Sunnuntai;7;5;12;4;3;7
89;23.01.2017;2017;01;00;Maanantai;3;1;4;1;0;1
89;23.01.2017;2017;01;01;Maanantai;1;3;4;0;0;0
89;23.01.2017;2017;01;02;Maanantai;2;0;2;0;0;0
89;23.01.2017;2017;01;03;Maanantai;4;1;5;0;0;0
89;23.01.2017;2017;01;04;Maanantai;0;2;2;0;2;2
89;23.01.2017;2017;01;05;Maanantai;2;5;7;3;2;5
89;23.01.2017;2017;01;06;Maanantai;6;21;27;2;9;11
89;23.01.2017;2017;01;07;Maanantai;16;96;112;11;30;41
89;23.01.2017;2017;01;08;Maanantai;26;149;175;12;44;56
89;23.01.2017;2017;01;09;Maanantai;25;79;104;6;33;39
89;23.01.2017;2017;01;10;Maanantai;23;61;84;29;25;54
89;23.01.2017;2017;01;11;Maanantai;39;55;94;21;35;56
89;23.01.2017;2017;01;12;Maanantai;47;36;83;26;37;63
89;23.01.2017;2017;01;13;Maanantai;51;47;98;37;28;65
89;23.01.2017;2017;01;14;Maanantai;61;39;100;35;25;60
89;23.01.2017;2017;01;15;Maanantai;102;39;141;39;26;65
89;23.01.2017;2017;01;16;Maanantai;110;57;167;57;34;91
89;23.01.2017;2017;01;17;Maanantai;89;46;135;34;27;61
89;23.01.2017;2017;01;18;Maanantai;55;29;84;37;22;59
89;23.01.2017;2017;01;19;Maanantai;36;22;58;35;24;59
89;23.01.2017;2017;01;20;Maanantai;30;15;45;16;11;27
89;23.01.2017;2017;01;21;Maanantai;34;16;50;17;12;29
89;23.01.2017;2017;01;22;Maanantai;12;7;19;2;0;2
89;23.01.2017;2017;01;23;Maanantai;8;7;15;2;0;2
89;24.01.2017;2017;01;00;Tiistai;4;3;7;0;0;0
89;24.01.2017;2017;01;01;Tiistai;1;1;2;0;0;0
89;24.01.2017;2017;01;02;Tiistai;1;1;2;0;0;0
89;24.01.2017;2017;01;03;Tiistai;2;3;5;1;0;1
89;24.01.2017;2017;01;04;Tiistai;0;3;3;1;0;1
89;24.01.2017;2017;01;05;Tiistai;1;5;6;1;2;3
89;24.01.2017;2017;01;06;Tiistai;7;23;30;3;10;13
89;24.01.2017;2017;01;07;Tiistai;16;89;105;6;32;38
89;24.01.2017;2017;01;08;Tiistai;23;137;160;13;46;59
89;24.01.2017;2017;01;09;Tiistai;18;60;78;10;39;49
89;24.01.2017;2017;01;10;Tiistai;24;48;72;20;26;46
89;24.01.2017;2017;01;11;Tiistai;25;28;53;34;26;60
89;24.01.2017;2017;01;12;Tiistai;32;35;67;21;35;56
89;24.01.2017;2017;01;13;Tiistai;30;29;59;31;28;59
89;24.01.2017;2017;01;14;Tiistai;45;21;66;31;28;59
89;24.01.2017;2017;01;15;Tiistai;100;36;136;38;30;68
89;24.01.2017;2017;01;16;Tiistai;89;48;137;48;15;63
89;24.01.2017;2017;01;17;Tiistai;69;43;112;35;26;61
89;24.01.2017;2017;01;18;Tiistai;43;30;73;33;22;55
89;24.01.2017;2017;01;19;Tiistai;32;16;48;11;17;28
89;24.01.2017;2017;01;20;Tiistai;39;7;46;24;8;32
89;24.01.2017;2017;01;21;Tiistai;33;5;38;6;4;10
89;24.01.2017;2017;01;22;Tiistai;8;7;15;5;2;7
89;24.01.2017;2017;01;23;Tiistai;6;1;7;5;0;5
89;25.01.2017;2017;01;00;Keskiviikko;3;1;4;0;0;0
89;25.01.2017;2017;01;01;Keskiviikko;2;2;4;0;0;0
89;25.01.2017;2017;01;02;Keskiviikko;0;2;2;0;0;0
89;25.01.2017;2017;01;03;Keskiviikko;1;2;3;0;0;0
89;25.01.2017;2017;01;04;Keskiviikko;1;2;3;0;0;0
89;25.01.2017;2017;01;05;Keskiviikko;1;9;10;1;1;2
89;25.01.2017;2017;01;06;Keskiviikko;10;21;31;1;8;9
89;25.01.2017;2017;01;07;Keskiviikko;14;92;106;7;31;38
89;25.01.2017;2017;01;08;Keskiviikko;20;116;136;16;48;64
89;25.01.2017;2017;01;09;Keskiviikko;20;64;84;15;40;55
89;25.01.2017;2017;01;10;Keskiviikko;18;53;71;18;33;51
89;25.01.2017;2017;01;11;Keskiviikko;31;53;84;21;30;51
89;25.01.2017;2017;01;12;Keskiviikko;31;40;71;30;42;72
89;25.01.2017;2017;01;13;Keskiviikko;52;43;95;22;23;45
89;25.01.2017;2017;01;14;Keskiviikko;42;26;68;44;20;64
89;25.01.2017;2017;01;15;Keskiviikko;109;32;141;40;27;67
89;25.01.2017;2017;01;16;Keskiviikko;103;45;148;52;18;70
89;25.01.2017;2017;01;17;Keskiviikko;71;39;110;35;23;58
89;25.01.2017;2017;01;18;Keskiviikko;51;31;82;26;23;49
89;25.01.2017;2017;01;19;Keskiviikko;54;20;74;30;27;57
89;25.01.2017;2017;01;20;Keskiviikko;42;14;56;24;13;37
89;25.01.2017;2017;01;21;Keskiviikko;27;9;36;9;11;20
89;25.01.2017;2017;01;22;Keskiviikko;14;6;20;5;7;12
89;25.01.2017;2017;01;23;Keskiviikko;6;6;12;2;2;4
89;26.01.2017;2017;01;00;Torstai;1;1;2;1;1;2
89;26.01.2017;2017;01;01;Torstai;1;0;1;0;1;1
89;26.01.2017;2017;01;02;Torstai;0;0;0;1;1;2
89;26.01.2017;2017;01;03;Torstai;1;0;1;0;0;0
89;26.01.2017;2017;01;04;Torstai;2;2;4;0;1;1
89;26.01.2017;2017;01;05;Torstai;2;9;11;4;3;7
89;26.01.2017;2017;01;06;Torstai;6;22;28;0;8;8
89;26.01.2017;2017;01;07;Torstai;16;87;103;9;31;40
89;26.01.2017;2017;01;08;Torstai;25;127;152;10;44;54
89;26.01.2017;2017;01;09;Torstai;23;62;85;11;32;43
89;26.01.2017;2017;01;10;Torstai;29;58;87;15;30;45
89;26.01.2017;2017;01;11;Torstai;39;45;84;27;35;62
89;26.01.2017;2017;01;12;Torstai;35;45;80;29;39;68
89;26.01.2017;2017;01;13;Torstai;48;49;97;44;37;81
89;26.01.2017;2017;01;14;Torstai;68;37;105;48;44;92
89;26.01.2017;2017;01;15;Torstai;101;38;139;46;39;85
89;26.01.2017;2017;01;16;Torstai;96;55;151;58;36;94
89;26.01.2017;2017;01;17;Torstai;61;39;100;36;26;62
89;26.01.2017;2017;01;18;Torstai;50;32;82;28;24;52
89;26.01.2017;2017;01;19;Torstai;42;30;72;29;21;50
89;26.01.2017;2017;01;20;Torstai;37;17;54;15;15;30
89;26.01.2017;2017;01;21;Torstai;29;8;37;12;10;22
89;26.01.2017;2017;01;22;Torstai;4;3;7;6;6;12
89;26.01.2017;2017;01;23;Torstai;12;3;15;6;4;10
89;27.01.2017;2017;01;00;Perjantai;3;2;5;1;0;1
89;27.01.2017;2017;01;01;Perjantai;1;0;1;1;3;4
89;27.01.2017;2017;01;02;Perjantai;2;0;2;2;0;2
89;27.01.2017;2017;01;03;Perjantai;2;0;2;0;0;0
89;27.01.2017;2017;01;04;Perjantai;0;3;3;1;0;1
89;27.01.2017;2017;01;05;Perjantai;3;5;8;1;0;1
89;27.01.2017;2017;01;06;Perjantai;10;31;41;5;13;18
89;27.01.2017;2017;01;07;Perjantai;21;84;105;8;25;33
89;27.01.2017;2017;01;08;Perjantai;30;112;142;8;48;56
89;27.01.2017;2017;01;09;Perjantai;17;69;86;16;29;45
89;27.01.2017;2017;01;10;Perjantai;22;61;83;23;32;55
89;27.01.2017;2017;01;11;Perjantai;30;34;64;24;39;63
89;27.01.2017;2017;01;12;Perjantai;36;57;93;33;50;83
89;27.01.2017;2017;01;13;Perjantai;51;57;108;41;39;80
89;27.01.2017;2017;01;14;Perjantai;84;43;127;42;33;75
89;27.01.2017;2017;01;15;Perjantai;86;52;138;29;37;66
89;27.01.2017;2017;01;16;Perjantai;86;54;140;31;41;72
89;27.01.2017;2017;01;17;Perjantai;62;44;106;42;28;70
89;27.01.2017;2017;01;18;Perjantai;50;26;76;15;20;35
89;27.01.2017;2017;01;19;Perjantai;40;17;57;33;37;70
89;27.01.2017;2017;01;20;Perjantai;22;34;56;22;10;32
89;27.01.2017;2017;01;21;Perjantai;34;3;37;15;10;25
89;27.01.2017;2017;01;22;Perjantai;15;13;28;2;5;7
89;27.01.2017;2017;01;23;Perjantai;9;5;14;4;1;5
89;28.01.2017;2017;01;00;Lauantai;10;6;16;8;4;12
89;28.01.2017;2017;01;01;Lauantai;12;5;17;2;7;9
89;28.01.2017;2017;01;02;Lauantai;11;1;12;11;1;12
89;28.01.2017;2017;01;03;Lauantai;6;1;7;3;2;5
89;28.01.2017;2017;01;04;Lauantai;7;3;10;6;2;8
89;28.01.2017;2017;01;05;Lauantai;1;8;9;2;5;7
89;28.01.2017;2017;01;06;Lauantai;0;4;4;2;3;5
89;28.01.2017;2017;01;07;Lauantai;6;7;13;4;6;10
89;28.01.2017;2017;01;08;Lauantai;2;12;14;7;21;28
89;28.01.2017;2017;01;09;Lauantai;3;24;27;11;25;36
89;28.01.2017;2017;01;10;Lauantai;20;26;46;18;46;64
89;28.01.2017;2017;01;11;Lauantai;25;41;66;37;62;99
89;28.01.2017;2017;01;12;Lauantai;34;41;75;47;76;123
89;28.01.2017;2017;01;13;Lauantai;29;46;75;58;59;117
89;28.01.2017;2017;01;14;Lauantai;31;44;75;40;45;85
89;28.01.2017;2017;01;15;Lauantai;55;28;83;36;31;67
89;28.01.2017;2017;01;16;Lauantai;41;32;73;21;37;58
89;28.01.2017;2017;01;17;Lauantai;30;19;49;21;28;49
89;28.01.2017;2017;01;18;Lauantai;26;20;46;24;18;42
89;28.01.2017;2017;01;19;Lauantai;21;22;43;11;27;38
89;28.01.2017;2017;01;20;Lauantai;20;20;40;11;22;33
89;28.01.2017;2017;01;21;Lauantai;13;12;25;10;6;16
89;28.01.2017;2017;01;22;Lauantai;10;13;23;14;11;25
89;28.01.2017;2017;01;23;Lauantai;17;12;29;10;8;18
89;29.01.2017;2017;01;00;Sunnuntai;9;10;19;3;10;13
89;29.01.2017;2017;01;01;Sunnuntai;10;1;11;3;4;7
89;29.01.2017;2017;01;02;Sunnuntai;10;4;14;8;2;10
89;29.01.2017;2017;01;03;Sunnuntai;12;1;13;8;1;9
89;29.01.2017;2017;01;04;Sunnuntai;13;1;14;10;1;11
89;29.01.2017;2017;01;05;Sunnuntai;5;2;7;2;0;2
89;29.01.2017;2017;01;06;Sunnuntai;2;2;4;1;1;2
89;29.01.2017;2017;01;07;Sunnuntai;4;5;9;4;5;9
89;29.01.2017;2017;01;08;Sunnuntai;2;4;6;1;2;3
89;29.01.2017;2017;01;09;Sunnuntai;9;7;16;12;23;35
89;29.01.2017;2017;01;10;Sunnuntai;9;17;26;33;33;66
89;29.01.2017;2017;01;11;Sunnuntai;10;23;33;40;48;88
89;29.01.2017;2017;01;12;Sunnuntai;23;32;55;46;64;110
89;29.01.2017;2017;01;13;Sunnuntai;25;33;58;52;54;106
89;29.01.2017;2017;01;14;Sunnuntai;29;19;48;44;55;99
89;29.01.2017;2017;01;15;Sunnuntai;44;28;72;41;37;78
89;29.01.2017;2017;01;16;Sunnuntai;33;21;54;46;28;74
89;29.01.2017;2017;01;17;Sunnuntai;33;16;49;28;24;52
89;29.01.2017;2017;01;18;Sunnuntai;17;13;30;38;16;54
89;29.01.2017;2017;01;19;Sunnuntai;16;26;42;28;23;51
89;29.01.2017;2017;01;20;Sunnuntai;21;8;29;26;11;37
89;29.01.2017;2017;01;21;Sunnuntai;10;5;15;9;8;17
89;29.01.2017;2017;01;22;Sunnuntai;6;3;9;6;3;9
89;29.01.2017;2017;01;23;Sunnuntai;4;4;8;3;2;5
89;30.01.2017;2017;01;00;Maanantai;4;3;7;3;2;5
89;30.01.2017;2017;01;01;Maanantai;3;1;4;1;0;1
89;30.01.2017;2017;01;02;Maanantai;1;1;2;0;0;0
89;30.01.2017;2017;01;03;Maanantai;0;2;2;1;0;1
89;30.01.2017;2017;01;04;Maanantai;2;1;3;0;0;0
89;30.01.2017;2017;01;05;Maanantai;2;7;9;1;2;3
89;30.01.2017;2017;01;06;Maanantai;4;25;29;3;8;11
89;30.01.2017;2017;01;07;Maanantai;28;98;126;10;28;38
89;30.01.2017;2017;01;08;Maanantai;17;137;154;7;37;44
89;30.01.2017;2017;01;09;Maanantai;27;69;96;5;38;43
89;30.01.2017;2017;01;10;Maanantai;13;41;54;17;21;38
89;30.01.2017;2017;01;11;Maanantai;36;34;70;19;33;52
89;30.01.2017;2017;01;12;Maanantai;39;42;81;24;24;48
89;30.01.2017;2017;01;13;Maanantai;36;38;74;30;26;56
89;30.01.2017;2017;01;14;Maanantai;71;33;104;24;44;68
89;30.01.2017;2017;01;15;Maanantai;111;44;155;51;40;91
89;30.01.2017;2017;01;16;Maanantai;132;62;194;51;34;85
89;30.01.2017;2017;01;17;Maanantai;73;42;115;36;23;59
89;30.01.2017;2017;01;18;Maanantai;45;22;67;37;30;67
89;30.01.2017;2017;01;19;Maanantai;36;30;66;43;28;71
89;30.01.2017;2017;01;20;Maanantai;34;19;53;22;16;38
89;30.01.2017;2017;01;21;Maanantai;17;10;27;21;12;33
89;30.01.2017;2017;01;22;Maanantai;10;8;18;3;2;5
89;30.01.2017;2017;01;23;Maanantai;5;4;9;2;0;2
89;31.01.2017;2017;01;00;Tiistai;2;3;5;2;1;3
89;31.01.2017;2017;01;01;Tiistai;2;1;3;2;0;2
89;31.01.2017;2017;01;02;Tiistai;3;0;3;0;1;1
89;31.01.2017;2017;01;03;Tiistai;3;1;4;0;0;0
89;31.01.2017;2017;01;04;Tiistai;1;3;4;0;0;0
89;31.01.2017;2017;01;05;Tiistai;3;5;8;1;2;3
89;31.01.2017;2017;01;06;Tiistai;12;28;40;2;10;12
89;31.01.2017;2017;01;07;Tiistai;18;94;112;6;24;30
89;31.01.2017;2017;01;08;Tiistai;26;157;183;6;36;42
89;31.01.2017;2017;01;09;Tiistai;22;58;80;14;31;45
89;31.01.2017;2017;01;10;Tiistai;27;41;68;20;40;60
89;31.01.2017;2017;01;11;Tiistai;47;57;104;33;46;79
89;31.01.2017;2017;01;12;Tiistai;31;51;82;34;46;80
89;31.01.2017;2017;01;13;Tiistai;45;53;98;36;37;73
89;31.01.2017;2017;01;14;Tiistai;61;47;108;42;37;79
89;31.01.2017;2017;01;15;Tiistai;112;43;155;29;31;60
89;31.01.2017;2017;01;16;Tiistai;110;49;159;46;30;76
89;31.01.2017;2017;01;17;Tiistai;87;37;124;36;18;54
89;31.01.2017;2017;01;18;Tiistai;68;42;110;42;21;63
89;31.01.2017;2017;01;19;Tiistai;38;24;62;30;20;50
89;31.01.2017;2017;01;20;Tiistai;38;11;49;25;14;39
89;31.01.2017;2017;01;21;Tiistai;46;14;60;12;14;26
89;31.01.2017;2017;01;22;Tiistai;8;9;17;6;4;10
89;31.01.2017;2017;01;23;Tiistai;6;4;10;2;3;5
89;01.02.2017;2017;02;00;Keskiviikko;1;3;4;2;1;3
89;01.02.2017;2017;02;01;Keskiviikko;3;3;6;0;0;0
89;01.02.2017;2017;02;02;Keskiviikko;3;0;3;1;0;1
89;01.02.2017;2017;02;03;Keskiviikko;3;0;3;0;0;0
89;01.02.2017;2017;02;04;Keskiviikko;0;4;4;0;0;0
89;01.02.2017;2017;02;05;Keskiviikko;2;6;8;1;2;3
89;01.02.2017;2017;02;06;Keskiviikko;7;37;44;2;5;7
89;01.02.2017;2017;02;07;Keskiviikko;19;106;125;8;29;37
89;01.02.2017;2017;02;08;Keskiviikko;23;142;165;12;47;59
89;01.02.2017;2017;02;09;Keskiviikko;29;56;85;10;30;40
89;01.02.2017;2017;02;10;Keskiviikko;28;48;76;20;41;61
89;01.02.2017;2017;02;11;Keskiviikko;27;53;80;28;28;56
89;01.02.2017;2017;02;12;Keskiviikko;45;49;94;30;33;63
89;01.02.2017;2017;02;13;Keskiviikko;42;29;71;33;39;72
89;01.02.2017;2017;02;14;Keskiviikko;80;38;118;40;28;68
89;01.02.2017;2017;02;15;Keskiviikko;101;39;140;42;25;67
89;01.02.2017;2017;02;16;Keskiviikko;113;59;172;47;38;85
89;01.02.2017;2017;02;17;Keskiviikko;79;48;127;37;24;61
89;01.02.2017;2017;02;18;Keskiviikko;64;37;101;38;27;65
89;01.02.2017;2017;02;19;Keskiviikko;57;17;74;23;20;43
89;01.02.2017;2017;02;20;Keskiviikko;35;18;53;23;15;38
89;01.02.2017;2017;02;21;Keskiviikko;35;13;48;17;11;28
89;01.02.2017;2017;02;22;Keskiviikko;10;7;17;4;6;10
89;01.02.2017;2017;02;23;Keskiviikko;6;4;10;4;2;6
89;02.02.2017;2017;02;00;Torstai;7;7;14;0;2;2
89;02.02.2017;2017;02;01;Torstai;4;0;4;2;0;2
89;02.02.2017;2017;02;02;Torstai;8;1;9;0;3;3
89;02.02.2017;2017;02;03;Torstai;2;4;6;0;0;0
89;02.02.2017;2017;02;04;Torstai;1;0;1;0;1;1
89;02.02.2017;2017;02;05;Torstai;2;5;7;1;1;2
89;02.02.2017;2017;02;06;Torstai;7;25;32;3;6;9
89;02.02.2017;2017;02;07;Torstai;22;90;112;6;29;35
89;02.02.2017;2017;02;08;Torstai;20;154;174;13;33;46
89;02.02.2017;2017;02;09;Torstai;22;66;88;17;28;45
89;02.02.2017;2017;02;10;Torstai;31;41;72;16;29;45
89;02.02.2017;2017;02;11;Torstai;30;30;60;18;35;53
89;02.02.2017;2017;02;12;Torstai;34;31;65;31;26;57
89;02.02.2017;2017;02;13;Torstai;46;32;78;31;22;53
89;02.02.2017;2017;02;14;Torstai;60;38;98;22;16;38
89;02.02.2017;2017;02;15;Torstai;86;40;126;25;16;41
89;02.02.2017;2017;02;16;Torstai;108;38;146;43;26;69
89;02.02.2017;2017;02;17;Torstai;66;21;87;38;33;71
89;02.02.2017;2017;02;18;Torstai;48;26;74;25;20;45
89;02.02.2017;2017;02;19;Torstai;31;21;52;33;19;52
89;02.02.2017;2017;02;20;Torstai;32;13;45;25;8;33
89;02.02.2017;2017;02;21;Torstai;19;11;30;11;7;18
89;02.02.2017;2017;02;22;Torstai;2;10;12;5;2;7
89;02.02.2017;2017;02;23;Torstai;8;7;15;6;6;12
89;03.02.2017;2017;02;00;Perjantai;5;4;9;6;4;10
89;03.02.2017;2017;02;01;Perjantai;3;0;3;3;3;6
89;03.02.2017;2017;02;02;Perjantai;3;1;4;7;0;7
89;03.02.2017;2017;02;03;Perjantai;8;2;10;2;0;2
89;03.02.2017;2017;02;04;Perjantai;4;2;6;4;3;7
89;03.02.2017;2017;02;05;Perjantai;0;3;3;1;0;1
89;03.02.2017;2017;02;06;Perjantai;7;22;29;2;9;11
89;03.02.2017;2017;02;07;Perjantai;21;99;120;4;24;28
89;03.02.2017;2017;02;08;Perjantai;14;95;109;17;50;67
89;03.02.2017;2017;02;09;Perjantai;23;60;83;13;30;43
89;03.02.2017;2017;02;10;Perjantai;26;53;79;20;28;48
89;03.02.2017;2017;02;11;Perjantai;21;43;64;19;50;69
89;03.02.2017;2017;02;12;Perjantai;37;56;93;35;34;69
89;03.02.2017;2017;02;13;Perjantai;55;57;112;39;32;71
89;03.02.2017;2017;02;14;Perjantai;74;47;121;40;25;65
89;03.02.2017;2017;02;15;Perjantai;93;56;149;19;22;41
89;03.02.2017;2017;02;16;Perjantai;79;46;125;39;26;65
89;03.02.2017;2017;02;17;Perjantai;63;41;104;33;27;60
89;03.02.2017;2017;02;18;Perjantai;47;19;66;21;32;53
89;03.02.2017;2017;02;19;Perjantai;34;24;58;23;23;46
89;03.02.2017;2017;02;20;Perjantai;30;17;47;19;22;41
89;03.02.2017;2017;02;21;Perjantai;24;10;34;17;9;26
89;03.02.2017;2017;02;22;Perjantai;14;20;34;11;8;19
89;03.02.2017;2017;02;23;Perjantai;12;8;20;5;8;13
89;04.02.2017;2017;02;00;Lauantai;11;4;15;1;0;1
89;04.02.2017;2017;02;01;Lauantai;4;0;4;4;2;6
89;04.02.2017;2017;02;02;Lauantai;7;4;11;2;3;5
89;04.02.2017;2017;02;03;Lauantai;13;2;15;2;1;3
89;04.02.2017;2017;02;04;Lauantai;4;0;4;6;0;6
89;04.02.2017;2017;02;05;Lauantai;3;1;4;1;2;3
89;04.02.2017;2017;02;06;Lauantai;4;7;11;0;1;1
89;04.02.2017;2017;02;07;Lauantai;2;8;10;2;6;8
89;04.02.2017;2017;02;08;Lauantai;3;8;11;5;11;16
89;04.02.2017;2017;02;09;Lauantai;6;23;29;11;21;32
89;04.02.2017;2017;02;10;Lauantai;8;30;38;29;45;74
89;04.02.2017;2017;02;11;Lauantai;22;41;63;38;44;82
89;04.02.2017;2017;02;12;Lauantai;21;37;58;41;62;103
89;04.02.2017;2017;02;13;Lauantai;35;36;71;50;51;101
89;04.02.2017;2017;02;14;Lauantai;44;28;72;47;55;102
89;04.02.2017;2017;02;15;Lauantai;42;26;68;40;33;73
89;04.02.2017;2017;02;16;Lauantai;48;26;74;36;47;83
89;04.02.2017;2017;02;17;Lauantai;30;38;68;26;27;53
89;04.02.2017;2017;02;18;Lauantai;25;23;48;20;31;51
89;04.02.2017;2017;02;19;Lauantai;19;16;35;29;28;57
89;04.02.2017;2017;02;20;Lauantai;22;17;39;13;14;27
89;04.02.2017;2017;02;21;Lauantai;27;3;30;17;13;30
89;04.02.2017;2017;02;22;Lauantai;9;15;24;4;8;12
89;04.02.2017;2017;02;23;Lauantai;10;8;18;4;7;11
89;05.02.2017;2017;02;00;Sunnuntai;12;8;20;7;10;17
89;05.02.2017;2017;02;01;Sunnuntai;10;7;17;5;3;8
89;05.02.2017;2017;02;02;Sunnuntai;8;1;9;4;2;6
89;05.02.2017;2017;02;03;Sunnuntai;14;1;15;5;0;5
89;05.02.2017;2017;02;04;Sunnuntai;9;1;10;8;0;8
89;05.02.2017;2017;02;05;Sunnuntai;5;2;7;1;0;1
89;05.02.2017;2017;02;06;Sunnuntai;2;2;4;0;1;1
89;05.02.2017;2017;02;07;Sunnuntai;3;3;6;2;4;6
89;05.02.2017;2017;02;08;Sunnuntai;2;1;3;5;12;17
89;05.02.2017;2017;02;09;Sunnuntai;8;8;16;19;15;34
89;05.02.2017;2017;02;10;Sunnuntai;8;25;33;29;34;63
89;05.02.2017;2017;02;11;Sunnuntai;14;29;43;41;44;85
89;05.02.2017;2017;02;12;Sunnuntai;18;32;50;37;35;72
89;05.02.2017;2017;02;13;Sunnuntai;33;30;63;59;57;116
89;05.02.2017;2017;02;14;Sunnuntai;24;31;55;47;43;90
89;05.02.2017;2017;02;15;Sunnuntai;32;18;50;49;35;84
89;05.02.2017;2017;02;16;Sunnuntai;31;21;52;23;35;58
89;05.02.2017;2017;02;17;Sunnuntai;32;26;58;33;29;62
89;05.02.2017;2017;02;18;Sunnuntai;18;17;35;26;22;48
89;05.02.2017;2017;02;19;Sunnuntai;19;13;32;25;40;65
89;05.02.2017;2017;02;20;Sunnuntai;21;8;29;15;15;30
89;05.02.2017;2017;02;21;Sunnuntai;18;8;26;14;7;21
89;05.02.2017;2017;02;22;Sunnuntai;7;6;13;5;5;10
89;05.02.2017;2017;02;23;Sunnuntai;4;4;8;1;2;3
89;06.02.2017;2017;02;00;Maanantai;4;2;6;3;0;3
89;06.02.2017;2017;02;01;Maanantai;4;1;5;1;0;1
89;06.02.2017;2017;02;02;Maanantai;0;0;0;1;0;1
89;06.02.2017;2017;02;03;Maanantai;0;0;0;0;0;0
89;06.02.2017;2017;02;04;Maanantai;0;3;3;0;0;0
89;06.02.2017;2017;02;05;Maanantai;1;7;8;1;1;2
89;06.02.2017;2017;02;06;Maanantai;7;30;37;4;7;11
89;06.02.2017;2017;02;07;Maanantai;14;80;94;7;35;42
89;06.02.2017;2017;02;08;Maanantai;25;126;151;11;46;57
89;06.02.2017;2017;02;09;Maanantai;22;74;96;20;41;61
89;06.02.2017;2017;02;10;Maanantai;23;50;73;29;44;73
89;06.02.2017;2017;02;11;Maanantai;32;33;65;38;15;53
89;06.02.2017;2017;02;12;Maanantai;32;41;73;29;34;63
89;06.02.2017;2017;02;13;Maanantai;43;36;79;28;25;53
89;06.02.2017;2017;02;14;Maanantai;47;30;77;45;25;70
89;06.02.2017;2017;02;15;Maanantai;117;49;166;36;37;73
89;06.02.2017;2017;02;16;Maanantai;122;46;168;47;26;73
89;06.02.2017;2017;02;17;Maanantai;94;59;153;40;40;80
89;06.02.2017;2017;02;18;Maanantai;47;30;77;28;31;59
89;06.02.2017;2017;02;19;Maanantai;49;23;72;30;24;54
89;06.02.2017;2017;02;20;Maanantai;27;13;40;21;19;40
89;06.02.2017;2017;02;21;Maanantai;20;8;28;8;13;21
89;06.02.2017;2017;02;22;Maanantai;14;8;22;9;8;17
89;06.02.2017;2017;02;23;Maanantai;1;3;4;2;3;5
89;07.02.2017;2017;02;00;Tiistai;4;2;6;5;1;6
89;07.02.2017;2017;02;01;Tiistai;1;2;3;0;1;1
89;07.02.2017;2017;02;02;Tiistai;0;3;3;0;1;1
89;07.02.2017;2017;02;03;Tiistai;3;0;3;0;0;0
89;07.02.2017;2017;02;04;Tiistai;2;3;5;1;0;1
89;07.02.2017;2017;02;05;Tiistai;1;7;8;2;0;2
89;07.02.2017;2017;02;06;Tiistai;6;32;38;5;9;14
89;07.02.2017;2017;02;07;Tiistai;19;87;106;5;32;37
89;07.02.2017;2017;02;08;Tiistai;23;138;161;7;41;48
89;07.02.2017;2017;02;09;Tiistai;27;69;96;17;37;54
89;07.02.2017;2017;02;10;Tiistai;28;44;72;20;40;60
89;07.02.2017;2017;02;11;Tiistai;37;45;82;24;39;63
89;07.02.2017;2017;02;12;Tiistai;26;41;67;41;27;68
89;07.02.2017;2017;02;13;Tiistai;40;36;76;32;46;78
89;07.02.2017;2017;02;14;Tiistai;44;32;76;34;32;66
89;07.02.2017;2017;02;15;Tiistai;109;29;138;35;23;58
89;07.02.2017;2017;02;16;Tiistai;125;59;184;68;23;91
89;07.02.2017;2017;02;17;Tiistai;72;37;109;36;25;61
89;07.02.2017;2017;02;18;Tiistai;55;29;84;31;26;57
89;07.02.2017;2017;02;19;Tiistai;44;13;57;45;17;62
89;07.02.2017;2017;02;20;Tiistai;26;19;45;26;16;42
89;07.02.2017;2017;02;21;Tiistai;29;9;38;8;17;25
89;07.02.2017;2017;02;22;Tiistai;10;11;21;2;4;6
89;07.02.2017;2017;02;23;Tiistai;7;2;9;3;1;4
89;08.02.2017;2017;02;00;Keskiviikko;5;1;6;0;1;1
89;08.02.2017;2017;02;01;Keskiviikko;1;3;4;6;1;7
89;08.02.2017;2017;02;02;Keskiviikko;0;1;1;1;0;1
89;08.02.2017;2017;02;03;Keskiviikko;0;2;2;0;0;0
89;08.02.2017;2017;02;04;Keskiviikko;1;1;2;0;1;1
89;08.02.2017;2017;02;05;Keskiviikko;1;10;11;1;1;2
89;08.02.2017;2017;02;06;Keskiviikko;7;26;33;0;11;11
89;08.02.2017;2017;02;07;Keskiviikko;18;77;95;5;28;33
89;08.02.2017;2017;02;08;Keskiviikko;24;112;136;19;44;63
89;08.02.2017;2017;02;09;Keskiviikko;12;52;64;11;22;33
89;08.02.2017;2017;02;10;Keskiviikko;29;35;64;13;23;36
89;08.02.2017;2017;02;11;Keskiviikko;15;44;59;18;35;53
89;08.02.2017;2017;02;12;Keskiviikko;28;43;71;21;24;45
89;08.02.2017;2017;02;13;Keskiviikko;42;37;79;40;31;71
89;08.02.2017;2017;02;14;Keskiviikko;63;39;102;48;32;80
89;08.02.2017;2017;02;15;Keskiviikko;78;44;122;39;34;73
89;08.02.2017;2017;02;16;Keskiviikko;100;51;151;44;28;72
89;08.02.2017;2017;02;17;Keskiviikko;76;32;108;35;18;53
89;08.02.2017;2017;02;18;Keskiviikko;34;24;58;26;19;45
89;08.02.2017;2017;02;19;Keskiviikko;37;13;50;13;13;26
89;08.02.2017;2017;02;20;Keskiviikko;27;11;38;11;9;20
89;08.02.2017;2017;02;21;Keskiviikko;20;6;26;12;4;16
89;08.02.2017;2017;02;22;Keskiviikko;13;8;21;6;3;9
89;08.02.2017;2017;02;23;Keskiviikko;10;3;13;0;2;2
89;09.02.2017;2017;02;00;Torstai;4;2;6;2;0;2
89;09.02.2017;2017;02;01;Torstai;3;0;3;0;0;0
89;09.02.2017;2017;02;02;Torstai;1;0;1;1;0;1
89;09.02.2017;2017;02;03;Torstai;1;1;2;1;0;1
89;09.02.2017;2017;02;04;Torstai;2;3;5;1;0;1
89;09.02.2017;2017;02;05;Torstai;1;6;7;1;0;1
89;09.02.2017;2017;02;06;Torstai;4;26;30;3;9;12
89;09.02.2017;2017;02;07;Torstai;12;64;76;8;23;31
89;09.02.2017;2017;02;08;Torstai;15;116;131;6;47;53
89;09.02.2017;2017;02;09;Torstai;17;52;69;9;33;42
89;09.02.2017;2017;02;10;Torstai;16;39;55;7;25;32
89;09.02.2017;2017;02;11;Torstai;23;41;64;12;17;29
89;09.02.2017;2017;02;12;Torstai;30;29;59;20;39;59
89;09.02.2017;2017;02;13;Torstai;53;35;88;29;32;61
89;09.02.2017;2017;02;14;Torstai;45;24;69;29;26;55
89;09.02.2017;2017;02;15;Torstai;83;36;119;38;28;66
89;09.02.2017;2017;02;16;Torstai;97;42;139;40;23;63
89;09.02.2017;2017;02;17;Torstai;52;37;89;27;21;48
89;09.02.2017;2017;02;18;Torstai;47;26;73;31;20;51
89;09.02.2017;2017;02;19;Torstai;43;22;65;24;12;36
89;09.02.2017;2017;02;20;Torstai;33;15;48;18;8;26
89;09.02.2017;2017;02;21;Torstai;22;8;30;10;11;21
89;09.02.2017;2017;02;22;Torstai;8;8;16;7;1;8
89;09.02.2017;2017;02;23;Torstai;7;3;10;1;0;1
89;10.02.2017;2017;02;00;Perjantai;8;6;14;1;1;2
89;10.02.2017;2017;02;01;Perjantai;1;1;2;0;0;0
89;10.02.2017;2017;02;02;Perjantai;2;0;2;2;0;2
89;10.02.2017;2017;02;03;Perjantai;5;2;7;0;0;0
89;10.02.2017;2017;02;04;Perjantai;1;4;5;0;0;0
89;10.02.2017;2017;02;05;Perjantai;1;7;8;3;0;3
89;10.02.2017;2017;02;06;Perjantai;7;30;37;2;7;9
89;10.02.2017;2017;02;07;Perjantai;20;82;102;6;28;34
89;10.02.2017;2017;02;08;Perjantai;25;113;138;13;41;54
89;10.02.2017;2017;02;09;Perjantai;24;59;83;9;27;36
89;10.02.2017;2017;02;10;Perjantai;17;40;57;23;27;50
89;10.02.2017;2017;02;11;Perjantai;25;55;80;20;24;44
89;10.02.2017;2017;02;12;Perjantai;54;53;107;25;32;57
89;10.02.2017;2017;02;13;Perjantai;45;50;95;38;37;75
89;10.02.2017;2017;02;14;Perjantai;72;46;118;34;23;57
89;10.02.2017;2017;02;15;Perjantai;97;46;143;33;31;64
89;10.02.2017;2017;02;16;Perjantai;81;61;142;51;28;79
89;10.02.2017;2017;02;17;Perjantai;66;33;99;21;16;37
89;10.02.2017;2017;02;18;Perjantai;37;34;71;18;18;36
89;10.02.2017;2017;02;19;Perjantai;20;27;47;25;21;46
89;10.02.2017;2017;02;20;Perjantai;19;16;35;17;14;31
89;10.02.2017;2017;02;21;Perjantai;23;10;33;15;16;31
89;10.02.2017;2017;02;22;Perjantai;19;11;30;8;5;13
89;10.02.2017;2017;02;23;Perjantai;9;12;21;7;4;11
89;11.02.2017;2017;02;00;Lauantai;9;5;14;2;7;9
89;11.02.2017;2017;02;01;Lauantai;4;4;8;4;5;9
89;11.02.2017;2017;02;02;Lauantai;12;1;13;6;2;8
89;11.02.2017;2017;02;03;Lauantai;9;0;9;2;0;2
89;11.02.2017;2017;02;04;Lauantai;5;0;5;11;0;11
89;11.02.2017;2017;02;05;Lauantai;3;4;7;2;2;4
89;11.02.2017;2017;02;06;Lauantai;1;8;9;2;1;3
89;11.02.2017;2017;02;07;Lauantai;2;9;11;6;5;11
89;11.02.2017;2017;02;08;Lauantai;3;24;27;11;12;23
89;11.02.2017;2017;02;09;Lauantai;8;20;28;11;31;42
89;11.02.2017;2017;02;10;Lauantai;14;23;37;25;35;60
89;11.02.2017;2017;02;11;Lauantai;18;31;49;35;39;74
89;11.02.2017;2017;02;12;Lauantai;26;47;73;32;47;79
89;11.02.2017;2017;02;13;Lauantai;41;33;74;34;48;82
89;11.02.2017;2017;02;14;Lauantai;28;40;68;47;33;80
89;11.02.2017;2017;02;15;Lauantai;38;23;61;43;25;68
89;11.02.2017;2017;02;16;Lauantai;31;24;55;36;32;68
89;11.02.2017;2017;02;17;Lauantai;39;29;68;31;21;52
89;11.02.2017;2017;02;18;Lauantai;20;25;45;33;26;59
89;11.02.2017;2017;02;19;Lauantai;20;14;34;15;18;33
89;11.02.2017;2017;02;20;Lauantai;18;19;37;8;21;29
89;11.02.2017;2017;02;21;Lauantai;19;26;45;13;10;23
89;11.02.2017;2017;02;22;Lauantai;7;17;24;4;9;13
89;11.02.2017;2017;02;23;Lauantai;9;15;24;5;6;11
89;12.02.2017;2017;02;00;Sunnuntai;10;5;15;7;2;9
89;12.02.2017;2017;02;01;Sunnuntai;11;1;12;4;2;6
89;12.02.2017;2017;02;02;Sunnuntai;9;5;14;4;1;5
89;12.02.2017;2017;02;03;Sunnuntai;10;2;12;4;2;6
89;12.02.2017;2017;02;04;Sunnuntai;9;2;11;3;0;3
89;12.02.2017;2017;02;05;Sunnuntai;5;3;8;0;0;0
89;12.02.2017;2017;02;06;Sunnuntai;1;3;4;2;3;5
89;12.02.2017;2017;02;07;Sunnuntai;0;6;6;3;0;3
89;12.02.2017;2017;02;08;Sunnuntai;1;1;2;6;7;13
89;12.02.2017;2017;02;09;Sunnuntai;12;13;25;13;12;25
89;12.02.2017;2017;02;10;Sunnuntai;7;17;24;29;34;63
89;12.02.2017;2017;02;11;Sunnuntai;10;26;36;33;30;63
89;12.02.2017;2017;02;12;Sunnuntai;16;30;46;42;60;102
89;12.02.2017;2017;02;13;Sunnuntai;23;20;43;52;76;128
89;12.02.2017;2017;02;14;Sunnuntai;26;35;61;49;54;103
89;12.02.2017;2017;02;15;Sunnuntai;30;19;49;33;30;63
89;12.02.2017;2017;02;16;Sunnuntai;32;23;55;39;26;65
89;12.02.2017;2017;02;17;Sunnuntai;22;18;40;36;35;71
89;12.02.2017;2017;02;18;Sunnuntai;19;15;34;30;18;48
89;12.02.2017;2017;02;19;Sunnuntai;22;23;45;19;29;48
89;12.02.2017;2017;02;20;Sunnuntai;8;11;19;19;13;32
89;12.02.2017;2017;02;21;Sunnuntai;12;6;18;8;5;13
89;12.02.2017;2017;02;22;Sunnuntai;12;6;18;5;5;10
89;12.02.2017;2017;02;23;Sunnuntai;4;6;10;6;2;8
89;13.02.2017;2017;02;00;Maanantai;3;3;6;1;0;1
89;13.02.2017;2017;02;01;Maanantai;0;1;1;2;1;3
89;13.02.2017;2017;02;02;Maanantai;1;1;2;0;1;1
89;13.02.2017;2017;02;03;Maanantai;1;1;2;0;2;2
89;13.02.2017;2017;02;04;Maanantai;2;3;5;0;0;0
89;13.02.2017;2017;02;05;Maanantai;3;4;7;1;1;2
89;13.02.2017;2017;02;06;Maanantai;8;36;44;4;7;11
89;13.02.2017;2017;02;07;Maanantai;15;104;119;6;27;33
89;13.02.2017;2017;02;08;Maanantai;22;140;162;11;42;53
89;13.02.2017;2017;02;09;Maanantai;27;95;122;16;45;61
89;13.02.2017;2017;02;10;Maanantai;26;52;78;26;37;63
89;13.02.2017;2017;02;11;Maanantai;39;50;89;36;46;82
89;13.02.2017;2017;02;12;Maanantai;33;47;80;38;44;82
89;13.02.2017;2017;02;13;Maanantai;55;49;104;51;52;103
89;13.02.2017;2017;02;14;Maanantai;77;39;116;44;51;95
89;13.02.2017;2017;02;15;Maanantai;112;47;159;35;44;79
89;13.02.2017;2017;02;16;Maanantai;147;69;216;55;36;91
89;13.02.2017;2017;02;17;Maanantai;73;48;121;33;27;60
89;13.02.2017;2017;02;18;Maanantai;65;20;85;20;28;48
89;13.02.2017;2017;02;19;Maanantai;42;27;69;23;16;39
89;13.02.2017;2017;02;20;Maanantai;33;19;52;18;12;30
89;13.02.2017;2017;02;21;Maanantai;24;17;41;14;3;17
89;13.02.2017;2017;02;22;Maanantai;11;6;17;8;3;11
89;13.02.2017;2017;02;23;Maanantai;4;7;11;4;0;4
89;14.02.2017;2017;02;00;Tiistai;5;0;5;3;1;4
89;14.02.2017;2017;02;01;Tiistai;2;1;3;0;0;0
89;14.02.2017;2017;02;02;Tiistai;1;1;2;1;0;1
89;14.02.2017;2017;02;03;Tiistai;2;1;3;1;0;1
89;14.02.2017;2017;02;04;Tiistai;0;2;2;0;0;0
89;14.02.2017;2017;02;05;Tiistai;4;5;9;3;3;6
89;14.02.2017;2017;02;06;Tiistai;8;25;33;2;5;7
89;14.02.2017;2017;02;07;Tiistai;17;88;105;5;25;30
89;14.02.2017;2017;02;08;Tiistai;24;143;167;12;52;64
89;14.02.2017;2017;02;09;Tiistai;29;79;108;11;44;55
89;14.02.2017;2017;02;10;Tiistai;27;70;97;21;49;70
89;14.02.2017;2017;02;11;Tiistai;37;54;91;34;32;66
89;14.02.2017;2017;02;12;Tiistai;42;41;83;44;40;84
89;14.02.2017;2017;02;13;Tiistai;47;44;91;34;36;70
89;14.02.2017;2017;02;14;Tiistai;54;37;91;43;33;76
89;14.02.2017;2017;02;15;Tiistai;103;42;145;51;52;103
89;14.02.2017;2017;02;16;Tiistai;142;63;205;54;33;87
89;14.02.2017;2017;02;17;Tiistai;96;62;158;34;39;73
89;14.02.2017;2017;02;18;Tiistai;48;28;76;35;24;59
89;14.02.2017;2017;02;19;Tiistai;44;23;67;31;18;49
89;14.02.2017;2017;02;20;Tiistai;34;20;54;30;23;53
89;14.02.2017;2017;02;21;Tiistai;43;5;48;18;16;34
89;14.02.2017;2017;02;22;Tiistai;14;6;20;6;2;8
89;14.02.2017;2017;02;23;Tiistai;5;10;15;3;2;5
89;15.02.2017;2017;02;00;Keskiviikko;7;6;13;1;0;1
89;15.02.2017;2017;02;01;Keskiviikko;1;1;2;1;1;2
89;15.02.2017;2017;02;02;Keskiviikko;2;1;3;2;1;3
89;15.02.2017;2017;02;03;Keskiviikko;6;1;7;1;0;1
89;15.02.2017;2017;02;04;Keskiviikko;2;2;4;2;1;3
89;15.02.2017;2017;02;05;Keskiviikko;4;4;8;1;2;3
89;15.02.2017;2017;02;06;Keskiviikko;5;29;34;3;9;12
89;15.02.2017;2017;02;07;Keskiviikko;17;87;104;11;30;41
89;15.02.2017;2017;02;08;Keskiviikko;39;166;205;26;55;81
89;15.02.2017;2017;02;09;Keskiviikko;19;95;114;22;75;97
89;15.02.2017;2017;02;10;Keskiviikko;27;39;66;22;44;66
89;15.02.2017;2017;02;11;Keskiviikko;49;55;104;60;25;85
89;15.02.2017;2017;02;12;Keskiviikko;55;59;114;21;32;53
89;15.02.2017;2017;02;13;Keskiviikko;60;46;106;32;32;64
89;15.02.2017;2017;02;14;Keskiviikko;67;48;115;48;26;74
89;15.02.2017;2017;02;15;Keskiviikko;109;47;156;38;25;63
89;15.02.2017;2017;02;16;Keskiviikko;113;51;164;43;23;66
89;15.02.2017;2017;02;17;Keskiviikko;91;61;152;38;32;70
89;15.02.2017;2017;02;18;Keskiviikko;55;29;84;33;41;74
89;15.02.2017;2017;02;19;Keskiviikko;53;22;75;29;29;58
89;15.02.2017;2017;02;20;Keskiviikko;38;29;67;35;18;53
89;15.02.2017;2017;02;21;Keskiviikko;37;9;46;20;10;30
89;15.02.2017;2017;02;22;Keskiviikko;19;15;34;8;5;13
89;15.02.2017;2017;02;23;Keskiviikko;4;13;17;4;9;13
89;16.02.2017;2017;02;00;Torstai;5;6;11;1;3;4
89;16.02.2017;2017;02;01;Torstai;3;2;5;0;2;2
89;16.02.2017;2017;02;02;Torstai;6;1;7;4;1;5
89;16.02.2017;2017;02;03;Torstai;2;2;4;0;1;1
89;16.02.2017;2017;02;04;Torstai;8;1;9;4;0;4
89;16.02.2017;2017;02;05;Torstai;8;4;12;2;1;3
89;16.02.2017;2017;02;06;Torstai;7;20;27;4;8;12
89;16.02.2017;2017;02;07;Torstai;23;98;121;8;29;37
89;16.02.2017;2017;02;08;Torstai;26;145;171;13;42;55
89;16.02.2017;2017;02;09;Torstai;22;76;98;8;39;47
89;16.02.2017;2017;02;10;Torstai;30;55;85;24;38;62
89;16.02.2017;2017;02;11;Torstai;47;42;89;29;34;63
89;16.02.2017;2017;02;12;Torstai;40;47;87;19;37;56
89;16.02.2017;2017;02;13;Torstai;48;70;118;26;74;100
89;16.02.2017;2017;02;14;Torstai;109;33;142;67;15;82
89;16.02.2017;2017;02;15;Torstai;103;44;147;35;24;59
89;16.02.2017;2017;02;16;Torstai;121;60;181;48;35;83
89;16.02.2017;2017;02;17;Torstai;77;48;125;38;31;69
89;16.02.2017;2017;02;18;Torstai;67;30;97;34;28;62
89;16.02.2017;2017;02;19;Torstai;36;28;64;33;26;59
89;16.02.2017;2017;02;20;Torstai;36;18;54;25;12;37
89;16.02.2017;2017;02;21;Torstai;28;20;48;9;14;23
89;16.02.2017;2017;02;22;Torstai;12;11;23;4;8;12
89;16.02.2017;2017;02;23;Torstai;4;6;10;1;2;3
89;17.02.2017;2017;02;00;Perjantai;9;5;14;1;2;3
89;17.02.2017;2017;02;01;Perjantai;1;1;2;0;1;1
89;17.02.2017;2017;02;02;Perjantai;4;1;5;3;2;5
89;17.02.2017;2017;02;03;Perjantai;2;1;3;3;0;3
89;17.02.2017;2017;02;04;Perjantai;3;2;5;1;0;1
89;17.02.2017;2017;02;05;Perjantai;4;8;12;2;2;4
89;17.02.2017;2017;02;06;Perjantai;5;22;27;2;6;8
89;17.02.2017;2017;02;07;Perjantai;18;91;109;9;34;43
89;17.02.2017;2017;02;08;Perjantai;28;107;135;9;35;44
89;17.02.2017;2017;02;09;Perjantai;30;80;110;17;51;68
89;17.02.2017;2017;02;10;Perjantai;33;55;88;26;41;67
89;17.02.2017;2017;02;11;Perjantai;33;62;95;36;42;78
89;17.02.2017;2017;02;12;Perjantai;41;49;90;39;35;74
89;17.02.2017;2017;02;13;Perjantai;57;40;97;27;32;59
89;17.02.2017;2017;02;14;Perjantai;88;51;139;30;32;62
89;17.02.2017;2017;02;15;Perjantai;92;47;139;51;44;95
89;17.02.2017;2017;02;16;Perjantai;108;44;152;45;42;87
89;17.02.2017;2017;02;17;Perjantai;76;59;135;39;39;78
89;17.02.2017;2017;02;18;Perjantai;50;20;70;29;22;51
89;17.02.2017;2017;02;19;Perjantai;35;23;58;18;16;34
89;17.02.2017;2017;02;20;Perjantai;25;22;47;18;15;33
89;17.02.2017;2017;02;21;Perjantai;30;18;48;11;15;26
89;17.02.2017;2017;02;22;Perjantai;17;21;38;1;10;11
89;17.02.2017;2017;02;23;Perjantai;7;9;16;2;5;7
89;18.02.2017;2017;02;00;Lauantai;8;7;15;6;2;8
89;18.02.2017;2017;02;01;Lauantai;12;6;18;4;3;7
89;18.02.2017;2017;02;02;Lauantai;12;4;16;2;2;4
89;18.02.2017;2017;02;03;Lauantai;9;0;9;5;0;5
89;18.02.2017;2017;02;04;Lauantai;11;2;13;4;0;4
89;18.02.2017;2017;02;05;Lauantai;7;2;9;1;1;2
89;18.02.2017;2017;02;06;Lauantai;3;2;5;1;4;5
89;18.02.2017;2017;02;07;Lauantai;4;10;14;2;5;7
89;18.02.2017;2017;02;08;Lauantai;2;6;8;6;8;14
89;18.02.2017;2017;02;09;Lauantai;9;25;34;11;16;27
89;18.02.2017;2017;02;10;Lauantai;21;34;55;16;27;43
89;18.02.2017;2017;02;11;Lauantai;14;45;59;51;71;122
89;18.02.2017;2017;02;12;Lauantai;34;66;100;52;72;124
89;18.02.2017;2017;02;13;Lauantai;41;40;81;55;52;107
89;18.02.2017;2017;02;14;Lauantai;51;44;95;66;59;125
89;18.02.2017;2017;02;15;Lauantai;53;27;80;60;47;107
89;18.02.2017;2017;02;16;Lauantai;46;28;74;52;34;86
89;18.02.2017;2017;02;17;Lauantai;41;22;63;30;32;62
89;18.02.2017;2017;02;18;Lauantai;24;19;43;22;17;39
89;18.02.2017;2017;02;19;Lauantai;20;24;44;23;21;44
89;18.02.2017;2017;02;20;Lauantai;19;18;37;11;12;23
89;18.02.2017;2017;02;21;Lauantai;28;15;43;7;16;23
89;18.02.2017;2017;02;22;Lauantai;13;20;33;4;7;11
89;18.02.2017;2017;02;23;Lauantai;9;9;18;7;5;12
89;19.02.2017;2017;02;00;Sunnuntai;7;26;33;7;4;11
89;19.02.2017;2017;02;01;Sunnuntai;5;17;22;3;10;13
89;19.02.2017;2017;02;02;Sunnuntai;7;6;13;1;1;2
89;19.02.2017;2017;02;03;Sunnuntai;12;2;14;7;1;8
89;19.02.2017;2017;02;04;Sunnuntai;23;1;24;7;0;7
89;19.02.2017;2017;02;05;Sunnuntai;3;1;4;0;0;0
89;19.02.2017;2017;02;06;Sunnuntai;1;4;5;1;2;3
89;19.02.2017;2017;02;07;Sunnuntai;5;7;12;6;3;9
89;19.02.2017;2017;02;08;Sunnuntai;3;1;4;5;10;15
89;19.02.2017;2017;02;09;Sunnuntai;6;10;16;11;20;31
89;19.02.2017;2017;02;10;Sunnuntai;9;29;38;21;30;51
89;19.02.2017;2017;02;11;Sunnuntai;15;26;41;39;47;86
89;19.02.2017;2017;02;12;Sunnuntai;10;28;38;50;57;107
89;19.02.2017;2017;02;13;Sunnuntai;28;21;49;51;67;118
89;19.02.2017;2017;02;14;Sunnuntai;46;33;79;56;43;99
89;19.02.2017;2017;02;15;Sunnuntai;44;36;80;45;44;89
89;19.02.2017;2017;02;16;Sunnuntai;31;37;68;39;34;73
89;19.02.2017;2017;02;17;Sunnuntai;35;34;69;30;48;78
89;19.02.2017;2017;02;18;Sunnuntai;17;20;37;30;16;46
89;19.02.2017;2017;02;19;Sunnuntai;30;18;48;23;20;43
89;19.02.2017;2017;02;20;Sunnuntai;12;11;23;15;6;21
89;19.02.2017;2017;02;21;Sunnuntai;20;12;32;8;8;16
89;19.02.2017;2017;02;22;Sunnuntai;7;1;8;4;3;7
89;19.02.2017;2017;02;23;Sunnuntai;5;4;9;5;3;8
89;20.02.2017;2017;02;00;Maanantai;3;1;4;0;1;1
89;20.02.2017;2017;02;01;Maanantai;1;0;1;1;2;3
89;20.02.2017;2017;02;02;Maanantai;2;1;3;2;2;4
89;20.02.2017;2017;02;03;Maanantai;1;1;2;0;0;0
89;20.02.2017;2017;02;04;Maanantai;5;2;7;2;0;2
89;20.02.2017;2017;02;05;Maanantai;2;2;4;2;1;3
89;20.02.2017;2017;02;06;Maanantai;14;18;32;8;3;11
89;20.02.2017;2017;02;07;Maanantai;68;36;104;12;0;12
89;20.02.2017;2017;02;08;Maanantai;112;52;164;32;0;32
89;20.02.2017;2017;02;09;Maanantai;79;32;111;22;0;22
89;20.02.2017;2017;02;10;Maanantai;53;17;70;22;0;22
89;20.02.2017;2017;02;11;Maanantai;56;19;75;29;0;29
89;20.02.2017;2017;02;12;Maanantai;74;25;99;27;0;27
89;20.02.2017;2017;02;13;Maanantai;64;15;79;41;0;41
89;20.02.2017;2017;02;14;Maanantai;102;19;121;29;0;29
89;20.02.2017;2017;02;15;Maanantai;113;25;138;30;0;30
89;20.02.2017;2017;02;16;Maanantai;134;35;169;38;0;38
89;20.02.2017;2017;02;17;Maanantai;91;16;107;59;0;59
89;20.02.2017;2017;02;18;Maanantai;76;12;88;40;0;40
89;20.02.2017;2017;02;19;Maanantai;53;15;68;38;0;38
89;20.02.2017;2017;02;20;Maanantai;41;7;48;24;0;24
89;20.02.2017;2017;02;21;Maanantai;28;3;31;14;0;14
89;20.02.2017;2017;02;22;Maanantai;15;5;20;6;0;6
89;20.02.2017;2017;02;23;Maanantai;6;0;6;2;0;2
89;21.02.2017;2017;02;00;Tiistai;4;1;5;2;0;2
89;21.02.2017;2017;02;01;Tiistai;0;0;0;0;0;0
89;21.02.2017;2017;02;02;Tiistai;1;0;1;0;0;0
89;21.02.2017;2017;02;03;Tiistai;4;0;4;0;0;0
89;21.02.2017;2017;02;04;Tiistai;3;0;3;0;0;0
89;21.02.2017;2017;02;05;Tiistai;7;2;9;0;0;0
89;21.02.2017;2017;02;06;Tiistai;26;11;37;4;0;4
89;21.02.2017;2017;02;07;Tiistai;90;27;117;17;0;17
89;21.02.2017;2017;02;08;Tiistai;150;37;187;31;0;31
89;21.02.2017;2017;02;09;Tiistai;83;15;98;36;0;36
89;21.02.2017;2017;02;10;Tiistai;60;10;70;44;0;44
89;21.02.2017;2017;02;11;Tiistai;74;13;87;42;0;42
89;21.02.2017;2017;02;12;Tiistai;65;3;68;42;0;42
89;21.02.2017;2017;02;13;Tiistai;80;4;84;41;0;41
89;21.02.2017;2017;02;14;Tiistai;92;5;97;55;0;55
89;21.02.2017;2017;02;15;Tiistai;142;14;156;50;0;50
89;21.02.2017;2017;02;16;Tiistai;157;21;178;49;0;49
89;21.02.2017;2017;02;17;Tiistai;134;12;146;38;0;38
89;21.02.2017;2017;02;18;Tiistai;72;3;75;37;0;37
89;21.02.2017;2017;02;19;Tiistai;58;11;69;33;0;33
89;21.02.2017;2017;02;20;Tiistai;52;5;57;15;0;15
89;21.02.2017;2017;02;21;Tiistai;28;2;30;13;0;13
89;21.02.2017;2017;02;22;Tiistai;13;0;13;5;0;5
89;21.02.2017;2017;02;23;Tiistai;5;0;5;3;0;3
89;22.02.2017;2017;02;00;Keskiviikko;5;0;5;5;0;5
89;22.02.2017;2017;02;01;Keskiviikko;3;0;3;1;0;1
89;22.02.2017;2017;02;02;Keskiviikko;2;0;2;0;0;0
89;22.02.2017;2017;02;03;Keskiviikko;3;1;4;0;0;0
89;22.02.2017;2017;02;04;Keskiviikko;2;0;2;0;0;0
89;22.02.2017;2017;02;05;Keskiviikko;6;1;7;3;0;3
89;22.02.2017;2017;02;06;Keskiviikko;18;4;22;6;0;6
89;22.02.2017;2017;02;07;Keskiviikko;92;26;118;28;0;28
89;22.02.2017;2017;02;08;Keskiviikko;61;97;158;31;52;83
89;22.02.2017;2017;02;09;Keskiviikko;22;80;102;11;52;63
89;22.02.2017;2017;02;10;Keskiviikko;26;40;66;28;39;67
89;22.02.2017;2017;02;11;Keskiviikko;24;54;78;41;31;72
89;22.02.2017;2017;02;12;Keskiviikko;34;54;88;30;37;67
89;22.02.2017;2017;02;13;Keskiviikko;58;43;101;22;31;53
89;22.02.2017;2017;02;14;Keskiviikko;84;37;121;40;20;60
89;22.02.2017;2017;02;15;Keskiviikko;99;46;145;38;19;57
89;22.02.2017;2017;02;16;Keskiviikko;122;47;169;37;29;66
89;22.02.2017;2017;02;17;Keskiviikko;73;40;113;35;21;56
89;22.02.2017;2017;02;18;Keskiviikko;47;29;76;40;23;63
89;22.02.2017;2017;02;19;Keskiviikko;39;13;52;15;21;36
89;22.02.2017;2017;02;20;Keskiviikko;31;22;53;15;13;28
89;22.02.2017;2017;02;21;Keskiviikko;32;10;42;11;12;23
89;22.02.2017;2017;02;22;Keskiviikko;9;9;18;5;4;9
89;22.02.2017;2017;02;23;Keskiviikko;22;5;27;4;2;6
89;23.02.2017;2017;02;00;Torstai;1;2;3;0;2;2
89;23.02.2017;2017;02;01;Torstai;2;0;2;0;1;1
89;23.02.2017;2017;02;02;Torstai;0;1;1;2;0;2
89;23.02.2017;2017;02;03;Torstai;2;3;5;0;0;0
89;23.02.2017;2017;02;04;Torstai;12;0;12;1;0;1
89;23.02.2017;2017;02;05;Torstai;0;5;5;0;2;2
89;23.02.2017;2017;02;06;Torstai;6;16;22;3;7;10
89;23.02.2017;2017;02;07;Torstai;25;86;111;6;25;31
89;23.02.2017;2017;02;08;Torstai;24;126;150;19;57;76
89;23.02.2017;2017;02;09;Torstai;16;76;92;21;20;41
89;23.02.2017;2017;02;10;Torstai;23;42;65;16;28;44
89;23.02.2017;2017;02;11;Torstai;35;41;76;11;25;36
89;23.02.2017;2017;02;12;Torstai;42;37;79;19;32;51
89;23.02.2017;2017;02;13;Torstai;51;46;97;24;21;45
89;23.02.2017;2017;02;14;Torstai;48;26;74;35;18;53
89;23.02.2017;2017;02;15;Torstai;90;39;129;34;22;56
89;23.02.2017;2017;02;16;Torstai;111;45;156;47;24;71
89;23.02.2017;2017;02;17;Torstai;68;43;111;25;21;46
89;23.02.2017;2017;02;18;Torstai;48;25;73;18;30;48
89;23.02.2017;2017;02;19;Torstai;47;26;73;23;18;41
89;23.02.2017;2017;02;20;Torstai;31;28;59;31;19;50
89;23.02.2017;2017;02;21;Torstai;28;12;40;17;10;27
89;23.02.2017;2017;02;22;Torstai;11;6;17;6;5;11
89;23.02.2017;2017;02;23;Torstai;5;2;7;6;4;10
89;24.02.2017;2017;02;00;Perjantai;6;4;10;6;1;7
89;24.02.2017;2017;02;01;Perjantai;1;3;4;0;0;0
89;24.02.2017;2017;02;02;Perjantai;0;1;1;0;0;0
89;24.02.2017;2017;02;03;Perjantai;5;2;7;1;0;1
89;24.02.2017;2017;02;04;Perjantai;3;2;5;2;3;5
89;24.02.2017;2017;02;05;Perjantai;4;6;10;0;0;0
89;24.02.2017;2017;02;06;Perjantai;7;30;37;2;6;8
89;24.02.2017;2017;02;07;Perjantai;16;82;98;4;26;30
89;24.02.2017;2017;02;08;Perjantai;22;128;150;14;41;55
89;24.02.2017;2017;02;09;Perjantai;16;70;86;14;31;45
89;24.02.2017;2017;02;10;Perjantai;24;55;79;15;33;48
89;24.02.2017;2017;02;11;Perjantai;36;42;78;24;28;52
89;24.02.2017;2017;02;12;Perjantai;42;49;91;24;35;59
89;24.02.2017;2017;02;13;Perjantai;57;39;96;29;30;59
89;24.02.2017;2017;02;14;Perjantai;53;43;96;39;25;64
89;24.02.2017;2017;02;15;Perjantai;81;49;130;41;35;76
89;24.02.2017;2017;02;16;Perjantai;76;58;134;44;31;75
89;24.02.2017;2017;02;17;Perjantai;57;40;97;31;26;57
89;24.02.2017;2017;02;18;Perjantai;42;38;80;23;24;47
89;24.02.2017;2017;02;19;Perjantai;33;20;53;19;13;32
89;24.02.2017;2017;02;20;Perjantai;31;27;58;8;9;17
89;24.02.2017;2017;02;21;Perjantai;40;14;54;12;5;17
89;24.02.2017;2017;02;22;Perjantai;24;17;41;7;6;13
89;24.02.2017;2017;02;23;Perjantai;13;6;19;7;6;13
89;25.02.2017;2017;02;00;Lauantai;12;6;18;1;4;5
89;25.02.2017;2017;02;01;Lauantai;8;3;11;4;2;6
89;25.02.2017;2017;02;02;Lauantai;10;3;13;4;2;6
89;25.02.2017;2017;02;03;Lauantai;14;2;16;5;1;6
89;25.02.2017;2017;02;04;Lauantai;10;0;10;6;0;6
89;25.02.2017;2017;02;05;Lauantai;4;5;9;0;0;0
89;25.02.2017;2017;02;06;Lauantai;2;10;12;1;1;2
89;25.02.2017;2017;02;07;Lauantai;4;9;13;1;7;8
89;25.02.2017;2017;02;08;Lauantai;4;21;25;9;18;27
89;25.02.2017;2017;02;09;Lauantai;3;24;27;17;23;40
89;25.02.2017;2017;02;10;Lauantai;13;28;41;21;35;56
89;25.02.2017;2017;02;11;Lauantai;16;43;59;39;54;93
89;25.02.2017;2017;02;12;Lauantai;32;39;71;51;75;126
89;25.02.2017;2017;02;13;Lauantai;31;60;91;60;71;131
89;25.02.2017;2017;02;14;Lauantai;39;35;74;46;52;98
89;25.02.2017;2017;02;15;Lauantai;32;30;62;47;53;100
89;25.02.2017;2017;02;16;Lauantai;49;31;80;69;43;112
89;25.02.2017;2017;02;17;Lauantai;40;21;61;30;37;67
89;25.02.2017;2017;02;18;Lauantai;32;18;50;23;24;47
89;25.02.2017;2017;02;19;Lauantai;23;18;41;20;19;39
89;25.02.2017;2017;02;20;Lauantai;13;14;27;7;8;15
89;25.02.2017;2017;02;21;Lauantai;17;9;26;10;9;19
89;25.02.2017;2017;02;22;Lauantai;15;15;30;10;8;18
89;25.02.2017;2017;02;23;Lauantai;3;11;14;12;3;15
89;26.02.2017;2017;02;00;Sunnuntai;8;14;22;4;3;7
89;26.02.2017;2017;02;01;Sunnuntai;7;4;11;4;4;8
89;26.02.2017;2017;02;02;Sunnuntai;7;2;9;4;2;6
89;26.02.2017;2017;02;03;Sunnuntai;10;1;11;4;1;5
89;26.02.2017;2017;02;04;Sunnuntai;12;0;12;7;0;7
89;26.02.2017;2017;02;05;Sunnuntai;5;3;8;0;1;1
89;26.02.2017;2017;02;06;Sunnuntai;2;7;9;1;2;3
89;26.02.2017;2017;02;07;Sunnuntai;2;2;4;3;2;5
89;26.02.2017;2017;02;08;Sunnuntai;2;6;8;9;9;18
89;26.02.2017;2017;02;09;Sunnuntai;7;13;20;13;17;30
89;26.02.2017;2017;02;10;Sunnuntai;7;24;31;25;38;63
89;26.02.2017;2017;02;11;Sunnuntai;10;23;33;35;37;72
89;26.02.2017;2017;02;12;Sunnuntai;16;25;41;44;51;95
89;26.02.2017;2017;02;13;Sunnuntai;30;40;70;47;55;102
89;26.02.2017;2017;02;14;Sunnuntai;20;48;68;64;62;126
89;26.02.2017;2017;02;15;Sunnuntai;41;32;73;60;54;114
89;26.02.2017;2017;02;16;Sunnuntai;32;34;66;41;50;91
89;26.02.2017;2017;02;17;Sunnuntai;33;25;58;40;35;75
89;26.02.2017;2017;02;18;Sunnuntai;38;23;61;39;25;64
89;26.02.2017;2017;02;19;Sunnuntai;13;9;22;16;20;36
89;26.02.2017;2017;02;20;Sunnuntai;13;12;25;11;10;21
89;26.02.2017;2017;02;21;Sunnuntai;16;8;24;12;10;22
89;26.02.2017;2017;02;22;Sunnuntai;9;2;11;8;5;13
89;26.02.2017;2017;02;23;Sunnuntai;4;3;7;1;1;2
89;27.02.2017;2017;02;00;Maanantai;6;3;9;2;0;2
89;27.02.2017;2017;02;01;Maanantai;0;0;0;2;0;2
89;27.02.2017;2017;02;02;Maanantai;2;2;4;0;0;0
89;27.02.2017;2017;02;03;Maanantai;1;1;2;0;0;0
89;27.02.2017;2017;02;04;Maanantai;2;2;4;1;0;1
89;27.02.2017;2017;02;05;Maanantai;2;8;10;1;2;3
89;27.02.2017;2017;02;06;Maanantai;3;25;28;3;4;7
89;27.02.2017;2017;02;07;Maanantai;14;75;89;5;34;39
89;27.02.2017;2017;02;08;Maanantai;15;117;132;9;50;59
89;27.02.2017;2017;02;09;Maanantai;20;64;84;11;31;42
89;27.02.2017;2017;02;10;Maanantai;23;32;55;10;24;34
89;27.02.2017;2017;02;11;Maanantai;31;44;75;21;29;50
89;27.02.2017;2017;02;12;Maanantai;24;41;65;21;36;57
89;27.02.2017;2017;02;13;Maanantai;41;37;78;46;35;81
89;27.02.2017;2017;02;14;Maanantai;66;34;100;53;38;91
89;27.02.2017;2017;02;15;Maanantai;77;40;117;51;49;100
89;27.02.2017;2017;02;16;Maanantai;109;52;161;64;36;100
89;27.02.2017;2017;02;17;Maanantai;100;45;145;45;27;72
89;27.02.2017;2017;02;18;Maanantai;45;24;69;32;27;59
89;27.02.2017;2017;02;19;Maanantai;33;15;48;23;28;51
89;27.02.2017;2017;02;20;Maanantai;29;11;40;31;11;42
89;27.02.2017;2017;02;21;Maanantai;18;12;30;12;5;17
89;27.02.2017;2017;02;22;Maanantai;12;8;20;0;9;9
89;27.02.2017;2017;02;23;Maanantai;2;6;8;1;1;2
89;28.02.2017;2017;02;00;Tiistai;4;3;7;2;0;2
89;28.02.2017;2017;02;01;Tiistai;1;1;2;5;2;7
89;28.02.2017;2017;02;02;Tiistai;1;2;3;0;1;1
89;28.02.2017;2017;02;03;Tiistai;1;3;4;2;0;2
89;28.02.2017;2017;02;04;Tiistai;0;2;2;2;1;3
89;28.02.2017;2017;02;05;Tiistai;4;5;9;1;3;4
89;28.02.2017;2017;02;06;Tiistai;9;33;42;1;12;13
89;28.02.2017;2017;02;07;Tiistai;19;93;112;9;29;38
89;28.02.2017;2017;02;08;Tiistai;20;152;172;13;53;66
89;28.02.2017;2017;02;09;Tiistai;32;86;118;20;46;66
89;28.02.2017;2017;02;10;Tiistai;25;67;92;21;29;50
89;28.02.2017;2017;02;11;Tiistai;42;59;101;37;45;82
89;28.02.2017;2017;02;12;Tiistai;43;49;92;32;43;75
89;28.02.2017;2017;02;13;Tiistai;47;46;93;35;21;56
89;28.02.2017;2017;02;14;Tiistai;48;40;88;32;27;59
89;28.02.2017;2017;02;15;Tiistai;105;47;152;32;24;56
89;28.02.2017;2017;02;16;Tiistai;136;69;205;52;24;76
89;28.02.2017;2017;02;17;Tiistai;94;44;138;36;33;69
89;28.02.2017;2017;02;18;Tiistai;51;42;93;29;30;59
89;28.02.2017;2017;02;19;Tiistai;58;20;78;33;18;51
89;28.02.2017;2017;02;20;Tiistai;25;26;51;29;11;40
89;28.02.2017;2017;02;21;Tiistai;34;24;58;12;15;27
89;28.02.2017;2017;02;22;Tiistai;17;13;30;8;4;12
89;28.02.2017;2017;02;23;Tiistai;6;2;8;3;1;4
89;01.03.2017;2017;03;00;Keskiviikko;4;2;6;3;1;4
89;01.03.2017;2017;03;01;Keskiviikko;6;1;7;5;0;5
89;01.03.2017;2017;03;02;Keskiviikko;9;0;9;0;1;1
89;01.03.2017;2017;03;03;Keskiviikko;4;2;6;0;0;0
89;01.03.2017;2017;03;04;Keskiviikko;5;2;7;2;1;3
89;01.03.2017;2017;03;05;Keskiviikko;2;3;5;3;1;4
89;01.03.2017;2017;03;06;Keskiviikko;9;32;41;7;9;16
89;01.03.2017;2017;03;07;Keskiviikko;25;98;123;5;26;31
89;01.03.2017;2017;03;08;Keskiviikko;27;145;172;8;44;52
89;01.03.2017;2017;03;09;Keskiviikko;20;60;80;13;34;47
89;01.03.2017;2017;03;10;Keskiviikko;22;69;91;13;23;36
89;01.03.2017;2017;03;11;Keskiviikko;43;40;83;24;19;43
89;01.03.2017;2017;03;12;Keskiviikko;31;51;82;29;34;63
89;01.03.2017;2017;03;13;Keskiviikko;36;38;74;20;21;41
89;01.03.2017;2017;03;14;Keskiviikko;58;47;105;22;10;32
89;01.03.2017;2017;03;15;Keskiviikko;84;24;108;26;26;52
89;01.03.2017;2017;03;16;Keskiviikko;109;42;151;29;21;50
89;01.03.2017;2017;03;17;Keskiviikko;68;45;113;35;22;57
89;01.03.2017;2017;03;18;Keskiviikko;41;31;72;27;20;47
89;01.03.2017;2017;03;19;Keskiviikko;41;24;65;28;20;48
89;01.03.2017;2017;03;20;Keskiviikko;32;17;49;19;13;32
89;01.03.2017;2017;03;21;Keskiviikko;31;17;48;14;6;20
89;01.03.2017;2017;03;22;Keskiviikko;9;8;17;7;5;12
89;01.03.2017;2017;03;23;Keskiviikko;10;3;13;2;2;4
89;02.03.2017;2017;03;00;Torstai;1;3;4;3;3;6
89;02.03.2017;2017;03;01;Torstai;0;0;0;3;0;3
89;02.03.2017;2017;03;02;Torstai;4;0;4;0;1;1
89;02.03.2017;2017;03;03;Torstai;1;2;3;2;0;2
89;02.03.2017;2017;03;04;Torstai;1;2;3;1;0;1
89;02.03.2017;2017;03;05;Torstai;3;3;6;5;5;10
89;02.03.2017;2017;03;06;Torstai;9;31;40;2;9;11
89;02.03.2017;2017;03;07;Torstai;20;95;115;7;28;35
89;02.03.2017;2017;03;08;Torstai;25;152;177;12;38;50
89;02.03.2017;2017;03;09;Torstai;20;78;98;14;38;52
89;02.03.2017;2017;03;10;Torstai;32;43;75;21;44;65
89;02.03.2017;2017;03;11;Torstai;33;51;84;35;36;71
89;02.03.2017;2017;03;12;Torstai;34;54;88;22;23;45
89;02.03.2017;2017;03;13;Torstai;48;46;94;28;26;54
89;02.03.2017;2017;03;14;Torstai;63;28;91;20;20;40
89;02.03.2017;2017;03;15;Torstai;84;37;121;22;21;43
89;02.03.2017;2017;03;16;Torstai;94;44;138;31;29;60
89;02.03.2017;2017;03;17;Torstai;62;30;92;40;26;66
89;02.03.2017;2017;03;18;Torstai;56;30;86;31;21;52
89;02.03.2017;2017;03;19;Torstai;30;30;60;22;13;35
89;02.03.2017;2017;03;20;Torstai;28;25;53;21;16;37
89;02.03.2017;2017;03;21;Torstai;34;10;44;21;8;29
89;02.03.2017;2017;03;22;Torstai;13;4;17;2;4;6
89;02.03.2017;2017;03;23;Torstai;12;2;14;5;7;12
89;03.03.2017;2017;03;00;Perjantai;6;11;17;2;5;7
89;03.03.2017;2017;03;01;Perjantai;3;1;4;4;0;4
89;03.03.2017;2017;03;02;Perjantai;1;0;1;0;2;2
89;03.03.2017;2017;03;03;Perjantai;3;3;6;2;0;2
89;03.03.2017;2017;03;04;Perjantai;1;2;3;4;5;9
89;03.03.2017;2017;03;05;Perjantai;2;7;9;1;0;1
89;03.03.2017;2017;03;06;Perjantai;7;21;28;5;14;19
89;03.03.2017;2017;03;07;Perjantai;15;79;94;13;33;46
89;03.03.2017;2017;03;08;Perjantai;16;129;145;17;50;67
89;03.03.2017;2017;03;09;Perjantai;16;57;73;20;38;58
89;03.03.2017;2017;03;10;Perjantai;23;49;72;32;43;75
89;03.03.2017;2017;03;11;Perjantai;39;55;94;32;46;78
89;03.03.2017;2017;03;12;Perjantai;40;39;79;42;53;95
89;03.03.2017;2017;03;13;Perjantai;58;36;94;46;39;85
89;03.03.2017;2017;03;14;Perjantai;73;45;118;44;42;86
89;03.03.2017;2017;03;15;Perjantai;84;37;121;45;50;95
89;03.03.2017;2017;03;16;Perjantai;78;47;125;48;35;83
89;03.03.2017;2017;03;17;Perjantai;53;32;85;33;37;70
89;03.03.2017;2017;03;18;Perjantai;35;23;58;22;16;38
89;03.03.2017;2017;03;19;Perjantai;36;22;58;16;10;26
89;03.03.2017;2017;03;20;Perjantai;17;16;33;9;9;18
89;03.03.2017;2017;03;21;Perjantai;22;16;38;13;5;18
89;03.03.2017;2017;03;22;Perjantai;13;9;22;7;1;8
89;03.03.2017;2017;03;23;Perjantai;5;14;19;5;2;7
89;04.03.2017;2017;03;00;Lauantai;10;18;28;3;5;8
89;04.03.2017;2017;03;01;Lauantai;4;0;4;1;2;3
89;04.03.2017;2017;03;02;Lauantai;6;4;10;3;0;3
89;04.03.2017;2017;03;03;Lauantai;7;0;7;5;4;9
89;04.03.2017;2017;03;04;Lauantai;9;0;9;2;0;2
89;04.03.2017;2017;03;05;Lauantai;2;3;5;0;5;5
89;04.03.2017;2017;03;06;Lauantai;6;8;14;0;2;2
89;04.03.2017;2017;03;07;Lauantai;1;2;3;2;4;6
89;04.03.2017;2017;03;08;Lauantai;5;15;20;7;13;20
89;04.03.2017;2017;03;09;Lauantai;11;23;34;14;24;38
89;04.03.2017;2017;03;10;Lauantai;15;30;45;36;43;79
89;04.03.2017;2017;03;11;Lauantai;29;32;61;25;41;66
89;04.03.2017;2017;03;12;Lauantai;19;38;57;36;44;80
89;04.03.2017;2017;03;13;Lauantai;24;30;54;45;52;97
89;04.03.2017;2017;03;14;Lauantai;36;34;70;49;33;82
89;04.03.2017;2017;03;15;Lauantai;44;27;71;26;32;58
89;04.03.2017;2017;03;16;Lauantai;30;36;66;42;30;72
89;04.03.2017;2017;03;17;Lauantai;44;29;73;32;28;60
89;04.03.2017;2017;03;18;Lauantai;26;19;45;33;24;57
89;04.03.2017;2017;03;19;Lauantai;32;15;47;23;26;49
89;04.03.2017;2017;03;20;Lauantai;9;10;19;12;9;21
89;04.03.2017;2017;03;21;Lauantai;15;9;24;7;12;19
89;04.03.2017;2017;03;22;Lauantai;8;15;23;3;5;8
89;04.03.2017;2017;03;23;Lauantai;8;13;21;3;5;8
89;05.03.2017;2017;03;00;Sunnuntai;8;16;24;3;4;7
89;05.03.2017;2017;03;01;Sunnuntai;4;6;10;4;1;5
89;05.03.2017;2017;03;02;Sunnuntai;3;1;4;6;3;9
89;05.03.2017;2017;03;03;Sunnuntai;7;2;9;9;0;9
89;05.03.2017;2017;03;04;Sunnuntai;13;0;13;4;1;5
89;05.03.2017;2017;03;05;Sunnuntai;5;2;7;1;0;1
89;05.03.2017;2017;03;06;Sunnuntai;3;4;7;0;3;3
89;05.03.2017;2017;03;07;Sunnuntai;2;3;5;5;4;9
89;05.03.2017;2017;03;08;Sunnuntai;2;1;3;7;5;12
89;05.03.2017;2017;03;09;Sunnuntai;3;10;13;12;11;23
89;05.03.2017;2017;03;10;Sunnuntai;15;16;31;20;27;47
89;05.03.2017;2017;03;11;Sunnuntai;9;19;28;53;62;115
89;05.03.2017;2017;03;12;Sunnuntai;19;25;44;56;57;113
89;05.03.2017;2017;03;13;Sunnuntai;17;32;49;73;79;152
89;05.03.2017;2017;03;14;Sunnuntai;28;31;59;66;55;121
89;05.03.2017;2017;03;15;Sunnuntai;36;22;58;42;38;80
89;05.03.2017;2017;03;16;Sunnuntai;32;22;54;46;34;80
89;05.03.2017;2017;03;17;Sunnuntai;25;16;41;34;32;66
89;05.03.2017;2017;03;18;Sunnuntai;22;15;37;30;14;44
89;05.03.2017;2017;03;19;Sunnuntai;16;10;26;9;15;24
89;05.03.2017;2017;03;20;Sunnuntai;9;5;14;14;12;26
89;05.03.2017;2017;03;21;Sunnuntai;6;7;13;7;5;12
89;05.03.2017;2017;03;22;Sunnuntai;7;2;9;3;6;9
89;05.03.2017;2017;03;23;Sunnuntai;7;2;9;2;1;3
89;06.03.2017;2017;03;00;Maanantai;4;2;6;0;2;2
89;06.03.2017;2017;03;01;Maanantai;2;3;5;2;1;3
89;06.03.2017;2017;03;02;Maanantai;1;0;1;1;0;1
89;06.03.2017;2017;03;03;Maanantai;0;2;2;1;0;1
89;06.03.2017;2017;03;04;Maanantai;3;1;4;3;0;3
89;06.03.2017;2017;03;05;Maanantai;1;6;7;1;2;3
89;06.03.2017;2017;03;06;Maanantai;5;16;21;0;5;5
89;06.03.2017;2017;03;07;Maanantai;10;79;89;8;22;30
89;06.03.2017;2017;03;08;Maanantai;9;79;88;7;32;39
89;06.03.2017;2017;03;09;Maanantai;12;39;51;10;30;40
89;06.03.2017;2017;03;10;Maanantai;13;30;43;14;34;48
89;06.03.2017;2017;03;11;Maanantai;28;31;59;34;29;63
89;06.03.2017;2017;03;12;Maanantai;25;40;65;26;34;60
89;06.03.2017;2017;03;13;Maanantai;25;48;73;35;52;87
89;06.03.2017;2017;03;14;Maanantai;48;36;84;49;51;100
89;06.03.2017;2017;03;15;Maanantai;70;47;117;64;33;97
89;06.03.2017;2017;03;16;Maanantai;83;42;125;54;41;95
89;06.03.2017;2017;03;17;Maanantai;65;28;93;49;23;72
89;06.03.2017;2017;03;18;Maanantai;37;22;59;35;32;67
89;06.03.2017;2017;03;19;Maanantai;19;22;41;26;32;58
89;06.03.2017;2017;03;20;Maanantai;22;7;29;10;7;17
89;06.03.2017;2017;03;21;Maanantai;23;12;35;4;2;6
89;06.03.2017;2017;03;22;Maanantai;9;6;15;4;2;6
89;06.03.2017;2017;03;23;Maanantai;8;5;13;0;3;3
89;07.03.2017;2017;03;00;Tiistai;1;4;5;5;2;7
89;07.03.2017;2017;03;01;Tiistai;2;1;3;3;2;5
89;07.03.2017;2017;03;02;Tiistai;2;3;5;1;2;3
89;07.03.2017;2017;03;03;Tiistai;2;1;3;2;2;4
89;07.03.2017;2017;03;04;Tiistai;0;4;4;0;2;2
89;07.03.2017;2017;03;05;Tiistai;0;6;6;1;0;1
89;07.03.2017;2017;03;06;Tiistai;5;18;23;2;6;8
89;07.03.2017;2017;03;07;Tiistai;11;78;89;12;20;32
89;07.03.2017;2017;03;08;Tiistai;10;78;88;6;28;34
89;07.03.2017;2017;03;09;Tiistai;15;35;50;12;30;42
89;07.03.2017;2017;03;10;Tiistai;25;24;49;21;32;53
89;07.03.2017;2017;03;11;Tiistai;20;38;58;39;40;79
89;07.03.2017;2017;03;12;Tiistai;31;47;78;51;47;98
89;07.03.2017;2017;03;13;Tiistai;39;31;70;53;34;87
89;07.03.2017;2017;03;14;Tiistai;46;34;80;44;47;91
89;07.03.2017;2017;03;15;Tiistai;66;36;102;40;37;77
89;07.03.2017;2017;03;16;Tiistai;79;45;124;60;33;93
89;07.03.2017;2017;03;17;Tiistai;67;46;113;33;36;69
89;07.03.2017;2017;03;18;Tiistai;42;20;62;32;21;53
89;07.03.2017;2017;03;19;Tiistai;29;20;49;24;18;42
89;07.03.2017;2017;03;20;Tiistai;16;23;39;24;17;41
89;07.03.2017;2017;03;21;Tiistai;26;7;33;10;6;16
89;07.03.2017;2017;03;22;Tiistai;15;5;20;6;6;12
89;07.03.2017;2017;03;23;Tiistai;8;1;9;2;5;7
89;08.03.2017;2017;03;00;Keskiviikko;4;3;7;2;0;2
89;08.03.2017;2017;03;01;Keskiviikko;0;0;0;1;0;1
89;08.03.2017;2017;03;02;Keskiviikko;0;1;1;0;1;1
89;08.03.2017;2017;03;03;Keskiviikko;5;3;8;2;0;2
89;08.03.2017;2017;03;04;Keskiviikko;2;1;3;0;0;0
89;08.03.2017;2017;03;05;Keskiviikko;1;7;8;0;1;1
89;08.03.2017;2017;03;06;Keskiviikko;8;27;35;1;2;3
89;08.03.2017;2017;03;07;Keskiviikko;9;77;86;7;14;21
89;08.03.2017;2017;03;08;Keskiviikko;19;74;93;6;31;37
89;08.03.2017;2017;03;09;Keskiviikko;16;40;56;15;20;35
89;08.03.2017;2017;03;10;Keskiviikko;20;39;59;19;26;45
89;08.03.2017;2017;03;11;Keskiviikko;25;43;68;25;47;72
89;08.03.2017;2017;03;12;Keskiviikko;34;54;88;24;31;55
89;08.03.2017;2017;03;13;Keskiviikko;38;40;78;38;32;70
89;08.03.2017;2017;03;14;Keskiviikko;42;17;59;19;18;37
89;08.03.2017;2017;03;15;Keskiviikko;57;34;91;30;20;50
89;08.03.2017;2017;03;16;Keskiviikko;87;56;143;37;29;66
89;08.03.2017;2017;03;17;Keskiviikko;50;43;93;28;23;51
89;08.03.2017;2017;03;18;Keskiviikko;47;22;69;23;27;50
89;08.03.2017;2017;03;19;Keskiviikko;29;17;46;37;22;59
89;08.03.2017;2017;03;20;Keskiviikko;21;11;32;22;11;33
89;08.03.2017;2017;03;21;Keskiviikko;24;8;32;14;7;21
89;08.03.2017;2017;03;22;Keskiviikko;9;3;12;6;9;15
89;08.03.2017;2017;03;23;Keskiviikko;13;2;15;3;2;5
89;09.03.2017;2017;03;00;Torstai;2;9;11;3;2;5
89;09.03.2017;2017;03;01;Torstai;1;1;2;0;0;0
89;09.03.2017;2017;03;02;Torstai;5;0;5;0;1;1
89;09.03.2017;2017;03;03;Torstai;0;8;8;3;0;3
89;09.03.2017;2017;03;04;Torstai;1;1;2;1;0;1
89;09.03.2017;2017;03;05;Torstai;1;3;4;1;1;2
89;09.03.2017;2017;03;06;Torstai;6;15;21;1;2;3
89;09.03.2017;2017;03;07;Torstai;15;64;79;10;17;27
89;09.03.2017;2017;03;08;Torstai;13;74;87;5;29;34
89;09.03.2017;2017;03;09;Torstai;7;49;56;6;36;42
89;09.03.2017;2017;03;10;Torstai;21;42;63;26;30;56
89;09.03.2017;2017;03;11;Torstai;27;44;71;22;30;52
89;09.03.2017;2017;03;12;Torstai;28;32;60;18;24;42
89;09.03.2017;2017;03;13;Torstai;28;33;61;25;27;52
89;09.03.2017;2017;03;14;Torstai;53;27;80;29;15;44
89;09.03.2017;2017;03;15;Torstai;46;26;72;28;21;49
89;09.03.2017;2017;03;16;Torstai;80;33;113;31;29;60
89;09.03.2017;2017;03;17;Torstai;61;36;97;31;23;54
89;09.03.2017;2017;03;18;Torstai;36;27;63;26;23;49
89;09.03.2017;2017;03;19;Torstai;25;14;39;30;20;50
89;09.03.2017;2017;03;20;Torstai;21;22;43;21;11;32
89;09.03.2017;2017;03;21;Torstai;24;20;44;16;14;30
89;09.03.2017;2017;03;22;Torstai;11;7;18;9;5;14
89;09.03.2017;2017;03;23;Torstai;12;3;15;5;1;6
89;10.03.2017;2017;03;00;Perjantai;5;3;8;3;0;3
89;10.03.2017;2017;03;01;Perjantai;4;0;4;3;1;4
89;10.03.2017;2017;03;02;Perjantai;2;3;5;0;1;1
89;10.03.2017;2017;03;03;Perjantai;3;1;4;0;2;2
89;10.03.2017;2017;03;04;Perjantai;1;1;2;0;0;0
89;10.03.2017;2017;03;05;Perjantai;6;7;13;1;2;3
89;10.03.2017;2017;03;06;Perjantai;7;19;26;1;5;6
89;10.03.2017;2017;03;07;Perjantai;15;69;84;7;15;22
89;10.03.2017;2017;03;08;Perjantai;5;60;65;6;24;30
89;10.03.2017;2017;03;09;Perjantai;5;48;53;5;30;35
89;10.03.2017;2017;03;10;Perjantai;23;44;67;24;30;54
89;10.03.2017;2017;03;11;Perjantai;32;37;69;20;23;43
89;10.03.2017;2017;03;12;Perjantai;33;44;77;28;40;68
89;10.03.2017;2017;03;13;Perjantai;35;37;72;31;22;53
89;10.03.2017;2017;03;14;Perjantai;51;43;94;40;36;76
89;10.03.2017;2017;03;15;Perjantai;66;31;97;27;31;58
89;10.03.2017;2017;03;16;Perjantai;71;35;106;50;46;96
89;10.03.2017;2017;03;17;Perjantai;52;27;79;32;27;59
89;10.03.2017;2017;03;18;Perjantai;36;21;57;25;18;43
89;10.03.2017;2017;03;19;Perjantai;31;19;50;21;25;46
89;10.03.2017;2017;03;20;Perjantai;18;11;29;24;11;35
89;10.03.2017;2017;03;21;Perjantai;26;21;47;13;5;18
89;10.03.2017;2017;03;22;Perjantai;14;14;28;7;12;19
89;10.03.2017;2017;03;23;Perjantai;9;11;20;4;11;15
89;11.03.2017;2017;03;00;Lauantai;7;8;15;4;3;7
89;11.03.2017;2017;03;01;Lauantai;4;2;6;5;2;7
89;11.03.2017;2017;03;02;Lauantai;4;3;7;3;4;7
89;11.03.2017;2017;03;03;Lauantai;8;3;11;3;2;5
89;11.03.2017;2017;03;04;Lauantai;5;0;5;10;0;10
89;11.03.2017;2017;03;05;Lauantai;6;4;10;2;4;6
89;11.03.2017;2017;03;06;Lauantai;4;12;16;0;3;3
89;11.03.2017;2017;03;07;Lauantai;3;5;8;1;3;4
89;11.03.2017;2017;03;08;Lauantai;1;16;17;9;11;20
89;11.03.2017;2017;03;09;Lauantai;7;25;32;13;19;32
89;11.03.2017;2017;03;10;Lauantai;4;23;27;20;40;60
89;11.03.2017;2017;03;11;Lauantai;23;50;73;42;64;106
89;11.03.2017;2017;03;12;Lauantai;35;41;76;55;76;131
89;11.03.2017;2017;03;13;Lauantai;34;32;66;44;57;101
89;11.03.2017;2017;03;14;Lauantai;38;34;72;54;29;83
89;11.03.2017;2017;03;15;Lauantai;35;30;65;45;38;83
89;11.03.2017;2017;03;16;Lauantai;27;25;52;31;28;59
89;11.03.2017;2017;03;17;Lauantai;26;26;52;36;27;63
89;11.03.2017;2017;03;18;Lauantai;35;15;50;11;20;31
89;11.03.2017;2017;03;19;Lauantai;19;13;32;14;22;36
89;11.03.2017;2017;03;20;Lauantai;24;16;40;20;18;38
89;11.03.2017;2017;03;21;Lauantai;12;12;24;18;10;28
89;11.03.2017;2017;03;22;Lauantai;8;18;26;13;8;21
89;11.03.2017;2017;03;23;Lauantai;15;12;27;4;8;12
89;12.03.2017;2017;03;00;Sunnuntai;10;16;26;8;10;18
89;12.03.2017;2017;03;01;Sunnuntai;4;5;9;1;3;4
89;12.03.2017;2017;03;02;Sunnuntai;3;4;7;9;1;10
89;12.03.2017;2017;03;03;Sunnuntai;15;0;15;6;1;7
89;12.03.2017;2017;03;04;Sunnuntai;10;1;11;12;1;13
89;12.03.2017;2017;03;05;Sunnuntai;5;1;6;2;0;2
89;12.03.2017;2017;03;06;Sunnuntai;3;7;10;0;4;4
89;12.03.2017;2017;03;07;Sunnuntai;1;4;5;5;8;13
89;12.03.2017;2017;03;08;Sunnuntai;6;7;13;7;11;18
89;12.03.2017;2017;03;09;Sunnuntai;16;12;28;14;24;38
89;12.03.2017;2017;03;10;Sunnuntai;9;17;26;29;28;57
89;12.03.2017;2017;03;11;Sunnuntai;11;23;34;37;52;89
89;12.03.2017;2017;03;12;Sunnuntai;29;35;64;49;68;117
89;12.03.2017;2017;03;13;Sunnuntai;30;36;66;47;60;107
89;12.03.2017;2017;03;14;Sunnuntai;41;34;75;46;43;89
89;12.03.2017;2017;03;15;Sunnuntai;44;20;64;47;33;80
89;12.03.2017;2017;03;16;Sunnuntai;23;25;48;20;49;69
89;12.03.2017;2017;03;17;Sunnuntai;26;23;49;34;34;68
89;12.03.2017;2017;03;18;Sunnuntai;23;23;46;38;23;61
89;12.03.2017;2017;03;19;Sunnuntai;13;16;29;28;16;44
89;12.03.2017;2017;03;20;Sunnuntai;22;5;27;26;13;39
89;12.03.2017;2017;03;21;Sunnuntai;16;4;20;14;6;20
89;12.03.2017;2017;03;22;Sunnuntai;8;5;13;6;2;8
89;12.03.2017;2017;03;23;Sunnuntai;3;0;3;4;0;4
89;13.03.2017;2017;03;00;Maanantai;4;3;7;1;1;2
89;13.03.2017;2017;03;01;Maanantai;2;1;3;0;0;0
89;13.03.2017;2017;03;02;Maanantai;0;0;0;0;1;1
89;13.03.2017;2017;03;03;Maanantai;0;1;1;2;0;2
89;13.03.2017;2017;03;04;Maanantai;1;0;1;1;1;2
89;13.03.2017;2017;03;05;Maanantai;1;7;8;1;1;2
89;13.03.2017;2017;03;06;Maanantai;6;22;28;4;6;10
89;13.03.2017;2017;03;07;Maanantai;24;120;144;6;23;29
89;13.03.2017;2017;03;08;Maanantai;25;148;173;12;36;48
89;13.03.2017;2017;03;09;Maanantai;25;84;109;18;32;50
89;13.03.2017;2017;03;10;Maanantai;26;54;80;24;39;63
89;13.03.2017;2017;03;11;Maanantai;45;60;105;28;46;74
89;13.03.2017;2017;03;12;Maanantai;41;55;96;46;37;83
89;13.03.2017;2017;03;13;Maanantai;44;55;99;59;53;112
89;13.03.2017;2017;03;14;Maanantai;67;42;109;63;44;107
89;13.03.2017;2017;03;15;Maanantai;96;56;152;58;45;103
89;13.03.2017;2017;03;16;Maanantai;122;74;196;56;52;108
89;13.03.2017;2017;03;17;Maanantai;104;40;144;48;44;92
89;13.03.2017;2017;03;18;Maanantai;62;44;106;46;43;89
89;13.03.2017;2017;03;19;Maanantai;45;29;74;44;18;62
89;13.03.2017;2017;03;20;Maanantai;36;12;48;20;19;39
89;13.03.2017;2017;03;21;Maanantai;29;12;41;18;7;25
89;13.03.2017;2017;03;22;Maanantai;18;14;32;8;8;16
89;13.03.2017;2017;03;23;Maanantai;7;4;11;8;10;18
89;14.03.2017;2017;03;00;Tiistai;2;3;5;4;0;4
89;14.03.2017;2017;03;01;Tiistai;1;3;4;2;2;4
89;14.03.2017;2017;03;02;Tiistai;0;1;1;0;0;0
89;14.03.2017;2017;03;03;Tiistai;0;6;6;1;0;1
89;14.03.2017;2017;03;04;Tiistai;4;2;6;0;0;0
89;14.03.2017;2017;03;05;Tiistai;0;6;6;6;4;10
89;14.03.2017;2017;03;06;Tiistai;15;28;43;6;7;13
89;14.03.2017;2017;03;07;Tiistai;16;119;135;11;26;37
89;14.03.2017;2017;03;08;Tiistai;17;148;165;14;46;60
89;14.03.2017;2017;03;09;Tiistai;36;71;107;14;25;39
89;14.03.2017;2017;03;10;Tiistai;26;41;67;31;44;75
89;14.03.2017;2017;03;11;Tiistai;27;31;58;26;33;59
89;14.03.2017;2017;03;12;Tiistai;40;57;97;34;24;58
89;14.03.2017;2017;03;13;Tiistai;50;44;94;19;24;43
89;14.03.2017;2017;03;14;Tiistai;66;41;107;18;24;42
89;14.03.2017;2017;03;15;Tiistai;111;41;152;24;27;51
89;14.03.2017;2017;03;16;Tiistai;124;52;176;37;27;64
89;14.03.2017;2017;03;17;Tiistai;78;42;120;48;23;71
89;14.03.2017;2017;03;18;Tiistai;53;56;109;42;22;64
89;14.03.2017;2017;03;19;Tiistai;37;25;62;29;30;59
89;14.03.2017;2017;03;20;Tiistai;42;18;60;24;19;43
89;14.03.2017;2017;03;21;Tiistai;22;10;32;13;12;25
89;14.03.2017;2017;03;22;Tiistai;11;5;16;7;4;11
89;14.03.2017;2017;03;23;Tiistai;6;3;9;5;0;5
89;15.03.2017;2017;03;00;Keskiviikko;2;2;4;0;0;0
89;15.03.2017;2017;03;01;Keskiviikko;3;1;4;0;0;0
89;15.03.2017;2017;03;02;Keskiviikko;0;0;0;1;0;1
89;15.03.2017;2017;03;03;Keskiviikko;6;2;8;0;0;0
89;15.03.2017;2017;03;04;Keskiviikko;0;2;2;1;0;1
89;15.03.2017;2017;03;05;Keskiviikko;3;7;10;5;6;11
89;15.03.2017;2017;03;06;Keskiviikko;9;26;35;4;11;15
89;15.03.2017;2017;03;07;Keskiviikko;17;69;86;7;29;36
89;15.03.2017;2017;03;08;Keskiviikko;24;151;175;15;29;44
89;15.03.2017;2017;03;09;Keskiviikko;26;65;91;14;36;50
89;15.03.2017;2017;03;10;Keskiviikko;29;48;77;21;34;55
89;15.03.2017;2017;03;11;Keskiviikko;29;45;74;33;30;63
89;15.03.2017;2017;03;12;Keskiviikko;36;61;97;24;25;49
89;15.03.2017;2017;03;13;Keskiviikko;51;31;82;32;18;50
89;15.03.2017;2017;03;14;Keskiviikko;74;43;117;35;27;62
89;15.03.2017;2017;03;15;Keskiviikko;91;47;138;36;31;67
89;15.03.2017;2017;03;16;Keskiviikko;106;51;157;42;27;69
89;15.03.2017;2017;03;17;Keskiviikko;80;45;125;30;20;50
89;15.03.2017;2017;03;18;Keskiviikko;57;44;101;24;24;48
89;15.03.2017;2017;03;19;Keskiviikko;33;18;51;26;19;45
89;15.03.2017;2017;03;20;Keskiviikko;30;17;47;17;12;29
89;15.03.2017;2017;03;21;Keskiviikko;22;16;38;16;9;25
89;15.03.2017;2017;03;22;Keskiviikko;16;5;21;5;8;13
89;15.03.2017;2017;03;23;Keskiviikko;8;4;12;3;1;4
89;16.03.2017;2017;03;00;Torstai;8;3;11;2;6;8
89;16.03.2017;2017;03;01;Torstai;5;1;6;0;2;2
89;16.03.2017;2017;03;02;Torstai;2;0;2;2;1;3
89;16.03.2017;2017;03;03;Torstai;2;2;4;0;0;0
89;16.03.2017;2017;03;04;Torstai;3;0;3;4;0;4
89;16.03.2017;2017;03;05;Torstai;0;7;7;5;4;9
89;16.03.2017;2017;03;06;Torstai;7;27;34;1;8;9
89;16.03.2017;2017;03;07;Torstai;22;84;106;15;24;39
89;16.03.2017;2017;03;08;Torstai;17;157;174;21;44;65
89;16.03.2017;2017;03;09;Torstai;27;87;114;19;31;50
89;16.03.2017;2017;03;10;Torstai;35;63;98;20;45;65
89;16.03.2017;2017;03;11;Torstai;48;45;93;32;45;77
89;16.03.2017;2017;03;12;Torstai;37;56;93;50;57;107
89;16.03.2017;2017;03;13;Torstai;46;46;92;66;48;114
89;16.03.2017;2017;03;14;Torstai;70;46;116;56;39;95
89;16.03.2017;2017;03;15;Torstai;92;67;159;54;43;97
89;16.03.2017;2017;03;16;Torstai;118;57;175;55;39;94
89;16.03.2017;2017;03;17;Torstai;70;40;110;48;45;93
89;16.03.2017;2017;03;18;Torstai;50;36;86;38;22;60
89;16.03.2017;2017;03;19;Torstai;38;28;66;29;27;56
89;16.03.2017;2017;03;20;Torstai;25;20;45;33;21;54
89;16.03.2017;2017;03;21;Torstai;30;11;41;19;7;26
89;16.03.2017;2017;03;22;Torstai;6;8;14;4;5;9
89;16.03.2017;2017;03;23;Torstai;8;5;13;4;0;4
89;17.03.2017;2017;03;00;Perjantai;4;3;7;2;2;4
89;17.03.2017;2017;03;01;Perjantai;3;0;3;0;0;0
89;17.03.2017;2017;03;02;Perjantai;1;3;4;2;0;2
89;17.03.2017;2017;03;03;Perjantai;7;1;8;1;0;1
89;17.03.2017;2017;03;04;Perjantai;2;1;3;1;1;2
89;17.03.2017;2017;03;05;Perjantai;1;4;5;1;1;2
89;17.03.2017;2017;03;06;Perjantai;3;21;24;3;7;10
89;17.03.2017;2017;03;07;Perjantai;11;59;70;12;29;41
89;17.03.2017;2017;03;08;Perjantai;17;110;127;14;34;48
89;17.03.2017;2017;03;09;Perjantai;11;51;62;12;20;32
89;17.03.2017;2017;03;10;Perjantai;20;34;54;9;25;34
89;17.03.2017;2017;03;11;Perjantai;30;37;67;16;30;46
89;17.03.2017;2017;03;12;Perjantai;26;39;65;29;28;57
89;17.03.2017;2017;03;13;Perjantai;39;44;83;31;22;53
89;17.03.2017;2017;03;14;Perjantai;60;33;93;27;26;53
89;17.03.2017;2017;03;15;Perjantai;63;22;85;17;16;33
89;17.03.2017;2017;03;16;Perjantai;65;28;93;26;18;44
89;17.03.2017;2017;03;17;Perjantai;55;14;69;27;24;51
89;17.03.2017;2017;03;18;Perjantai;12;18;30;17;9;26
89;17.03.2017;2017;03;19;Perjantai;25;8;33;14;13;27
89;17.03.2017;2017;03;20;Perjantai;21;13;34;5;15;20
89;17.03.2017;2017;03;21;Perjantai;18;13;31;7;5;12
89;17.03.2017;2017;03;22;Perjantai;15;9;24;9;1;10
89;17.03.2017;2017;03;23;Perjantai;8;6;14;7;3;10
89;18.03.2017;2017;03;00;Lauantai;8;13;21;4;1;5
89;18.03.2017;2017;03;01;Lauantai;9;4;13;6;2;8
89;18.03.2017;2017;03;02;Lauantai;8;5;13;0;1;1
89;18.03.2017;2017;03;03;Lauantai;8;0;8;3;1;4
89;18.03.2017;2017;03;04;Lauantai;9;0;9;6;1;7
89;18.03.2017;2017;03;05;Lauantai;1;2;3;1;1;2
89;18.03.2017;2017;03;06;Lauantai;3;4;7;1;5;6
89;18.03.2017;2017;03;07;Lauantai;3;6;9;7;4;11
89;18.03.2017;2017;03;08;Lauantai;2;13;15;9;11;20
89;18.03.2017;2017;03;09;Lauantai;7;22;29;12;21;33
89;18.03.2017;2017;03;10;Lauantai;10;23;33;20;23;43
89;18.03.2017;2017;03;11;Lauantai;9;29;38;29;47;76
89;18.03.2017;2017;03;12;Lauantai;20;39;59;24;33;57
89;18.03.2017;2017;03;13;Lauantai;33;29;62;27;23;50
89;18.03.2017;2017;03;14;Lauantai;28;31;59;17;26;43
89;18.03.2017;2017;03;15;Lauantai;34;20;54;41;30;71
89;18.03.2017;2017;03;16;Lauantai;28;30;58;29;23;52
89;18.03.2017;2017;03;17;Lauantai;39;38;77;41;25;66
89;18.03.2017;2017;03;18;Lauantai;19;9;28;26;24;50
89;18.03.2017;2017;03;19;Lauantai;25;16;41;17;17;34
89;18.03.2017;2017;03;20;Lauantai;21;18;39;9;15;24
89;18.03.2017;2017;03;21;Lauantai;9;12;21;11;8;19
89;18.03.2017;2017;03;22;Lauantai;16;12;28;10;6;16
89;18.03.2017;2017;03;23;Lauantai;11;17;28;3;12;15
89;19.03.2017;2017;03;00;Sunnuntai;8;7;15;5;7;12
89;19.03.2017;2017;03;01;Sunnuntai;14;2;16;6;0;6
89;19.03.2017;2017;03;02;Sunnuntai;8;6;14;5;1;6
89;19.03.2017;2017;03;03;Sunnuntai;8;1;9;7;0;7
89;19.03.2017;2017;03;04;Sunnuntai;7;0;7;8;0;8
89;19.03.2017;2017;03;05;Sunnuntai;4;1;5;1;1;2
89;19.03.2017;2017;03;06;Sunnuntai;1;7;8;2;2;4
89;19.03.2017;2017;03;07;Sunnuntai;4;7;11;7;5;12
89;19.03.2017;2017;03;08;Sunnuntai;1;1;2;11;12;23
89;19.03.2017;2017;03;09;Sunnuntai;8;26;34;17;34;51
89;19.03.2017;2017;03;10;Sunnuntai;16;26;42;46;46;92
89;19.03.2017;2017;03;11;Sunnuntai;15;35;50;48;77;125
89;19.03.2017;2017;03;12;Sunnuntai;26;42;68;62;93;155
89;19.03.2017;2017;03;13;Sunnuntai;29;35;64;67;79;146
89;19.03.2017;2017;03;14;Sunnuntai;27;26;53;68;98;166
89;19.03.2017;2017;03;15;Sunnuntai;31;20;51;68;67;135
89;19.03.2017;2017;03;16;Sunnuntai;25;30;55;70;85;155
89;19.03.2017;2017;03;17;Sunnuntai;26;20;46;67;46;113
89;19.03.2017;2017;03;18;Sunnuntai;28;19;47;35;27;62
89;19.03.2017;2017;03;19;Sunnuntai;21;14;35;22;25;47
89;19.03.2017;2017;03;20;Sunnuntai;9;6;15;16;13;29
89;19.03.2017;2017;03;21;Sunnuntai;12;4;16;12;7;19
89;19.03.2017;2017;03;22;Sunnuntai;7;8;15;8;3;11
89;19.03.2017;2017;03;23;Sunnuntai;6;2;8;4;3;7
89;20.03.2017;2017;03;00;Maanantai;2;1;3;0;0;0
89;20.03.2017;2017;03;01;Maanantai;1;0;1;1;1;2
89;20.03.2017;2017;03;02;Maanantai;0;0;0;0;0;0
89;20.03.2017;2017;03;03;Maanantai;0;5;5;0;0;0
89;20.03.2017;2017;03;04;Maanantai;0;0;0;2;1;3
89;20.03.2017;2017;03;05;Maanantai;2;13;15;2;1;3
89;20.03.2017;2017;03;06;Maanantai;7;23;30;2;6;8
89;20.03.2017;2017;03;07;Maanantai;19;82;101;9;30;39
89;20.03.2017;2017;03;08;Maanantai;27;127;154;14;52;66
89;20.03.2017;2017;03;09;Maanantai;22;69;91;13;38;51
89;20.03.2017;2017;03;10;Maanantai;15;47;62;28;44;72
89;20.03.2017;2017;03;11;Maanantai;29;32;61;30;37;67
89;20.03.2017;2017;03;12;Maanantai;33;32;65;33;37;70
89;20.03.2017;2017;03;13;Maanantai;39;34;73;46;40;86
89;20.03.2017;2017;03;14;Maanantai;66;40;106;57;43;100
89;20.03.2017;2017;03;15;Maanantai;104;42;146;47;64;111
89;20.03.2017;2017;03;16;Maanantai;91;40;131;67;51;118
89;20.03.2017;2017;03;17;Maanantai;80;35;115;35;44;79
89;20.03.2017;2017;03;18;Maanantai;52;28;80;42;40;82
89;20.03.2017;2017;03;19;Maanantai;41;20;61;32;16;48
89;20.03.2017;2017;03;20;Maanantai;25;17;42;29;21;50
89;20.03.2017;2017;03;21;Maanantai;25;7;32;10;4;14
89;20.03.2017;2017;03;22;Maanantai;12;4;16;5;4;9
89;20.03.2017;2017;03;23;Maanantai;7;3;10;2;0;2
89;21.03.2017;2017;03;00;Tiistai;7;6;13;2;0;2
89;21.03.2017;2017;03;01;Tiistai;0;0;0;0;0;0
89;21.03.2017;2017;03;02;Tiistai;0;0;0;1;1;2
89;21.03.2017;2017;03;03;Tiistai;0;4;4;0;0;0
89;21.03.2017;2017;03;04;Tiistai;0;3;3;0;1;1
89;21.03.2017;2017;03;05;Tiistai;3;6;9;2;0;2
89;21.03.2017;2017;03;06;Tiistai;7;23;30;0;11;11
89;21.03.2017;2017;03;07;Tiistai;18;88;106;13;26;39
89;21.03.2017;2017;03;08;Tiistai;23;146;169;20;57;77
89;21.03.2017;2017;03;09;Tiistai;21;59;80;18;50;68
89;21.03.2017;2017;03;10;Tiistai;26;53;79;22;47;69
89;21.03.2017;2017;03;11;Tiistai;34;54;88;30;46;76
89;21.03.2017;2017;03;12;Tiistai;40;35;75;35;34;69
89;21.03.2017;2017;03;13;Tiistai;37;30;67;41;37;78
89;21.03.2017;2017;03;14;Tiistai;53;26;79;40;24;64
89;21.03.2017;2017;03;15;Tiistai;99;32;131;33;25;58
89;21.03.2017;2017;03;16;Tiistai;99;52;151;40;33;73
89;21.03.2017;2017;03;17;Tiistai;77;40;117;42;39;81
89;21.03.2017;2017;03;18;Tiistai;44;37;81;40;33;73
89;21.03.2017;2017;03;19;Tiistai;35;17;52;30;27;57
89;21.03.2017;2017;03;20;Tiistai;25;15;40;29;16;45
89;21.03.2017;2017;03;21;Tiistai;22;6;28;10;12;22
89;21.03.2017;2017;03;22;Tiistai;14;7;21;6;2;8
89;21.03.2017;2017;03;23;Tiistai;4;4;8;4;2;6
89;22.03.2017;2017;03;00;Keskiviikko;1;1;2;4;0;4
89;22.03.2017;2017;03;01;Keskiviikko;3;0;3;1;0;1
89;22.03.2017;2017;03;02;Keskiviikko;2;0;2;2;1;3
89;22.03.2017;2017;03;03;Keskiviikko;1;3;4;1;0;1
89;22.03.2017;2017;03;04;Keskiviikko;1;1;2;0;0;0
89;22.03.2017;2017;03;05;Keskiviikko;1;6;7;2;0;2
89;22.03.2017;2017;03;06;Keskiviikko;8;19;27;2;8;10
89;22.03.2017;2017;03;07;Keskiviikko;14;73;87;15;29;44
89;22.03.2017;2017;03;08;Keskiviikko;20;141;161;14;39;53
89;22.03.2017;2017;03;09;Keskiviikko;12;50;62;13;25;38
89;22.03.2017;2017;03;10;Keskiviikko;26;27;53;11;28;39
89;22.03.2017;2017;03;11;Keskiviikko;23;43;66;27;37;64
89;22.03.2017;2017;03;12;Keskiviikko;35;49;84;26;44;70
89;22.03.2017;2017;03;13;Keskiviikko;53;41;94;40;20;60
89;22.03.2017;2017;03;14;Keskiviikko;69;35;104;23;24;47
89;22.03.2017;2017;03;15;Keskiviikko;86;56;142;44;19;63
89;22.03.2017;2017;03;16;Keskiviikko;116;54;170;46;22;68
89;22.03.2017;2017;03;17;Keskiviikko;56;33;89;28;34;62
89;22.03.2017;2017;03;18;Keskiviikko;56;36;92;54;30;84
89;22.03.2017;2017;03;19;Keskiviikko;40;13;53;22;25;47
89;22.03.2017;2017;03;20;Keskiviikko;29;22;51;18;19;37
89;22.03.2017;2017;03;21;Keskiviikko;27;18;45;16;11;27
89;22.03.2017;2017;03;22;Keskiviikko;10;5;15;7;5;12
89;22.03.2017;2017;03;23;Keskiviikko;6;6;12;0;1;1
89;23.03.2017;2017;03;00;Torstai;5;3;8;3;1;4
89;23.03.2017;2017;03;01;Torstai;5;0;5;0;0;0
89;23.03.2017;2017;03;02;Torstai;2;0;2;1;1;2
89;23.03.2017;2017;03;03;Torstai;2;2;4;1;0;1
89;23.03.2017;2017;03;04;Torstai;0;1;1;2;0;2
89;23.03.2017;2017;03;05;Torstai;1;7;8;1;0;1
89;23.03.2017;2017;03;06;Torstai;8;27;35;4;11;15
89;23.03.2017;2017;03;07;Torstai;19;99;118;15;25;40
89;23.03.2017;2017;03;08;Torstai;21;130;151;12;48;60
89;23.03.2017;2017;03;09;Torstai;23;73;96;18;33;51
89;23.03.2017;2017;03;10;Torstai;26;51;77;35;37;72
89;23.03.2017;2017;03;11;Torstai;37;50;87;28;40;68
89;23.03.2017;2017;03;12;Torstai;49;39;88;35;33;68
89;23.03.2017;2017;03;13;Torstai;42;50;92;37;28;65
89;23.03.2017;2017;03;14;Torstai;64;47;111;34;29;63
89;23.03.2017;2017;03;15;Torstai;95;31;126;29;31;60
89;23.03.2017;2017;03;16;Torstai;111;61;172;49;32;81
89;23.03.2017;2017;03;17;Torstai;68;60;128;43;31;74
89;23.03.2017;2017;03;18;Torstai;66;38;104;32;29;61
89;23.03.2017;2017;03;19;Torstai;40;25;65;41;21;62
89;23.03.2017;2017;03;20;Torstai;35;23;58;18;14;32
89;23.03.2017;2017;03;21;Torstai;22;13;35;22;10;32
89;23.03.2017;2017;03;22;Torstai;11;11;22;5;7;12
89;23.03.2017;2017;03;23;Torstai;6;11;17;2;2;4
89;24.03.2017;2017;03;00;Perjantai;6;5;11;1;1;2
89;24.03.2017;2017;03;01;Perjantai;4;0;4;0;1;1
89;24.03.2017;2017;03;02;Perjantai;1;1;2;4;0;4
89;24.03.2017;2017;03;03;Perjantai;8;2;10;1;0;1
89;24.03.2017;2017;03;04;Perjantai;5;0;5;1;0;1
89;24.03.2017;2017;03;05;Perjantai;2;8;10;1;1;2
89;24.03.2017;2017;03;06;Perjantai;9;29;38;2;5;7
89;24.03.2017;2017;03;07;Perjantai;21;70;91;18;29;47
89;24.03.2017;2017;03;08;Perjantai;25;126;151;11;37;48
89;24.03.2017;2017;03;09;Perjantai;30;59;89;23;28;51
89;24.03.2017;2017;03;10;Perjantai;19;35;54;28;33;61
89;24.03.2017;2017;03;11;Perjantai;25;52;77;25;35;60
89;24.03.2017;2017;03;12;Perjantai;51;57;108;52;53;105
89;24.03.2017;2017;03;13;Perjantai;30;51;81;46;31;77
89;24.03.2017;2017;03;14;Perjantai;60;40;100;33;45;78
89;24.03.2017;2017;03;15;Perjantai;85;45;130;27;46;73
89;24.03.2017;2017;03;16;Perjantai;85;46;131;47;21;68
89;24.03.2017;2017;03;17;Perjantai;59;41;100;38;28;66
89;24.03.2017;2017;03;18;Perjantai;49;30;79;35;25;60
89;24.03.2017;2017;03;19;Perjantai;40;19;59;23;15;38
89;24.03.2017;2017;03;20;Perjantai;25;27;52;23;17;40
89;24.03.2017;2017;03;21;Perjantai;27;13;40;13;10;23
89;24.03.2017;2017;03;22;Perjantai;16;14;30;16;5;21
89;24.03.2017;2017;03;23;Perjantai;8;10;18;7;3;10
89;25.03.2017;2017;03;00;Lauantai;6;11;17;5;8;13
89;25.03.2017;2017;03;01;Lauantai;6;8;14;10;7;17
89;25.03.2017;2017;03;02;Lauantai;8;5;13;3;2;5
89;25.03.2017;2017;03;03;Lauantai;8;0;8;1;0;1
89;25.03.2017;2017;03;04;Lauantai;7;2;9;5;0;5
89;25.03.2017;2017;03;05;Lauantai;2;3;5;2;2;4
89;25.03.2017;2017;03;06;Lauantai;5;4;9;0;1;1
89;25.03.2017;2017;03;07;Lauantai;2;7;9;9;5;14
89;25.03.2017;2017;03;08;Lauantai;5;12;17;5;13;18
89;25.03.2017;2017;03;09;Lauantai;8;35;43;16;27;43
89;25.03.2017;2017;03;10;Lauantai;12;27;39;29;51;80
89;25.03.2017;2017;03;11;Lauantai;14;30;44;23;46;69
89;25.03.2017;2017;03;12;Lauantai;31;43;74;43;59;102
89;25.03.2017;2017;03;13;Lauantai;32;31;63;53;47;100
89;25.03.2017;2017;03;14;Lauantai;38;43;81;42;51;93
89;25.03.2017;2017;03;15;Lauantai;42;49;91;52;61;113
89;25.03.2017;2017;03;16;Lauantai;41;27;68;65;58;123
89;25.03.2017;2017;03;17;Lauantai;44;29;73;43;44;87
89;25.03.2017;2017;03;18;Lauantai;40;25;65;29;34;63
89;25.03.2017;2017;03;19;Lauantai;33;32;65;31;19;50
89;25.03.2017;2017;03;20;Lauantai;10;8;18;21;21;42
89;25.03.2017;2017;03;21;Lauantai;11;13;24;13;13;26
89;25.03.2017;2017;03;22;Lauantai;21;10;31;9;10;19
89;25.03.2017;2017;03;23;Lauantai;13;13;26;9;7;16
89;26.03.2017;2017;03;00;Sunnuntai;18;17;35;10;12;22
89;26.03.2017;2017;03;01;Sunnuntai;4;3;7;3;6;9
89;26.03.2017;2017;03;02;Sunnuntai;0;0;0;0;0;0
89;26.03.2017;2017;03;03;Sunnuntai;11;2;13;8;1;9
89;26.03.2017;2017;03;04;Sunnuntai;16;1;17;13;2;15
89;26.03.2017;2017;03;05;Sunnuntai;3;1;4;5;0;5
89;26.03.2017;2017;03;06;Sunnuntai;1;3;4;1;2;3
89;26.03.2017;2017;03;07;Sunnuntai;2;3;5;1;2;3
89;26.03.2017;2017;03;08;Sunnuntai;2;3;5;3;7;10
89;26.03.2017;2017;03;09;Sunnuntai;0;24;24;10;12;22
89;26.03.2017;2017;03;10;Sunnuntai;9;17;26;21;26;47
89;26.03.2017;2017;03;11;Sunnuntai;8;29;37;40;48;88
89;26.03.2017;2017;03;12;Sunnuntai;15;34;49;45;56;101
89;26.03.2017;2017;03;13;Sunnuntai;37;42;79;78;73;151
89;26.03.2017;2017;03;14;Sunnuntai;38;34;72;63;82;145
89;26.03.2017;2017;03;15;Sunnuntai;39;27;66;58;55;113
89;26.03.2017;2017;03;16;Sunnuntai;26;27;53;71;38;109
89;26.03.2017;2017;03;17;Sunnuntai;38;28;66;48;58;106
89;26.03.2017;2017;03;18;Sunnuntai;42;20;62;47;32;79
89;26.03.2017;2017;03;19;Sunnuntai;24;16;40;36;33;69
89;26.03.2017;2017;03;20;Sunnuntai;19;19;38;27;24;51
89;26.03.2017;2017;03;21;Sunnuntai;19;10;29;15;14;29
89;26.03.2017;2017;03;22;Sunnuntai;12;6;18;3;5;8
89;26.03.2017;2017;03;23;Sunnuntai;3;3;6;5;3;8
89;27.03.2017;2017;03;00;Maanantai;4;3;7;5;1;6
89;27.03.2017;2017;03;01;Maanantai;0;1;1;0;0;0
89;27.03.2017;2017;03;02;Maanantai;0;1;1;0;3;3
89;27.03.2017;2017;03;03;Maanantai;3;2;5;0;0;0
89;27.03.2017;2017;03;04;Maanantai;5;0;5;0;0;0
89;27.03.2017;2017;03;05;Maanantai;1;4;5;2;3;5
89;27.03.2017;2017;03;06;Maanantai;6;27;33;1;6;7
89;27.03.2017;2017;03;07;Maanantai;19;94;113;15;27;42
89;27.03.2017;2017;03;08;Maanantai;33;147;180;12;41;53
89;27.03.2017;2017;03;09;Maanantai;17;88;105;12;41;53
89;27.03.2017;2017;03;10;Maanantai;24;57;81;31;22;53
89;27.03.2017;2017;03;11;Maanantai;34;60;94;35;39;74
89;27.03.2017;2017;03;12;Maanantai;23;46;69;27;27;54
89;27.03.2017;2017;03;13;Maanantai;46;49;95;26;35;61
89;27.03.2017;2017;03;14;Maanantai;49;42;91;29;31;60
89;27.03.2017;2017;03;15;Maanantai;93;37;130;25;22;47
89;27.03.2017;2017;03;16;Maanantai;101;44;145;33;18;51
89;27.03.2017;2017;03;17;Maanantai;66;29;95;27;20;47
89;27.03.2017;2017;03;18;Maanantai;41;37;78;25;17;42
89;27.03.2017;2017;03;19;Maanantai;49;31;80;29;31;60
89;27.03.2017;2017;03;20;Maanantai;30;14;44;23;20;43
89;27.03.2017;2017;03;21;Maanantai;24;10;34;19;9;28
89;27.03.2017;2017;03;22;Maanantai;18;7;25;5;11;16
89;27.03.2017;2017;03;23;Maanantai;7;7;14;0;2;2
89;28.03.2017;2017;03;00;Tiistai;2;3;5;2;1;3
89;28.03.2017;2017;03;01;Tiistai;2;1;3;4;0;4
89;28.03.2017;2017;03;02;Tiistai;0;0;0;0;1;1
89;28.03.2017;2017;03;03;Tiistai;2;2;4;1;0;1
89;28.03.2017;2017;03;04;Tiistai;1;1;2;1;0;1
89;28.03.2017;2017;03;05;Tiistai;1;5;6;5;3;8
89;28.03.2017;2017;03;06;Tiistai;12;28;40;4;5;9
89;28.03.2017;2017;03;07;Tiistai;18;79;97;13;26;39
89;28.03.2017;2017;03;08;Tiistai;24;151;175;13;52;65
89;28.03.2017;2017;03;09;Tiistai;21;72;93;11;49;60
89;28.03.2017;2017;03;10;Tiistai;21;45;66;39;45;84
89;28.03.2017;2017;03;11;Tiistai;21;48;69;32;38;70
89;28.03.2017;2017;03;12;Tiistai;31;32;63;37;41;78
89;28.03.2017;2017;03;13;Tiistai;55;64;119;49;28;77
89;28.03.2017;2017;03;14;Tiistai;80;50;130;40;46;86
89;28.03.2017;2017;03;15;Tiistai;93;43;136;40;33;73
89;28.03.2017;2017;03;16;Tiistai;120;62;182;63;43;106
89;28.03.2017;2017;03;17;Tiistai;79;47;126;39;40;79
89;28.03.2017;2017;03;18;Tiistai;59;41;100;57;43;100
89;28.03.2017;2017;03;19;Tiistai;44;35;79;37;34;71
89;28.03.2017;2017;03;20;Tiistai;49;24;73;34;20;54
89;28.03.2017;2017;03;21;Tiistai;25;14;39;16;12;28
89;28.03.2017;2017;03;22;Tiistai;9;4;13;4;4;8
89;28.03.2017;2017;03;23;Tiistai;7;5;12;4;5;9
89;29.03.2017;2017;03;00;Keskiviikko;7;1;8;2;0;2
89;29.03.2017;2017;03;01;Keskiviikko;2;1;3;1;0;1
89;29.03.2017;2017;03;02;Keskiviikko;3;0;3;0;0;0
89;29.03.2017;2017;03;03;Keskiviikko;2;2;4;1;1;2
89;29.03.2017;2017;03;04;Keskiviikko;2;1;3;0;0;0
89;29.03.2017;2017;03;05;Keskiviikko;1;7;8;2;0;2
89;29.03.2017;2017;03;06;Keskiviikko;6;32;38;5;3;8
89;29.03.2017;2017;03;07;Keskiviikko;24;90;114;9;32;41
89;29.03.2017;2017;03;08;Keskiviikko;24;161;185;13;41;54
89;29.03.2017;2017;03;09;Keskiviikko;25;70;95;18;40;58
89;29.03.2017;2017;03;10;Keskiviikko;18;74;92;21;31;52
89;29.03.2017;2017;03;11;Keskiviikko;33;71;104;22;38;60
89;29.03.2017;2017;03;12;Keskiviikko;45;58;103;35;66;101
89;29.03.2017;2017;03;13;Keskiviikko;58;40;98;51;49;100
89;29.03.2017;2017;03;14;Keskiviikko;72;55;127;53;42;95
89;29.03.2017;2017;03;15;Keskiviikko;95;56;151;53;35;88
89;29.03.2017;2017;03;16;Keskiviikko;115;69;184;54;31;85
89;29.03.2017;2017;03;17;Keskiviikko;69;56;125;45;28;73
89;29.03.2017;2017;03;18;Keskiviikko;49;42;91;46;46;92
89;29.03.2017;2017;03;19;Keskiviikko;52;29;81;35;34;69
89;29.03.2017;2017;03;20;Keskiviikko;48;19;67;21;15;36
89;29.03.2017;2017;03;21;Keskiviikko;34;17;51;13;8;21
89;29.03.2017;2017;03;22;Keskiviikko;23;3;26;8;2;10
89;29.03.2017;2017;03;23;Keskiviikko;11;13;24;6;2;8
89;30.03.2017;2017;03;00;Torstai;2;7;9;0;2;2
89;30.03.2017;2017;03;01;Torstai;4;0;4;3;1;4
89;30.03.2017;2017;03;02;Torstai;4;3;7;1;2;3
89;30.03.2017;2017;03;03;Torstai;2;5;7;0;0;0
89;30.03.2017;2017;03;04;Torstai;3;1;4;0;0;0
89;30.03.2017;2017;03;05;Torstai;2;6;8;1;0;1
89;30.03.2017;2017;03;06;Torstai;10;26;36;2;5;7
89;30.03.2017;2017;03;07;Torstai;13;79;92;8;25;33
89;30.03.2017;2017;03;08;Torstai;28;158;186;10;42;52
89;30.03.2017;2017;03;09;Torstai;25;65;90;14;28;42
89;30.03.2017;2017;03;10;Torstai;25;51;76;19;39;58
89;30.03.2017;2017;03;11;Torstai;31;47;78;23;34;57
89;30.03.2017;2017;03;12;Torstai;51;58;109;32;35;67
89;30.03.2017;2017;03;13;Torstai;41;59;100;37;32;69
89;30.03.2017;2017;03;14;Torstai;81;50;131;27;45;72
89;30.03.2017;2017;03;15;Torstai;95;58;153;43;32;75
89;30.03.2017;2017;03;16;Torstai;93;66;159;60;30;90
89;30.03.2017;2017;03;17;Torstai;66;52;118;36;33;69
89;30.03.2017;2017;03;18;Torstai;47;41;88;46;33;79
89;30.03.2017;2017;03;19;Torstai;47;30;77;40;38;78
89;30.03.2017;2017;03;20;Torstai;43;35;78;29;23;52
89;30.03.2017;2017;03;21;Torstai;38;9;47;18;9;27
89;30.03.2017;2017;03;22;Torstai;20;7;27;6;6;12
89;30.03.2017;2017;03;23;Torstai;6;4;10;7;6;13
89;31.03.2017;2017;03;00;Perjantai;4;3;7;3;0;3
89;31.03.2017;2017;03;01;Perjantai;1;1;2;1;0;1
89;31.03.2017;2017;03;02;Perjantai;4;0;4;0;3;3
89;31.03.2017;2017;03;03;Perjantai;3;4;7;1;0;1
89;31.03.2017;2017;03;04;Perjantai;5;1;6;2;0;2
89;31.03.2017;2017;03;05;Perjantai;4;8;12;1;3;4
89;31.03.2017;2017;03;06;Perjantai;6;26;32;6;6;12
89;31.03.2017;2017;03;07;Perjantai;16;82;98;10;18;28
89;31.03.2017;2017;03;08;Perjantai;23;145;168;4;65;69
89;31.03.2017;2017;03;09;Perjantai;25;65;90;27;36;63
89;31.03.2017;2017;03;10;Perjantai;18;61;79;17;39;56
89;31.03.2017;2017;03;11;Perjantai;46;51;97;30;29;59
89;31.03.2017;2017;03;12;Perjantai;42;56;98;38;40;78
89;31.03.2017;2017;03;13;Perjantai;62;55;117;33;35;68
89;31.03.2017;2017;03;14;Perjantai;57;50;107;42;35;77
89;31.03.2017;2017;03;15;Perjantai;99;54;153;42;44;86
89;31.03.2017;2017;03;16;Perjantai;117;52;169;44;31;75
89;31.03.2017;2017;03;17;Perjantai;57;48;105;40;42;82
89;31.03.2017;2017;03;18;Perjantai;47;35;82;34;25;59
89;31.03.2017;2017;03;19;Perjantai;45;30;75;25;35;60
89;31.03.2017;2017;03;20;Perjantai;33;35;68;15;16;31
89;31.03.2017;2017;03;21;Perjantai;24;20;44;17;10;27
89;31.03.2017;2017;03;22;Perjantai;19;15;34;8;4;12
89;31.03.2017;2017;03;23;Perjantai;11;12;23;2;1;3
89;01.04.2017;2017;04;00;Lauantai;7;6;13;8;4;12
89;01.04.2017;2017;04;01;Lauantai;10;0;10;2;1;3
89;01.04.2017;2017;04;02;Lauantai;14;2;16;2;3;5
89;01.04.2017;2017;04;03;Lauantai;9;1;10;3;1;4
89;01.04.2017;2017;04;04;Lauantai;5;3;8;3;1;4
89;01.04.2017;2017;04;05;Lauantai;7;3;10;0;1;1
89;01.04.2017;2017;04;06;Lauantai;2;6;8;1;1;2
89;01.04.2017;2017;04;07;Lauantai;5;11;16;1;3;4
89;01.04.2017;2017;04;08;Lauantai;4;9;13;7;13;20
89;01.04.2017;2017;04;09;Lauantai;2;15;17;15;25;40
89;01.04.2017;2017;04;10;Lauantai;13;18;31;17;27;44
89;01.04.2017;2017;04;11;Lauantai;14;42;56;27;50;77
89;01.04.2017;2017;04;12;Lauantai;26;60;86;22;47;69
89;01.04.2017;2017;04;13;Lauantai;33;41;74;43;32;75
89;01.04.2017;2017;04;14;Lauantai;37;40;77;29;12;41
89;01.04.2017;2017;04;15;Lauantai;32;27;59;22;11;33
89;01.04.2017;2017;04;16;Lauantai;47;19;66;21;12;33
89;01.04.2017;2017;04;17;Lauantai;26;29;55;21;19;40
89;01.04.2017;2017;04;18;Lauantai;16;28;44;13;19;32
89;01.04.2017;2017;04;19;Lauantai;16;12;28;17;13;30
89;01.04.2017;2017;04;20;Lauantai;17;19;36;16;17;33
89;01.04.2017;2017;04;21;Lauantai;13;7;20;7;10;17
89;01.04.2017;2017;04;22;Lauantai;26;16;42;7;14;21
89;01.04.2017;2017;04;23;Lauantai;4;14;18;11;7;18
89;02.04.2017;2017;04;00;Sunnuntai;12;13;25;6;5;11
89;02.04.2017;2017;04;01;Sunnuntai;7;3;10;6;4;10
89;02.04.2017;2017;04;02;Sunnuntai;6;3;9;0;3;3
89;02.04.2017;2017;04;03;Sunnuntai;8;0;8;9;3;12
89;02.04.2017;2017;04;04;Sunnuntai;16;1;17;5;2;7
89;02.04.2017;2017;04;05;Sunnuntai;4;0;4;0;0;0
89;02.04.2017;2017;04;06;Sunnuntai;2;4;6;0;2;2
89;02.04.2017;2017;04;07;Sunnuntai;3;6;9;10;6;16
89;02.04.2017;2017;04;08;Sunnuntai;2;8;10;8;3;11
89;02.04.2017;2017;04;09;Sunnuntai;5;30;35;22;24;46
89;02.04.2017;2017;04;10;Sunnuntai;11;18;29;27;35;62
89;02.04.2017;2017;04;11;Sunnuntai;20;20;40;40;39;79
89;02.04.2017;2017;04;12;Sunnuntai;14;35;49;32;66;98
89;02.04.2017;2017;04;13;Sunnuntai;29;33;62;45;62;107
89;02.04.2017;2017;04;14;Sunnuntai;49;39;88;52;53;105
89;02.04.2017;2017;04;15;Sunnuntai;34;32;66;39;44;83
89;02.04.2017;2017;04;16;Sunnuntai;38;33;71;51;37;88
89;02.04.2017;2017;04;17;Sunnuntai;26;16;42;38;42;80
89;02.04.2017;2017;04;18;Sunnuntai;46;28;74;53;35;88
89;02.04.2017;2017;04;19;Sunnuntai;26;23;49;25;40;65
89;02.04.2017;2017;04;20;Sunnuntai;22;14;36;29;27;56
89;02.04.2017;2017;04;21;Sunnuntai;21;9;30;18;10;28
89;02.04.2017;2017;04;22;Sunnuntai;16;4;20;4;5;9
89;02.04.2017;2017;04;23;Sunnuntai;4;3;7;2;1;3
89;03.04.2017;2017;04;00;Maanantai;4;2;6;1;1;2
89;03.04.2017;2017;04;01;Maanantai;1;2;3;2;1;3
89;03.04.2017;2017;04;02;Maanantai;2;1;3;0;1;1
89;03.04.2017;2017;04;03;Maanantai;2;1;3;2;0;2
89;03.04.2017;2017;04;04;Maanantai;2;0;2;3;0;3
89;03.04.2017;2017;04;05;Maanantai;2;9;11;3;2;5
89;03.04.2017;2017;04;06;Maanantai;9;28;37;1;3;4
89;03.04.2017;2017;04;07;Maanantai;23;115;138;8;23;31
89;03.04.2017;2017;04;08;Maanantai;19;165;184;11;39;50
89;03.04.2017;2017;04;09;Maanantai;24;79;103;24;26;50
89;03.04.2017;2017;04;10;Maanantai;26;62;88;31;35;66
89;03.04.2017;2017;04;11;Maanantai;27;48;75;31;52;83
89;03.04.2017;2017;04;12;Maanantai;57;59;116;48;39;87
89;03.04.2017;2017;04;13;Maanantai;44;77;121;53;44;97
89;03.04.2017;2017;04;14;Maanantai;85;43;128;48;27;75
89;03.04.2017;2017;04;15;Maanantai;124;62;186;41;32;73
89;03.04.2017;2017;04;16;Maanantai;114;72;186;49;32;81
89;03.04.2017;2017;04;17;Maanantai;91;45;136;46;27;73
89;03.04.2017;2017;04;18;Maanantai;53;37;90;34;29;63
89;03.04.2017;2017;04;19;Maanantai;42;34;76;35;30;65
89;03.04.2017;2017;04;20;Maanantai;38;26;64;42;12;54
89;03.04.2017;2017;04;21;Maanantai;26;16;42;17;15;32
89;03.04.2017;2017;04;22;Maanantai;15;8;23;12;6;18
89;03.04.2017;2017;04;23;Maanantai;6;1;7;0;4;4
89;04.04.2017;2017;04;00;Tiistai;1;1;2;1;1;2
89;04.04.2017;2017;04;01;Tiistai;2;0;2;1;2;3
89;04.04.2017;2017;04;02;Tiistai;1;1;2;0;0;0
89;04.04.2017;2017;04;03;Tiistai;1;2;3;1;0;1
89;04.04.2017;2017;04;04;Tiistai;1;1;2;1;0;1
89;04.04.2017;2017;04;05;Tiistai;1;10;11;1;6;7
89;04.04.2017;2017;04;06;Tiistai;12;29;41;2;3;5
89;04.04.2017;2017;04;07;Tiistai;20;104;124;13;21;34
89;04.04.2017;2017;04;08;Tiistai;24;142;166;12;49;61
89;04.04.2017;2017;04;09;Tiistai;29;84;113;16;33;49
89;04.04.2017;2017;04;10;Tiistai;19;42;61;29;43;72
89;04.04.2017;2017;04;11;Tiistai;27;56;83;33;40;73
89;04.04.2017;2017;04;12;Tiistai;38;49;87;34;31;65
89;04.04.2017;2017;04;13;Tiistai;51;51;102;33;25;58
89;04.04.2017;2017;04;14;Tiistai;59;49;108;38;25;63
89;04.04.2017;2017;04;15;Tiistai;93;49;142;53;46;99
89;04.04.2017;2017;04;16;Tiistai;128;66;194;56;42;98
89;04.04.2017;2017;04;17;Tiistai;93;52;145;52;47;99
89;04.04.2017;2017;04;18;Tiistai;60;52;112;57;51;108
89;04.04.2017;2017;04;19;Tiistai;60;21;81;31;46;77
89;04.04.2017;2017;04;20;Tiistai;42;26;68;36;22;58
89;04.04.2017;2017;04;21;Tiistai;30;10;40;14;10;24
89;04.04.2017;2017;04;22;Tiistai;13;4;17;10;8;18
89;04.04.2017;2017;04;23;Tiistai;4;3;7;4;7;11
89;05.04.2017;2017;04;00;Keskiviikko;1;1;2;2;1;3
89;05.04.2017;2017;04;01;Keskiviikko;3;0;3;0;0;0
89;05.04.2017;2017;04;02;Keskiviikko;2;1;3;1;0;1
89;05.04.2017;2017;04;03;Keskiviikko;1;4;5;1;2;3
89;05.04.2017;2017;04;04;Keskiviikko;1;1;2;0;1;1
89;05.04.2017;2017;04;05;Keskiviikko;2;9;11;1;2;3
89;05.04.2017;2017;04;06;Keskiviikko;10;42;52;0;5;5
89;05.04.2017;2017;04;07;Keskiviikko;21;107;128;10;24;34
89;05.04.2017;2017;04;08;Keskiviikko;29;165;194;15;49;64
89;05.04.2017;2017;04;09;Keskiviikko;30;72;102;29;44;73
89;05.04.2017;2017;04;10;Keskiviikko;26;74;100;28;34;62
89;05.04.2017;2017;04;11;Keskiviikko;44;59;103;37;48;85
89;05.04.2017;2017;04;12;Keskiviikko;38;81;119;40;60;100
89;05.04.2017;2017;04;13;Keskiviikko;70;52;122;40;32;72
89;05.04.2017;2017;04;14;Keskiviikko;83;69;152;81;51;132
89;05.04.2017;2017;04;15;Keskiviikko;120;79;199;63;40;103
89;05.04.2017;2017;04;16;Keskiviikko;146;74;220;66;73;139
89;05.04.2017;2017;04;17;Keskiviikko;113;61;174;51;49;100
89;05.04.2017;2017;04;18;Keskiviikko;72;47;119;79;54;133
89;05.04.2017;2017;04;19;Keskiviikko;68;43;111;60;46;106
89;05.04.2017;2017;04;20;Keskiviikko;46;26;72;46;29;75
89;05.04.2017;2017;04;21;Keskiviikko;39;13;52;25;16;41
89;05.04.2017;2017;04;22;Keskiviikko;23;2;25;12;5;17
89;05.04.2017;2017;04;23;Keskiviikko;14;5;19;8;2;10
89;06.04.2017;2017;04;00;Torstai;4;10;14;0;3;3
89;06.04.2017;2017;04;01;Torstai;4;0;4;2;0;2
89;06.04.2017;2017;04;02;Torstai;4;2;6;3;2;5
89;06.04.2017;2017;04;03;Torstai;2;1;3;1;0;1
89;06.04.2017;2017;04;04;Torstai;1;1;2;2;0;2
89;06.04.2017;2017;04;05;Torstai;4;5;9;3;1;4
89;06.04.2017;2017;04;06;Torstai;10;38;48;0;9;9
89;06.04.2017;2017;04;07;Torstai;27;99;126;11;29;40
89;06.04.2017;2017;04;08;Torstai;26;172;198;20;46;66
89;06.04.2017;2017;04;09;Torstai;27;108;135;20;44;64
89;06.04.2017;2017;04;10;Torstai;26;69;95;18;35;53
89;06.04.2017;2017;04;11;Torstai;47;58;105;31;26;57
89;06.04.2017;2017;04;12;Torstai;35;68;103;32;31;63
89;06.04.2017;2017;04;13;Torstai;62;54;116;23;39;62
89;06.04.2017;2017;04;14;Torstai;64;51;115;39;23;62
89;06.04.2017;2017;04;15;Torstai;112;43;155;35;17;52
89;06.04.2017;2017;04;16;Torstai;128;62;190;21;34;55
89;06.04.2017;2017;04;17;Torstai;100;40;140;28;27;55
89;06.04.2017;2017;04;18;Torstai;56;36;92;36;30;66
89;06.04.2017;2017;04;19;Torstai;46;29;75;23;30;53
89;06.04.2017;2017;04;20;Torstai;51;24;75;30;24;54
89;06.04.2017;2017;04;21;Torstai;35;11;46;17;12;29
89;06.04.2017;2017;04;22;Torstai;16;13;29;9;6;15
89;06.04.2017;2017;04;23;Torstai;11;7;18;3;1;4
89;07.04.2017;2017;04;00;Perjantai;3;6;9;1;2;3
89;07.04.2017;2017;04;01;Perjantai;2;1;3;1;5;6
89;07.04.2017;2017;04;02;Perjantai;1;1;2;0;2;2
89;07.04.2017;2017;04;03;Perjantai;4;3;7;0;0;0
89;07.04.2017;2017;04;04;Perjantai;1;2;3;1;0;1
89;07.04.2017;2017;04;05;Perjantai;0;11;11;2;0;2
89;07.04.2017;2017;04;06;Perjantai;9;33;42;2;12;14
89;07.04.2017;2017;04;07;Perjantai;24;96;120;11;29;40
89;07.04.2017;2017;04;08;Perjantai;24;150;174;12;67;79
89;07.04.2017;2017;04;09;Perjantai;29;64;93;13;23;36
89;07.04.2017;2017;04;10;Perjantai;24;62;86;17;26;43
89;07.04.2017;2017;04;11;Perjantai;44;45;89;19;38;57
89;07.04.2017;2017;04;12;Perjantai;51;60;111;28;28;56
89;07.04.2017;2017;04;13;Perjantai;58;59;117;36;29;65
89;07.04.2017;2017;04;14;Perjantai;85;57;142;31;34;65
89;07.04.2017;2017;04;15;Perjantai;109;63;172;40;48;88
89;07.04.2017;2017;04;16;Perjantai;104;60;164;41;35;76
89;07.04.2017;2017;04;17;Perjantai;82;36;118;22;28;50
89;07.04.2017;2017;04;18;Perjantai;51;29;80;22;17;39
89;07.04.2017;2017;04;19;Perjantai;45;31;76;24;22;46
89;07.04.2017;2017;04;20;Perjantai;45;20;65;16;20;36
89;07.04.2017;2017;04;21;Perjantai;26;19;45;14;13;27
89;07.04.2017;2017;04;22;Perjantai;21;14;35;12;13;25
89;07.04.2017;2017;04;23;Perjantai;12;11;23;6;12;18
89;08.04.2017;2017;04;00;Lauantai;12;12;24;3;5;8
89;08.04.2017;2017;04;01;Lauantai;6;12;18;4;8;12
89;08.04.2017;2017;04;02;Lauantai;11;7;18;5;3;8
89;08.04.2017;2017;04;03;Lauantai;7;1;8;1;2;3
89;08.04.2017;2017;04;04;Lauantai;4;2;6;6;1;7
89;08.04.2017;2017;04;05;Lauantai;3;4;7;0;1;1
89;08.04.2017;2017;04;06;Lauantai;4;8;12;0;2;2
89;08.04.2017;2017;04;07;Lauantai;2;9;11;7;5;12
89;08.04.2017;2017;04;08;Lauantai;4;13;17;10;16;26
89;08.04.2017;2017;04;09;Lauantai;3;28;31;18;28;46
89;08.04.2017;2017;04;10;Lauantai;20;34;54;34;54;88
89;08.04.2017;2017;04;11;Lauantai;22;55;77;36;56;92
89;08.04.2017;2017;04;12;Lauantai;39;41;80;35;67;102
89;08.04.2017;2017;04;13;Lauantai;52;84;136;34;49;83
89;08.04.2017;2017;04;14;Lauantai;70;49;119;55;50;105
89;08.04.2017;2017;04;15;Lauantai;64;48;112;52;50;102
89;08.04.2017;2017;04;16;Lauantai;74;40;114;50;43;93
89;08.04.2017;2017;04;17;Lauantai;41;35;76;35;38;73
89;08.04.2017;2017;04;18;Lauantai;39;35;74;38;31;69
89;08.04.2017;2017;04;19;Lauantai;31;33;64;26;36;62
89;08.04.2017;2017;04;20;Lauantai;22;20;42;17;15;32
89;08.04.2017;2017;04;21;Lauantai;14;14;28;9;7;16
89;08.04.2017;2017;04;22;Lauantai;19;11;30;11;17;28
89;08.04.2017;2017;04;23;Lauantai;12;6;18;10;5;15
89;09.04.2017;2017;04;00;Sunnuntai;13;7;20;4;5;9
89;09.04.2017;2017;04;01;Sunnuntai;6;7;13;5;3;8
89;09.04.2017;2017;04;02;Sunnuntai;4;2;6;2;2;4
89;09.04.2017;2017;04;03;Sunnuntai;10;1;11;7;0;7
89;09.04.2017;2017;04;04;Sunnuntai;8;1;9;13;1;14
89;09.04.2017;2017;04;05;Sunnuntai;6;4;10;0;1;1
89;09.04.2017;2017;04;06;Sunnuntai;3;4;7;1;1;2
89;09.04.2017;2017;04;07;Sunnuntai;6;5;11;4;7;11
89;09.04.2017;2017;04;08;Sunnuntai;3;3;6;6;6;12
89;09.04.2017;2017;04;09;Sunnuntai;6;7;13;13;16;29
89;09.04.2017;2017;04;10;Sunnuntai;12;24;36;21;23;44
89;09.04.2017;2017;04;11;Sunnuntai;17;36;53;24;33;57
89;09.04.2017;2017;04;12;Sunnuntai;18;27;45;38;37;75
89;09.04.2017;2017;04;13;Sunnuntai;22;33;55;37;20;57
89;09.04.2017;2017;04;14;Sunnuntai;30;31;61;25;38;63
89;09.04.2017;2017;04;15;Sunnuntai;25;22;47;35;44;79
89;09.04.2017;2017;04;16;Sunnuntai;32;24;56;30;26;56
89;09.04.2017;2017;04;17;Sunnuntai;27;32;59;36;40;76
89;09.04.2017;2017;04;18;Sunnuntai;38;31;69;44;32;76
89;09.04.2017;2017;04;19;Sunnuntai;31;25;56;24;34;58
89;09.04.2017;2017;04;20;Sunnuntai;23;9;32;25;19;44
89;09.04.2017;2017;04;21;Sunnuntai;19;5;24;21;6;27
89;09.04.2017;2017;04;22;Sunnuntai;11;6;17;8;3;11
89;09.04.2017;2017;04;23;Sunnuntai;5;6;11;1;4;5
89;10.04.2017;2017;04;00;Maanantai;4;4;8;2;2;4
89;10.04.2017;2017;04;01;Maanantai;0;0;0;0;0;0
89;10.04.2017;2017;04;02;Maanantai;2;0;2;1;0;1
89;10.04.2017;2017;04;03;Maanantai;0;5;5;0;0;0
89;10.04.2017;2017;04;04;Maanantai;3;1;4;1;0;1
89;10.04.2017;2017;04;05;Maanantai;4;6;10;2;1;3
89;10.04.2017;2017;04;06;Maanantai;5;34;39;3;6;9
89;10.04.2017;2017;04;07;Maanantai;21;92;113;7;26;33
89;10.04.2017;2017;04;08;Maanantai;18;153;171;9;39;48
89;10.04.2017;2017;04;09;Maanantai;15;81;96;10;36;46
89;10.04.2017;2017;04;10;Maanantai;31;52;83;17;18;35
89;10.04.2017;2017;04;11;Maanantai;38;50;88;25;30;55
89;10.04.2017;2017;04;12;Maanantai;33;50;83;17;30;47
89;10.04.2017;2017;04;13;Maanantai;40;32;72;43;11;54
89;10.04.2017;2017;04;14;Maanantai;57;25;82;24;22;46
89;10.04.2017;2017;04;15;Maanantai;99;30;129;22;28;50
89;10.04.2017;2017;04;16;Maanantai;115;50;165;30;17;47
89;10.04.2017;2017;04;17;Maanantai;68;32;100;14;9;23
89;10.04.2017;2017;04;18;Maanantai;44;21;65;17;10;27
89;10.04.2017;2017;04;19;Maanantai;25;14;39;15;11;26
89;10.04.2017;2017;04;20;Maanantai;30;20;50;14;7;21
89;10.04.2017;2017;04;21;Maanantai;20;10;30;13;10;23
89;10.04.2017;2017;04;22;Maanantai;7;7;14;6;4;10
89;10.04.2017;2017;04;23;Maanantai;4;5;9;4;2;6
89;11.04.2017;2017;04;00;Tiistai;6;0;6;0;1;1
89;11.04.2017;2017;04;01;Tiistai;3;1;4;0;0;0
89;11.04.2017;2017;04;02;Tiistai;0;0;0;4;2;6
89;11.04.2017;2017;04;03;Tiistai;2;2;4;0;1;1
89;11.04.2017;2017;04;04;Tiistai;1;2;3;1;0;1
89;11.04.2017;2017;04;05;Tiistai;1;6;7;1;1;2
89;11.04.2017;2017;04;06;Tiistai;10;22;32;1;8;9
89;11.04.2017;2017;04;07;Tiistai;13;74;87;9;14;23
89;11.04.2017;2017;04;08;Tiistai;16;99;115;12;53;65
89;11.04.2017;2017;04;09;Tiistai;21;60;81;13;14;27
89;11.04.2017;2017;04;10;Tiistai;19;34;53;16;24;40
89;11.04.2017;2017;04;11;Tiistai;15;40;55;18;15;33
89;11.04.2017;2017;04;12;Tiistai;26;31;57;18;11;29
89;11.04.2017;2017;04;13;Tiistai;29;23;52;20;19;39
89;11.04.2017;2017;04;14;Tiistai;50;39;89;28;24;52
89;11.04.2017;2017;04;15;Tiistai;78;29;107;29;33;62
89;11.04.2017;2017;04;16;Tiistai;80;53;133;50;23;73
89;11.04.2017;2017;04;17;Tiistai;57;44;101;31;26;57
89;11.04.2017;2017;04;18;Tiistai;64;28;92;47;31;78
89;11.04.2017;2017;04;19;Tiistai;58;26;84;36;19;55
89;11.04.2017;2017;04;20;Tiistai;38;23;61;32;32;64
89;11.04.2017;2017;04;21;Tiistai;30;16;46;22;20;42
89;11.04.2017;2017;04;22;Tiistai;16;6;22;7;6;13
89;11.04.2017;2017;04;23;Tiistai;10;1;11;4;4;8
89;12.04.2017;2017;04;00;Keskiviikko;6;3;9;0;4;4
89;12.04.2017;2017;04;01;Keskiviikko;2;0;2;0;1;1
89;12.04.2017;2017;04;02;Keskiviikko;0;0;0;4;2;6
89;12.04.2017;2017;04;03;Keskiviikko;2;3;5;1;0;1
89;12.04.2017;2017;04;04;Keskiviikko;1;2;3;2;1;3
89;12.04.2017;2017;04;05;Keskiviikko;4;9;13;1;1;2
89;12.04.2017;2017;04;06;Keskiviikko;6;26;32;5;10;15
89;12.04.2017;2017;04;07;Keskiviikko;21;103;124;6;22;28
89;12.04.2017;2017;04;08;Keskiviikko;23;141;164;12;40;52
89;12.04.2017;2017;04;09;Keskiviikko;25;66;91;15;42;57
89;12.04.2017;2017;04;10;Keskiviikko;20;55;75;15;32;47
89;12.04.2017;2017;04;11;Keskiviikko;46;53;99;37;56;93
89;12.04.2017;2017;04;12;Keskiviikko;44;68;112;54;49;103
89;12.04.2017;2017;04;13;Keskiviikko;52;44;96;28;37;65
89;12.04.2017;2017;04;14;Keskiviikko;86;49;135;43;25;68
89;12.04.2017;2017;04;15;Keskiviikko;103;55;158;30;26;56
89;12.04.2017;2017;04;16;Keskiviikko;121;74;195;47;26;73
89;12.04.2017;2017;04;17;Keskiviikko;75;50;125;38;34;72
89;12.04.2017;2017;04;18;Keskiviikko;68;30;98;37;33;70
89;12.04.2017;2017;04;19;Keskiviikko;47;31;78;39;32;71
89;12.04.2017;2017;04;20;Keskiviikko;52;23;75;30;17;47
89;12.04.2017;2017;04;21;Keskiviikko;39;19;58;19;11;30
89;12.04.2017;2017;04;22;Keskiviikko;20;17;37;2;5;7
89;12.04.2017;2017;04;23;Keskiviikko;7;11;18;4;4;8
89;13.04.2017;2017;04;00;Torstai;4;4;8;3;1;4
89;13.04.2017;2017;04;01;Torstai;7;1;8;1;0;1
89;13.04.2017;2017;04;02;Torstai;7;3;10;2;1;3
89;13.04.2017;2017;04;03;Torstai;1;3;4;2;0;2
89;13.04.2017;2017;04;04;Torstai;7;4;11;2;1;3
89;13.04.2017;2017;04;05;Torstai;2;6;8;1;1;2
89;13.04.2017;2017;04;06;Torstai;13;27;40;3;9;12
89;13.04.2017;2017;04;07;Torstai;25;83;108;12;20;32
89;13.04.2017;2017;04;08;Torstai;26;129;155;16;35;51
89;13.04.2017;2017;04;09;Torstai;22;70;92;14;37;51
89;13.04.2017;2017;04;10;Torstai;28;56;84;13;28;41
89;13.04.2017;2017;04;11;Torstai;39;49;88;22;31;53
89;13.04.2017;2017;04;12;Torstai;41;53;94;23;25;48
89;13.04.2017;2017;04;13;Torstai;67;45;112;25;24;49
89;13.04.2017;2017;04;14;Torstai;88;55;143;38;33;71
89;13.04.2017;2017;04;15;Torstai;99;40;139;26;19;45
89;13.04.2017;2017;04;16;Torstai;88;49;137;32;18;50
89;13.04.2017;2017;04;17;Torstai;66;45;111;18;23;41
89;13.04.2017;2017;04;18;Torstai;33;29;62;19;30;49
89;13.04.2017;2017;04;19;Torstai;48;26;74;20;21;41
89;13.04.2017;2017;04;20;Torstai;38;13;51;24;16;40
89;13.04.2017;2017;04;21;Torstai;28;17;45;18;10;28
89;13.04.2017;2017;04;22;Torstai;11;15;26;6;13;19
89;13.04.2017;2017;04;23;Torstai;14;12;26;7;6;13
89;14.04.2017;2017;04;00;Perjantai;4;10;14;2;4;6
89;14.04.2017;2017;04;01;Perjantai;5;13;18;2;6;8
89;14.04.2017;2017;04;02;Perjantai;5;1;6;2;3;5
89;14.04.2017;2017;04;03;Perjantai;4;1;5;2;0;2
89;14.04.2017;2017;04;04;Perjantai;3;4;7;3;1;4
89;14.04.2017;2017;04;05;Perjantai;2;2;4;0;3;3
89;14.04.2017;2017;04;06;Perjantai;1;13;14;0;2;2
89;14.04.2017;2017;04;07;Perjantai;0;3;3;5;5;10
89;14.04.2017;2017;04;08;Perjantai;2;8;10;10;5;15
89;14.04.2017;2017;04;09;Perjantai;3;14;17;19;14;33
89;14.04.2017;2017;04;10;Perjantai;13;18;31;27;37;64
89;14.04.2017;2017;04;11;Perjantai;11;26;37;37;38;75
89;14.04.2017;2017;04;12;Perjantai;25;33;58;36;44;80
89;14.04.2017;2017;04;13;Perjantai;23;23;46;43;47;90
89;14.04.2017;2017;04;14;Perjantai;24;34;58;38;41;79
89;14.04.2017;2017;04;15;Perjantai;33;20;53;40;23;63
89;14.04.2017;2017;04;16;Perjantai;32;22;54;35;39;74
89;14.04.2017;2017;04;17;Perjantai;21;23;44;34;26;60
89;14.04.2017;2017;04;18;Perjantai;30;18;48;24;20;44
89;14.04.2017;2017;04;19;Perjantai;20;27;47;28;32;60
89;14.04.2017;2017;04;20;Perjantai;19;19;38;19;15;34
89;14.04.2017;2017;04;21;Perjantai;19;15;34;13;12;25
89;14.04.2017;2017;04;22;Perjantai;10;10;20;9;13;22
89;14.04.2017;2017;04;23;Perjantai;4;8;12;2;3;5
89;15.04.2017;2017;04;00;Lauantai;4;22;26;2;10;12
89;15.04.2017;2017;04;01;Lauantai;9;8;17;5;2;7
89;15.04.2017;2017;04;02;Lauantai;7;9;16;5;2;7
89;15.04.2017;2017;04;03;Lauantai;9;1;10;5;1;6
89;15.04.2017;2017;04;04;Lauantai;7;1;8;5;0;5
89;15.04.2017;2017;04;05;Lauantai;5;1;6;0;2;2
89;15.04.2017;2017;04;06;Lauantai;3;8;11;0;5;5
89;15.04.2017;2017;04;07;Lauantai;2;8;10;11;6;17
89;15.04.2017;2017;04;08;Lauantai;2;2;4;8;3;11
89;15.04.2017;2017;04;09;Lauantai;4;19;23;12;14;26
89;15.04.2017;2017;04;10;Lauantai;10;17;27;14;31;45
89;15.04.2017;2017;04;11;Lauantai;14;28;42;29;29;58
89;15.04.2017;2017;04;12;Lauantai;17;33;50;30;40;70
89;15.04.2017;2017;04;13;Lauantai;13;19;32;32;34;66
89;15.04.2017;2017;04;14;Lauantai;30;34;64;27;32;59
89;15.04.2017;2017;04;15;Lauantai;44;18;62;41;35;76
89;15.04.2017;2017;04;16;Lauantai;28;35;63;43;36;79
89;15.04.2017;2017;04;17;Lauantai;26;30;56;23;23;46
89;15.04.2017;2017;04;18;Lauantai;25;32;57;21;44;65
89;15.04.2017;2017;04;19;Lauantai;32;25;57;30;28;58
89;15.04.2017;2017;04;20;Lauantai;22;5;27;24;27;51
89;15.04.2017;2017;04;21;Lauantai;15;22;37;10;13;23
89;15.04.2017;2017;04;22;Lauantai;12;16;28;8;11;19
89;15.04.2017;2017;04;23;Lauantai;6;13;19;3;5;8
89;16.04.2017;2017;04;00;Sunnuntai;3;6;9;2;4;6
89;16.04.2017;2017;04;01;Sunnuntai;7;3;10;6;5;11
89;16.04.2017;2017;04;02;Sunnuntai;9;3;12;5;0;5
89;16.04.2017;2017;04;03;Sunnuntai;7;0;7;5;1;6
89;16.04.2017;2017;04;04;Sunnuntai;8;1;9;7;0;7
89;16.04.2017;2017;04;05;Sunnuntai;7;2;9;2;0;2
89;16.04.2017;2017;04;06;Sunnuntai;3;8;11;3;0;3
89;16.04.2017;2017;04;07;Sunnuntai;0;4;4;1;4;5
89;16.04.2017;2017;04;08;Sunnuntai;6;1;7;8;6;14
89;16.04.2017;2017;04;09;Sunnuntai;8;8;16;17;18;35
89;16.04.2017;2017;04;10;Sunnuntai;11;27;38;31;41;72
89;16.04.2017;2017;04;11;Sunnuntai;16;41;57;41;52;93
89;16.04.2017;2017;04;12;Sunnuntai;39;27;66;54;56;110
89;16.04.2017;2017;04;13;Sunnuntai;42;34;76;59;39;98
89;16.04.2017;2017;04;14;Sunnuntai;46;28;74;54;71;125
89;16.04.2017;2017;04;15;Sunnuntai;49;35;84;60;38;98
89;16.04.2017;2017;04;16;Sunnuntai;35;31;66;48;47;95
89;16.04.2017;2017;04;17;Sunnuntai;22;31;53;32;48;80
89;16.04.2017;2017;04;18;Sunnuntai;23;25;48;24;31;55
89;16.04.2017;2017;04;19;Sunnuntai;35;23;58;26;27;53
89;16.04.2017;2017;04;20;Sunnuntai;13;15;28;17;20;37
89;16.04.2017;2017;04;21;Sunnuntai;12;18;30;13;21;34
89;16.04.2017;2017;04;22;Sunnuntai;6;7;13;9;5;14
89;16.04.2017;2017;04;23;Sunnuntai;7;4;11;2;10;12
89;17.04.2017;2017;04;00;Maanantai;6;10;16;3;3;6
89;17.04.2017;2017;04;01;Maanantai;3;3;6;4;1;5
89;17.04.2017;2017;04;02;Maanantai;2;2;4;1;0;1
89;17.04.2017;2017;04;03;Maanantai;3;1;4;3;0;3
89;17.04.2017;2017;04;04;Maanantai;5;1;6;3;0;3
89;17.04.2017;2017;04;05;Maanantai;1;1;2;2;0;2
89;17.04.2017;2017;04;06;Maanantai;3;11;14;2;2;4
89;17.04.2017;2017;04;07;Maanantai;1;8;9;4;6;10
89;17.04.2017;2017;04;08;Maanantai;4;5;9;7;6;13
89;17.04.2017;2017;04;09;Maanantai;10;7;17;13;11;24
89;17.04.2017;2017;04;10;Maanantai;21;39;60;26;41;67
89;17.04.2017;2017;04;11;Maanantai;26;49;75;61;60;121
89;17.04.2017;2017;04;12;Maanantai;44;52;96;51;58;109
89;17.04.2017;2017;04;13;Maanantai;35;53;88;57;59;116
89;17.04.2017;2017;04;14;Maanantai;38;45;83;61;70;131
89;17.04.2017;2017;04;15;Maanantai;65;43;108;58;76;134
89;17.04.2017;2017;04;16;Maanantai;49;54;103;83;86;169
89;17.04.2017;2017;04;17;Maanantai;41;51;92;64;48;112
89;17.04.2017;2017;04;18;Maanantai;52;31;83;42;47;89
89;17.04.2017;2017;04;19;Maanantai;39;18;57;37;26;63
89;17.04.2017;2017;04;20;Maanantai;25;19;44;21;28;49
89;17.04.2017;2017;04;21;Maanantai;16;9;25;20;22;42
89;17.04.2017;2017;04;22;Maanantai;10;6;16;9;5;14
89;17.04.2017;2017;04;23;Maanantai;7;8;15;2;4;6
89;18.04.2017;2017;04;00;Tiistai;5;3;8;5;3;8
89;18.04.2017;2017;04;01;Tiistai;1;2;3;1;1;2
89;18.04.2017;2017;04;02;Tiistai;1;0;1;2;1;3
89;18.04.2017;2017;04;03;Tiistai;1;1;2;1;2;3
89;18.04.2017;2017;04;04;Tiistai;0;3;3;0;0;0
89;18.04.2017;2017;04;05;Tiistai;0;8;8;1;2;3
89;18.04.2017;2017;04;06;Tiistai;7;26;33;2;9;11
89;18.04.2017;2017;04;07;Tiistai;23;106;129;8;19;27
89;18.04.2017;2017;04;08;Tiistai;32;160;192;10;42;52
89;18.04.2017;2017;04;09;Tiistai;32;89;121;12;44;56
89;18.04.2017;2017;04;10;Tiistai;33;72;105;21;40;61
89;18.04.2017;2017;04;11;Tiistai;57;62;119;26;37;63
89;18.04.2017;2017;04;12;Tiistai;49;64;113;45;46;91
89;18.04.2017;2017;04;13;Tiistai;71;67;138;40;49;89
89;18.04.2017;2017;04;14;Tiistai;87;64;151;43;46;89
89;18.04.2017;2017;04;15;Tiistai;135;46;181;56;20;76
89;18.04.2017;2017;04;16;Tiistai;153;87;240;56;28;84
89;18.04.2017;2017;04;17;Tiistai;104;64;168;41;33;74
89;18.04.2017;2017;04;18;Tiistai;70;39;109;50;44;94
89;18.04.2017;2017;04;19;Tiistai;64;40;104;72;41;113
89;18.04.2017;2017;04;20;Tiistai;48;19;67;47;31;78
89;18.04.2017;2017;04;21;Tiistai;43;13;56;19;19;38
89;18.04.2017;2017;04;22;Tiistai;17;13;30;12;4;16
89;18.04.2017;2017;04;23;Tiistai;6;9;15;2;4;6
89;19.04.2017;2017;04;00;Keskiviikko;6;1;7;3;2;5
89;19.04.2017;2017;04;01;Keskiviikko;3;1;4;1;1;2
89;19.04.2017;2017;04;02;Keskiviikko;1;2;3;4;2;6
89;19.04.2017;2017;04;03;Keskiviikko;3;4;7;0;0;0
89;19.04.2017;2017;04;04;Keskiviikko;2;2;4;0;1;1
89;19.04.2017;2017;04;05;Keskiviikko;2;10;12;1;2;3
89;19.04.2017;2017;04;06;Keskiviikko;8;31;39;3;5;8
89;19.04.2017;2017;04;07;Keskiviikko;24;96;120;12;26;38
89;19.04.2017;2017;04;08;Keskiviikko;42;170;212;17;37;54
89;19.04.2017;2017;04;09;Keskiviikko;26;98;124;19;35;54
89;19.04.2017;2017;04;10;Keskiviikko;34;70;104;21;27;48
89;19.04.2017;2017;04;11;Keskiviikko;31;68;99;21;30;51
89;19.04.2017;2017;04;12;Keskiviikko;54;103;157;27;33;60
89;19.04.2017;2017;04;13;Keskiviikko;82;57;139;45;36;81
89;19.04.2017;2017;04;14;Keskiviikko;114;59;173;41;37;78
89;19.04.2017;2017;04;15;Keskiviikko;139;61;200;43;26;69
89;19.04.2017;2017;04;16;Keskiviikko;147;87;234;48;26;74
89;19.04.2017;2017;04;17;Keskiviikko;101;54;155;40;39;79
89;19.04.2017;2017;04;18;Keskiviikko;78;52;130;52;46;98
89;19.04.2017;2017;04;19;Keskiviikko;70;35;105;43;33;76
89;19.04.2017;2017;04;20;Keskiviikko;66;26;92;27;31;58
89;19.04.2017;2017;04;21;Keskiviikko;36;28;64;35;17;52
89;19.04.2017;2017;04;22;Keskiviikko;16;16;32;6;9;15
89;19.04.2017;2017;04;23;Keskiviikko;8;7;15;3;2;5
89;20.04.2017;2017;04;00;Torstai;9;5;14;1;2;3
89;20.04.2017;2017;04;01;Torstai;4;1;5;1;2;3
89;20.04.2017;2017;04;02;Torstai;3;1;4;1;0;1
89;20.04.2017;2017;04;03;Torstai;3;5;8;1;0;1
89;20.04.2017;2017;04;04;Torstai;6;1;7;0;0;0
89;20.04.2017;2017;04;05;Torstai;1;17;18;1;1;2
89;20.04.2017;2017;04;06;Torstai;6;30;36;3;11;14
89;20.04.2017;2017;04;07;Torstai;25;95;120;8;26;34
89;20.04.2017;2017;04;08;Torstai;39;140;179;12;39;51
89;20.04.2017;2017;04;09;Torstai;19;101;120;15;38;53
89;20.04.2017;2017;04;10;Torstai;37;68;105;18;28;46
89;20.04.2017;2017;04;11;Torstai;43;62;105;32;33;65
89;20.04.2017;2017;04;12;Torstai;51;50;101;30;36;66
89;20.04.2017;2017;04;13;Torstai;64;75;139;33;28;61
89;20.04.2017;2017;04;14;Torstai;75;41;116;27;27;54
89;20.04.2017;2017;04;15;Torstai;102;36;138;24;14;38
89;20.04.2017;2017;04;16;Torstai;122;43;165;15;13;28
89;20.04.2017;2017;04;17;Torstai;45;18;63;19;12;31
89;20.04.2017;2017;04;18;Torstai;54;22;76;18;8;26
89;20.04.2017;2017;04;19;Torstai;31;28;59;13;8;21
89;20.04.2017;2017;04;20;Torstai;27;16;43;24;15;39
89;20.04.2017;2017;04;21;Torstai;29;15;44;22;10;32
89;20.04.2017;2017;04;22;Torstai;16;18;34;10;8;18
89;20.04.2017;2017;04;23;Torstai;7;20;27;2;3;5
89;21.04.2017;2017;04;00;Perjantai;4;9;13;2;0;2
89;21.04.2017;2017;04;01;Perjantai;4;3;7;0;1;1
89;21.04.2017;2017;04;02;Perjantai;4;0;4;1;0;1
89;21.04.2017;2017;04;03;Perjantai;5;4;9;2;0;2
89;21.04.2017;2017;04;04;Perjantai;4;3;7;1;0;1
89;21.04.2017;2017;04;05;Perjantai;3;8;11;0;1;1
89;21.04.2017;2017;04;06;Perjantai;5;35;40;3;9;12
89;21.04.2017;2017;04;07;Perjantai;15;102;117;9;30;39
89;21.04.2017;2017;04;08;Perjantai;29;143;172;11;26;37
89;21.04.2017;2017;04;09;Perjantai;28;87;115;25;40;65
89;21.04.2017;2017;04;10;Perjantai;16;60;76;23;41;64
89;21.04.2017;2017;04;11;Perjantai;38;65;103;28;37;65
89;21.04.2017;2017;04;12;Perjantai;56;71;127;31;44;75
89;21.04.2017;2017;04;13;Perjantai;73;90;163;31;34;65
89;21.04.2017;2017;04;14;Perjantai;112;67;179;47;39;86
89;21.04.2017;2017;04;15;Perjantai;143;73;216;42;37;79
89;21.04.2017;2017;04;16;Perjantai;127;54;181;37;28;65
89;21.04.2017;2017;04;17;Perjantai;71;68;139;28;39;67
89;21.04.2017;2017;04;18;Perjantai;61;37;98;31;33;64
89;21.04.2017;2017;04;19;Perjantai;41;23;64;24;23;47
89;21.04.2017;2017;04;20;Perjantai;48;30;78;27;16;43
89;21.04.2017;2017;04;21;Perjantai;27;19;46;13;9;22
89;21.04.2017;2017;04;22;Perjantai;18;15;33;6;8;14
89;21.04.2017;2017;04;23;Perjantai;16;14;30;16;12;28
89;22.04.2017;2017;04;00;Lauantai;10;10;20;6;6;12
89;22.04.2017;2017;04;01;Lauantai;13;1;14;1;4;5
89;22.04.2017;2017;04;02;Lauantai;11;1;12;1;1;2
89;22.04.2017;2017;04;03;Lauantai;4;2;6;6;0;6
89;22.04.2017;2017;04;04;Lauantai;13;2;15;6;1;7
89;22.04.2017;2017;04;05;Lauantai;8;4;12;1;2;3
89;22.04.2017;2017;04;06;Lauantai;3;5;8;4;3;7
89;22.04.2017;2017;04;07;Lauantai;3;12;15;4;2;6
89;22.04.2017;2017;04;08;Lauantai;6;22;28;5;12;17
89;22.04.2017;2017;04;09;Lauantai;5;34;39;20;25;45
89;22.04.2017;2017;04;10;Lauantai;24;34;58;31;24;55
89;22.04.2017;2017;04;11;Lauantai;33;87;120;20;59;79
89;22.04.2017;2017;04;12;Lauantai;42;79;121;54;62;116
89;22.04.2017;2017;04;13;Lauantai;90;75;165;58;44;102
89;22.04.2017;2017;04;14;Lauantai;75;48;123;46;52;98
89;22.04.2017;2017;04;15;Lauantai;75;59;134;33;39;72
89;22.04.2017;2017;04;16;Lauantai;71;32;103;53;33;86
89;22.04.2017;2017;04;17;Lauantai;49;42;91;38;44;82
89;22.04.2017;2017;04;18;Lauantai;64;38;102;33;37;70
89;22.04.2017;2017;04;19;Lauantai;35;27;62;32;31;63
89;22.04.2017;2017;04;20;Lauantai;28;36;64;26;31;57
89;22.04.2017;2017;04;21;Lauantai;27;17;44;11;14;25
89;22.04.2017;2017;04;22;Lauantai;15;8;23;12;11;23
89;22.04.2017;2017;04;23;Lauantai;12;17;29;12;7;19
89;23.04.2017;2017;04;00;Sunnuntai;17;8;25;3;9;12
89;23.04.2017;2017;04;01;Sunnuntai;12;5;17;2;5;7
89;23.04.2017;2017;04;02;Sunnuntai;8;7;15;10;11;21
89;23.04.2017;2017;04;03;Sunnuntai;9;1;10;9;0;9
89;23.04.2017;2017;04;04;Sunnuntai;10;1;11;6;1;7
89;23.04.2017;2017;04;05;Sunnuntai;2;4;6;2;3;5
89;23.04.2017;2017;04;06;Sunnuntai;4;10;14;3;2;5
89;23.04.2017;2017;04;07;Sunnuntai;4;6;10;7;5;12
89;23.04.2017;2017;04;08;Sunnuntai;3;10;13;5;4;9
89;23.04.2017;2017;04;09;Sunnuntai;8;21;29;20;22;42
89;23.04.2017;2017;04;10;Sunnuntai;12;30;42;34;36;70
89;23.04.2017;2017;04;11;Sunnuntai;57;52;109;56;60;116
89;23.04.2017;2017;04;12;Sunnuntai;71;61;132;80;81;161
89;23.04.2017;2017;04;13;Sunnuntai;60;102;162;48;65;113
89;23.04.2017;2017;04;14;Sunnuntai;42;89;131;59;65;124
89;23.04.2017;2017;04;15;Sunnuntai;90;131;221;60;76;136
89;23.04.2017;2017;04;16;Sunnuntai;39;57;96;32;33;65
89;23.04.2017;2017;04;17;Sunnuntai;41;24;65;18;14;32
89;23.04.2017;2017;04;18;Sunnuntai;48;36;84;39;30;69
89;23.04.2017;2017;04;19;Sunnuntai;29;28;57;24;31;55
89;23.04.2017;2017;04;20;Sunnuntai;25;19;44;27;24;51
89;23.04.2017;2017;04;21;Sunnuntai;23;11;34;25;24;49
89;23.04.2017;2017;04;22;Sunnuntai;7;19;26;3;5;8
89;23.04.2017;2017;04;23;Sunnuntai;8;6;14;1;2;3
89;24.04.2017;2017;04;00;Maanantai;9;3;12;7;1;8
89;24.04.2017;2017;04;01;Maanantai;8;6;14;0;0;0
89;24.04.2017;2017;04;02;Maanantai;4;2;6;2;2;4
89;24.04.2017;2017;04;03;Maanantai;11;3;14;1;0;1
89;24.04.2017;2017;04;04;Maanantai;0;1;1;1;1;2
89;24.04.2017;2017;04;05;Maanantai;5;22;27;3;2;5
89;24.04.2017;2017;04;06;Maanantai;13;60;73;4;5;9
89;24.04.2017;2017;04;07;Maanantai;26;152;178;14;30;44
89;24.04.2017;2017;04;08;Maanantai;34;163;197;7;40;47
89;24.04.2017;2017;04;09;Maanantai;34;96;130;17;39;56
89;24.04.2017;2017;04;10;Maanantai;45;52;97;26;29;55
89;24.04.2017;2017;04;11;Maanantai;43;75;118;43;37;80
89;24.04.2017;2017;04;12;Maanantai;56;83;139;44;28;72
89;24.04.2017;2017;04;13;Maanantai;69;75;144;44;33;77
89;24.04.2017;2017;04;14;Maanantai;99;62;161;46;49;95
89;24.04.2017;2017;04;15;Maanantai;159;88;247;40;58;98
89;24.04.2017;2017;04;16;Maanantai;187;73;260;62;29;91
89;24.04.2017;2017;04;17;Maanantai;106;51;157;44;22;66
89;24.04.2017;2017;04;18;Maanantai;57;46;103;39;31;70
89;24.04.2017;2017;04;19;Maanantai;73;30;103;18;23;41
89;24.04.2017;2017;04;20;Maanantai;44;22;66;30;31;61
89;24.04.2017;2017;04;21;Maanantai;37;19;56;27;17;44
89;24.04.2017;2017;04;22;Maanantai;17;16;33;10;7;17
89;24.04.2017;2017;04;23;Maanantai;10;6;16;7;3;10
89;25.04.2017;2017;04;00;Tiistai;5;2;7;2;2;4
89;25.04.2017;2017;04;01;Tiistai;4;2;6;2;2;4
89;25.04.2017;2017;04;02;Tiistai;6;5;11;1;3;4
89;25.04.2017;2017;04;03;Tiistai;3;3;6;0;1;1
89;25.04.2017;2017;04;04;Tiistai;3;2;5;0;0;0
89;25.04.2017;2017;04;05;Tiistai;6;17;23;4;1;5
89;25.04.2017;2017;04;06;Tiistai;14;66;80;3;12;15
89;25.04.2017;2017;04;07;Tiistai;31;143;174;17;39;56
89;25.04.2017;2017;04;08;Tiistai;35;158;193;16;51;67
89;25.04.2017;2017;04;09;Tiistai;37;103;140;23;52;75
89;25.04.2017;2017;04;10;Tiistai;45;61;106;38;43;81
89;25.04.2017;2017;04;11;Tiistai;52;88;140;40;41;81
89;25.04.2017;2017;04;12;Tiistai;65;81;146;36;54;90
89;25.04.2017;2017;04;13;Tiistai;87;56;143;46;47;93
89;25.04.2017;2017;04;14;Tiistai;131;69;200;63;41;104
89;25.04.2017;2017;04;15;Tiistai;163;86;249;53;39;92
89;25.04.2017;2017;04;16;Tiistai;173;104;277;65;41;106
89;25.04.2017;2017;04;17;Tiistai;107;77;184;53;32;85
89;25.04.2017;2017;04;18;Tiistai;81;56;137;67;51;118
89;25.04.2017;2017;04;19;Tiistai;73;46;119;42;49;91
89;25.04.2017;2017;04;20;Tiistai;56;45;101;32;27;59
89;25.04.2017;2017;04;21;Tiistai;42;19;61;25;18;43
89;25.04.2017;2017;04;22;Tiistai;19;9;28;9;9;18
89;25.04.2017;2017;04;23;Tiistai;5;3;8;6;2;8
89;26.04.2017;2017;04;00;Keskiviikko;1;2;3;1;0;1
89;26.04.2017;2017;04;01;Keskiviikko;2;5;7;2;1;3
89;26.04.2017;2017;04;02;Keskiviikko;4;1;5;0;0;0
89;26.04.2017;2017;04;03;Keskiviikko;4;3;7;0;0;0
89;26.04.2017;2017;04;04;Keskiviikko;3;0;3;0;0;0
89;26.04.2017;2017;04;05;Keskiviikko;4;14;18;0;1;1
89;26.04.2017;2017;04;06;Keskiviikko;9;45;54;5;7;12
89;26.04.2017;2017;04;07;Keskiviikko;15;118;133;8;25;33
89;26.04.2017;2017;04;08;Keskiviikko;27;166;193;15;42;57
89;26.04.2017;2017;04;09;Keskiviikko;22;72;94;12;22;34
89;26.04.2017;2017;04;10;Keskiviikko;22;42;64;12;9;21
89;26.04.2017;2017;04;11;Keskiviikko;31;33;64;12;15;27
89;26.04.2017;2017;04;12;Keskiviikko;17;29;46;12;10;22
89;26.04.2017;2017;04;13;Keskiviikko;38;25;63;13;14;27
89;26.04.2017;2017;04;14;Keskiviikko;64;44;108;24;16;40
89;26.04.2017;2017;04;15;Keskiviikko;80;31;111;11;15;26
89;26.04.2017;2017;04;16;Keskiviikko;102;43;145;27;16;43
89;26.04.2017;2017;04;17;Keskiviikko;75;53;128;12;11;23
89;26.04.2017;2017;04;18;Keskiviikko;56;26;82;14;12;26
89;26.04.2017;2017;04;19;Keskiviikko;28;22;50;16;18;34
89;26.04.2017;2017;04;20;Keskiviikko;39;21;60;11;11;22
89;26.04.2017;2017;04;21;Keskiviikko;24;6;30;15;7;22
89;26.04.2017;2017;04;22;Keskiviikko;17;7;24;3;4;7
89;26.04.2017;2017;04;23;Keskiviikko;12;6;18;1;4;5
89;27.04.2017;2017;04;00;Torstai;2;2;4;2;2;4
89;27.04.2017;2017;04;01;Torstai;2;0;2;2;0;2
89;27.04.2017;2017;04;02;Torstai;2;1;3;3;0;3
89;27.04.2017;2017;04;03;Torstai;2;5;7;0;0;0
89;27.04.2017;2017;04;04;Torstai;2;0;2;2;0;2
89;27.04.2017;2017;04;05;Torstai;4;4;8;1;2;3
89;27.04.2017;2017;04;06;Torstai;7;35;42;4;7;11
89;27.04.2017;2017;04;07;Torstai;20;87;107;4;13;17
89;27.04.2017;2017;04;08;Torstai;22;145;167;12;38;50
89;27.04.2017;2017;04;09;Torstai;20;101;121;14;37;51
89;27.04.2017;2017;04;10;Torstai;34;44;78;21;23;44
89;27.04.2017;2017;04;11;Torstai;39;70;109;27;28;55
89;27.04.2017;2017;04;12;Torstai;40;60;100;22;24;46
89;27.04.2017;2017;04;13;Torstai;49;62;111;28;34;62
89;27.04.2017;2017;04;14;Torstai;72;66;138;37;34;71
89;27.04.2017;2017;04;15;Torstai;104;58;162;25;22;47
89;27.04.2017;2017;04;16;Torstai;131;70;201;23;20;43
89;27.04.2017;2017;04;17;Torstai;95;58;153;31;29;60
89;27.04.2017;2017;04;18;Torstai;77;62;139;38;30;68
89;27.04.2017;2017;04;19;Torstai;51;43;94;48;30;78
89;27.04.2017;2017;04;20;Torstai;68;34;102;30;29;59
89;27.04.2017;2017;04;21;Torstai;45;20;65;20;11;31
89;27.04.2017;2017;04;22;Torstai;21;15;36;14;8;22
89;27.04.2017;2017;04;23;Torstai;16;13;29;3;1;4
89;28.04.2017;2017;04;00;Perjantai;3;17;20;3;3;6
89;28.04.2017;2017;04;01;Perjantai;11;2;13;4;1;5
89;28.04.2017;2017;04;02;Perjantai;4;1;5;2;0;2
89;28.04.2017;2017;04;03;Perjantai;6;5;11;1;0;1
89;28.04.2017;2017;04;04;Perjantai;10;1;11;1;0;1
89;28.04.2017;2017;04;05;Perjantai;3;17;20;2;2;4
89;28.04.2017;2017;04;06;Perjantai;13;61;74;3;8;11
89;28.04.2017;2017;04;07;Perjantai;41;129;170;13;26;39
89;28.04.2017;2017;04;08;Perjantai;29;132;161;15;35;50
89;28.04.2017;2017;04;09;Perjantai;33;103;136;38;54;92
89;28.04.2017;2017;04;10;Perjantai;48;73;121;19;31;50
89;28.04.2017;2017;04;11;Perjantai;69;93;162;39;57;96
89;28.04.2017;2017;04;12;Perjantai;87;61;148;39;44;83
89;28.04.2017;2017;04;13;Perjantai;89;64;153;39;27;66
89;28.04.2017;2017;04;14;Perjantai;121;65;186;37;29;66
89;28.04.2017;2017;04;15;Perjantai;136;91;227;33;32;65
89;28.04.2017;2017;04;16;Perjantai;107;84;191;30;24;54
89;28.04.2017;2017;04;17;Perjantai;75;47;122;28;31;59
89;28.04.2017;2017;04;18;Perjantai;75;62;137;39;36;75
89;28.04.2017;2017;04;19;Perjantai;73;56;129;27;33;60
89;28.04.2017;2017;04;20;Perjantai;55;47;102;22;27;49
89;28.04.2017;2017;04;21;Perjantai;39;40;79;23;13;36
89;28.04.2017;2017;04;22;Perjantai;21;18;39;16;13;29
89;28.04.2017;2017;04;23;Perjantai;23;22;45;9;7;16
89;29.04.2017;2017;04;00;Lauantai;27;14;41;3;7;10
89;29.04.2017;2017;04;01;Lauantai;16;5;21;3;0;3
89;29.04.2017;2017;04;02;Lauantai;11;3;14;4;1;5
89;29.04.2017;2017;04;03;Lauantai;15;0;15;4;0;4
89;29.04.2017;2017;04;04;Lauantai;6;3;9;2;0;2
89;29.04.2017;2017;04;05;Lauantai;7;6;13;4;1;5
89;29.04.2017;2017;04;06;Lauantai;9;16;25;1;2;3
89;29.04.2017;2017;04;07;Lauantai;5;24;29;6;12;18
89;29.04.2017;2017;04;08;Lauantai;12;24;36;11;13;24
89;29.04.2017;2017;04;09;Lauantai;12;60;72;26;29;55
89;29.04.2017;2017;04;10;Lauantai;24;66;90;27;39;66
89;29.04.2017;2017;04;11;Lauantai;49;109;158;50;66;116
89;29.04.2017;2017;04;12;Lauantai;66;114;180;48;59;107
89;29.04.2017;2017;04;13;Lauantai;79;97;176;65;79;144
89;29.04.2017;2017;04;14;Lauantai;88;105;193;62;63;125
89;29.04.2017;2017;04;15;Lauantai;99;87;186;57;58;115
89;29.04.2017;2017;04;16;Lauantai;90;69;159;67;58;125
89;29.04.2017;2017;04;17;Lauantai;83;83;166;57;45;102
89;29.04.2017;2017;04;18;Lauantai;80;68;148;29;28;57
89;29.04.2017;2017;04;19;Lauantai;69;65;134;40;29;69
89;29.04.2017;2017;04;20;Lauantai;44;41;85;36;29;65
89;29.04.2017;2017;04;21;Lauantai;36;36;72;20;23;43
89;29.04.2017;2017;04;22;Lauantai;21;51;72;11;11;22
89;29.04.2017;2017;04;23;Lauantai;25;25;50;5;12;17
89;30.04.2017;2017;04;00;Sunnuntai;22;14;36;9;5;14
89;30.04.2017;2017;04;01;Sunnuntai;23;6;29;11;2;13
89;30.04.2017;2017;04;02;Sunnuntai;17;4;21;11;1;12
89;30.04.2017;2017;04;03;Sunnuntai;26;1;27;4;1;5
89;30.04.2017;2017;04;04;Sunnuntai;18;2;20;4;1;5
89;30.04.2017;2017;04;05;Sunnuntai;3;2;5;0;1;1
89;30.04.2017;2017;04;06;Sunnuntai;4;8;12;1;2;3
89;30.04.2017;2017;04;07;Sunnuntai;6;4;10;3;6;9
89;30.04.2017;2017;04;08;Sunnuntai;2;6;8;8;3;11
89;30.04.2017;2017;04;09;Sunnuntai;8;18;26;16;10;26
89;30.04.2017;2017;04;10;Sunnuntai;13;26;39;14;21;35
89;30.04.2017;2017;04;11;Sunnuntai;14;65;79;30;32;62
89;30.04.2017;2017;04;12;Sunnuntai;28;73;101;38;46;84
89;30.04.2017;2017;04;13;Sunnuntai;39;110;149;30;51;81
89;30.04.2017;2017;04;14;Sunnuntai;46;120;166;38;49;87
89;30.04.2017;2017;04;15;Sunnuntai;71;82;153;41;44;85
89;30.04.2017;2017;04;16;Sunnuntai;65;41;106;40;38;78
89;30.04.2017;2017;04;17;Sunnuntai;52;54;106;28;26;54
89;30.04.2017;2017;04;18;Sunnuntai;55;58;113;27;28;55
89;30.04.2017;2017;04;19;Sunnuntai;35;24;59;18;12;30
89;30.04.2017;2017;04;20;Sunnuntai;20;25;45;14;17;31
89;30.04.2017;2017;04;21;Sunnuntai;18;36;54;16;16;32
89;30.04.2017;2017;04;22;Sunnuntai;21;22;43;7;19;26
89;30.04.2017;2017;04;23;Sunnuntai;19;22;41;9;5;14
89;01.05.2017;2017;05;00;Maanantai;28;8;36;10;8;18
89;01.05.2017;2017;05;01;Maanantai;24;10;34;13;4;17
89;01.05.2017;2017;05;02;Maanantai;22;4;26;11;1;12
89;01.05.2017;2017;05;03;Maanantai;31;3;34;10;1;11
89;01.05.2017;2017;05;04;Maanantai;21;4;25;8;0;8
89;01.05.2017;2017;05;05;Maanantai;4;2;6;1;1;2
89;01.05.2017;2017;05;06;Maanantai;6;14;20;3;2;5
89;01.05.2017;2017;05;07;Maanantai;5;4;9;6;3;9
89;01.05.2017;2017;05;08;Maanantai;2;8;10;10;11;21
89;01.05.2017;2017;05;09;Maanantai;11;43;54;25;25;50
89;01.05.2017;2017;05;10;Maanantai;23;77;100;25;60;85
89;01.05.2017;2017;05;11;Maanantai;55;178;233;50;95;145
89;01.05.2017;2017;05;12;Maanantai;54;168;222;63;85;148
89;01.05.2017;2017;05;13;Maanantai;171;155;326;89;94;183
89;01.05.2017;2017;05;14;Maanantai;187;100;287;111;73;184
89;01.05.2017;2017;05;15;Maanantai;152;93;245;97;64;161
89;01.05.2017;2017;05;16;Maanantai;155;79;234;93;61;154
89;01.05.2017;2017;05;17;Maanantai;98;75;173;63;45;108
89;01.05.2017;2017;05;18;Maanantai;79;34;113;38;27;65
89;01.05.2017;2017;05;19;Maanantai;64;29;93;37;28;65
89;01.05.2017;2017;05;20;Maanantai;37;25;62;23;30;53
89;01.05.2017;2017;05;21;Maanantai;40;13;53;15;11;26
89;01.05.2017;2017;05;22;Maanantai;15;13;28;6;5;11
89;01.05.2017;2017;05;23;Maanantai;7;7;14;7;5;12
89;02.05.2017;2017;05;00;Tiistai;9;1;10;2;4;6
89;02.05.2017;2017;05;01;Tiistai;2;3;5;3;1;4
89;02.05.2017;2017;05;02;Tiistai;1;0;1;0;0;0
89;02.05.2017;2017;05;03;Tiistai;2;3;5;1;0;1
89;02.05.2017;2017;05;04;Tiistai;1;3;4;0;0;0
89;02.05.2017;2017;05;05;Tiistai;3;11;14;1;4;5
89;02.05.2017;2017;05;06;Tiistai;15;48;63;3;11;14
89;02.05.2017;2017;05;07;Tiistai;33;126;159;6;20;26
89;02.05.2017;2017;05;08;Tiistai;48;209;257;16;36;52
89;02.05.2017;2017;05;09;Tiistai;34;132;166;19;33;52
89;02.05.2017;2017;05;10;Tiistai;40;83;123;19;35;54
89;02.05.2017;2017;05;11;Tiistai;56;74;130;26;21;47
89;02.05.2017;2017;05;12;Tiistai;69;83;152;53;35;88
89;02.05.2017;2017;05;13;Tiistai;85;80;165;41;61;102
89;02.05.2017;2017;05;14;Tiistai;127;86;213;38;35;73
89;02.05.2017;2017;05;15;Tiistai;153;84;237;41;37;78
89;02.05.2017;2017;05;16;Tiistai;199;93;292;54;36;90
89;02.05.2017;2017;05;17;Tiistai;118;73;191;41;42;83
89;02.05.2017;2017;05;18;Tiistai;106;70;176;53;37;90
89;02.05.2017;2017;05;19;Tiistai;88;35;123;31;58;89
89;02.05.2017;2017;05;20;Tiistai;63;26;89;42;34;76
89;02.05.2017;2017;05;21;Tiistai;42;22;64;15;29;44
89;02.05.2017;2017;05;22;Tiistai;26;7;33;9;12;21
89;02.05.2017;2017;05;23;Tiistai;7;5;12;5;6;11
89;03.05.2017;2017;05;00;Keskiviikko;5;2;7;1;3;4
89;03.05.2017;2017;05;01;Keskiviikko;3;3;6;2;1;3
89;03.05.2017;2017;05;02;Keskiviikko;3;2;5;3;3;6
89;03.05.2017;2017;05;03;Keskiviikko;0;5;5;0;0;0
89;03.05.2017;2017;05;04;Keskiviikko;2;1;3;2;1;3
89;03.05.2017;2017;05;05;Keskiviikko;2;8;10;1;2;3
89;03.05.2017;2017;05;06;Keskiviikko;12;54;66;5;7;12
89;03.05.2017;2017;05;07;Keskiviikko;30;146;176;8;19;27
89;03.05.2017;2017;05;08;Keskiviikko;53;220;273;28;62;90
89;03.05.2017;2017;05;09;Keskiviikko;48;115;163;19;39;58
89;03.05.2017;2017;05;10;Keskiviikko;48;88;136;32;39;71
89;03.05.2017;2017;05;11;Keskiviikko;49;79;128;31;38;69
89;03.05.2017;2017;05;12;Keskiviikko;86;103;189;26;31;57
89;03.05.2017;2017;05;13;Keskiviikko;104;65;169;30;32;62
89;03.05.2017;2017;05;14;Keskiviikko;136;85;221;42;18;60
89;03.05.2017;2017;05;15;Keskiviikko;151;80;231;24;21;45
89;03.05.2017;2017;05;16;Keskiviikko;188;94;282;39;24;63
89;03.05.2017;2017;05;17;Keskiviikko;131;81;212;26;43;69
89;03.05.2017;2017;05;18;Keskiviikko;90;47;137;49;33;82
89;03.05.2017;2017;05;19;Keskiviikko;94;49;143;55;45;100
89;03.05.2017;2017;05;20;Keskiviikko;64;31;95;43;38;81
89;03.05.2017;2017;05;21;Keskiviikko;45;24;69;19;21;40
89;03.05.2017;2017;05;22;Keskiviikko;20;17;37;12;11;23
89;03.05.2017;2017;05;23;Keskiviikko;9;6;15;5;8;13
89;04.05.2017;2017;05;00;Torstai;6;3;9;0;0;0
89;04.05.2017;2017;05;01;Torstai;2;1;3;1;1;2
89;04.05.2017;2017;05;02;Torstai;2;0;2;1;0;1
89;04.05.2017;2017;05;03;Torstai;1;3;4;1;1;2
89;04.05.2017;2017;05;04;Torstai;2;3;5;2;1;3
89;04.05.2017;2017;05;05;Torstai;2;11;13;0;3;3
89;04.05.2017;2017;05;06;Torstai;16;75;91;6;7;13
89;04.05.2017;2017;05;07;Torstai;36;192;228;13;39;52
89;04.05.2017;2017;05;08;Torstai;32;218;250;16;42;58
89;04.05.2017;2017;05;09;Torstai;38;76;114;20;37;57
89;04.05.2017;2017;05;10;Torstai;56;75;131;31;38;69
89;04.05.2017;2017;05;11;Torstai;75;92;167;42;43;85
89;04.05.2017;2017;05;12;Torstai;85;83;168;41;36;77
89;04.05.2017;2017;05;13;Torstai;91;83;174;42;45;87
89;04.05.2017;2017;05;14;Torstai;134;78;212;40;27;67
89;04.05.2017;2017;05;15;Torstai;188;75;263;43;29;72
89;04.05.2017;2017;05;16;Torstai;201;103;304;49;37;86
89;04.05.2017;2017;05;17;Torstai;131;104;235;42;33;75
89;04.05.2017;2017;05;18;Torstai;90;71;161;51;54;105
89;04.05.2017;2017;05;19;Torstai;83;61;144;62;55;117
89;04.05.2017;2017;05;20;Torstai;67;28;95;33;23;56
89;04.05.2017;2017;05;21;Torstai;57;16;73;12;18;30
89;04.05.2017;2017;05;22;Torstai;37;7;44;10;7;17
89;04.05.2017;2017;05;23;Torstai;9;12;21;4;6;10
89;05.05.2017;2017;05;00;Perjantai;4;3;7;0;5;5
89;05.05.2017;2017;05;01;Perjantai;3;4;7;3;0;3
89;05.05.2017;2017;05;02;Perjantai;2;7;9;0;0;0
89;05.05.2017;2017;05;03;Perjantai;1;4;5;1;0;1
89;05.05.2017;2017;05;04;Perjantai;1;1;2;0;1;1
89;05.05.2017;2017;05;05;Perjantai;2;10;12;1;1;2
89;05.05.2017;2017;05;06;Perjantai;8;66;74;4;6;10
89;05.05.2017;2017;05;07;Perjantai;29;107;136;8;24;32
89;05.05.2017;2017;05;08;Perjantai;39;200;239;14;44;58
89;05.05.2017;2017;05;09;Perjantai;36;124;160;28;121;149
89;05.05.2017;2017;05;10;Perjantai;48;88;136;33;35;68
89;05.05.2017;2017;05;11;Perjantai;72;99;171;68;44;112
89;05.05.2017;2017;05;12;Perjantai;94;106;200;59;37;96
89;05.05.2017;2017;05;13;Perjantai;111;90;201;32;49;81
89;05.05.2017;2017;05;14;Perjantai;137;93;230;54;44;98
89;05.05.2017;2017;05;15;Perjantai;186;127;313;47;46;93
89;05.05.2017;2017;05;16;Perjantai;203;114;317;53;49;102
89;05.05.2017;2017;05;17;Perjantai;146;80;226;39;73;112
89;05.05.2017;2017;05;18;Perjantai;84;64;148;47;50;97
89;05.05.2017;2017;05;19;Perjantai;93;54;147;54;45;99
89;05.05.2017;2017;05;20;Perjantai;93;39;132;33;40;73
89;05.05.2017;2017;05;21;Perjantai;47;34;81;16;10;26
89;05.05.2017;2017;05;22;Perjantai;25;29;54;10;11;21
89;05.05.2017;2017;05;23;Perjantai;25;18;43;6;5;11
89;06.05.2017;2017;05;00;Lauantai;16;16;32;9;7;16
89;06.05.2017;2017;05;01;Lauantai;14;10;24;3;2;5
89;06.05.2017;2017;05;02;Lauantai;12;4;16;4;2;6
89;06.05.2017;2017;05;03;Lauantai;14;5;19;10;4;14
89;06.05.2017;2017;05;04;Lauantai;20;1;21;16;5;21
89;06.05.2017;2017;05;05;Lauantai;9;5;14;1;1;2
89;06.05.2017;2017;05;06;Lauantai;5;14;19;2;3;5
89;06.05.2017;2017;05;07;Lauantai;4;12;16;8;13;21
89;06.05.2017;2017;05;08;Lauantai;8;20;28;8;14;22
89;06.05.2017;2017;05;09;Lauantai;13;50;63;22;17;39
89;06.05.2017;2017;05;10;Lauantai;21;67;88;12;34;46
89;06.05.2017;2017;05;11;Lauantai;38;75;113;19;19;38
89;06.05.2017;2017;05;12;Lauantai;44;84;128;22;49;71
89;06.05.2017;2017;05;13;Lauantai;56;69;125;21;47;68
89;06.05.2017;2017;05;14;Lauantai;79;72;151;24;42;66
89;06.05.2017;2017;05;15;Lauantai;99;66;165;38;42;80
89;06.05.2017;2017;05;16;Lauantai;99;75;174;60;53;113
89;06.05.2017;2017;05;17;Lauantai;62;67;129;53;50;103
89;06.05.2017;2017;05;18;Lauantai;86;70;156;48;49;97
89;06.05.2017;2017;05;19;Lauantai;68;59;127;26;39;65
89;06.05.2017;2017;05;20;Lauantai;58;26;84;25;36;61
89;06.05.2017;2017;05;21;Lauantai;34;35;69;10;17;27
89;06.05.2017;2017;05;22;Lauantai;43;34;77;7;18;25
89;06.05.2017;2017;05;23;Lauantai;17;21;38;8;9;17
89;07.05.2017;2017;05;00;Sunnuntai;19;11;30;3;6;9
89;07.05.2017;2017;05;01;Sunnuntai;13;5;18;7;1;8
89;07.05.2017;2017;05;02;Sunnuntai;17;9;26;3;1;4
89;07.05.2017;2017;05;03;Sunnuntai;8;4;12;1;1;2
89;07.05.2017;2017;05;04;Sunnuntai;12;2;14;4;0;4
89;07.05.2017;2017;05;05;Sunnuntai;5;5;10;2;1;3
89;07.05.2017;2017;05;06;Sunnuntai;4;7;11;1;0;1
89;07.05.2017;2017;05;07;Sunnuntai;2;6;8;8;4;12
89;07.05.2017;2017;05;08;Sunnuntai;8;9;17;8;22;30
89;07.05.2017;2017;05;09;Sunnuntai;16;25;41;29;29;58
89;07.05.2017;2017;05;10;Sunnuntai;14;43;57;44;46;90
89;07.05.2017;2017;05;11;Sunnuntai;41;47;88;41;51;92
89;07.05.2017;2017;05;12;Sunnuntai;52;88;140;47;52;99
89;07.05.2017;2017;05;13;Sunnuntai;58;82;140;42;71;113
89;07.05.2017;2017;05;14;Sunnuntai;77;85;162;49;66;115
89;07.05.2017;2017;05;15;Sunnuntai;110;77;187;46;44;90
89;07.05.2017;2017;05;16;Sunnuntai;83;60;143;55;41;96
89;07.05.2017;2017;05;17;Sunnuntai;73;55;128;36;32;68
89;07.05.2017;2017;05;18;Sunnuntai;62;45;107;28;39;67
89;07.05.2017;2017;05;19;Sunnuntai;54;27;81;10;21;31
89;07.05.2017;2017;05;20;Sunnuntai;38;26;64;12;32;44
89;07.05.2017;2017;05;21;Sunnuntai;15;19;34;8;14;22
89;07.05.2017;2017;05;22;Sunnuntai;7;6;13;7;4;11
89;07.05.2017;2017;05;23;Sunnuntai;13;7;20;4;5;9
89;08.05.2017;2017;05;00;Maanantai;5;2;7;0;2;2
89;08.05.2017;2017;05;01;Maanantai;2;0;2;1;1;2
89;08.05.2017;2017;05;02;Maanantai;0;2;2;0;2;2
89;08.05.2017;2017;05;03;Maanantai;1;2;3;1;0;1
89;08.05.2017;2017;05;04;Maanantai;3;3;6;20;6;26
89;08.05.2017;2017;05;05;Maanantai;3;11;14;0;1;1
89;08.05.2017;2017;05;06;Maanantai;18;71;89;4;13;17
89;08.05.2017;2017;05;07;Maanantai;38;186;224;10;31;41
89;08.05.2017;2017;05;08;Maanantai;36;217;253;8;42;50
89;08.05.2017;2017;05;09;Maanantai;32;115;147;10;35;45
89;08.05.2017;2017;05;10;Maanantai;43;60;103;25;38;63
89;08.05.2017;2017;05;11;Maanantai;68;82;150;29;26;55
89;08.05.2017;2017;05;12;Maanantai;61;74;135;36;36;72
89;08.05.2017;2017;05;13;Maanantai;91;66;157;21;31;52
89;08.05.2017;2017;05;14;Maanantai;99;59;158;30;31;61
89;08.05.2017;2017;05;15;Maanantai;150;54;204;26;33;59
89;08.05.2017;2017;05;16;Maanantai;191;60;251;43;12;55
89;08.05.2017;2017;05;17;Maanantai;110;62;172;23;25;48
89;08.05.2017;2017;05;18;Maanantai;77;44;121;34;32;66
89;08.05.2017;2017;05;19;Maanantai;77;42;119;38;44;82
89;08.05.2017;2017;05;20;Maanantai;52;20;72;33;23;56
89;08.05.2017;2017;05;21;Maanantai;25;8;33;18;18;36
89;08.05.2017;2017;05;22;Maanantai;8;10;18;6;3;9
89;08.05.2017;2017;05;23;Maanantai;5;5;10;2;1;3
89;09.05.2017;2017;05;00;Tiistai;3;7;10;1;2;3
89;09.05.2017;2017;05;01;Tiistai;2;1;3;1;1;2
89;09.05.2017;2017;05;02;Tiistai;0;2;2;0;0;0
89;09.05.2017;2017;05;03;Tiistai;1;5;6;1;2;3
89;09.05.2017;2017;05;04;Tiistai;1;2;3;24;14;38
89;09.05.2017;2017;05;05;Tiistai;2;10;12;2;2;4
89;09.05.2017;2017;05;06;Tiistai;19;66;85;10;8;18
89;09.05.2017;2017;05;07;Tiistai;29;170;199;10;19;29
89;09.05.2017;2017;05;08;Tiistai;33;212;245;12;39;51
89;09.05.2017;2017;05;09;Tiistai;35;90;125;17;49;66
89;09.05.2017;2017;05;10;Tiistai;42;77;119;23;31;54
89;09.05.2017;2017;05;11;Tiistai;49;70;119;26;27;53
89;09.05.2017;2017;05;12;Tiistai;54;49;103;12;25;37
89;09.05.2017;2017;05;13;Tiistai;64;62;126;26;27;53
89;09.05.2017;2017;05;14;Tiistai;104;55;159;43;25;68
89;09.05.2017;2017;05;15;Tiistai;149;57;206;30;26;56
89;09.05.2017;2017;05;16;Tiistai;154;83;237;36;17;53
89;09.05.2017;2017;05;17;Tiistai;104;89;193;25;29;54
89;09.05.2017;2017;05;18;Tiistai;95;55;150;27;44;71
89;09.05.2017;2017;05;19;Tiistai;79;39;118;35;46;81
89;09.05.2017;2017;05;20;Tiistai;62;30;92;24;29;53
89;09.05.2017;2017;05;21;Tiistai;35;20;55;15;14;29
89;09.05.2017;2017;05;22;Tiistai;18;8;26;9;5;14
89;09.05.2017;2017;05;23;Tiistai;8;8;16;4;3;7
89;10.05.2017;2017;05;00;Keskiviikko;4;5;9;1;0;1
89;10.05.2017;2017;05;01;Keskiviikko;4;1;5;2;0;2
89;10.05.2017;2017;05;02;Keskiviikko;3;2;5;1;0;1
89;10.05.2017;2017;05;03;Keskiviikko;3;4;7;1;1;2
89;10.05.2017;2017;05;04;Keskiviikko;0;1;1;18;15;33
89;10.05.2017;2017;05;05;Keskiviikko;3;15;18;0;0;0
89;10.05.2017;2017;05;06;Keskiviikko;16;59;75;3;9;12
89;10.05.2017;2017;05;07;Keskiviikko;33;173;206;7;27;34
89;10.05.2017;2017;05;08;Keskiviikko;30;222;252;23;65;88
89;10.05.2017;2017;05;09;Keskiviikko;34;107;141;50;37;87
89;10.05.2017;2017;05;10;Keskiviikko;50;72;122;32;36;68
89;10.05.2017;2017;05;11;Keskiviikko;69;83;152;34;36;70
89;10.05.2017;2017;05;12;Keskiviikko;67;75;142;32;44;76
89;10.05.2017;2017;05;13;Keskiviikko;87;76;163;28;47;75
89;10.05.2017;2017;05;14;Keskiviikko;119;58;177;31;29;60
89;10.05.2017;2017;05;15;Keskiviikko;166;77;243;28;26;54
89;10.05.2017;2017;05;16;Keskiviikko;172;84;256;31;21;52
89;10.05.2017;2017;05;17;Keskiviikko;95;49;144;23;25;48
89;10.05.2017;2017;05;18;Keskiviikko;94;37;131;29;34;63
89;10.05.2017;2017;05;19;Keskiviikko;92;25;117;24;18;42
89;10.05.2017;2017;05;20;Keskiviikko;37;29;66;29;23;52
89;10.05.2017;2017;05;21;Keskiviikko;36;20;56;21;11;32
89;10.05.2017;2017;05;22;Keskiviikko;17;7;24;2;6;8
89;10.05.2017;2017;05;23;Keskiviikko;17;8;25;3;7;10
89;11.05.2017;2017;05;00;Torstai;6;5;11;2;3;5
89;11.05.2017;2017;05;01;Torstai;2;3;5;0;2;2
89;11.05.2017;2017;05;02;Torstai;5;2;7;2;2;4
89;11.05.2017;2017;05;03;Torstai;1;3;4;0;1;1
89;11.05.2017;2017;05;04;Torstai;3;3;6;1;0;1
89;11.05.2017;2017;05;05;Torstai;3;8;11;1;1;2
89;11.05.2017;2017;05;06;Torstai;17;65;82;6;4;10
89;11.05.2017;2017;05;07;Torstai;35;158;193;13;34;47
89;11.05.2017;2017;05;08;Torstai;35;213;248;15;43;58
89;11.05.2017;2017;05;09;Torstai;21;70;91;10;43;53
89;11.05.2017;2017;05;10;Torstai;40;50;90;28;25;53
89;11.05.2017;2017;05;11;Torstai;47;64;111;19;20;39
89;11.05.2017;2017;05;12;Torstai;50;56;106;18;28;46
89;11.05.2017;2017;05;13;Torstai;72;80;152;25;20;45
89;11.05.2017;2017;05;14;Torstai;112;72;184;21;24;45
89;11.05.2017;2017;05;15;Torstai;161;51;212;23;22;45
89;11.05.2017;2017;05;16;Torstai;160;79;239;23;19;42
89;11.05.2017;2017;05;17;Torstai;101;81;182;23;45;68
89;11.05.2017;2017;05;18;Torstai;89;57;146;59;53;112
89;11.05.2017;2017;05;19;Torstai;64;21;85;31;45;76
89;11.05.2017;2017;05;20;Torstai;69;31;100;23;31;54
89;11.05.2017;2017;05;21;Torstai;40;24;64;20;10;30
89;11.05.2017;2017;05;22;Torstai;12;22;34;7;4;11
89;11.05.2017;2017;05;23;Torstai;14;6;20;6;6;12
89;12.05.2017;2017;05;00;Perjantai;5;2;7;1;1;2
89;12.05.2017;2017;05;01;Perjantai;3;3;6;0;1;1
89;12.05.2017;2017;05;02;Perjantai;1;3;4;1;2;3
89;12.05.2017;2017;05;03;Perjantai;3;6;9;0;0;0
89;12.05.2017;2017;05;04;Perjantai;6;0;6;0;0;0
89;12.05.2017;2017;05;05;Perjantai;3;10;13;0;2;2
89;12.05.2017;2017;05;06;Perjantai;16;56;72;6;10;16
89;12.05.2017;2017;05;07;Perjantai;31;170;201;2;28;30
89;12.05.2017;2017;05;08;Perjantai;27;176;203;8;32;40
89;12.05.2017;2017;05;09;Perjantai;39;89;128;11;30;41
89;12.05.2017;2017;05;10;Perjantai;47;68;115;23;23;46
89;12.05.2017;2017;05;11;Perjantai;54;98;152;15;32;47
89;12.05.2017;2017;05;12;Perjantai;78;68;146;31;40;71
89;12.05.2017;2017;05;13;Perjantai;88;66;154;40;37;77
89;12.05.2017;2017;05;14;Perjantai;132;71;203;43;37;80
89;12.05.2017;2017;05;15;Perjantai;138;93;231;32;45;77
89;12.05.2017;2017;05;16;Perjantai;137;103;240;33;20;53
89;12.05.2017;2017;05;17;Perjantai;94;75;169;31;31;62
89;12.05.2017;2017;05;18;Perjantai;100;66;166;33;32;65
89;12.05.2017;2017;05;19;Perjantai;75;52;127;26;25;51
89;12.05.2017;2017;05;20;Perjantai;49;35;84;17;15;32
89;12.05.2017;2017;05;21;Perjantai;52;24;76;16;15;31
89;12.05.2017;2017;05;22;Perjantai;36;26;62;3;13;16
89;12.05.2017;2017;05;23;Perjantai;23;15;38;2;5;7
89;13.05.2017;2017;05;00;Lauantai;13;14;27;6;11;17
89;13.05.2017;2017;05;01;Lauantai;12;9;21;4;2;6
89;13.05.2017;2017;05;02;Lauantai;10;2;12;4;2;6
89;13.05.2017;2017;05;03;Lauantai;14;3;17;3;0;3
89;13.05.2017;2017;05;04;Lauantai;7;4;11;8;2;10
89;13.05.2017;2017;05;05;Lauantai;4;6;10;0;2;2
89;13.05.2017;2017;05;06;Lauantai;5;15;20;2;2;4
89;13.05.2017;2017;05;07;Lauantai;10;21;31;6;3;9
89;13.05.2017;2017;05;08;Lauantai;12;34;46;12;8;20
89;13.05.2017;2017;05;09;Lauantai;12;48;60;12;28;40
89;13.05.2017;2017;05;10;Lauantai;43;64;107;24;34;58
89;13.05.2017;2017;05;11;Lauantai;49;95;144;21;46;67
89;13.05.2017;2017;05;12;Lauantai;64;86;150;16;57;73
89;13.05.2017;2017;05;13;Lauantai;86;84;170;32;38;70
89;13.05.2017;2017;05;14;Lauantai;66;83;149;28;24;52
89;13.05.2017;2017;05;15;Lauantai;83;77;160;37;33;70
89;13.05.2017;2017;05;16;Lauantai;90;78;168;51;42;93
89;13.05.2017;2017;05;17;Lauantai;71;69;140;37;37;74
89;13.05.2017;2017;05;18;Lauantai;79;61;140;48;49;97
89;13.05.2017;2017;05;19;Lauantai;39;46;85;31;33;64
89;13.05.2017;2017;05;20;Lauantai;51;49;100;13;18;31
89;13.05.2017;2017;05;21;Lauantai;37;35;72;19;26;45
89;13.05.2017;2017;05;22;Lauantai;19;24;43;15;14;29
89;13.05.2017;2017;05;23;Lauantai;23;22;45;1;10;11
89;14.05.2017;2017;05;00;Sunnuntai;20;9;29;8;9;17
89;14.05.2017;2017;05;01;Sunnuntai;20;11;31;1;4;5
89;14.05.2017;2017;05;02;Sunnuntai;7;8;15;5;2;7
89;14.05.2017;2017;05;03;Sunnuntai;15;2;17;3;4;7
89;14.05.2017;2017;05;04;Sunnuntai;9;1;10;3;1;4
89;14.05.2017;2017;05;05;Sunnuntai;5;4;9;0;1;1
89;14.05.2017;2017;05;06;Sunnuntai;4;11;15;3;1;4
89;14.05.2017;2017;05;07;Sunnuntai;6;5;11;4;3;7
89;14.05.2017;2017;05;08;Sunnuntai;5;10;15;6;3;9
89;14.05.2017;2017;05;09;Sunnuntai;10;21;31;2;12;14
89;14.05.2017;2017;05;10;Sunnuntai;10;16;26;13;11;24
89;14.05.2017;2017;05;11;Sunnuntai;12;15;27;6;15;21
89;14.05.2017;2017;05;12;Sunnuntai;16;9;25;14;12;26
89;14.05.2017;2017;05;13;Sunnuntai;16;27;43;5;14;19
89;14.05.2017;2017;05;14;Sunnuntai;9;20;29;5;6;11
89;14.05.2017;2017;05;15;Sunnuntai;17;24;41;16;19;35
89;14.05.2017;2017;05;16;Sunnuntai;24;14;38;12;15;27
89;14.05.2017;2017;05;17;Sunnuntai;28;14;42;18;18;36
89;14.05.2017;2017;05;18;Sunnuntai;26;7;33;26;15;41
89;14.05.2017;2017;05;19;Sunnuntai;15;17;32;13;16;29
89;14.05.2017;2017;05;20;Sunnuntai;23;13;36;13;15;28
89;14.05.2017;2017;05;21;Sunnuntai;15;15;30;6;13;19
89;14.05.2017;2017;05;22;Sunnuntai;14;10;24;4;0;4
89;14.05.2017;2017;05;23;Sunnuntai;6;6;12;0;1;1
89;15.05.2017;2017;05;00;Maanantai;6;3;9;0;3;3
89;15.05.2017;2017;05;01;Maanantai;1;0;1;0;0;0
89;15.05.2017;2017;05;02;Maanantai;2;3;5;0;0;0
89;15.05.2017;2017;05;03;Maanantai;0;3;3;1;0;1
89;15.05.2017;2017;05;04;Maanantai;0;0;0;0;0;0
89;15.05.2017;2017;05;05;Maanantai;5;16;21;1;1;2
89;15.05.2017;2017;05;06;Maanantai;12;57;69;5;5;10
89;15.05.2017;2017;05;07;Maanantai;35;187;222;4;33;37
89;15.05.2017;2017;05;08;Maanantai;36;211;247;16;24;40
89;15.05.2017;2017;05;09;Maanantai;34;82;116;29;37;66
89;15.05.2017;2017;05;10;Maanantai;46;78;124;13;37;50
89;15.05.2017;2017;05;11;Maanantai;51;78;129;25;38;63
89;15.05.2017;2017;05;12;Maanantai;68;68;136;23;37;60
89;15.05.2017;2017;05;13;Maanantai;84;82;166;36;64;100
89;15.05.2017;2017;05;14;Maanantai;127;61;188;41;37;78
89;15.05.2017;2017;05;15;Maanantai;177;79;256;54;40;94
89;15.05.2017;2017;05;16;Maanantai;200;105;305;52;50;102
89;15.05.2017;2017;05;17;Maanantai;138;115;253;69;78;147
89;15.05.2017;2017;05;18;Maanantai;111;62;173;39;57;96
89;15.05.2017;2017;05;19;Maanantai;79;56;135;55;57;112
89;15.05.2017;2017;05;20;Maanantai;70;37;107;38;34;72
89;15.05.2017;2017;05;21;Maanantai;47;22;69;17;19;36
89;15.05.2017;2017;05;22;Maanantai;16;26;42;14;3;17
89;15.05.2017;2017;05;23;Maanantai;12;6;18;7;2;9
89;16.05.2017;2017;05;00;Tiistai;2;5;7;3;1;4
89;16.05.2017;2017;05;01;Tiistai;1;3;4;2;1;3
89;16.05.2017;2017;05;02;Tiistai;3;2;5;0;1;1
89;16.05.2017;2017;05;03;Tiistai;5;3;8;1;1;2
89;16.05.2017;2017;05;04;Tiistai;1;1;2;2;0;2
89;16.05.2017;2017;05;05;Tiistai;2;9;11;0;1;1
89;16.05.2017;2017;05;06;Tiistai;21;81;102;5;10;15
89;16.05.2017;2017;05;07;Tiistai;49;211;260;7;33;40
89;16.05.2017;2017;05;08;Tiistai;52;215;267;29;41;70
89;16.05.2017;2017;05;09;Tiistai;43;103;146;20;45;65
89;16.05.2017;2017;05;10;Tiistai;55;96;151;35;48;83
89;16.05.2017;2017;05;11;Tiistai;61;108;169;19;54;73
89;16.05.2017;2017;05;12;Tiistai;104;90;194;40;51;91
89;16.05.2017;2017;05;13;Tiistai;121;101;222;50;50;100
89;16.05.2017;2017;05;14;Tiistai;153;84;237;53;40;93
89;16.05.2017;2017;05;15;Tiistai;192;94;286;46;37;83
89;16.05.2017;2017;05;16;Tiistai;213;106;319;50;49;99
89;16.05.2017;2017;05;17;Tiistai;152;124;276;73;49;122
89;16.05.2017;2017;05;18;Tiistai;116;82;198;41;86;127
89;16.05.2017;2017;05;19;Tiistai;124;54;178;27;47;74
89;16.05.2017;2017;05;20;Tiistai;63;57;120;36;46;82
89;16.05.2017;2017;05;21;Tiistai;54;21;75;27;9;36
89;16.05.2017;2017;05;22;Tiistai;25;9;34;6;6;12
89;16.05.2017;2017;05;23;Tiistai;16;15;31;7;3;10
89;17.05.2017;2017;05;00;Keskiviikko;8;3;11;3;2;5
89;17.05.2017;2017;05;01;Keskiviikko;1;3;4;0;1;1
89;17.05.2017;2017;05;02;Keskiviikko;1;2;3;1;0;1
89;17.05.2017;2017;05;03;Keskiviikko;5;2;7;4;1;5
89;17.05.2017;2017;05;04;Keskiviikko;1;2;3;0;1;1
89;17.05.2017;2017;05;05;Keskiviikko;4;12;16;0;1;1
89;17.05.2017;2017;05;06;Keskiviikko;16;47;63;3;11;14
89;17.05.2017;2017;05;07;Keskiviikko;32;155;187;8;32;40
89;17.05.2017;2017;05;08;Keskiviikko;26;185;211;12;38;50
89;17.05.2017;2017;05;09;Keskiviikko;27;79;106;5;24;29
89;17.05.2017;2017;05;10;Keskiviikko;24;50;74;26;20;46
89;17.05.2017;2017;05;11;Keskiviikko;32;56;88;10;14;24
89;17.05.2017;2017;05;12;Keskiviikko;32;36;68;11;10;21
89;17.05.2017;2017;05;13;Keskiviikko;55;49;104;18;26;44
89;17.05.2017;2017;05;14;Keskiviikko;87;57;144;19;20;39
89;17.05.2017;2017;05;15;Keskiviikko;133;54;187;20;9;29
89;17.05.2017;2017;05;16;Keskiviikko;135;56;191;23;9;32
89;17.05.2017;2017;05;17;Keskiviikko;75;52;127;21;31;52
89;17.05.2017;2017;05;18;Keskiviikko;57;37;94;17;22;39
89;17.05.2017;2017;05;19;Keskiviikko;79;21;100;15;21;36
89;17.05.2017;2017;05;20;Keskiviikko;46;13;59;16;13;29
89;17.05.2017;2017;05;21;Keskiviikko;29;23;52;13;9;22
89;17.05.2017;2017;05;22;Keskiviikko;10;16;26;10;8;18
89;17.05.2017;2017;05;23;Keskiviikko;7;9;16;6;1;7
89;18.05.2017;2017;05;00;Torstai;5;3;8;1;3;4
89;18.05.2017;2017;05;01;Torstai;1;3;4;2;0;2
89;18.05.2017;2017;05;02;Torstai;3;1;4;2;0;2
89;18.05.2017;2017;05;03;Torstai;3;4;7;2;0;2
89;18.05.2017;2017;05;04;Torstai;0;4;4;0;1;1
89;18.05.2017;2017;05;05;Torstai;5;11;16;1;0;1
89;18.05.2017;2017;05;06;Torstai;17;73;90;7;9;16
89;18.05.2017;2017;05;07;Torstai;39;170;209;7;27;34
89;18.05.2017;2017;05;08;Torstai;37;191;228;25;30;55
89;18.05.2017;2017;05;09;Torstai;27;103;130;10;35;45
89;18.05.2017;2017;05;10;Torstai;38;91;129;17;28;45
89;18.05.2017;2017;05;11;Torstai;54;85;139;21;34;55
89;18.05.2017;2017;05;12;Torstai;60;85;145;23;42;65
89;18.05.2017;2017;05;13;Torstai;77;87;164;33;27;60
89;18.05.2017;2017;05;14;Torstai;99;75;174;36;22;58
89;18.05.2017;2017;05;15;Torstai;189;77;266;20;30;50
89;18.05.2017;2017;05;16;Torstai;201;83;284;39;27;66
89;18.05.2017;2017;05;17;Torstai;112;69;181;29;35;64
89;18.05.2017;2017;05;18;Torstai;67;45;112;45;33;78
89;18.05.2017;2017;05;19;Torstai;69;41;110;27;37;64
89;18.05.2017;2017;05;20;Torstai;75;48;123;30;37;67
89;18.05.2017;2017;05;21;Torstai;38;28;66;12;25;37
89;18.05.2017;2017;05;22;Torstai;14;8;22;14;10;24
89;18.05.2017;2017;05;23;Torstai;12;13;25;2;1;3
89;19.05.2017;2017;05;00;Perjantai;4;3;7;0;3;3
89;19.05.2017;2017;05;01;Perjantai;3;2;5;2;0;2
89;19.05.2017;2017;05;02;Perjantai;2;4;6;1;3;4
89;19.05.2017;2017;05;03;Perjantai;1;3;4;1;0;1
89;19.05.2017;2017;05;04;Perjantai;2;2;4;0;3;3
89;19.05.2017;2017;05;05;Perjantai;3;12;15;1;0;1
89;19.05.2017;2017;05;06;Perjantai;15;41;56;1;4;5
89;19.05.2017;2017;05;07;Perjantai;21;112;133;3;27;30
89;19.05.2017;2017;05;08;Perjantai;24;91;115;9;22;31
89;19.05.2017;2017;05;09;Perjantai;23;68;91;5;16;21
89;19.05.2017;2017;05;10;Perjantai;18;39;57;9;18;27
89;19.05.2017;2017;05;11;Perjantai;25;36;61;15;24;39
89;19.05.2017;2017;05;12;Perjantai;37;59;96;14;24;38
89;19.05.2017;2017;05;13;Perjantai;70;71;141;26;38;64
89;19.05.2017;2017;05;14;Perjantai;98;63;161;27;23;50
89;19.05.2017;2017;05;15;Perjantai;117;49;166;32;26;58
89;19.05.2017;2017;05;16;Perjantai;114;52;166;27;24;51
89;19.05.2017;2017;05;17;Perjantai;62;83;145;22;24;46
89;19.05.2017;2017;05;18;Perjantai;45;41;86;23;28;51
89;19.05.2017;2017;05;19;Perjantai;41;23;64;18;28;46
89;19.05.2017;2017;05;20;Perjantai;46;27;73;14;22;36
89;19.05.2017;2017;05;21;Perjantai;31;21;52;8;7;15
89;19.05.2017;2017;05;22;Perjantai;25;15;40;2;13;15
89;19.05.2017;2017;05;23;Perjantai;25;16;41;1;6;7
89;20.05.2017;2017;05;00;Lauantai;12;7;19;2;5;7
89;20.05.2017;2017;05;01;Lauantai;11;7;18;2;0;2
89;20.05.2017;2017;05;02;Lauantai;11;5;16;5;0;5
89;20.05.2017;2017;05;03;Lauantai;14;1;15;2;1;3
89;20.05.2017;2017;05;04;Lauantai;10;4;14;4;1;5
89;20.05.2017;2017;05;05;Lauantai;6;5;11;1;3;4
89;20.05.2017;2017;05;06;Lauantai;4;8;12;3;2;5
89;20.05.2017;2017;05;07;Lauantai;7;20;27;5;16;21
89;20.05.2017;2017;05;08;Lauantai;13;39;52;2;13;15
89;20.05.2017;2017;05;09;Lauantai;22;65;87;19;31;50
89;20.05.2017;2017;05;10;Lauantai;42;119;161;18;58;76
89;20.05.2017;2017;05;11;Lauantai;44;111;155;65;258;323
89;20.05.2017;2017;05;12;Lauantai;83;187;270;47;378;425
89;20.05.2017;2017;05;13;Lauantai;77;175;252;97;889;986
89;20.05.2017;2017;05;14;Lauantai;123;187;310;91;377;468
89;20.05.2017;2017;05;15;Lauantai;152;160;312;122;217;339
89;20.05.2017;2017;05;16;Lauantai;147;117;264;365;394;759
89;20.05.2017;2017;05;17;Lauantai;112;89;201;42;54;96
89;20.05.2017;2017;05;18;Lauantai;72;84;156;55;32;87
89;20.05.2017;2017;05;19;Lauantai;81;78;159;32;42;74
89;20.05.2017;2017;05;20;Lauantai;50;67;117;22;38;60
89;20.05.2017;2017;05;21;Lauantai;41;21;62;11;17;28
89;20.05.2017;2017;05;22;Lauantai;37;40;77;6;12;18
89;20.05.2017;2017;05;23;Lauantai;32;50;82;6;8;14
89;21.05.2017;2017;05;00;Sunnuntai;26;28;54;7;8;15
89;21.05.2017;2017;05;01;Sunnuntai;31;20;51;7;4;11
89;21.05.2017;2017;05;02;Sunnuntai;18;5;23;4;4;8
89;21.05.2017;2017;05;03;Sunnuntai;26;6;32;9;0;9
89;21.05.2017;2017;05;04;Sunnuntai;15;2;17;3;0;3
89;21.05.2017;2017;05;05;Sunnuntai;3;2;5;1;0;1
89;21.05.2017;2017;05;06;Sunnuntai;6;7;13;0;3;3
89;21.05.2017;2017;05;07;Sunnuntai;5;7;12;6;3;9
89;21.05.2017;2017;05;08;Sunnuntai;8;15;23;4;9;13
89;21.05.2017;2017;05;09;Sunnuntai;9;26;35;9;19;28
89;21.05.2017;2017;05;10;Sunnuntai;19;47;66;27;23;50
89;21.05.2017;2017;05;11;Sunnuntai;49;77;126;28;47;75
89;21.05.2017;2017;05;12;Sunnuntai;58;115;173;42;72;114
89;21.05.2017;2017;05;13;Sunnuntai;89;123;212;70;95;165
89;21.05.2017;2017;05;14;Sunnuntai;85;130;215;58;95;153
89;21.05.2017;2017;05;15;Sunnuntai;140;114;254;82;81;163
89;21.05.2017;2017;05;16;Sunnuntai;129;113;242;93;116;209
89;21.05.2017;2017;05;17;Sunnuntai;93;77;170;50;53;103
89;21.05.2017;2017;05;18;Sunnuntai;79;64;143;49;45;94
89;21.05.2017;2017;05;19;Sunnuntai;63;71;134;34;49;83
89;21.05.2017;2017;05;20;Sunnuntai;61;68;129;35;36;71
89;21.05.2017;2017;05;21;Sunnuntai;28;23;51;16;19;35
89;21.05.2017;2017;05;22;Sunnuntai;13;17;30;7;16;23
89;21.05.2017;2017;05;23;Sunnuntai;12;7;19;6;4;10
89;22.05.2017;2017;05;00;Maanantai;8;2;10;5;0;5
89;22.05.2017;2017;05;01;Maanantai;6;1;7;2;0;2
89;22.05.2017;2017;05;02;Maanantai;2;5;7;0;0;0
89;22.05.2017;2017;05;03;Maanantai;1;2;3;0;0;0
89;22.05.2017;2017;05;04;Maanantai;8;5;13;1;0;1
89;22.05.2017;2017;05;05;Maanantai;5;14;19;2;3;5
89;22.05.2017;2017;05;06;Maanantai;16;70;86;3;10;13
89;22.05.2017;2017;05;07;Maanantai;34;216;250;12;26;38
89;22.05.2017;2017;05;08;Maanantai;47;215;262;7;43;50
89;22.05.2017;2017;05;09;Maanantai;38;134;172;10;40;50
89;22.05.2017;2017;05;10;Maanantai;52;100;152;27;36;63
89;22.05.2017;2017;05;11;Maanantai;74;102;176;31;41;72
89;22.05.2017;2017;05;12;Maanantai;101;112;213;31;48;79
89;22.05.2017;2017;05;13;Maanantai;128;139;267;45;55;100
89;22.05.2017;2017;05;14;Maanantai;151;117;268;53;54;107
89;22.05.2017;2017;05;15;Maanantai;222;121;343;52;49;101
89;22.05.2017;2017;05;16;Maanantai;276;116;392;53;42;95
89;22.05.2017;2017;05;17;Maanantai;166;129;295;49;45;94
89;22.05.2017;2017;05;18;Maanantai;126;109;235;65;81;146
89;22.05.2017;2017;05;19;Maanantai;116;83;199;47;53;100
89;22.05.2017;2017;05;20;Maanantai;78;59;137;24;25;49
89;22.05.2017;2017;05;21;Maanantai;49;33;82;27;19;46
89;22.05.2017;2017;05;22;Maanantai;16;18;34;17;12;29
89;22.05.2017;2017;05;23;Maanantai;10;9;19;20;18;38
89;23.05.2017;2017;05;00;Tiistai;6;4;10;4;5;9
89;23.05.2017;2017;05;01;Tiistai;4;3;7;2;0;2
89;23.05.2017;2017;05;02;Tiistai;1;1;2;0;0;0
89;23.05.2017;2017;05;03;Tiistai;2;5;7;0;0;0
89;23.05.2017;2017;05;04;Tiistai;1;3;4;0;0;0
89;23.05.2017;2017;05;05;Tiistai;4;9;13;1;3;4
89;23.05.2017;2017;05;06;Tiistai;29;75;104;3;8;11
89;23.05.2017;2017;05;07;Tiistai;34;225;259;7;27;34
89;23.05.2017;2017;05;08;Tiistai;45;221;266;4;37;41
89;23.05.2017;2017;05;09;Tiistai;40;104;144;13;49;62
89;23.05.2017;2017;05;10;Tiistai;51;101;152;17;30;47
89;23.05.2017;2017;05;11;Tiistai;87;104;191;33;30;63
89;23.05.2017;2017;05;12;Tiistai;74;115;189;38;48;86
89;23.05.2017;2017;05;13;Tiistai;147;92;239;42;64;106
89;23.05.2017;2017;05;14;Tiistai;142;126;268;50;63;113
89;23.05.2017;2017;05;15;Tiistai;202;116;318;44;46;90
89;23.05.2017;2017;05;16;Tiistai;242;144;386;61;47;108
89;23.05.2017;2017;05;17;Tiistai;144;116;260;54;56;110
89;23.05.2017;2017;05;18;Tiistai;146;112;258;52;80;132
89;23.05.2017;2017;05;19;Tiistai;162;91;253;76;68;144
89;23.05.2017;2017;05;20;Tiistai;79;53;132;32;35;67
89;23.05.2017;2017;05;21;Tiistai;63;36;99;10;23;33
89;23.05.2017;2017;05;22;Tiistai;24;19;43;8;10;18
89;23.05.2017;2017;05;23;Tiistai;9;10;19;1;5;6
89;24.05.2017;2017;05;00;Keskiviikko;10;3;13;1;6;7
89;24.05.2017;2017;05;01;Keskiviikko;3;4;7;1;0;1
89;24.05.2017;2017;05;02;Keskiviikko;3;3;6;0;0;0
89;24.05.2017;2017;05;03;Keskiviikko;1;8;9;0;0;0
89;24.05.2017;2017;05;04;Keskiviikko;1;4;5;0;1;1
89;24.05.2017;2017;05;05;Keskiviikko;7;20;27;2;2;4
89;24.05.2017;2017;05;06;Keskiviikko;24;74;98;4;6;10
89;24.05.2017;2017;05;07;Keskiviikko;43;196;239;10;26;36
89;24.05.2017;2017;05;08;Keskiviikko;38;215;253;10;37;47
89;24.05.2017;2017;05;09;Keskiviikko;48;134;182;11;84;95
89;24.05.2017;2017;05;10;Keskiviikko;57;119;176;56;56;112
89;24.05.2017;2017;05;11;Keskiviikko;87;109;196;45;46;91
89;24.05.2017;2017;05;12;Keskiviikko;104;118;222;28;66;94
89;24.05.2017;2017;05;13;Keskiviikko;152;115;267;71;43;114
89;24.05.2017;2017;05;14;Keskiviikko;160;127;287;51;69;120
89;24.05.2017;2017;05;15;Keskiviikko;219;125;344;74;75;149
89;24.05.2017;2017;05;16;Keskiviikko;230;139;369;108;85;193
89;24.05.2017;2017;05;17;Keskiviikko;171;165;336;71;77;148
89;24.05.2017;2017;05;18;Keskiviikko;126;134;260;56;75;131
89;24.05.2017;2017;05;19;Keskiviikko;145;95;240;53;54;107
89;24.05.2017;2017;05;20;Keskiviikko;86;85;171;20;40;60
89;24.05.2017;2017;05;21;Keskiviikko;76;66;142;22;28;50
89;24.05.2017;2017;05;22;Keskiviikko;62;55;117;14;27;41
89;24.05.2017;2017;05;23;Keskiviikko;39;36;75;7;6;13
89;25.05.2017;2017;05;00;Torstai;37;14;51;5;7;12
89;25.05.2017;2017;05;01;Torstai;22;8;30;7;0;7
89;25.05.2017;2017;05;02;Torstai;23;6;29;5;0;5
89;25.05.2017;2017;05;03;Torstai;23;10;33;7;1;8
89;25.05.2017;2017;05;04;Torstai;14;6;20;4;1;5
89;25.05.2017;2017;05;05;Torstai;5;6;11;2;0;2
89;25.05.2017;2017;05;06;Torstai;7;18;25;2;3;5
89;25.05.2017;2017;05;07;Torstai;11;7;18;9;16;25
89;25.05.2017;2017;05;08;Torstai;17;25;42;10;15;25
89;25.05.2017;2017;05;09;Torstai;15;94;109;16;32;48
89;25.05.2017;2017;05;10;Torstai;52;87;139;24;37;61
89;25.05.2017;2017;05;11;Torstai;84;76;160;45;32;77
89;25.05.2017;2017;05;12;Torstai;71;100;171;18;47;65
89;25.05.2017;2017;05;13;Torstai;79;84;163;36;58;94
89;25.05.2017;2017;05;14;Torstai;77;82;159;16;39;55
89;25.05.2017;2017;05;15;Torstai;92;72;164;32;38;70
89;25.05.2017;2017;05;16;Torstai;109;106;215;42;71;113
89;25.05.2017;2017;05;17;Torstai;96;101;197;51;79;130
89;25.05.2017;2017;05;18;Torstai;91;91;182;59;55;114
89;25.05.2017;2017;05;19;Torstai;101;76;177;53;63;116
89;25.05.2017;2017;05;20;Torstai;62;50;112;31;43;74
89;25.05.2017;2017;05;21;Torstai;44;38;82;17;22;39
89;25.05.2017;2017;05;22;Torstai;25;25;50;11;9;20
89;25.05.2017;2017;05;23;Torstai;8;13;21;7;5;12
89;26.05.2017;2017;05;00;Perjantai;10;2;12;1;2;3
89;26.05.2017;2017;05;01;Perjantai;4;4;8;1;2;3
89;26.05.2017;2017;05;02;Perjantai;5;3;8;2;0;2
89;26.05.2017;2017;05;03;Perjantai;5;4;9;0;2;2
89;26.05.2017;2017;05;04;Perjantai;1;2;3;0;0;0
89;26.05.2017;2017;05;05;Perjantai;4;17;21;0;2;2
89;26.05.2017;2017;05;06;Perjantai;14;52;66;4;4;8
89;26.05.2017;2017;05;07;Perjantai;30;122;152;3;12;15
89;26.05.2017;2017;05;08;Perjantai;20;163;183;10;18;28
89;26.05.2017;2017;05;09;Perjantai;34;106;140;15;38;53
89;26.05.2017;2017;05;10;Perjantai;73;222;295;28;44;72
89;26.05.2017;2017;05;11;Perjantai;83;134;217;16;37;53
89;26.05.2017;2017;05;12;Perjantai;117;89;206;28;40;68
89;26.05.2017;2017;05;13;Perjantai;162;113;275;43;40;83
89;26.05.2017;2017;05;14;Perjantai;144;90;234;19;15;34
89;26.05.2017;2017;05;15;Perjantai;146;101;247;28;25;53
89;26.05.2017;2017;05;16;Perjantai;142;98;240;35;26;61
89;26.05.2017;2017;05;17;Perjantai;130;70;200;34;32;66
89;26.05.2017;2017;05;18;Perjantai;99;84;183;52;47;99
89;26.05.2017;2017;05;19;Perjantai;118;49;167;33;31;64
89;26.05.2017;2017;05;20;Perjantai;93;64;157;48;59;107
89;26.05.2017;2017;05;21;Perjantai;51;46;97;30;27;57
89;26.05.2017;2017;05;22;Perjantai;38;62;100;21;49;70
89;26.05.2017;2017;05;23;Perjantai;27;23;50;14;33;47
89;27.05.2017;2017;05;00;Lauantai;16;29;45;10;29;39
89;27.05.2017;2017;05;01;Lauantai;20;9;29;10;16;26
89;27.05.2017;2017;05;02;Lauantai;8;8;16;5;8;13
89;27.05.2017;2017;05;03;Lauantai;14;4;18;5;2;7
89;27.05.2017;2017;05;04;Lauantai;10;4;14;5;0;5
89;27.05.2017;2017;05;05;Lauantai;4;11;15;0;2;2
89;27.05.2017;2017;05;06;Lauantai;7;14;21;2;1;3
89;27.05.2017;2017;05;07;Lauantai;4;12;16;8;9;17
89;27.05.2017;2017;05;08;Lauantai;9;35;44;6;13;19
89;27.05.2017;2017;05;09;Lauantai;20;88;108;9;27;36
89;27.05.2017;2017;05;10;Lauantai;53;102;155;10;44;54
89;27.05.2017;2017;05;11;Lauantai;63;110;173;24;65;89
89;27.05.2017;2017;05;12;Lauantai;76;121;197;37;33;70
89;27.05.2017;2017;05;13;Lauantai;97;97;194;43;41;84
89;27.05.2017;2017;05;14;Lauantai;127;71;198;25;29;54
89;27.05.2017;2017;05;15;Lauantai;70;51;121;34;12;46
89;27.05.2017;2017;05;16;Lauantai;61;41;102;25;27;52
89;27.05.2017;2017;05;17;Lauantai;47;38;85;20;15;35
89;27.05.2017;2017;05;18;Lauantai;66;40;106;18;29;47
89;27.05.2017;2017;05;19;Lauantai;43;42;85;19;27;46
89;27.05.2017;2017;05;20;Lauantai;45;48;93;15;35;50
89;27.05.2017;2017;05;21;Lauantai;35;43;78;7;21;28
89;27.05.2017;2017;05;22;Lauantai;27;40;67;7;10;17
89;27.05.2017;2017;05;23;Lauantai;12;33;45;2;5;7
89;28.05.2017;2017;05;00;Sunnuntai;17;13;30;5;5;10
89;28.05.2017;2017;05;01;Sunnuntai;20;7;27;6;5;11
89;28.05.2017;2017;05;02;Sunnuntai;14;11;25;4;0;4
89;28.05.2017;2017;05;03;Sunnuntai;27;2;29;9;0;9
89;28.05.2017;2017;05;04;Sunnuntai;9;2;11;5;2;7
89;28.05.2017;2017;05;05;Sunnuntai;4;4;8;1;0;1
89;28.05.2017;2017;05;06;Sunnuntai;7;10;17;3;2;5
89;28.05.2017;2017;05;07;Sunnuntai;3;9;12;10;7;17
89;28.05.2017;2017;05;08;Sunnuntai;6;15;21;10;9;19
89;28.05.2017;2017;05;09;Sunnuntai;16;16;32;18;24;42
89;28.05.2017;2017;05;10;Sunnuntai;12;19;31;13;15;28
89;28.05.2017;2017;05;11;Sunnuntai;17;13;30;7;8;15
89;28.05.2017;2017;05;12;Sunnuntai;12;8;20;4;11;15
89;28.05.2017;2017;05;13;Sunnuntai;21;25;46;6;11;17
89;28.05.2017;2017;05;14;Sunnuntai;27;21;48;12;14;26
89;28.05.2017;2017;05;15;Sunnuntai;35;28;63;18;25;43
89;28.05.2017;2017;05;16;Sunnuntai;36;31;67;33;31;64
89;28.05.2017;2017;05;17;Sunnuntai;27;33;60;21;30;51
89;28.05.2017;2017;05;18;Sunnuntai;47;40;87;16;22;38
89;28.05.2017;2017;05;19;Sunnuntai;13;25;38;20;25;45
89;28.05.2017;2017;05;20;Sunnuntai;27;23;50;13;13;26
89;28.05.2017;2017;05;21;Sunnuntai;13;17;30;6;7;13
89;28.05.2017;2017;05;22;Sunnuntai;14;3;17;9;1;10
89;28.05.2017;2017;05;23;Sunnuntai;5;5;10;3;5;8
89;29.05.2017;2017;05;00;Maanantai;3;2;5;0;2;2
89;29.05.2017;2017;05;01;Maanantai;0;2;2;1;1;2
89;29.05.2017;2017;05;02;Maanantai;2;2;4;0;1;1
89;29.05.2017;2017;05;03;Maanantai;1;2;3;1;0;1
89;29.05.2017;2017;05;04;Maanantai;2;7;9;2;1;3
89;29.05.2017;2017;05;05;Maanantai;3;16;19;0;3;3
89;29.05.2017;2017;05;06;Maanantai;19;64;83;3;8;11
89;29.05.2017;2017;05;07;Maanantai;32;180;212;6;24;30
89;29.05.2017;2017;05;08;Maanantai;34;209;243;4;30;34
89;29.05.2017;2017;05;09;Maanantai;39;117;156;5;30;35
89;29.05.2017;2017;05;10;Maanantai;39;67;106;18;35;53
89;29.05.2017;2017;05;11;Maanantai;68;86;154;28;37;65
89;29.05.2017;2017;05;12;Maanantai;86;91;177;44;38;82
89;29.05.2017;2017;05;13;Maanantai;107;91;198;46;46;92
89;29.05.2017;2017;05;14;Maanantai;140;98;238;33;55;88
89;29.05.2017;2017;05;15;Maanantai;175;91;266;36;30;66
89;29.05.2017;2017;05;16;Maanantai;209;88;297;46;32;78
89;29.05.2017;2017;05;17;Maanantai;146;86;232;35;17;52
89;29.05.2017;2017;05;18;Maanantai;107;70;177;35;46;81
89;29.05.2017;2017;05;19;Maanantai;102;57;159;54;57;111
89;29.05.2017;2017;05;20;Maanantai;59;39;98;30;26;56
89;29.05.2017;2017;05;21;Maanantai;49;16;65;20;22;42
89;29.05.2017;2017;05;22;Maanantai;19;10;29;7;12;19
89;29.05.2017;2017;05;23;Maanantai;12;5;17;3;6;9
89;30.05.2017;2017;05;00;Tiistai;2;4;6;1;1;2
89;30.05.2017;2017;05;01;Tiistai;3;2;5;0;0;0
89;30.05.2017;2017;05;02;Tiistai;1;4;5;1;0;1
89;30.05.2017;2017;05;03;Tiistai;1;3;4;1;1;2
89;30.05.2017;2017;05;04;Tiistai;2;8;10;1;0;1
89;30.05.2017;2017;05;05;Tiistai;8;11;19;0;1;1
89;30.05.2017;2017;05;06;Tiistai;18;68;86;2;9;11
89;30.05.2017;2017;05;07;Tiistai;38;197;235;5;33;38
89;30.05.2017;2017;05;08;Tiistai;37;227;264;8;55;63
89;30.05.2017;2017;05;09;Tiistai;50;149;199;24;97;121
89;30.05.2017;2017;05;10;Tiistai;64;108;172;56;33;89
89;30.05.2017;2017;05;11;Tiistai;100;114;214;70;46;116
89;30.05.2017;2017;05;12;Tiistai;121;135;256;29;32;61
89;30.05.2017;2017;05;13;Tiistai;102;96;198;42;46;88
89;30.05.2017;2017;05;14;Tiistai;159;78;237;44;35;79
89;30.05.2017;2017;05;15;Tiistai;195;119;314;41;71;112
89;30.05.2017;2017;05;16;Tiistai;231;93;324;51;42;93
89;30.05.2017;2017;05;17;Tiistai;158;138;296;58;44;102
89;30.05.2017;2017;05;18;Tiistai;111;83;194;50;61;111
89;30.05.2017;2017;05;19;Tiistai;110;73;183;43;46;89
89;30.05.2017;2017;05;20;Tiistai;69;61;130;32;43;75
89;30.05.2017;2017;05;21;Tiistai;59;25;84;24;24;48
89;30.05.2017;2017;05;22;Tiistai;24;16;40;16;6;22
89;30.05.2017;2017;05;23;Tiistai;27;14;41;8;6;14
89;31.05.2017;2017;05;00;Keskiviikko;8;6;14;2;3;5
89;31.05.2017;2017;05;01;Keskiviikko;5;4;9;2;1;3
89;31.05.2017;2017;05;02;Keskiviikko;3;3;6;0;2;2
89;31.05.2017;2017;05;03;Keskiviikko;2;4;6;0;1;1
89;31.05.2017;2017;05;04;Keskiviikko;4;2;6;3;2;5
89;31.05.2017;2017;05;05;Keskiviikko;4;14;18;0;2;2
89;31.05.2017;2017;05;06;Keskiviikko;16;64;80;1;6;7
89;31.05.2017;2017;05;07;Keskiviikko;25;158;183;7;25;32
89;31.05.2017;2017;05;08;Keskiviikko;31;196;227;8;26;34
89;31.05.2017;2017;05;09;Keskiviikko;42;120;162;7;43;50
89;31.05.2017;2017;05;10;Keskiviikko;27;44;71;24;11;35
89;31.05.2017;2017;05;11;Keskiviikko;36;62;98;16;20;36
89;31.05.2017;2017;05;12;Keskiviikko;79;97;176;19;28;47
89;31.05.2017;2017;05;13;Keskiviikko;79;71;150;15;20;35
89;31.05.2017;2017;05;14;Keskiviikko;118;85;203;14;26;40
89;31.05.2017;2017;05;15;Keskiviikko;174;84;258;16;20;36
89;31.05.2017;2017;05;16;Keskiviikko;182;99;281;27;18;45
89;31.05.2017;2017;05;17;Keskiviikko;116;83;199;25;32;57
89;31.05.2017;2017;05;18;Keskiviikko;104;54;158;44;35;79
89;31.05.2017;2017;05;19;Keskiviikko;84;60;144;32;32;64
89;31.05.2017;2017;05;20;Keskiviikko;60;32;92;28;22;50
89;31.05.2017;2017;05;21;Keskiviikko;48;25;73;12;23;35
89;31.05.2017;2017;05;22;Keskiviikko;32;21;53;7;6;13
89;31.05.2017;2017;05;23;Keskiviikko;8;12;20;2;5;7
89;01.06.2017;2017;06;00;Torstai;4;7;11;1;2;3
89;01.06.2017;2017;06;01;Torstai;4;2;6;2;5;7
89;01.06.2017;2017;06;02;Torstai;4;3;7;1;0;1
89;01.06.2017;2017;06;03;Torstai;5;4;9;4;0;4
89;01.06.2017;2017;06;04;Torstai;6;4;10;1;0;1
89;01.06.2017;2017;06;05;Torstai;5;16;21;1;0;1
89;01.06.2017;2017;06;06;Torstai;25;76;101;2;6;8
89;01.06.2017;2017;06;07;Torstai;30;185;215;4;19;23
89;01.06.2017;2017;06;08;Torstai;38;217;255;11;37;48
89;01.06.2017;2017;06;09;Torstai;39;101;140;15;33;48
89;01.06.2017;2017;06;10;Torstai;56;74;130;48;54;102
89;01.06.2017;2017;06;11;Torstai;79;71;150;19;30;49
89;01.06.2017;2017;06;12;Torstai;62;63;125;21;9;30
89;01.06.2017;2017;06;13;Torstai;66;63;129;16;17;33
89;01.06.2017;2017;06;14;Torstai;91;55;146;23;15;38
89;01.06.2017;2017;06;15;Torstai;163;57;220;14;12;26
89;01.06.2017;2017;06;16;Torstai;173;76;249;23;18;41
89;01.06.2017;2017;06;17;Torstai;104;52;156;19;13;32
89;01.06.2017;2017;06;18;Torstai;84;46;130;29;26;55
89;01.06.2017;2017;06;19;Torstai;70;32;102;21;28;49
89;01.06.2017;2017;06;20;Torstai;42;36;78;21;17;38
89;01.06.2017;2017;06;21;Torstai;41;25;66;9;14;23
89;01.06.2017;2017;06;22;Torstai;17;9;26;3;4;7
89;01.06.2017;2017;06;23;Torstai;10;7;17;2;3;5
89;02.06.2017;2017;06;00;Perjantai;6;9;15;0;4;4
89;02.06.2017;2017;06;01;Perjantai;4;3;7;0;7;7
89;02.06.2017;2017;06;02;Perjantai;2;3;5;0;0;0
89;02.06.2017;2017;06;03;Perjantai;2;5;7;3;1;4
89;02.06.2017;2017;06;04;Perjantai;4;2;6;4;1;5
89;02.06.2017;2017;06;05;Perjantai;2;10;12;0;2;2
89;02.06.2017;2017;06;06;Perjantai;13;60;73;0;1;1
89;02.06.2017;2017;06;07;Perjantai;15;111;126;2;21;23
89;02.06.2017;2017;06;08;Perjantai;27;167;194;4;18;22
89;02.06.2017;2017;06;09;Perjantai;26;71;97;14;22;36
89;02.06.2017;2017;06;10;Perjantai;48;57;105;14;20;34
89;02.06.2017;2017;06;11;Perjantai;58;85;143;21;17;38
89;02.06.2017;2017;06;12;Perjantai;69;73;142;23;27;50
89;02.06.2017;2017;06;13;Perjantai;73;64;137;23;23;46
89;02.06.2017;2017;06;14;Perjantai;103;54;157;15;21;36
89;02.06.2017;2017;06;15;Perjantai;148;56;204;21;21;42
89;02.06.2017;2017;06;16;Perjantai;126;65;191;12;16;28
89;02.06.2017;2017;06;17;Perjantai;93;51;144;16;13;29
89;02.06.2017;2017;06;18;Perjantai;63;43;106;12;13;25
89;02.06.2017;2017;06;19;Perjantai;55;37;92;15;20;35
89;02.06.2017;2017;06;20;Perjantai;49;46;95;16;11;27
89;02.06.2017;2017;06;21;Perjantai;44;45;89;9;12;21
89;02.06.2017;2017;06;22;Perjantai;19;32;51;6;2;8
89;02.06.2017;2017;06;23;Perjantai;20;17;37;7;8;15
89;03.06.2017;2017;06;00;Lauantai;22;28;50;5;6;11
89;03.06.2017;2017;06;01;Lauantai;21;5;26;3;5;8
89;03.06.2017;2017;06;02;Lauantai;11;3;14;6;3;9
89;03.06.2017;2017;06;03;Lauantai;12;4;16;1;0;1
89;03.06.2017;2017;06;04;Lauantai;17;1;18;7;0;7
89;03.06.2017;2017;06;05;Lauantai;4;8;12;1;3;4
89;03.06.2017;2017;06;06;Lauantai;7;15;22;1;6;7
89;03.06.2017;2017;06;07;Lauantai;3;17;20;5;5;10
89;03.06.2017;2017;06;08;Lauantai;15;35;50;4;8;12
89;03.06.2017;2017;06;09;Lauantai;13;44;57;12;21;33
89;03.06.2017;2017;06;10;Lauantai;27;38;65;15;26;41
89;03.06.2017;2017;06;11;Lauantai;35;46;81;21;19;40
89;03.06.2017;2017;06;12;Lauantai;53;54;107;21;25;46
89;03.06.2017;2017;06;13;Lauantai;58;41;99;16;30;46
89;03.06.2017;2017;06;14;Lauantai;71;59;130;23;20;43
89;03.06.2017;2017;06;15;Lauantai;53;59;112;22;16;38
89;03.06.2017;2017;06;16;Lauantai;56;58;114;30;26;56
89;03.06.2017;2017;06;17;Lauantai;61;46;107;18;19;37
89;03.06.2017;2017;06;18;Lauantai;48;38;86;23;32;55
89;03.06.2017;2017;06;19;Lauantai;46;64;110;11;18;29
89;03.06.2017;2017;06;20;Lauantai;27;58;85;19;29;48
89;03.06.2017;2017;06;21;Lauantai;25;37;62;8;7;15
89;03.06.2017;2017;06;22;Lauantai;17;25;42;12;8;20
89;03.06.2017;2017;06;23;Lauantai;20;14;34;5;5;10
89;04.06.2017;2017;06;00;Sunnuntai;25;26;51;14;9;23
89;04.06.2017;2017;06;01;Sunnuntai;20;13;33;6;7;13
89;04.06.2017;2017;06;02;Sunnuntai;21;6;27;13;4;17
89;04.06.2017;2017;06;03;Sunnuntai;27;3;30;12;2;14
89;04.06.2017;2017;06;04;Sunnuntai;30;3;33;13;1;14
89;04.06.2017;2017;06;05;Sunnuntai;2;2;4;2;0;2
89;04.06.2017;2017;06;06;Sunnuntai;5;8;13;3;2;5
89;04.06.2017;2017;06;07;Sunnuntai;5;3;8;3;5;8
89;04.06.2017;2017;06;08;Sunnuntai;4;14;18;13;8;21
89;04.06.2017;2017;06;09;Sunnuntai;20;26;46;23;32;55
89;04.06.2017;2017;06;10;Sunnuntai;19;48;67;29;32;61
89;04.06.2017;2017;06;11;Sunnuntai;34;59;93;37;56;93
89;04.06.2017;2017;06;12;Sunnuntai;64;91;155;30;50;80
89;04.06.2017;2017;06;13;Sunnuntai;84;83;167;44;66;110
89;04.06.2017;2017;06;14;Sunnuntai;97;77;174;45;50;95
89;04.06.2017;2017;06;15;Sunnuntai;101;71;172;40;49;89
89;04.06.2017;2017;06;16;Sunnuntai;72;71;143;43;46;89
89;04.06.2017;2017;06;17;Sunnuntai;65;57;122;31;37;68
89;04.06.2017;2017;06;18;Sunnuntai;63;59;122;42;25;67
89;04.06.2017;2017;06;19;Sunnuntai;54;41;95;26;41;67
89;04.06.2017;2017;06;20;Sunnuntai;32;36;68;23;16;39
89;04.06.2017;2017;06;21;Sunnuntai;32;20;52;13;12;25
89;04.06.2017;2017;06;22;Sunnuntai;17;13;30;6;9;15
89;04.06.2017;2017;06;23;Sunnuntai;12;10;22;7;2;9
89;05.06.2017;2017;06;00;Maanantai;8;16;24;2;0;2
89;05.06.2017;2017;06;01;Maanantai;6;6;12;0;1;1
89;05.06.2017;2017;06;02;Maanantai;2;4;6;2;0;2
89;05.06.2017;2017;06;03;Maanantai;2;6;8;1;0;1
89;05.06.2017;2017;06;04;Maanantai;6;5;11;0;1;1
89;05.06.2017;2017;06;05;Maanantai;6;16;22;3;3;6
89;05.06.2017;2017;06;06;Maanantai;20;71;91;3;3;6
89;05.06.2017;2017;06;07;Maanantai;35;171;206;4;21;25
89;05.06.2017;2017;06;08;Maanantai;37;163;200;7;18;25
89;05.06.2017;2017;06;09;Maanantai;35;135;170;17;35;52
89;05.06.2017;2017;06;10;Maanantai;46;96;142;17;31;48
89;05.06.2017;2017;06;11;Maanantai;82;114;196;12;48;60
89;05.06.2017;2017;06;12;Maanantai;95;124;219;33;34;67
89;05.06.2017;2017;06;13;Maanantai;109;100;209;39;46;85
89;05.06.2017;2017;06;14;Maanantai;134;103;237;61;43;104
89;05.06.2017;2017;06;15;Maanantai;173;112;285;31;24;55
89;05.06.2017;2017;06;16;Maanantai;254;141;395;36;30;66
89;05.06.2017;2017;06;17;Maanantai;135;97;232;50;30;80
89;05.06.2017;2017;06;18;Maanantai;131;80;211;28;30;58
89;05.06.2017;2017;06;19;Maanantai;117;51;168;36;34;70
89;05.06.2017;2017;06;20;Maanantai;63;32;95;13;22;35
89;05.06.2017;2017;06;21;Maanantai;38;26;64;14;9;23
89;05.06.2017;2017;06;22;Maanantai;16;12;28;2;5;7
89;05.06.2017;2017;06;23;Maanantai;11;7;18;5;4;9
89;06.06.2017;2017;06;00;Tiistai;9;2;11;0;2;2
89;06.06.2017;2017;06;01;Tiistai;4;0;4;1;2;3
89;06.06.2017;2017;06;02;Tiistai;1;5;6;0;0;0
89;06.06.2017;2017;06;03;Tiistai;1;1;2;1;1;2
89;06.06.2017;2017;06;04;Tiistai;2;1;3;0;0;0
89;06.06.2017;2017;06;05;Tiistai;3;12;15;0;2;2
89;06.06.2017;2017;06;06;Tiistai;13;69;82;1;3;4
89;06.06.2017;2017;06;07;Tiistai;35;147;182;1;13;14
89;06.06.2017;2017;06;08;Tiistai;21;133;154;11;18;29
89;06.06.2017;2017;06;09;Tiistai;15;67;82;6;13;19
89;06.06.2017;2017;06;10;Tiistai;33;51;84;10;29;39
89;06.06.2017;2017;06;11;Tiistai;33;62;95;16;20;36
89;06.06.2017;2017;06;12;Tiistai;46;74;120;22;30;52
89;06.06.2017;2017;06;13;Tiistai;71;68;139;24;18;42
89;06.06.2017;2017;06;14;Tiistai;96;93;189;49;34;83
89;06.06.2017;2017;06;15;Tiistai;176;104;280;31;38;69
89;06.06.2017;2017;06;16;Tiistai;190;138;328;54;45;99
89;06.06.2017;2017;06;17;Tiistai;152;104;256;52;46;98
89;06.06.2017;2017;06;18;Tiistai;122;93;215;49;62;111
89;06.06.2017;2017;06;19;Tiistai;129;85;214;51;61;112
89;06.06.2017;2017;06;20;Tiistai;92;80;172;30;38;68
89;06.06.2017;2017;06;21;Tiistai;60;64;124;19;25;44
89;06.06.2017;2017;06;22;Tiistai;47;20;67;10;13;23
89;06.06.2017;2017;06;23;Tiistai;19;20;39;9;9;18
89;07.06.2017;2017;06;00;Keskiviikko;17;8;25;4;2;6
89;07.06.2017;2017;06;01;Keskiviikko;9;4;13;1;1;2
89;07.06.2017;2017;06;02;Keskiviikko;5;2;7;3;0;3
89;07.06.2017;2017;06;03;Keskiviikko;4;1;5;0;0;0
89;07.06.2017;2017;06;04;Keskiviikko;2;4;6;1;2;3
89;07.06.2017;2017;06;05;Keskiviikko;9;20;29;1;2;3
89;07.06.2017;2017;06;06;Keskiviikko;23;80;103;3;8;11
89;07.06.2017;2017;06;07;Keskiviikko;42;214;256;3;24;27
89;07.06.2017;2017;06;08;Keskiviikko;51;176;227;10;26;36
89;07.06.2017;2017;06;09;Keskiviikko;44;131;175;9;36;45
89;07.06.2017;2017;06;10;Keskiviikko;75;130;205;21;45;66
89;07.06.2017;2017;06;11;Keskiviikko;94;154;248;37;66;103
89;07.06.2017;2017;06;12;Keskiviikko;123;159;282;47;85;132
89;07.06.2017;2017;06;13;Keskiviikko;168;174;342;61;65;126
89;07.06.2017;2017;06;14;Keskiviikko;208;155;363;70;65;135
89;07.06.2017;2017;06;15;Keskiviikko;268;170;438;56;61;117
89;07.06.2017;2017;06;16;Keskiviikko;293;198;491;79;61;140
89;07.06.2017;2017;06;17;Keskiviikko;226;176;402;55;89;144
89;07.06.2017;2017;06;18;Keskiviikko;212;198;410;60;82;142
89;07.06.2017;2017;06;19;Keskiviikko;189;138;327;60;75;135
89;07.06.2017;2017;06;20;Keskiviikko;154;120;274;33;49;82
89;07.06.2017;2017;06;21;Keskiviikko;105;94;199;15;30;45
89;07.06.2017;2017;06;22;Keskiviikko;54;34;88;19;27;46
89;07.06.2017;2017;06;23;Keskiviikko;40;24;64;8;9;17
89;08.06.2017;2017;06;00;Torstai;23;14;37;13;7;20
89;08.06.2017;2017;06;01;Torstai;9;9;18;3;0;3
89;08.06.2017;2017;06;02;Torstai;6;6;12;8;3;11
89;08.06.2017;2017;06;03;Torstai;9;1;10;2;0;2
89;08.06.2017;2017;06;04;Torstai;5;2;7;3;0;3
89;08.06.2017;2017;06;05;Torstai;3;12;15;3;3;6
89;08.06.2017;2017;06;06;Torstai;25;90;115;4;6;10
89;08.06.2017;2017;06;07;Torstai;43;206;249;6;22;28
89;08.06.2017;2017;06;08;Torstai;44;174;218;6;30;36
89;08.06.2017;2017;06;09;Torstai;39;127;166;14;32;46
89;08.06.2017;2017;06;10;Torstai;73;117;190;25;39;64
89;08.06.2017;2017;06;11;Torstai;89;141;230;28;55;83
89;08.06.2017;2017;06;12;Torstai;137;157;294;41;71;112
89;08.06.2017;2017;06;13;Torstai;136;161;297;42;69;111
89;08.06.2017;2017;06;14;Torstai;194;163;357;69;66;135
89;08.06.2017;2017;06;15;Torstai;217;169;386;66;52;118
89;08.06.2017;2017;06;16;Torstai;259;169;428;67;58;125
89;08.06.2017;2017;06;17;Torstai;184;190;374;42;60;102
89;08.06.2017;2017;06;18;Torstai;158;144;302;37;56;93
89;08.06.2017;2017;06;19;Torstai;173;134;307;66;60;126
89;08.06.2017;2017;06;20;Torstai;153;83;236;45;55;100
89;08.06.2017;2017;06;21;Torstai;112;82;194;28;19;47
89;08.06.2017;2017;06;22;Torstai;63;30;93;15;20;35
89;08.06.2017;2017;06;23;Torstai;30;10;40;12;8;20
89;09.06.2017;2017;06;00;Perjantai;10;12;22;9;6;15
89;09.06.2017;2017;06;01;Perjantai;12;2;14;6;1;7
89;09.06.2017;2017;06;02;Perjantai;10;5;15;1;3;4
89;09.06.2017;2017;06;03;Perjantai;6;1;7;1;1;2
89;09.06.2017;2017;06;04;Perjantai;4;5;9;2;2;4
89;09.06.2017;2017;06;05;Perjantai;7;17;24;4;1;5
89;09.06.2017;2017;06;06;Perjantai;21;95;116;2;8;10
89;09.06.2017;2017;06;07;Perjantai;33;172;205;4;18;22
89;09.06.2017;2017;06;08;Perjantai;41;179;220;3;22;25
89;09.06.2017;2017;06;09;Perjantai;52;113;165;14;23;37
89;09.06.2017;2017;06;10;Perjantai;53;121;174;24;33;57
89;09.06.2017;2017;06;11;Perjantai;76;146;222;26;53;79
89;09.06.2017;2017;06;12;Perjantai;123;147;270;37;53;90
89;09.06.2017;2017;06;13;Perjantai;123;145;268;66;70;136
89;09.06.2017;2017;06;14;Perjantai;213;162;375;59;72;131
89;09.06.2017;2017;06;15;Perjantai;247;129;376;62;35;97
89;09.06.2017;2017;06;16;Perjantai;216;168;384;58;58;116
89;09.06.2017;2017;06;17;Perjantai;125;158;283;51;51;102
89;09.06.2017;2017;06;18;Perjantai;130;166;296;47;56;103
89;09.06.2017;2017;06;19;Perjantai;154;140;294;41;58;99
89;09.06.2017;2017;06;20;Perjantai;119;130;249;23;35;58
89;09.06.2017;2017;06;21;Perjantai;107;86;193;12;27;39
89;09.06.2017;2017;06;22;Perjantai;61;71;132;10;27;37
89;09.06.2017;2017;06;23;Perjantai;50;29;79;14;16;30
89;10.06.2017;2017;06;00;Lauantai;30;18;48;13;6;19
89;10.06.2017;2017;06;01;Lauantai;30;5;35;19;5;24
89;10.06.2017;2017;06;02;Lauantai;36;7;43;12;3;15
89;10.06.2017;2017;06;03;Lauantai;27;9;36;12;3;15
89;10.06.2017;2017;06;04;Lauantai;25;3;28;2;0;2
89;10.06.2017;2017;06;05;Lauantai;12;8;20;4;6;10
89;10.06.2017;2017;06;06;Lauantai;7;14;21;0;7;7
89;10.06.2017;2017;06;07;Lauantai;8;17;25;2;8;10
89;10.06.2017;2017;06;08;Lauantai;16;38;54;6;13;19
89;10.06.2017;2017;06;09;Lauantai;23;77;100;9;23;32
89;10.06.2017;2017;06;10;Lauantai;19;76;95;23;25;48
89;10.06.2017;2017;06;11;Lauantai;72;119;191;33;38;71
89;10.06.2017;2017;06;12;Lauantai;96;140;236;34;63;97
89;10.06.2017;2017;06;13;Lauantai;133;195;328;70;84;154
89;10.06.2017;2017;06;14;Lauantai;148;149;297;77;79;156
89;10.06.2017;2017;06;15;Lauantai;170;141;311;57;79;136
89;10.06.2017;2017;06;16;Lauantai;174;135;309;80;70;150
89;10.06.2017;2017;06;17;Lauantai;139;138;277;52;52;104
89;10.06.2017;2017;06;18;Lauantai;107;125;232;24;45;69
89;10.06.2017;2017;06;19;Lauantai;95;102;197;21;36;57
89;10.06.2017;2017;06;20;Lauantai;70;82;152;17;30;47
89;10.06.2017;2017;06;21;Lauantai;71;70;141;18;23;41
89;10.06.2017;2017;06;22;Lauantai;55;67;122;18;20;38
89;10.06.2017;2017;06;23;Lauantai;44;57;101;13;19;32
89;11.06.2017;2017;06;00;Sunnuntai;37;48;85;8;7;15
89;11.06.2017;2017;06;01;Sunnuntai;43;28;71;7;2;9
89;11.06.2017;2017;06;02;Sunnuntai;41;9;50;6;2;8
89;11.06.2017;2017;06;03;Sunnuntai;41;3;44;13;0;13
89;11.06.2017;2017;06;04;Sunnuntai;16;3;19;13;0;13
89;11.06.2017;2017;06;05;Sunnuntai;7;7;14;2;0;2
89;11.06.2017;2017;06;06;Sunnuntai;8;11;19;0;2;2
89;11.06.2017;2017;06;07;Sunnuntai;10;12;22;4;9;13
89;11.06.2017;2017;06;08;Sunnuntai;9;26;35;7;15;22
89;11.06.2017;2017;06;09;Sunnuntai;31;46;77;17;12;29
89;11.06.2017;2017;06;10;Sunnuntai;40;71;111;30;33;63
89;11.06.2017;2017;06;11;Sunnuntai;80;143;223;35;51;86
89;11.06.2017;2017;06;12;Sunnuntai;122;134;256;52;81;133
89;11.06.2017;2017;06;13;Sunnuntai;139;174;313;61;80;141
89;11.06.2017;2017;06;14;Sunnuntai;175;143;318;72;58;130
89;11.06.2017;2017;06;15;Sunnuntai;150;127;277;51;52;103
89;11.06.2017;2017;06;16;Sunnuntai;141;125;266;45;77;122
89;11.06.2017;2017;06;17;Sunnuntai;152;112;264;41;36;77
89;11.06.2017;2017;06;18;Sunnuntai;108;116;224;43;68;111
89;11.06.2017;2017;06;19;Sunnuntai;83;64;147;24;34;58
89;11.06.2017;2017;06;20;Sunnuntai;72;77;149;29;25;54
89;11.06.2017;2017;06;21;Sunnuntai;49;54;103;15;23;38
89;11.06.2017;2017;06;22;Sunnuntai;30;28;58;18;33;51
89;11.06.2017;2017;06;23;Sunnuntai;16;16;32;6;15;21
89;12.06.2017;2017;06;00;Maanantai;10;4;14;3;2;5
89;12.06.2017;2017;06;01;Maanantai;1;1;2;0;3;3
89;12.06.2017;2017;06;02;Maanantai;2;4;6;0;4;4
89;12.06.2017;2017;06;03;Maanantai;7;2;9;0;0;0
89;12.06.2017;2017;06;04;Maanantai;4;5;9;1;1;2
89;12.06.2017;2017;06;05;Maanantai;5;19;24;5;1;6
89;12.06.2017;2017;06;06;Maanantai;25;79;104;1;4;5
89;12.06.2017;2017;06;07;Maanantai;30;181;211;3;18;21
89;12.06.2017;2017;06;08;Maanantai;27;154;181;1;29;30
89;12.06.2017;2017;06;09;Maanantai;15;52;67;3;15;18
89;12.06.2017;2017;06;10;Maanantai;26;34;60;3;9;12
89;12.06.2017;2017;06;11;Maanantai;41;73;114;11;31;42
89;12.06.2017;2017;06;12;Maanantai;47;75;122;15;27;42
89;12.06.2017;2017;06;13;Maanantai;63;72;135;18;21;39
89;12.06.2017;2017;06;14;Maanantai;91;76;167;21;23;44
89;12.06.2017;2017;06;15;Maanantai;200;95;295;20;20;40
89;12.06.2017;2017;06;16;Maanantai;230;100;330;36;24;60
89;12.06.2017;2017;06;17;Maanantai;137;92;229;29;19;48
89;12.06.2017;2017;06;18;Maanantai;106;67;173;38;40;78
89;12.06.2017;2017;06;19;Maanantai;92;57;149;43;36;79
89;12.06.2017;2017;06;20;Maanantai;78;63;141;33;29;62
89;12.06.2017;2017;06;21;Maanantai;53;29;82;14;20;34
89;12.06.2017;2017;06;22;Maanantai;25;18;43;14;14;28
89;12.06.2017;2017;06;23;Maanantai;9;12;21;7;6;13
89;13.06.2017;2017;06;00;Tiistai;7;1;8;3;6;9
89;13.06.2017;2017;06;01;Tiistai;4;3;7;1;8;9
89;13.06.2017;2017;06;02;Tiistai;5;4;9;1;1;2
89;13.06.2017;2017;06;03;Tiistai;6;4;10;1;0;1
89;13.06.2017;2017;06;04;Tiistai;4;5;9;1;0;1
89;13.06.2017;2017;06;05;Tiistai;11;23;34;0;3;3
89;13.06.2017;2017;06;06;Tiistai;19;77;96;4;7;11
89;13.06.2017;2017;06;07;Tiistai;41;201;242;2;16;18
89;13.06.2017;2017;06;08;Tiistai;37;209;246;7;20;27
89;13.06.2017;2017;06;09;Tiistai;40;116;156;12;26;38
89;13.06.2017;2017;06;10;Tiistai;56;121;177;16;28;44
89;13.06.2017;2017;06;11;Tiistai;67;117;184;24;31;55
89;13.06.2017;2017;06;12;Tiistai;90;132;222;25;27;52
89;13.06.2017;2017;06;13;Tiistai;122;87;209;27;40;67
89;13.06.2017;2017;06;14;Tiistai;149;109;258;31;44;75
89;13.06.2017;2017;06;15;Tiistai;229;135;364;32;31;63
89;13.06.2017;2017;06;16;Tiistai;255;119;374;42;31;73
89;13.06.2017;2017;06;17;Tiistai;185;138;323;48;44;92
89;13.06.2017;2017;06;18;Tiistai;146;108;254;40;62;102
89;13.06.2017;2017;06;19;Tiistai;148;73;221;39;37;76
89;13.06.2017;2017;06;20;Tiistai;83;71;154;54;54;108
89;13.06.2017;2017;06;21;Tiistai;82;55;137;24;38;62
89;13.06.2017;2017;06;22;Tiistai;47;30;77;20;14;34
89;13.06.2017;2017;06;23;Tiistai;24;13;37;8;5;13
89;14.06.2017;2017;06;00;Keskiviikko;20;16;36;4;3;7
89;14.06.2017;2017;06;01;Keskiviikko;3;3;6;2;3;5
89;14.06.2017;2017;06;02;Keskiviikko;1;3;4;3;2;5
89;14.06.2017;2017;06;03;Keskiviikko;12;2;14;0;0;0
89;14.06.2017;2017;06;04;Keskiviikko;1;5;6;0;0;0
89;14.06.2017;2017;06;05;Keskiviikko;7;24;31;1;2;3
89;14.06.2017;2017;06;06;Keskiviikko;14;89;103;5;11;16
89;14.06.2017;2017;06;07;Keskiviikko;42;205;247;4;22;26
89;14.06.2017;2017;06;08;Keskiviikko;42;199;241;8;46;54
89;14.06.2017;2017;06;09;Keskiviikko;35;134;169;14;35;49
89;14.06.2017;2017;06;10;Keskiviikko;55;103;158;20;37;57
89;14.06.2017;2017;06;11;Keskiviikko;96;109;205;36;38;74
89;14.06.2017;2017;06;12;Keskiviikko;100;142;242;41;75;116
89;14.06.2017;2017;06;13;Keskiviikko;129;88;217;50;37;87
89;14.06.2017;2017;06;14;Keskiviikko;150;130;280;47;60;107
89;14.06.2017;2017;06;15;Keskiviikko;223;150;373;38;47;85
89;14.06.2017;2017;06;16;Keskiviikko;268;176;444;50;34;84
89;14.06.2017;2017;06;17;Keskiviikko;180;136;316;40;49;89
89;14.06.2017;2017;06;18;Keskiviikko;165;127;292;41;53;94
89;14.06.2017;2017;06;19;Keskiviikko;140;94;234;43;49;92
89;14.06.2017;2017;06;20;Keskiviikko;126;67;193;31;27;58
89;14.06.2017;2017;06;21;Keskiviikko;101;60;161;26;27;53
89;14.06.2017;2017;06;22;Keskiviikko;63;28;91;22;19;41
89;14.06.2017;2017;06;23;Keskiviikko;22;22;44;10;11;21
89;15.06.2017;2017;06;00;Torstai;21;15;36;12;11;23
89;15.06.2017;2017;06;01;Torstai;9;6;15;7;3;10
89;15.06.2017;2017;06;02;Torstai;8;10;18;1;4;5
89;15.06.2017;2017;06;03;Torstai;7;2;9;3;3;6
89;15.06.2017;2017;06;04;Torstai;4;6;10;3;1;4
89;15.06.2017;2017;06;05;Torstai;2;10;12;1;3;4
89;15.06.2017;2017;06;06;Torstai;26;98;124;1;9;10
89;15.06.2017;2017;06;07;Torstai;32;198;230;3;25;28
89;15.06.2017;2017;06;08;Torstai;53;208;261;13;30;43
89;15.06.2017;2017;06;09;Torstai;38;134;172;14;39;53
89;15.06.2017;2017;06;10;Torstai;74;113;187;25;42;67
89;15.06.2017;2017;06;11;Torstai;102;172;274;27;33;60
89;15.06.2017;2017;06;12;Torstai;113;156;269;32;58;90
89;15.06.2017;2017;06;13;Torstai;165;155;320;45;49;94
89;15.06.2017;2017;06;14;Torstai;201;158;359;59;52;111
89;15.06.2017;2017;06;15;Torstai;259;167;426;40;42;82
89;15.06.2017;2017;06;16;Torstai;275;197;472;56;54;110
89;15.06.2017;2017;06;17;Torstai;204;200;404;53;45;98
89;15.06.2017;2017;06;18;Torstai;204;163;367;48;61;109
89;15.06.2017;2017;06;19;Torstai;146;140;286;56;55;111
89;15.06.2017;2017;06;20;Torstai;150;105;255;51;48;99
89;15.06.2017;2017;06;21;Torstai;100;85;185;25;41;66
89;15.06.2017;2017;06;22;Torstai;59;33;92;9;12;21
89;15.06.2017;2017;06;23;Torstai;37;23;60;8;13;21
89;16.06.2017;2017;06;00;Perjantai;23;5;28;6;8;14
89;16.06.2017;2017;06;01;Perjantai;8;3;11;6;3;9
89;16.06.2017;2017;06;02;Perjantai;11;5;16;2;2;4
89;16.06.2017;2017;06;03;Perjantai;3;5;8;3;0;3
89;16.06.2017;2017;06;04;Perjantai;2;7;9;3;1;4
89;16.06.2017;2017;06;05;Perjantai;11;19;30;1;4;5
89;16.06.2017;2017;06;06;Perjantai;16;81;97;2;8;10
89;16.06.2017;2017;06;07;Perjantai;51;189;240;5;24;29
89;16.06.2017;2017;06;08;Perjantai;36;158;194;11;28;39
89;16.06.2017;2017;06;09;Perjantai;50;122;172;19;31;50
89;16.06.2017;2017;06;10;Perjantai;64;129;193;14;27;41
89;16.06.2017;2017;06;11;Perjantai;98;129;227;28;56;84
89;16.06.2017;2017;06;12;Perjantai;108;173;281;33;49;82
89;16.06.2017;2017;06;13;Perjantai;166;111;277;44;35;79
89;16.06.2017;2017;06;14;Perjantai;189;131;320;45;50;95
89;16.06.2017;2017;06;15;Perjantai;241;139;380;31;25;56
89;16.06.2017;2017;06;16;Perjantai;218;145;363;27;25;52
89;16.06.2017;2017;06;17;Perjantai;159;192;351;30;38;68
89;16.06.2017;2017;06;18;Perjantai;134;157;291;32;45;77
89;16.06.2017;2017;06;19;Perjantai;129;139;268;52;56;108
89;16.06.2017;2017;06;20;Perjantai;136;117;253;30;38;68
89;16.06.2017;2017;06;21;Perjantai;73;115;188;26;24;50
89;16.06.2017;2017;06;22;Perjantai;84;72;156;27;31;58
89;16.06.2017;2017;06;23;Perjantai;66;47;113;11;25;36
89;17.06.2017;2017;06;00;Lauantai;47;23;70;9;19;28
89;17.06.2017;2017;06;01;Lauantai;38;11;49;9;2;11
89;17.06.2017;2017;06;02;Lauantai;35;24;59;7;2;9
89;17.06.2017;2017;06;03;Lauantai;48;9;57;9;2;11
89;17.06.2017;2017;06;04;Lauantai;20;6;26;6;1;7
89;17.06.2017;2017;06;05;Lauantai;6;11;17;3;5;8
89;17.06.2017;2017;06;06;Lauantai;12;18;30;4;3;7
89;17.06.2017;2017;06;07;Lauantai;6;20;26;4;5;9
89;17.06.2017;2017;06;08;Lauantai;13;43;56;11;14;25
89;17.06.2017;2017;06;09;Lauantai;39;73;112;14;22;36
89;17.06.2017;2017;06;10;Lauantai;56;126;182;28;38;66
89;17.06.2017;2017;06;11;Lauantai;81;176;257;37;53;90
89;17.06.2017;2017;06;12;Lauantai;138;162;300;32;41;73
89;17.06.2017;2017;06;13;Lauantai;184;175;359;35;54;89
89;17.06.2017;2017;06;14;Lauantai;195;156;351;41;53;94
89;17.06.2017;2017;06;15;Lauantai;187;170;357;50;50;100
89;17.06.2017;2017;06;16;Lauantai;164;171;335;33;32;65
89;17.06.2017;2017;06;17;Lauantai;161;98;259;31;40;71
89;17.06.2017;2017;06;18;Lauantai;104;112;216;24;53;77
89;17.06.2017;2017;06;19;Lauantai;117;105;222;27;28;55
89;17.06.2017;2017;06;20;Lauantai;64;99;163;20;22;42
89;17.06.2017;2017;06;21;Lauantai;74;56;130;22;36;58
89;17.06.2017;2017;06;22;Lauantai;35;81;116;14;19;33
89;17.06.2017;2017;06;23;Lauantai;45;154;199;10;15;25
89;18.06.2017;2017;06;00;Sunnuntai;34;30;64;6;9;15
89;18.06.2017;2017;06;01;Sunnuntai;30;27;57;4;7;11
89;18.06.2017;2017;06;02;Sunnuntai;40;15;55;8;7;15
89;18.06.2017;2017;06;03;Sunnuntai;38;6;44;9;0;9
89;18.06.2017;2017;06;04;Sunnuntai;21;3;24;2;2;4
89;18.06.2017;2017;06;05;Sunnuntai;4;5;9;3;0;3
89;18.06.2017;2017;06;06;Sunnuntai;9;11;20;2;4;6
89;18.06.2017;2017;06;07;Sunnuntai;6;6;12;3;0;3
89;18.06.2017;2017;06;08;Sunnuntai;4;14;18;1;6;7
89;18.06.2017;2017;06;09;Sunnuntai;9;12;21;8;3;11
89;18.06.2017;2017;06;10;Sunnuntai;8;21;29;7;6;13
89;18.06.2017;2017;06;11;Sunnuntai;11;42;53;6;13;19
89;18.06.2017;2017;06;12;Sunnuntai;31;63;94;20;26;46
89;18.06.2017;2017;06;13;Sunnuntai;49;96;145;22;50;72
89;18.06.2017;2017;06;14;Sunnuntai;75;117;192;31;41;72
89;18.06.2017;2017;06;15;Sunnuntai;99;134;233;45;44;89
89;18.06.2017;2017;06;16;Sunnuntai;113;72;185;39;31;70
89;18.06.2017;2017;06;17;Sunnuntai;95;67;162;43;34;77
89;18.06.2017;2017;06;18;Sunnuntai;74;47;121;28;32;60
89;18.06.2017;2017;06;19;Sunnuntai;55;48;103;32;29;61
89;18.06.2017;2017;06;20;Sunnuntai;40;36;76;20;28;48
89;18.06.2017;2017;06;21;Sunnuntai;47;37;84;19;20;39
89;18.06.2017;2017;06;22;Sunnuntai;11;11;22;13;12;25
89;18.06.2017;2017;06;23;Sunnuntai;21;25;46;6;4;10
89;19.06.2017;2017;06;00;Maanantai;9;9;18;6;6;12
89;19.06.2017;2017;06;01;Maanantai;8;3;11;0;3;3
89;19.06.2017;2017;06;02;Maanantai;9;3;12;5;2;7
89;19.06.2017;2017;06;03;Maanantai;6;2;8;3;0;3
89;19.06.2017;2017;06;04;Maanantai;5;3;8;5;0;5
89;19.06.2017;2017;06;05;Maanantai;9;22;31;1;3;4
89;19.06.2017;2017;06;06;Maanantai;15;73;88;4;6;10
89;19.06.2017;2017;06;07;Maanantai;33;197;230;2;18;20
89;19.06.2017;2017;06;08;Maanantai;42;166;208;2;26;28
89;19.06.2017;2017;06;09;Maanantai;34;122;156;10;27;37
89;19.06.2017;2017;06;10;Maanantai;62;120;182;12;43;55
89;19.06.2017;2017;06;11;Maanantai;88;135;223;56;83;139
89;19.06.2017;2017;06;12;Maanantai;107;99;206;43;33;76
89;19.06.2017;2017;06;13;Maanantai;113;100;213;37;30;67
89;19.06.2017;2017;06;14;Maanantai;162;102;264;41;25;66
89;19.06.2017;2017;06;15;Maanantai;200;106;306;42;27;69
89;19.06.2017;2017;06;16;Maanantai;230;145;375;46;35;81
89;19.06.2017;2017;06;17;Maanantai;156;137;293;48;44;92
89;19.06.2017;2017;06;18;Maanantai;139;90;229;48;43;91
89;19.06.2017;2017;06;19;Maanantai;127;76;203;38;40;78
89;19.06.2017;2017;06;20;Maanantai;117;63;180;42;32;74
89;19.06.2017;2017;06;21;Maanantai;71;57;128;13;28;41
89;19.06.2017;2017;06;22;Maanantai;40;23;63;9;11;20
89;19.06.2017;2017;06;23;Maanantai;20;14;34;9;7;16
89;20.06.2017;2017;06;00;Tiistai;8;3;11;3;6;9
89;20.06.2017;2017;06;01;Tiistai;3;8;11;4;3;7
89;20.06.2017;2017;06;02;Tiistai;3;6;9;4;3;7
89;20.06.2017;2017;06;03;Tiistai;2;2;4;1;1;2
89;20.06.2017;2017;06;04;Tiistai;2;9;11;0;1;1
89;20.06.2017;2017;06;05;Tiistai;5;18;23;1;6;7
89;20.06.2017;2017;06;06;Tiistai;17;89;106;2;5;7
89;20.06.2017;2017;06;07;Tiistai;43;200;243;2;24;26
89;20.06.2017;2017;06;08;Tiistai;48;169;217;9;23;32
89;20.06.2017;2017;06;09;Tiistai;40;120;160;12;27;39
89;20.06.2017;2017;06;10;Tiistai;53;92;145;17;32;49
89;20.06.2017;2017;06;11;Tiistai;105;140;245;29;27;56
89;20.06.2017;2017;06;12;Tiistai;104;157;261;35;51;86
89;20.06.2017;2017;06;13;Tiistai;118;119;237;34;29;63
89;20.06.2017;2017;06;14;Tiistai;165;133;298;38;46;84
89;20.06.2017;2017;06;15;Tiistai;199;109;308;42;25;67
89;20.06.2017;2017;06;16;Tiistai;246;141;387;48;31;79
89;20.06.2017;2017;06;17;Tiistai;191;139;330;41;34;75
89;20.06.2017;2017;06;18;Tiistai;171;126;297;40;41;81
89;20.06.2017;2017;06;19;Tiistai;152;100;252;39;42;81
89;20.06.2017;2017;06;20;Tiistai;111;64;175;28;34;62
89;20.06.2017;2017;06;21;Tiistai;71;45;116;33;25;58
89;20.06.2017;2017;06;22;Tiistai;37;33;70;8;10;18
89;20.06.2017;2017;06;23;Tiistai;22;17;39;8;3;11
89;21.06.2017;2017;06;00;Keskiviikko;10;14;24;1;6;7
89;21.06.2017;2017;06;01;Keskiviikko;11;5;16;4;2;6
89;21.06.2017;2017;06;02;Keskiviikko;3;4;7;4;3;7
89;21.06.2017;2017;06;03;Keskiviikko;4;3;7;3;1;4
89;21.06.2017;2017;06;04;Keskiviikko;5;6;11;0;0;0
89;21.06.2017;2017;06;05;Keskiviikko;5;20;25;1;2;3
89;21.06.2017;2017;06;06;Keskiviikko;15;73;88;8;6;14
89;21.06.2017;2017;06;07;Keskiviikko;26;173;199;4;36;40
89;21.06.2017;2017;06;08;Keskiviikko;41;167;208;2;27;29
89;21.06.2017;2017;06;09;Keskiviikko;29;92;121;5;21;26
89;21.06.2017;2017;06;10;Keskiviikko;36;89;125;11;25;36
89;21.06.2017;2017;06;11;Keskiviikko;62;120;182;19;31;50
89;21.06.2017;2017;06;12;Keskiviikko;76;80;156;27;24;51
89;21.06.2017;2017;06;13;Keskiviikko;96;66;162;23;16;39
89;21.06.2017;2017;06;14;Keskiviikko;124;85;209;13;8;21
89;21.06.2017;2017;06;15;Keskiviikko;157;84;241;8;17;25
89;21.06.2017;2017;06;16;Keskiviikko;191;91;282;23;23;46
89;21.06.2017;2017;06;17;Keskiviikko;118;81;199;20;22;42
89;21.06.2017;2017;06;18;Keskiviikko;97;54;151;23;20;43
89;21.06.2017;2017;06;19;Keskiviikko;83;61;144;15;18;33
89;21.06.2017;2017;06;20;Keskiviikko;80;62;142;19;14;33
89;21.06.2017;2017;06;21;Keskiviikko;57;22;79;9;1;10
89;21.06.2017;2017;06;22;Keskiviikko;39;15;54;5;6;11
89;21.06.2017;2017;06;23;Keskiviikko;21;6;27;7;8;15
89;22.06.2017;2017;06;00;Torstai;12;8;20;6;4;10
89;22.06.2017;2017;06;01;Torstai;3;5;8;2;3;5
89;22.06.2017;2017;06;02;Torstai;2;3;5;2;1;3
89;22.06.2017;2017;06;03;Torstai;7;3;10;1;3;4
89;22.06.2017;2017;06;04;Torstai;3;8;11;3;1;4
89;22.06.2017;2017;06;05;Torstai;4;16;20;0;2;2
89;22.06.2017;2017;06;06;Torstai;14;78;92;1;2;3
89;22.06.2017;2017;06;07;Torstai;20;118;138;2;21;23
89;22.06.2017;2017;06;08;Torstai;32;141;173;4;20;24
89;22.06.2017;2017;06;09;Torstai;32;81;113;8;14;22
89;22.06.2017;2017;06;10;Torstai;32;62;94;13;20;33
89;22.06.2017;2017;06;11;Torstai;61;68;129;18;20;38
89;22.06.2017;2017;06;12;Torstai;52;81;133;21;21;42
89;22.06.2017;2017;06;13;Torstai;104;72;176;23;26;49
89;22.06.2017;2017;06;14;Torstai;129;71;200;22;21;43
89;22.06.2017;2017;06;15;Torstai;111;80;191;20;20;40
89;22.06.2017;2017;06;16;Torstai;108;51;159;27;8;35
89;22.06.2017;2017;06;17;Torstai;89;49;138;12;14;26
89;22.06.2017;2017;06;18;Torstai;66;30;96;12;16;28
89;22.06.2017;2017;06;19;Torstai;49;44;93;13;11;24
89;22.06.2017;2017;06;20;Torstai;46;34;80;14;11;25
89;22.06.2017;2017;06;21;Torstai;40;21;61;6;5;11
89;22.06.2017;2017;06;22;Torstai;14;15;29;8;7;15
89;22.06.2017;2017;06;23;Torstai;18;13;31;3;3;6
89;23.06.2017;2017;06;00;Perjantai;14;5;19;3;6;9
89;23.06.2017;2017;06;01;Perjantai;9;12;21;0;3;3
89;23.06.2017;2017;06;02;Perjantai;6;5;11;1;2;3
89;23.06.2017;2017;06;03;Perjantai;2;1;3;3;4;7
89;23.06.2017;2017;06;04;Perjantai;3;3;6;0;2;2
89;23.06.2017;2017;06;05;Perjantai;8;3;11;3;0;3
89;23.06.2017;2017;06;06;Perjantai;8;13;21;1;3;4
89;23.06.2017;2017;06;07;Perjantai;0;16;16;1;2;3
89;23.06.2017;2017;06;08;Perjantai;12;28;40;3;5;8
89;23.06.2017;2017;06;09;Perjantai;21;46;67;7;9;16
89;23.06.2017;2017;06;10;Perjantai;28;56;84;11;18;29
89;23.06.2017;2017;06;11;Perjantai;36;81;117;18;26;44
89;23.06.2017;2017;06;12;Perjantai;54;82;136;24;28;52
89;23.06.2017;2017;06;13;Perjantai;54;53;107;22;14;36
89;23.06.2017;2017;06;14;Perjantai;72;53;125;42;30;72
89;23.06.2017;2017;06;15;Perjantai;48;58;106;18;18;36
89;23.06.2017;2017;06;16;Perjantai;52;57;109;22;21;43
89;23.06.2017;2017;06;17;Perjantai;61;76;137;9;26;35
89;23.06.2017;2017;06;18;Perjantai;60;51;111;10;11;21
89;23.06.2017;2017;06;19;Perjantai;49;64;113;25;39;64
89;23.06.2017;2017;06;20;Perjantai;36;74;110;19;28;47
89;23.06.2017;2017;06;21;Perjantai;38;49;87;13;7;20
89;23.06.2017;2017;06;22;Perjantai;46;50;96;7;19;26
89;23.06.2017;2017;06;23;Perjantai;19;24;43;5;11;16
89;24.06.2017;2017;06;00;Lauantai;24;22;46;6;12;18
89;24.06.2017;2017;06;01;Lauantai;9;16;25;4;7;11
89;24.06.2017;2017;06;02;Lauantai;18;24;42;3;2;5
89;24.06.2017;2017;06;03;Lauantai;33;4;37;11;7;18
89;24.06.2017;2017;06;04;Lauantai;17;7;24;4;7;11
89;24.06.2017;2017;06;05;Lauantai;8;4;12;5;1;6
89;24.06.2017;2017;06;06;Lauantai;5;12;17;4;2;6
89;24.06.2017;2017;06;07;Lauantai;5;1;6;2;2;4
89;24.06.2017;2017;06;08;Lauantai;2;8;10;5;2;7
89;24.06.2017;2017;06;09;Lauantai;9;14;23;13;13;26
89;24.06.2017;2017;06;10;Lauantai;18;28;46;32;27;59
89;24.06.2017;2017;06;11;Lauantai;46;50;96;15;25;40
89;24.06.2017;2017;06;12;Lauantai;45;100;145;13;32;45
89;24.06.2017;2017;06;13;Lauantai;64;100;164;29;38;67
89;24.06.2017;2017;06;14;Lauantai;88;94;182;32;31;63
89;24.06.2017;2017;06;15;Lauantai;108;99;207;60;44;104
89;24.06.2017;2017;06;16;Lauantai;62;68;130;43;64;107
89;24.06.2017;2017;06;17;Lauantai;55;83;138;37;37;74
89;24.06.2017;2017;06;18;Lauantai;64;72;136;23;47;70
89;24.06.2017;2017;06;19;Lauantai;45;61;106;35;32;67
89;24.06.2017;2017;06;20;Lauantai;42;55;97;9;18;27
89;24.06.2017;2017;06;21;Lauantai;51;32;83;13;13;26
89;24.06.2017;2017;06;22;Lauantai;34;33;67;17;9;26
89;24.06.2017;2017;06;23;Lauantai;27;26;53;3;12;15
89;25.06.2017;2017;06;00;Sunnuntai;22;26;48;5;4;9
89;25.06.2017;2017;06;01;Sunnuntai;10;6;16;3;13;16
89;25.06.2017;2017;06;02;Sunnuntai;12;14;26;5;9;14
89;25.06.2017;2017;06;03;Sunnuntai;37;5;42;2;1;3
89;25.06.2017;2017;06;04;Sunnuntai;9;1;10;1;0;1
89;25.06.2017;2017;06;05;Sunnuntai;6;7;13;1;0;1
89;25.06.2017;2017;06;06;Sunnuntai;7;10;17;6;2;8
89;25.06.2017;2017;06;07;Sunnuntai;4;6;10;2;2;4
89;25.06.2017;2017;06;08;Sunnuntai;6;13;19;4;11;15
89;25.06.2017;2017;06;09;Sunnuntai;16;27;43;10;13;23
89;25.06.2017;2017;06;10;Sunnuntai;36;56;92;34;22;56
89;25.06.2017;2017;06;11;Sunnuntai;27;30;57;14;12;26
89;25.06.2017;2017;06;12;Sunnuntai;23;26;49;15;13;28
89;25.06.2017;2017;06;13;Sunnuntai;18;23;41;16;14;30
89;25.06.2017;2017;06;14;Sunnuntai;21;24;45;8;18;26
89;25.06.2017;2017;06;15;Sunnuntai;22;26;48;14;9;23
89;25.06.2017;2017;06;16;Sunnuntai;27;13;40;10;10;20
89;25.06.2017;2017;06;17;Sunnuntai;22;27;49;10;14;24
89;25.06.2017;2017;06;18;Sunnuntai;40;42;82;26;37;63
89;25.06.2017;2017;06;19;Sunnuntai;28;42;70;28;33;61
89;25.06.2017;2017;06;20;Sunnuntai;31;27;58;21;24;45
89;25.06.2017;2017;06;21;Sunnuntai;21;7;28;6;3;9
89;25.06.2017;2017;06;22;Sunnuntai;15;13;28;10;8;18
89;25.06.2017;2017;06;23;Sunnuntai;8;4;12;1;5;6
89;26.06.2017;2017;06;00;Maanantai;6;5;11;3;2;5
89;26.06.2017;2017;06;01;Maanantai;3;3;6;0;1;1
89;26.06.2017;2017;06;02;Maanantai;3;3;6;0;1;1
89;26.06.2017;2017;06;03;Maanantai;3;2;5;0;0;0
89;26.06.2017;2017;06;04;Maanantai;1;2;3;0;0;0
89;26.06.2017;2017;06;05;Maanantai;6;10;16;0;2;2
89;26.06.2017;2017;06;06;Maanantai;19;53;72;2;5;7
89;26.06.2017;2017;06;07;Maanantai;22;105;127;1;18;19
89;26.06.2017;2017;06;08;Maanantai;19;123;142;2;17;19
89;26.06.2017;2017;06;09;Maanantai;23;56;79;4;15;19
89;26.06.2017;2017;06;10;Maanantai;37;58;95;13;13;26
89;26.06.2017;2017;06;11;Maanantai;30;39;69;9;16;25
89;26.06.2017;2017;06;12;Maanantai;21;41;62;7;16;23
89;26.06.2017;2017;06;13;Maanantai;42;67;109;16;14;30
89;26.06.2017;2017;06;14;Maanantai;101;80;181;20;30;50
89;26.06.2017;2017;06;15;Maanantai;130;91;221;41;26;67
89;26.06.2017;2017;06;16;Maanantai;161;105;266;52;23;75
89;26.06.2017;2017;06;17;Maanantai;124;130;254;34;37;71
89;26.06.2017;2017;06;18;Maanantai;144;97;241;58;63;121
89;26.06.2017;2017;06;19;Maanantai;113;79;192;52;60;112
89;26.06.2017;2017;06;20;Maanantai;93;81;174;44;44;88
89;26.06.2017;2017;06;21;Maanantai;72;41;113;17;18;35
89;26.06.2017;2017;06;22;Maanantai;27;33;60;7;9;16
89;26.06.2017;2017;06;23;Maanantai;18;8;26;4;6;10
89;27.06.2017;2017;06;00;Tiistai;14;7;21;9;3;12
89;27.06.2017;2017;06;01;Tiistai;4;6;10;2;0;2
89;27.06.2017;2017;06;02;Tiistai;5;2;7;0;4;4
89;27.06.2017;2017;06;03;Tiistai;2;3;5;2;3;5
89;27.06.2017;2017;06;04;Tiistai;3;4;7;0;0;0
89;27.06.2017;2017;06;05;Tiistai;6;11;17;2;1;3
89;27.06.2017;2017;06;06;Tiistai;17;71;88;3;8;11
89;27.06.2017;2017;06;07;Tiistai;34;139;173;3;19;22
89;27.06.2017;2017;06;08;Tiistai;27;145;172;8;23;31
89;27.06.2017;2017;06;09;Tiistai;30;111;141;15;30;45
89;27.06.2017;2017;06;10;Tiistai;64;88;152;18;28;46
89;27.06.2017;2017;06;11;Tiistai;71;118;189;34;48;82
89;27.06.2017;2017;06;12;Tiistai;58;127;185;14;40;54
89;27.06.2017;2017;06;13;Tiistai;105;126;231;46;50;96
89;27.06.2017;2017;06;14;Tiistai;125;104;229;26;27;53
89;27.06.2017;2017;06;15;Tiistai;190;106;296;42;30;72
89;27.06.2017;2017;06;16;Tiistai;223;134;357;39;35;74
89;27.06.2017;2017;06;17;Tiistai;151;129;280;47;50;97
89;27.06.2017;2017;06;18;Tiistai;151;103;254;44;44;88
89;27.06.2017;2017;06;19;Tiistai;139;86;225;47;33;80
89;27.06.2017;2017;06;20;Tiistai;105;64;169;35;28;63
89;27.06.2017;2017;06;21;Tiistai;85;27;112;24;21;45
89;27.06.2017;2017;06;22;Tiistai;28;26;54;12;14;26
89;27.06.2017;2017;06;23;Tiistai;25;20;45;6;5;11
89;28.06.2017;2017;06;00;Keskiviikko;12;9;21;6;4;10
89;28.06.2017;2017;06;01;Keskiviikko;8;3;11;2;1;3
89;28.06.2017;2017;06;02;Keskiviikko;7;1;8;0;2;2
89;28.06.2017;2017;06;03;Keskiviikko;1;0;1;0;1;1
89;28.06.2017;2017;06;04;Keskiviikko;1;4;5;0;3;3
89;28.06.2017;2017;06;05;Keskiviikko;9;15;24;1;2;3
89;28.06.2017;2017;06;06;Keskiviikko;15;68;83;4;9;13
89;28.06.2017;2017;06;07;Keskiviikko;29;137;166;3;21;24
89;28.06.2017;2017;06;08;Keskiviikko;33;144;177;3;18;21
89;28.06.2017;2017;06;09;Keskiviikko;36;60;96;7;12;19
89;28.06.2017;2017;06;10;Keskiviikko;30;71;101;6;20;26
89;28.06.2017;2017;06;11;Keskiviikko;43;61;104;10;17;27
89;28.06.2017;2017;06;12;Keskiviikko;40;71;111;14;26;40
89;28.06.2017;2017;06;13;Keskiviikko;62;62;124;12;21;33
89;28.06.2017;2017;06;14;Keskiviikko;73;50;123;14;16;30
89;28.06.2017;2017;06;15;Keskiviikko;142;59;201;21;23;44
89;28.06.2017;2017;06;16;Keskiviikko;148;91;239;13;13;26
89;28.06.2017;2017;06;17;Keskiviikko;105;88;193;25;24;49
89;28.06.2017;2017;06;18;Keskiviikko;102;63;165;31;34;65
89;28.06.2017;2017;06;19;Keskiviikko;102;60;162;28;34;62
89;28.06.2017;2017;06;20;Keskiviikko;78;61;139;34;30;64
89;28.06.2017;2017;06;21;Keskiviikko;63;33;96;17;19;36
89;28.06.2017;2017;06;22;Keskiviikko;40;14;54;12;12;24
89;28.06.2017;2017;06;23;Keskiviikko;19;22;41;10;6;16
89;29.06.2017;2017;06;00;Torstai;12;16;28;4;3;7
89;29.06.2017;2017;06;01;Torstai;5;2;7;4;4;8
89;29.06.2017;2017;06;02;Torstai;5;4;9;2;3;5
89;29.06.2017;2017;06;03;Torstai;4;2;6;1;1;2
89;29.06.2017;2017;06;04;Torstai;7;2;9;4;2;6
89;29.06.2017;2017;06;05;Torstai;8;16;24;1;1;2
89;29.06.2017;2017;06;06;Torstai;16;74;90;6;7;13
89;29.06.2017;2017;06;07;Torstai;29;144;173;4;16;20
89;29.06.2017;2017;06;08;Torstai;30;164;194;9;24;33
89;29.06.2017;2017;06;09;Torstai;43;107;150;10;33;43
89;29.06.2017;2017;06;10;Torstai;45;124;169;16;27;43
89;29.06.2017;2017;06;11;Torstai;88;130;218;30;49;79
89;29.06.2017;2017;06;12;Torstai;92;168;260;31;65;96
89;29.06.2017;2017;06;13;Torstai;108;141;249;37;46;83
89;29.06.2017;2017;06;14;Torstai;153;138;291;44;51;95
89;29.06.2017;2017;06;15;Torstai;229;159;388;59;57;116
89;29.06.2017;2017;06;16;Torstai;201;160;361;34;36;70
89;29.06.2017;2017;06;17;Torstai;227;126;353;38;44;82
89;29.06.2017;2017;06;18;Torstai;150;126;276;43;50;93
89;29.06.2017;2017;06;19;Torstai;142;90;232;29;60;89
89;29.06.2017;2017;06;20;Torstai;150;83;233;47;26;73
89;29.06.2017;2017;06;21;Torstai;74;53;127;25;22;47
89;29.06.2017;2017;06;22;Torstai;45;27;72;15;14;29
89;29.06.2017;2017;06;23;Torstai;27;17;44;11;10;21
89;30.06.2017;2017;06;00;Perjantai;15;6;21;12;7;19
89;30.06.2017;2017;06;01;Perjantai;13;11;24;4;1;5
89;30.06.2017;2017;06;02;Perjantai;1;5;6;3;2;5
89;30.06.2017;2017;06;03;Perjantai;2;2;4;0;3;3
89;30.06.2017;2017;06;04;Perjantai;8;5;13;2;2;4
89;30.06.2017;2017;06;05;Perjantai;5;11;16;0;2;2
89;30.06.2017;2017;06;06;Perjantai;15;70;85;4;14;18
89;30.06.2017;2017;06;07;Perjantai;27;145;172;4;13;17
89;30.06.2017;2017;06;08;Perjantai;32;144;176;8;32;40
89;30.06.2017;2017;06;09;Perjantai;47;121;168;16;27;43
89;30.06.2017;2017;06;10;Perjantai;62;122;184;22;46;68
89;30.06.2017;2017;06;11;Perjantai;103;155;258;22;39;61
89;30.06.2017;2017;06;12;Perjantai;130;149;279;23;33;56
89;30.06.2017;2017;06;13;Perjantai;145;162;307;42;55;97
89;30.06.2017;2017;06;14;Perjantai;169;135;304;23;28;51
89;30.06.2017;2017;06;15;Perjantai;230;141;371;40;36;76
89;30.06.2017;2017;06;16;Perjantai;175;122;297;49;59;108
89;30.06.2017;2017;06;17;Perjantai;147;133;280;25;48;73
89;30.06.2017;2017;06;18;Perjantai;122;128;250;38;33;71
89;30.06.2017;2017;06;19;Perjantai;120;124;244;31;60;91
89;30.06.2017;2017;06;20;Perjantai;106;121;227;36;36;72
89;30.06.2017;2017;06;21;Perjantai;86;91;177;24;23;47
89;30.06.2017;2017;06;22;Perjantai;64;57;121;16;21;37
89;30.06.2017;2017;06;23;Perjantai;55;55;110;14;14;28
89;01.07.2017;2017;07;00;Lauantai;40;23;63;11;21;32
89;01.07.2017;2017;07;01;Lauantai;46;3;49;7;3;10
89;01.07.2017;2017;07;02;Lauantai;35;13;48;10;6;16
89;01.07.2017;2017;07;03;Lauantai;29;4;33;5;5;10
89;01.07.2017;2017;07;04;Lauantai;18;4;22;3;2;5
89;01.07.2017;2017;07;05;Lauantai;5;9;14;2;4;6
89;01.07.2017;2017;07;06;Lauantai;7;11;18;2;3;5
89;01.07.2017;2017;07;07;Lauantai;14;17;31;9;8;17
89;01.07.2017;2017;07;08;Lauantai;17;36;53;6;11;17
89;01.07.2017;2017;07;09;Lauantai;24;73;97;10;24;34
89;01.07.2017;2017;07;10;Lauantai;54;125;179;18;29;47
89;01.07.2017;2017;07;11;Lauantai;101;162;263;30;63;93
89;01.07.2017;2017;07;12;Lauantai;126;184;310;42;49;91
89;01.07.2017;2017;07;13;Lauantai;157;175;332;37;71;108
89;01.07.2017;2017;07;14;Lauantai;188;197;385;57;50;107
89;01.07.2017;2017;07;15;Lauantai;215;183;398;48;50;98
89;01.07.2017;2017;07;16;Lauantai;162;196;358;47;53;100
89;01.07.2017;2017;07;17;Lauantai;168;129;297;75;60;135
89;01.07.2017;2017;07;18;Lauantai;145;168;313;30;57;87
89;01.07.2017;2017;07;19;Lauantai;103;166;269;29;49;78
89;01.07.2017;2017;07;20;Lauantai;104;148;252;21;36;57
89;01.07.2017;2017;07;21;Lauantai;79;108;187;21;44;65
89;01.07.2017;2017;07;22;Lauantai;87;102;189;19;28;47
89;01.07.2017;2017;07;23;Lauantai;65;54;119;29;35;64
89;02.07.2017;2017;07;00;Sunnuntai;49;41;90;19;16;35
89;02.07.2017;2017;07;01;Sunnuntai;36;27;63;8;12;20
89;02.07.2017;2017;07;02;Sunnuntai;29;10;39;11;1;12
89;02.07.2017;2017;07;03;Sunnuntai;40;3;43;12;0;12
89;02.07.2017;2017;07;04;Sunnuntai;26;2;28;8;0;8
89;02.07.2017;2017;07;05;Sunnuntai;10;5;15;0;4;4
89;02.07.2017;2017;07;06;Sunnuntai;7;7;14;2;2;4
89;02.07.2017;2017;07;07;Sunnuntai;5;10;15;4;7;11
89;02.07.2017;2017;07;08;Sunnuntai;8;18;26;8;14;22
89;02.07.2017;2017;07;09;Sunnuntai;28;44;72;16;23;39
89;02.07.2017;2017;07;10;Sunnuntai;49;62;111;26;35;61
89;02.07.2017;2017;07;11;Sunnuntai;82;137;219;30;68;98
89;02.07.2017;2017;07;12;Sunnuntai;105;138;243;43;84;127
89;02.07.2017;2017;07;13;Sunnuntai;123;187;310;42;58;100
89;02.07.2017;2017;07;14;Sunnuntai;146;170;316;34;54;88
89;02.07.2017;2017;07;15;Sunnuntai;173;148;321;60;61;121
89;02.07.2017;2017;07;16;Sunnuntai;199;173;372;49;73;122
89;02.07.2017;2017;07;17;Sunnuntai;142;143;285;40;48;88
89;02.07.2017;2017;07;18;Sunnuntai;141;127;268;32;34;66
89;02.07.2017;2017;07;19;Sunnuntai;110;116;226;51;65;116
89;02.07.2017;2017;07;20;Sunnuntai;87;105;192;33;34;67
89;02.07.2017;2017;07;21;Sunnuntai;79;47;126;18;24;42
89;02.07.2017;2017;07;22;Sunnuntai;32;29;61;12;17;29
89;02.07.2017;2017;07;23;Sunnuntai;21;23;44;4;16;20
89;03.07.2017;2017;07;00;Maanantai;25;13;38;5;4;9
89;03.07.2017;2017;07;01;Maanantai;9;6;15;2;5;7
89;03.07.2017;2017;07;02;Maanantai;9;6;15;0;0;0
89;03.07.2017;2017;07;03;Maanantai;9;5;14;1;0;1
89;03.07.2017;2017;07;04;Maanantai;2;5;7;5;4;9
89;03.07.2017;2017;07;05;Maanantai;8;12;20;0;4;4
89;03.07.2017;2017;07;06;Maanantai;16;62;78;2;10;12
89;03.07.2017;2017;07;07;Maanantai;34;105;139;3;17;20
89;03.07.2017;2017;07;08;Maanantai;37;162;199;11;33;44
89;03.07.2017;2017;07;09;Maanantai;51;121;172;15;30;45
89;03.07.2017;2017;07;10;Maanantai;81;131;212;23;37;60
89;03.07.2017;2017;07;11;Maanantai;94;172;266;22;52;74
89;03.07.2017;2017;07;12;Maanantai;113;190;303;32;35;67
89;03.07.2017;2017;07;13;Maanantai;173;150;323;40;38;78
89;03.07.2017;2017;07;14;Maanantai;148;145;293;25;29;54
89;03.07.2017;2017;07;15;Maanantai;228;115;343;33;45;78
89;03.07.2017;2017;07;16;Maanantai;249;136;385;32;34;66
89;03.07.2017;2017;07;17;Maanantai;193;172;365;39;51;90
89;03.07.2017;2017;07;18;Maanantai;180;125;305;46;53;99
89;03.07.2017;2017;07;19;Maanantai;133;73;206;41;31;72
89;03.07.2017;2017;07;20;Maanantai;111;55;166;38;26;64
89;03.07.2017;2017;07;21;Maanantai;67;56;123;12;11;23
89;03.07.2017;2017;07;22;Maanantai;35;18;53;21;11;32
89;03.07.2017;2017;07;23;Maanantai;28;12;40;0;5;5
89;04.07.2017;2017;07;00;Tiistai;19;9;28;3;1;4
89;04.07.2017;2017;07;01;Tiistai;6;7;13;4;1;5
89;04.07.2017;2017;07;02;Tiistai;6;0;6;4;0;4
89;04.07.2017;2017;07;03;Tiistai;1;3;4;2;0;2
89;04.07.2017;2017;07;04;Tiistai;8;4;12;0;0;0
89;04.07.2017;2017;07;05;Tiistai;4;12;16;0;3;3
89;04.07.2017;2017;07;06;Tiistai;20;77;97;7;5;12
89;04.07.2017;2017;07;07;Tiistai;27;107;134;4;12;16
89;04.07.2017;2017;07;08;Tiistai;30;130;160;8;22;30
89;04.07.2017;2017;07;09;Tiistai;29;100;129;19;30;49
89;04.07.2017;2017;07;10;Tiistai;61;115;176;20;35;55
89;04.07.2017;2017;07;11;Tiistai;115;104;219;17;47;64
89;04.07.2017;2017;07;12;Tiistai;83;80;163;36;32;68
89;04.07.2017;2017;07;13;Tiistai;90;67;157;13;19;32
89;04.07.2017;2017;07;14;Tiistai;78;68;146;15;24;39
89;04.07.2017;2017;07;15;Tiistai;139;97;236;33;28;61
89;04.07.2017;2017;07;16;Tiistai;151;117;268;37;32;69
89;04.07.2017;2017;07;17;Tiistai;130;81;211;22;16;38
89;04.07.2017;2017;07;18;Tiistai;98;83;181;31;37;68
89;04.07.2017;2017;07;19;Tiistai;100;69;169;29;34;63
89;04.07.2017;2017;07;20;Tiistai;102;51;153;20;28;48
89;04.07.2017;2017;07;21;Tiistai;48;34;82;20;25;45
89;04.07.2017;2017;07;22;Tiistai;35;23;58;13;11;24
89;04.07.2017;2017;07;23;Tiistai;16;7;23;6;7;13
89;05.07.2017;2017;07;00;Keskiviikko;13;12;25;2;6;8
89;05.07.2017;2017;07;01;Keskiviikko;9;7;16;3;3;6
89;05.07.2017;2017;07;02;Keskiviikko;5;5;10;4;1;5
89;05.07.2017;2017;07;03;Keskiviikko;5;4;9;2;1;3
89;05.07.2017;2017;07;04;Keskiviikko;3;5;8;2;6;8
89;05.07.2017;2017;07;05;Keskiviikko;6;11;17;1;1;2
89;05.07.2017;2017;07;06;Keskiviikko;17;68;85;3;7;10
89;05.07.2017;2017;07;07;Keskiviikko;19;108;127;3;10;13
89;05.07.2017;2017;07;08;Keskiviikko;27;104;131;5;16;21
89;05.07.2017;2017;07;09;Keskiviikko;31;93;124;15;17;32
89;05.07.2017;2017;07;10;Keskiviikko;38;93;131;22;26;48
89;05.07.2017;2017;07;11;Keskiviikko;51;92;143;23;50;73
89;05.07.2017;2017;07;12;Keskiviikko;63;106;169;26;31;57
89;05.07.2017;2017;07;13;Keskiviikko;81;98;179;14;38;52
89;05.07.2017;2017;07;14;Keskiviikko;121;97;218;29;43;72
89;05.07.2017;2017;07;15;Keskiviikko;171;139;310;36;48;84
89;05.07.2017;2017;07;16;Keskiviikko;184;129;313;41;26;67
89;05.07.2017;2017;07;17;Keskiviikko;115;99;214;29;35;64
89;05.07.2017;2017;07;18;Keskiviikko;98;53;151;26;17;43
89;05.07.2017;2017;07;19;Keskiviikko;65;34;99;30;12;42
89;05.07.2017;2017;07;20;Keskiviikko;68;37;105;21;9;30
89;05.07.2017;2017;07;21;Keskiviikko;41;21;62;6;6;12
89;05.07.2017;2017;07;22;Keskiviikko;23;10;33;3;9;12
89;05.07.2017;2017;07;23;Keskiviikko;15;9;24;3;7;10
89;06.07.2017;2017;07;00;Torstai;16;4;20;1;1;2
89;06.07.2017;2017;07;01;Torstai;2;3;5;1;0;1
89;06.07.2017;2017;07;02;Torstai;7;10;17;2;2;4
89;06.07.2017;2017;07;03;Torstai;6;2;8;1;1;2
89;06.07.2017;2017;07;04;Torstai;5;7;12;1;0;1
89;06.07.2017;2017;07;05;Torstai;4;12;16;0;0;0
89;06.07.2017;2017;07;06;Torstai;24;66;90;1;6;7
89;06.07.2017;2017;07;07;Torstai;16;84;100;2;6;8
89;06.07.2017;2017;07;08;Torstai;10;91;101;5;21;26
89;06.07.2017;2017;07;09;Torstai;24;52;76;9;7;16
89;06.07.2017;2017;07;10;Torstai;17;39;56;9;15;24
89;06.07.2017;2017;07;11;Torstai;39;70;109;31;46;77
89;06.07.2017;2017;07;12;Torstai;50;80;130;18;28;46
89;06.07.2017;2017;07;13;Torstai;68;62;130;21;30;51
89;06.07.2017;2017;07;14;Torstai;76;86;162;18;20;38
89;06.07.2017;2017;07;15;Torstai;123;80;203;33;25;58
89;06.07.2017;2017;07;16;Torstai;141;82;223;27;23;50
89;06.07.2017;2017;07;17;Torstai;91;70;161;16;20;36
89;06.07.2017;2017;07;18;Torstai;77;51;128;17;22;39
89;06.07.2017;2017;07;19;Torstai;68;55;123;26;13;39
89;06.07.2017;2017;07;20;Torstai;76;38;114;26;19;45
89;06.07.2017;2017;07;21;Torstai;33;33;66;12;11;23
89;06.07.2017;2017;07;22;Torstai;23;15;38;4;12;16
89;06.07.2017;2017;07;23;Torstai;18;14;32;2;5;7
89;07.07.2017;2017;07;00;Perjantai;12;5;17;6;6;12
89;07.07.2017;2017;07;01;Perjantai;6;8;14;7;2;9
89;07.07.2017;2017;07;02;Perjantai;4;6;10;0;0;0
89;07.07.2017;2017;07;03;Perjantai;1;3;4;0;1;1
89;07.07.2017;2017;07;04;Perjantai;3;3;6;1;0;1
89;07.07.2017;2017;07;05;Perjantai;5;12;17;3;1;4
89;07.07.2017;2017;07;06;Perjantai;16;68;84;5;5;10
89;07.07.2017;2017;07;07;Perjantai;16;98;114;8;13;21
89;07.07.2017;2017;07;08;Perjantai;20;120;140;7;22;29
89;07.07.2017;2017;07;09;Perjantai;27;79;106;8;19;27
89;07.07.2017;2017;07;10;Perjantai;40;134;174;19;46;65
89;07.07.2017;2017;07;11;Perjantai;69;144;213;21;45;66
89;07.07.2017;2017;07;12;Perjantai;88;148;236;54;64;118
89;07.07.2017;2017;07;13;Perjantai;119;136;255;54;51;105
89;07.07.2017;2017;07;14;Perjantai;169;128;297;39;42;81
89;07.07.2017;2017;07;15;Perjantai;180;139;319;37;38;75
89;07.07.2017;2017;07;16;Perjantai;188;160;348;39;36;75
89;07.07.2017;2017;07;17;Perjantai;123;112;235;48;26;74
89;07.07.2017;2017;07;18;Perjantai;145;125;270;39;42;81
89;07.07.2017;2017;07;19;Perjantai;129;104;233;42;49;91
89;07.07.2017;2017;07;20;Perjantai;114;102;216;34;18;52
89;07.07.2017;2017;07;21;Perjantai;57;86;143;24;24;48
89;07.07.2017;2017;07;22;Perjantai;48;62;110;17;21;38
89;07.07.2017;2017;07;23;Perjantai;59;47;106;3;25;28
89;08.07.2017;2017;07;00;Lauantai;56;49;105;4;14;18
89;08.07.2017;2017;07;01;Lauantai;44;43;87;6;15;21
89;08.07.2017;2017;07;02;Lauantai;38;25;63;7;8;15
89;08.07.2017;2017;07;03;Lauantai;19;7;26;7;1;8
89;08.07.2017;2017;07;04;Lauantai;22;5;27;9;0;9
89;08.07.2017;2017;07;05;Lauantai;7;11;18;4;1;5
89;08.07.2017;2017;07;06;Lauantai;5;11;16;1;5;6
89;08.07.2017;2017;07;07;Lauantai;9;15;24;5;9;14
89;08.07.2017;2017;07;08;Lauantai;21;29;50;6;7;13
89;08.07.2017;2017;07;09;Lauantai;32;90;122;13;32;45
89;08.07.2017;2017;07;10;Lauantai;36;98;134;18;46;64
89;08.07.2017;2017;07;11;Lauantai;90;167;257;29;46;75
89;08.07.2017;2017;07;12;Lauantai;147;193;340;43;56;99
89;08.07.2017;2017;07;13;Lauantai;138;210;348;48;62;110
89;08.07.2017;2017;07;14;Lauantai;188;175;363;63;95;158
89;08.07.2017;2017;07;15;Lauantai;184;160;344;58;59;117
89;08.07.2017;2017;07;16;Lauantai;163;174;337;40;67;107
89;08.07.2017;2017;07;17;Lauantai;158;139;297;33;47;80
89;08.07.2017;2017;07;18;Lauantai;133;140;273;40;28;68
89;08.07.2017;2017;07;19;Lauantai;132;171;303;48;47;95
89;08.07.2017;2017;07;20;Lauantai;91;84;175;25;37;62
89;08.07.2017;2017;07;21;Lauantai;90;96;186;24;26;50
89;08.07.2017;2017;07;22;Lauantai;60;75;135;18;29;47
89;08.07.2017;2017;07;23;Lauantai;55;69;124;8;24;32
89;09.07.2017;2017;07;00;Sunnuntai;44;85;129;9;21;30
89;09.07.2017;2017;07;01;Sunnuntai;43;47;90;9;17;26
89;09.07.2017;2017;07;02;Sunnuntai;49;19;68;8;2;10
89;09.07.2017;2017;07;03;Sunnuntai;35;12;47;7;2;9
89;09.07.2017;2017;07;04;Sunnuntai;24;14;38;9;2;11
89;09.07.2017;2017;07;05;Sunnuntai;9;7;16;4;1;5
89;09.07.2017;2017;07;06;Sunnuntai;11;12;23;6;1;7
89;09.07.2017;2017;07;07;Sunnuntai;6;10;16;7;6;13
89;09.07.2017;2017;07;08;Sunnuntai;12;11;23;5;15;20
89;09.07.2017;2017;07;09;Sunnuntai;32;42;74;19;17;36
89;09.07.2017;2017;07;10;Sunnuntai;40;86;126;31;34;65
89;09.07.2017;2017;07;11;Sunnuntai;84;115;199;37;57;94
89;09.07.2017;2017;07;12;Sunnuntai;97;168;265;30;52;82
89;09.07.2017;2017;07;13;Sunnuntai;140;162;302;52;63;115
89;09.07.2017;2017;07;14;Sunnuntai;142;162;304;47;55;102
89;09.07.2017;2017;07;15;Sunnuntai;159;164;323;63;59;122
89;09.07.2017;2017;07;16;Sunnuntai;177;130;307;64;61;125
89;09.07.2017;2017;07;17;Sunnuntai;175;151;326;50;38;88
89;09.07.2017;2017;07;18;Sunnuntai;140;81;221;38;47;85
89;09.07.2017;2017;07;19;Sunnuntai;99;86;185;38;68;106
89;09.07.2017;2017;07;20;Sunnuntai;76;92;168;25;35;60
89;09.07.2017;2017;07;21;Sunnuntai;81;56;137;19;19;38
89;09.07.2017;2017;07;22;Sunnuntai;39;36;75;11;15;26
89;09.07.2017;2017;07;23;Sunnuntai;24;14;38;6;10;16
89;10.07.2017;2017;07;00;Maanantai;18;9;27;6;2;8
89;10.07.2017;2017;07;01;Maanantai;13;13;26;0;3;3
89;10.07.2017;2017;07;02;Maanantai;2;4;6;2;1;3
89;10.07.2017;2017;07;03;Maanantai;4;2;6;1;0;1
89;10.07.2017;2017;07;04;Maanantai;5;2;7;3;0;3
89;10.07.2017;2017;07;05;Maanantai;4;14;18;1;5;6
89;10.07.2017;2017;07;06;Maanantai;18;75;93;5;3;8
89;10.07.2017;2017;07;07;Maanantai;27;112;139;3;8;11
89;10.07.2017;2017;07;08;Maanantai;30;122;152;8;19;27
89;10.07.2017;2017;07;09;Maanantai;39;138;177;10;19;29
89;10.07.2017;2017;07;10;Maanantai;71;134;205;23;29;52
89;10.07.2017;2017;07;11;Maanantai;107;157;264;27;43;70
89;10.07.2017;2017;07;12;Maanantai;142;179;321;39;53;92
89;10.07.2017;2017;07;13;Maanantai;170;185;355;42;48;90
89;10.07.2017;2017;07;14;Maanantai;183;164;347;44;46;90
89;10.07.2017;2017;07;15;Maanantai;218;119;337;53;37;90
89;10.07.2017;2017;07;16;Maanantai;255;149;404;56;38;94
89;10.07.2017;2017;07;17;Maanantai;163;134;297;47;47;94
89;10.07.2017;2017;07;18;Maanantai;121;90;211;40;34;74
89;10.07.2017;2017;07;19;Maanantai;89;64;153;42;25;67
89;10.07.2017;2017;07;20;Maanantai;72;49;121;30;30;60
89;10.07.2017;2017;07;21;Maanantai;67;52;119;20;27;47
89;10.07.2017;2017;07;22;Maanantai;41;19;60;8;6;14
89;10.07.2017;2017;07;23;Maanantai;20;25;45;11;10;21
89;11.07.2017;2017;07;00;Tiistai;6;7;13;2;12;14
89;11.07.2017;2017;07;01;Tiistai;7;8;15;4;3;7
89;11.07.2017;2017;07;02;Tiistai;3;5;8;3;1;4
89;11.07.2017;2017;07;03;Tiistai;1;1;2;2;0;2
89;11.07.2017;2017;07;04;Tiistai;4;4;8;1;1;2
89;11.07.2017;2017;07;05;Tiistai;3;15;18;3;3;6
89;11.07.2017;2017;07;06;Tiistai;14;69;83;2;8;10
89;11.07.2017;2017;07;07;Tiistai;20;95;115;3;5;8
89;11.07.2017;2017;07;08;Tiistai;25;126;151;10;21;31
89;11.07.2017;2017;07;09;Tiistai;35;103;138;15;26;41
89;11.07.2017;2017;07;10;Tiistai;57;134;191;23;39;62
89;11.07.2017;2017;07;11;Tiistai;89;148;237;20;55;75
89;11.07.2017;2017;07;12;Tiistai;118;172;290;25;51;76
89;11.07.2017;2017;07;13;Tiistai;145;144;289;44;46;90
89;11.07.2017;2017;07;14;Tiistai;165;152;317;66;60;126
89;11.07.2017;2017;07;15;Tiistai;191;163;354;41;51;92
89;11.07.2017;2017;07;16;Tiistai;219;118;337;32;33;65
89;11.07.2017;2017;07;17;Tiistai;164;150;314;37;41;78
89;11.07.2017;2017;07;18;Tiistai;140;116;256;51;40;91
89;11.07.2017;2017;07;19;Tiistai;129;97;226;47;61;108
89;11.07.2017;2017;07;20;Tiistai;124;63;187;22;33;55
89;11.07.2017;2017;07;21;Tiistai;53;29;82;11;11;22
89;11.07.2017;2017;07;22;Tiistai;46;17;63;5;5;10
89;11.07.2017;2017;07;23;Tiistai;21;16;37;5;1;6
89;12.07.2017;2017;07;00;Keskiviikko;8;5;13;0;0;0
89;12.07.2017;2017;07;01;Keskiviikko;5;5;10;2;1;3
89;12.07.2017;2017;07;02;Keskiviikko;7;6;13;1;3;4
89;12.07.2017;2017;07;03;Keskiviikko;3;3;6;4;1;5
89;12.07.2017;2017;07;04;Keskiviikko;2;1;3;1;0;1
89;12.07.2017;2017;07;05;Keskiviikko;5;20;25;1;2;3
89;12.07.2017;2017;07;06;Keskiviikko;10;59;69;5;5;10
89;12.07.2017;2017;07;07;Keskiviikko;12;70;82;4;6;10
89;12.07.2017;2017;07;08;Keskiviikko;16;83;99;6;14;20
89;12.07.2017;2017;07;09;Keskiviikko;13;45;58;3;13;16
89;12.07.2017;2017;07;10;Keskiviikko;37;57;94;10;20;30
89;12.07.2017;2017;07;11;Keskiviikko;30;75;105;9;24;33
89;12.07.2017;2017;07;12;Keskiviikko;49;83;132;23;26;49
89;12.07.2017;2017;07;13;Keskiviikko;72;45;117;17;24;41
89;12.07.2017;2017;07;14;Keskiviikko;80;50;130;28;12;40
89;12.07.2017;2017;07;15;Keskiviikko;104;54;158;11;13;24
89;12.07.2017;2017;07;16;Keskiviikko;104;45;149;19;20;39
89;12.07.2017;2017;07;17;Keskiviikko;65;40;105;18;19;37
89;12.07.2017;2017;07;18;Keskiviikko;63;44;107;23;23;46
89;12.07.2017;2017;07;19;Keskiviikko;38;24;62;15;23;38
89;12.07.2017;2017;07;20;Keskiviikko;38;18;56;10;15;25
89;12.07.2017;2017;07;21;Keskiviikko;24;27;51;8;11;19
89;12.07.2017;2017;07;22;Keskiviikko;13;13;26;9;7;16
89;12.07.2017;2017;07;23;Keskiviikko;11;10;21;2;4;6
89;13.07.2017;2017;07;00;Torstai;18;4;22;7;1;8
89;13.07.2017;2017;07;01;Torstai;3;3;6;5;2;7
89;13.07.2017;2017;07;02;Torstai;5;4;9;2;3;5
89;13.07.2017;2017;07;03;Torstai;4;1;5;5;1;6
89;13.07.2017;2017;07;04;Torstai;8;3;11;2;1;3
89;13.07.2017;2017;07;05;Torstai;3;13;16;0;1;1
89;13.07.2017;2017;07;06;Torstai;16;50;66;4;9;13
89;13.07.2017;2017;07;07;Torstai;15;75;90;3;10;13
89;13.07.2017;2017;07;08;Torstai;16;110;126;5;11;16
89;13.07.2017;2017;07;09;Torstai;24;63;87;11;27;38
89;13.07.2017;2017;07;10;Torstai;32;89;121;25;25;50
89;13.07.2017;2017;07;11;Torstai;57;102;159;23;45;68
89;13.07.2017;2017;07;12;Torstai;68;118;186;16;47;63
89;13.07.2017;2017;07;13;Torstai;99;129;228;30;50;80
89;13.07.2017;2017;07;14;Torstai;155;142;297;59;62;121
89;13.07.2017;2017;07;15;Torstai;167;120;287;60;62;122
89;13.07.2017;2017;07;16;Torstai;157;132;289;29;23;52
89;13.07.2017;2017;07;17;Torstai;77;39;116;25;16;41
89;13.07.2017;2017;07;18;Torstai;70;48;118;26;34;60
89;13.07.2017;2017;07;19;Torstai;60;38;98;10;19;29
89;13.07.2017;2017;07;20;Torstai;60;58;118;25;19;44
89;13.07.2017;2017;07;21;Torstai;44;36;80;20;18;38
89;13.07.2017;2017;07;22;Torstai;38;16;54;16;10;26
89;13.07.2017;2017;07;23;Torstai;37;26;63;15;5;20
89;14.07.2017;2017;07;00;Perjantai;28;17;45;5;9;14
89;14.07.2017;2017;07;01;Perjantai;9;4;13;3;2;5
89;14.07.2017;2017;07;02;Perjantai;7;3;10;4;1;5
89;14.07.2017;2017;07;03;Perjantai;15;3;18;5;4;9
89;14.07.2017;2017;07;04;Perjantai;8;3;11;2;1;3
89;14.07.2017;2017;07;05;Perjantai;2;15;17;1;1;2
89;14.07.2017;2017;07;06;Perjantai;17;50;67;1;10;11
89;14.07.2017;2017;07;07;Perjantai;17;56;73;5;7;12
89;14.07.2017;2017;07;08;Perjantai;14;72;86;6;17;23
89;14.07.2017;2017;07;09;Perjantai;22;25;47;8;12;20
89;14.07.2017;2017;07;10;Perjantai;11;15;26;19;6;25
89;14.07.2017;2017;07;11;Perjantai;24;27;51;9;18;27
89;14.07.2017;2017;07;12;Perjantai;18;31;49;13;17;30
89;14.07.2017;2017;07;13;Perjantai;47;88;135;11;23;34
89;14.07.2017;2017;07;14;Perjantai;88;79;167;26;25;51
89;14.07.2017;2017;07;15;Perjantai;99;85;184;36;47;83
89;14.07.2017;2017;07;16;Perjantai;98;65;163;36;29;65
89;14.07.2017;2017;07;17;Perjantai;79;66;145;41;29;70
89;14.07.2017;2017;07;18;Perjantai;62;100;162;26;43;69
89;14.07.2017;2017;07;19;Perjantai;80;128;208;25;31;56
89;14.07.2017;2017;07;20;Perjantai;73;67;140;22;17;39
89;14.07.2017;2017;07;21;Perjantai;41;66;107;12;17;29
89;14.07.2017;2017;07;22;Perjantai;51;45;96;12;19;31
89;14.07.2017;2017;07;23;Perjantai;39;45;84;4;20;24
89;15.07.2017;2017;07;00;Lauantai;46;35;81;3;13;16
89;15.07.2017;2017;07;01;Lauantai;30;33;63;8;20;28
89;15.07.2017;2017;07;02;Lauantai;16;14;30;17;8;25
89;15.07.2017;2017;07;03;Lauantai;36;2;38;13;3;16
89;15.07.2017;2017;07;04;Lauantai;12;3;15;8;2;10
89;15.07.2017;2017;07;05;Lauantai;8;6;14;2;1;3
89;15.07.2017;2017;07;06;Lauantai;10;16;26;2;6;8
89;15.07.2017;2017;07;07;Lauantai;10;18;28;6;15;21
89;15.07.2017;2017;07;08;Lauantai;16;37;53;6;12;18
89;15.07.2017;2017;07;09;Lauantai;23;66;89;9;18;27
89;15.07.2017;2017;07;10;Lauantai;42;85;127;18;27;45
89;15.07.2017;2017;07;11;Lauantai;62;120;182;21;37;58
89;15.07.2017;2017;07;12;Lauantai;88;160;248;23;43;66
89;15.07.2017;2017;07;13;Lauantai;98;145;243;49;61;110
89;15.07.2017;2017;07;14;Lauantai;142;147;289;64;55;119
89;15.07.2017;2017;07;15;Lauantai;134;130;264;62;37;99
89;15.07.2017;2017;07;16;Lauantai;141;140;281;70;58;128
89;15.07.2017;2017;07;17;Lauantai;133;120;253;41;46;87
89;15.07.2017;2017;07;18;Lauantai;105;137;242;31;44;75
89;15.07.2017;2017;07;19;Lauantai;87;96;183;25;33;58
89;15.07.2017;2017;07;20;Lauantai;71;89;160;31;49;80
89;15.07.2017;2017;07;21;Lauantai;78;104;182;11;23;34
89;15.07.2017;2017;07;22;Lauantai;50;80;130;22;29;51
89;15.07.2017;2017;07;23;Lauantai;49;38;87;13;18;31
89;16.07.2017;2017;07;00;Sunnuntai;55;57;112;17;23;40
89;16.07.2017;2017;07;01;Sunnuntai;42;26;68;7;10;17
89;16.07.2017;2017;07;02;Sunnuntai;43;20;63;11;3;14
89;16.07.2017;2017;07;03;Sunnuntai;43;8;51;8;3;11
89;16.07.2017;2017;07;04;Sunnuntai;25;5;30;3;1;4
89;16.07.2017;2017;07;05;Sunnuntai;10;8;18;4;3;7
89;16.07.2017;2017;07;06;Sunnuntai;4;15;19;2;3;5
89;16.07.2017;2017;07;07;Sunnuntai;12;4;16;5;6;11
89;16.07.2017;2017;07;08;Sunnuntai;9;17;26;4;6;10
89;16.07.2017;2017;07;09;Sunnuntai;26;31;57;14;20;34
89;16.07.2017;2017;07;10;Sunnuntai;34;70;104;23;28;51
89;16.07.2017;2017;07;11;Sunnuntai;91;130;221;42;51;93
89;16.07.2017;2017;07;12;Sunnuntai;115;192;307;53;55;108
89;16.07.2017;2017;07;13;Sunnuntai;163;169;332;69;74;143
89;16.07.2017;2017;07;14;Sunnuntai;195;201;396;109;101;210
89;16.07.2017;2017;07;15;Sunnuntai;154;181;335;100;77;177
89;16.07.2017;2017;07;16;Sunnuntai;186;183;369;107;60;167
89;16.07.2017;2017;07;17;Sunnuntai;181;170;351;87;84;171
89;16.07.2017;2017;07;18;Sunnuntai;153;156;309;43;54;97
89;16.07.2017;2017;07;19;Sunnuntai;142;115;257;35;57;92
89;16.07.2017;2017;07;20;Sunnuntai;111;96;207;25;29;54
89;16.07.2017;2017;07;21;Sunnuntai;43;61;104;18;27;45
89;16.07.2017;2017;07;22;Sunnuntai;52;39;91;6;15;21
89;16.07.2017;2017;07;23;Sunnuntai;6;13;19;4;5;9
89;17.07.2017;2017;07;00;Maanantai;18;16;34;14;11;25
89;17.07.2017;2017;07;01;Maanantai;5;7;12;1;2;3
89;17.07.2017;2017;07;02;Maanantai;21;9;30;21;16;37
89;17.07.2017;2017;07;03;Maanantai;13;4;17;1;1;2
89;17.07.2017;2017;07;04;Maanantai;9;5;14;4;0;4
89;17.07.2017;2017;07;05;Maanantai;6;20;26;1;2;3
89;17.07.2017;2017;07;06;Maanantai;18;65;83;3;9;12
89;17.07.2017;2017;07;07;Maanantai;26;102;128;4;8;12
89;17.07.2017;2017;07;08;Maanantai;24;120;144;4;26;30
89;17.07.2017;2017;07;09;Maanantai;35;114;149;8;18;26
89;17.07.2017;2017;07;10;Maanantai;48;128;176;12;37;49
89;17.07.2017;2017;07;11;Maanantai;82;139;221;33;65;98
89;17.07.2017;2017;07;12;Maanantai;96;170;266;28;51;79
89;17.07.2017;2017;07;13;Maanantai;137;134;271;28;33;61
89;17.07.2017;2017;07;14;Maanantai;193;116;309;45;54;99
89;17.07.2017;2017;07;15;Maanantai;163;100;263;27;31;58
89;17.07.2017;2017;07;16;Maanantai;173;83;256;32;32;64
89;17.07.2017;2017;07;17;Maanantai;120;120;240;31;43;74
89;17.07.2017;2017;07;18;Maanantai;145;90;235;38;29;67
89;17.07.2017;2017;07;19;Maanantai;138;95;233;45;34;79
89;17.07.2017;2017;07;20;Maanantai;78;41;119;25;26;51
89;17.07.2017;2017;07;21;Maanantai;59;31;90;18;17;35
89;17.07.2017;2017;07;22;Maanantai;41;16;57;8;5;13
89;17.07.2017;2017;07;23;Maanantai;13;17;30;3;5;8
89;18.07.2017;2017;07;00;Tiistai;10;5;15;0;2;2
89;18.07.2017;2017;07;01;Tiistai;5;5;10;2;0;2
89;18.07.2017;2017;07;02;Tiistai;3;1;4;2;1;3
89;18.07.2017;2017;07;03;Tiistai;1;2;3;3;0;3
89;18.07.2017;2017;07;04;Tiistai;1;5;6;0;1;1
89;18.07.2017;2017;07;05;Tiistai;2;16;18;0;2;2
89;18.07.2017;2017;07;06;Tiistai;12;49;61;2;6;8
89;18.07.2017;2017;07;07;Tiistai;17;56;73;2;7;9
89;18.07.2017;2017;07;08;Tiistai;13;61;74;2;17;19
89;18.07.2017;2017;07;09;Tiistai;17;25;42;1;12;13
89;18.07.2017;2017;07;10;Tiistai;17;36;53;5;7;12
89;18.07.2017;2017;07;11;Tiistai;20;34;54;9;19;28
89;18.07.2017;2017;07;12;Tiistai;28;50;78;15;30;45
89;18.07.2017;2017;07;13;Tiistai;35;65;100;20;27;47
89;18.07.2017;2017;07;14;Tiistai;71;66;137;20;27;47
89;18.07.2017;2017;07;15;Tiistai;93;73;166;34;21;55
89;18.07.2017;2017;07;16;Tiistai;104;70;174;27;21;48
89;18.07.2017;2017;07;17;Tiistai;87;77;164;25;25;50
89;18.07.2017;2017;07;18;Tiistai;65;29;94;20;21;41
89;18.07.2017;2017;07;19;Tiistai;53;43;96;21;17;38
89;18.07.2017;2017;07;20;Tiistai;34;25;59;11;19;30
89;18.07.2017;2017;07;21;Tiistai;33;21;54;9;8;17
89;18.07.2017;2017;07;22;Tiistai;10;16;26;5;5;10
89;18.07.2017;2017;07;23;Tiistai;15;4;19;1;4;5
89;19.07.2017;2017;07;00;Keskiviikko;9;9;18;2;3;5
89;19.07.2017;2017;07;01;Keskiviikko;7;0;7;0;0;0
89;19.07.2017;2017;07;02;Keskiviikko;0;1;1;0;0;0
89;19.07.2017;2017;07;03;Keskiviikko;6;1;7;0;2;2
89;19.07.2017;2017;07;04;Keskiviikko;5;3;8;2;1;3
89;19.07.2017;2017;07;05;Keskiviikko;4;20;24;0;1;1
89;19.07.2017;2017;07;06;Keskiviikko;10;63;73;3;12;15
89;19.07.2017;2017;07;07;Keskiviikko;18;73;91;2;11;13
89;19.07.2017;2017;07;08;Keskiviikko;21;107;128;6;16;22
89;19.07.2017;2017;07;09;Keskiviikko;25;73;98;14;19;33
89;19.07.2017;2017;07;10;Keskiviikko;23;83;106;18;38;56
89;19.07.2017;2017;07;11;Keskiviikko;57;83;140;18;35;53
89;19.07.2017;2017;07;12;Keskiviikko;76;129;205;23;37;60
89;19.07.2017;2017;07;13;Keskiviikko;80;130;210;25;43;68
89;19.07.2017;2017;07;14;Keskiviikko;119;86;205;40;31;71
89;19.07.2017;2017;07;15;Keskiviikko;140;84;224;41;36;77
89;19.07.2017;2017;07;16;Keskiviikko;128;98;226;26;32;58
89;19.07.2017;2017;07;17;Keskiviikko;83;71;154;37;47;84
89;19.07.2017;2017;07;18;Keskiviikko;91;82;173;33;49;82
89;19.07.2017;2017;07;19;Keskiviikko;78;61;139;24;43;67
89;19.07.2017;2017;07;20;Keskiviikko;128;84;212;26;47;73
89;19.07.2017;2017;07;21;Keskiviikko;126;114;240;24;39;63
89;19.07.2017;2017;07;22;Keskiviikko;83;75;158;20;19;39
89;19.07.2017;2017;07;23;Keskiviikko;33;23;56;8;14;22
89;20.07.2017;2017;07;00;Torstai;13;22;35;3;3;6
89;20.07.2017;2017;07;01;Torstai;8;7;15;5;3;8
89;20.07.2017;2017;07;02;Torstai;6;3;9;1;3;4
89;20.07.2017;2017;07;03;Torstai;10;1;11;0;0;0
89;20.07.2017;2017;07;04;Torstai;9;8;17;4;0;4
89;20.07.2017;2017;07;05;Torstai;3;16;19;1;2;3
89;20.07.2017;2017;07;06;Torstai;16;65;81;4;12;16
89;20.07.2017;2017;07;07;Torstai;18;85;103;2;13;15
89;20.07.2017;2017;07;08;Torstai;26;100;126;5;14;19
89;20.07.2017;2017;07;09;Torstai;31;99;130;13;24;37
89;20.07.2017;2017;07;10;Torstai;42;80;122;15;43;58
89;20.07.2017;2017;07;11;Torstai;54;92;146;32;49;81
89;20.07.2017;2017;07;12;Torstai;59;93;152;19;45;64
89;20.07.2017;2017;07;13;Torstai;104;92;196;46;38;84
89;20.07.2017;2017;07;14;Torstai;116;92;208;47;41;88
89;20.07.2017;2017;07;15;Torstai;161;69;230;34;36;70
89;20.07.2017;2017;07;16;Torstai;146;102;248;31;43;74
89;20.07.2017;2017;07;17;Torstai;103;82;185;33;19;52
89;20.07.2017;2017;07;18;Torstai;101;89;190;29;33;62
89;20.07.2017;2017;07;19;Torstai;92;83;175;21;26;47
89;20.07.2017;2017;07;20;Torstai;75;61;136;17;20;37
89;20.07.2017;2017;07;21;Torstai;42;19;61;5;5;10
89;20.07.2017;2017;07;22;Torstai;31;19;50;7;8;15
89;20.07.2017;2017;07;23;Torstai;16;16;32;5;6;11
89;21.07.2017;2017;07;00;Perjantai;13;11;24;2;2;4
89;21.07.2017;2017;07;01;Perjantai;8;6;14;3;1;4
89;21.07.2017;2017;07;02;Perjantai;6;4;10;1;0;1
89;21.07.2017;2017;07;03;Perjantai;9;5;14;1;0;1
89;21.07.2017;2017;07;04;Perjantai;4;3;7;1;1;2
89;21.07.2017;2017;07;05;Perjantai;4;9;13;1;3;4
89;21.07.2017;2017;07;06;Perjantai;11;61;72;2;10;12
89;21.07.2017;2017;07;07;Perjantai;11;59;70;3;13;16
89;21.07.2017;2017;07;08;Perjantai;13;95;108;8;25;33
89;21.07.2017;2017;07;09;Perjantai;34;94;128;8;26;34
89;21.07.2017;2017;07;10;Perjantai;47;99;146;18;38;56
89;21.07.2017;2017;07;11;Perjantai;71;94;165;36;40;76
89;21.07.2017;2017;07;12;Perjantai;68;96;164;24;28;52
89;21.07.2017;2017;07;13;Perjantai;94;126;220;17;36;53
89;21.07.2017;2017;07;14;Perjantai;133;99;232;22;14;36
89;21.07.2017;2017;07;15;Perjantai;132;63;195;24;27;51
89;21.07.2017;2017;07;16;Perjantai;113;65;178;14;12;26
89;21.07.2017;2017;07;17;Perjantai;82;76;158;25;26;51
89;21.07.2017;2017;07;18;Perjantai;106;77;183;29;25;54
89;21.07.2017;2017;07;19;Perjantai;69;74;143;19;32;51
89;21.07.2017;2017;07;20;Perjantai;59;64;123;19;13;32
89;21.07.2017;2017;07;21;Perjantai;65;52;117;21;24;45
89;21.07.2017;2017;07;22;Perjantai;39;34;73;9;10;19
89;21.07.2017;2017;07;23;Perjantai;28;35;63;12;6;18
89;22.07.2017;2017;07;00;Lauantai;28;19;47;5;0;5
89;22.07.2017;2017;07;01;Lauantai;20;16;36;4;6;10
89;22.07.2017;2017;07;02;Lauantai;21;7;28;3;2;5
89;22.07.2017;2017;07;03;Lauantai;29;5;34;3;2;5
89;22.07.2017;2017;07;04;Lauantai;13;1;14;3;1;4
89;22.07.2017;2017;07;05;Lauantai;5;5;10;1;3;4
89;22.07.2017;2017;07;06;Lauantai;5;24;29;2;2;4
89;22.07.2017;2017;07;07;Lauantai;2;13;15;4;7;11
89;22.07.2017;2017;07;08;Lauantai;13;24;37;7;10;17
89;22.07.2017;2017;07;09;Lauantai;12;65;77;11;23;34
89;22.07.2017;2017;07;10;Lauantai;34;69;103;29;32;61
89;22.07.2017;2017;07;11;Lauantai;57;92;149;14;49;63
89;22.07.2017;2017;07;12;Lauantai;61;122;183;20;33;53
89;22.07.2017;2017;07;13;Lauantai;82;83;165;32;46;78
89;22.07.2017;2017;07;14;Lauantai;101;95;196;33;36;69
89;22.07.2017;2017;07;15;Lauantai;103;82;185;39;38;77
89;22.07.2017;2017;07;16;Lauantai;106;111;217;34;27;61
89;22.07.2017;2017;07;17;Lauantai;107;96;203;31;41;72
89;22.07.2017;2017;07;18;Lauantai;100;116;216;22;35;57
89;22.07.2017;2017;07;19;Lauantai;76;68;144;33;27;60
89;22.07.2017;2017;07;20;Lauantai;50;95;145;14;39;53
89;22.07.2017;2017;07;21;Lauantai;51;65;116;17;27;44
89;22.07.2017;2017;07;22;Lauantai;42;38;80;9;8;17
89;22.07.2017;2017;07;23;Lauantai;48;43;91;6;12;18
89;23.07.2017;2017;07;00;Sunnuntai;32;27;59;8;9;17
89;23.07.2017;2017;07;01;Sunnuntai;30;5;35;7;7;14
89;23.07.2017;2017;07;02;Sunnuntai;37;14;51;4;2;6
89;23.07.2017;2017;07;03;Sunnuntai;41;6;47;13;2;15
89;23.07.2017;2017;07;04;Sunnuntai;11;1;12;8;0;8
89;23.07.2017;2017;07;05;Sunnuntai;8;5;13;5;3;8
89;23.07.2017;2017;07;06;Sunnuntai;6;11;17;3;3;6
89;23.07.2017;2017;07;07;Sunnuntai;4;6;10;1;3;4
89;23.07.2017;2017;07;08;Sunnuntai;7;23;30;8;4;12
89;23.07.2017;2017;07;09;Sunnuntai;17;39;56;11;23;34
89;23.07.2017;2017;07;10;Sunnuntai;32;63;95;24;44;68
89;23.07.2017;2017;07;11;Sunnuntai;65;95;160;34;42;76
89;23.07.2017;2017;07;12;Sunnuntai;62;84;146;20;53;73
89;23.07.2017;2017;07;13;Sunnuntai;80;85;165;30;42;72
89;23.07.2017;2017;07;14;Sunnuntai;89;94;183;34;40;74
89;23.07.2017;2017;07;15;Sunnuntai;64;71;135;30;34;64
89;23.07.2017;2017;07;16;Sunnuntai;59;36;95;25;14;39
89;23.07.2017;2017;07;17;Sunnuntai;52;39;91;9;14;23
89;23.07.2017;2017;07;18;Sunnuntai;54;31;85;19;24;43
89;23.07.2017;2017;07;19;Sunnuntai;45;37;82;16;16;32
89;23.07.2017;2017;07;20;Sunnuntai;37;30;67;20;29;49
89;23.07.2017;2017;07;21;Sunnuntai;38;33;71;21;13;34
89;23.07.2017;2017;07;22;Sunnuntai;35;24;59;21;3;24
89;23.07.2017;2017;07;23;Sunnuntai;18;16;34;4;5;9
89;24.07.2017;2017;07;00;Maanantai;11;6;17;5;1;6
89;24.07.2017;2017;07;01;Maanantai;9;4;13;2;2;4
89;24.07.2017;2017;07;02;Maanantai;5;6;11;1;1;2
89;24.07.2017;2017;07;03;Maanantai;6;2;8;0;1;1
89;24.07.2017;2017;07;04;Maanantai;0;2;2;4;0;4
89;24.07.2017;2017;07;05;Maanantai;3;11;14;0;3;3
89;24.07.2017;2017;07;06;Maanantai;17;72;89;4;6;10
89;24.07.2017;2017;07;07;Maanantai;15;107;122;2;13;15
89;24.07.2017;2017;07;08;Maanantai;17;114;131;9;22;31
89;24.07.2017;2017;07;09;Maanantai;44;98;142;11;15;26
89;24.07.2017;2017;07;10;Maanantai;46;118;164;19;43;62
89;24.07.2017;2017;07;11;Maanantai;67;125;192;33;45;78
89;24.07.2017;2017;07;12;Maanantai;102;162;264;27;42;69
89;24.07.2017;2017;07;13;Maanantai;122;131;253;36;38;74
89;24.07.2017;2017;07;14;Maanantai;152;97;249;32;39;71
89;24.07.2017;2017;07;15;Maanantai;215;131;346;48;38;86
89;24.07.2017;2017;07;16;Maanantai;211;114;325;36;39;75
89;24.07.2017;2017;07;17;Maanantai;132;109;241;43;49;92
89;24.07.2017;2017;07;18;Maanantai;112;98;210;52;49;101
89;24.07.2017;2017;07;19;Maanantai;112;86;198;31;50;81
89;24.07.2017;2017;07;20;Maanantai;85;46;131;34;44;78
89;24.07.2017;2017;07;21;Maanantai;82;44;126;34;21;55
89;24.07.2017;2017;07;22;Maanantai;40;24;64;11;4;15
89;24.07.2017;2017;07;23;Maanantai;29;22;51;3;4;7
89;25.07.2017;2017;07;00;Tiistai;18;8;26;9;6;15
89;25.07.2017;2017;07;01;Tiistai;5;6;11;2;1;3
89;25.07.2017;2017;07;02;Tiistai;5;5;10;4;3;7
89;25.07.2017;2017;07;03;Tiistai;10;0;10;0;2;2
89;25.07.2017;2017;07;04;Tiistai;5;3;8;1;0;1
89;25.07.2017;2017;07;05;Tiistai;2;13;15;1;1;2
89;25.07.2017;2017;07;06;Tiistai;19;79;98;2;7;9
89;25.07.2017;2017;07;07;Tiistai;12;114;126;7;14;21
89;25.07.2017;2017;07;08;Tiistai;33;126;159;10;23;33
89;25.07.2017;2017;07;09;Tiistai;41;110;151;11;32;43
89;25.07.2017;2017;07;10;Tiistai;67;125;192;21;25;46
89;25.07.2017;2017;07;11;Tiistai;93;173;266;28;44;72
89;25.07.2017;2017;07;12;Tiistai;117;152;269;32;40;72
89;25.07.2017;2017;07;13;Tiistai;132;138;270;32;51;83
89;25.07.2017;2017;07;14;Tiistai;170;137;307;38;33;71
89;25.07.2017;2017;07;15;Tiistai;256;111;367;40;30;70
89;25.07.2017;2017;07;16;Tiistai;224;155;379;32;34;66
89;25.07.2017;2017;07;17;Tiistai;179;217;396;35;43;78
89;25.07.2017;2017;07;18;Tiistai;215;144;359;43;54;97
89;25.07.2017;2017;07;19;Tiistai;208;159;367;62;55;117
89;25.07.2017;2017;07;20;Tiistai;135;121;256;36;34;70
89;25.07.2017;2017;07;21;Tiistai;108;86;194;26;20;46
89;25.07.2017;2017;07;22;Tiistai;52;55;107;12;20;32
89;25.07.2017;2017;07;23;Tiistai;46;22;68;14;7;21
89;26.07.2017;2017;07;00;Keskiviikko;27;15;42;5;7;12
89;26.07.2017;2017;07;01;Keskiviikko;17;8;25;3;1;4
89;26.07.2017;2017;07;02;Keskiviikko;11;8;19;2;2;4
89;26.07.2017;2017;07;03;Keskiviikko;14;3;17;0;1;1
89;26.07.2017;2017;07;04;Keskiviikko;8;2;10;1;0;1
89;26.07.2017;2017;07;05;Keskiviikko;3;12;15;3;1;4
89;26.07.2017;2017;07;06;Keskiviikko;18;74;92;2;9;11
89;26.07.2017;2017;07;07;Keskiviikko;23;121;144;5;13;18
89;26.07.2017;2017;07;08;Keskiviikko;30;141;171;14;20;34
89;26.07.2017;2017;07;09;Keskiviikko;51;118;169;10;30;40
89;26.07.2017;2017;07;10;Keskiviikko;74;150;224;24;34;58
89;26.07.2017;2017;07;11;Keskiviikko;128;192;320;33;65;98
89;26.07.2017;2017;07;12;Keskiviikko;160;238;398;38;46;84
89;26.07.2017;2017;07;13;Keskiviikko;215;206;421;42;43;85
89;26.07.2017;2017;07;14;Keskiviikko;202;154;356;43;59;102
89;26.07.2017;2017;07;15;Keskiviikko;283;253;536;50;55;105
89;26.07.2017;2017;07;16;Keskiviikko;296;202;498;51;60;111
89;26.07.2017;2017;07;17;Keskiviikko;238;254;492;54;50;104
89;26.07.2017;2017;07;18;Keskiviikko;220;248;468;36;65;101
89;26.07.2017;2017;07;19;Keskiviikko;224;201;425;50;64;114
89;26.07.2017;2017;07;20;Keskiviikko;175;155;330;38;35;73
89;26.07.2017;2017;07;21;Keskiviikko;104;82;186;24;31;55
89;26.07.2017;2017;07;22;Keskiviikko;88;69;157;21;28;49
89;26.07.2017;2017;07;23;Keskiviikko;62;18;80;8;9;17
89;27.07.2017;2017;07;00;Torstai;33;21;54;9;5;14
89;27.07.2017;2017;07;01;Torstai;23;6;29;6;5;11
89;27.07.2017;2017;07;02;Torstai;18;7;25;3;4;7
89;27.07.2017;2017;07;03;Torstai;13;5;18;3;3;6
89;27.07.2017;2017;07;04;Torstai;10;6;16;1;0;1
89;27.07.2017;2017;07;05;Torstai;5;17;22;3;1;4
89;27.07.2017;2017;07;06;Torstai;25;76;101;2;6;8
89;27.07.2017;2017;07;07;Torstai;21;115;136;4;19;23
89;27.07.2017;2017;07;08;Torstai;22;137;159;6;19;25
89;27.07.2017;2017;07;09;Torstai;37;112;149;15;28;43
89;27.07.2017;2017;07;10;Torstai;54;159;213;31;37;68
89;27.07.2017;2017;07;11;Torstai;116;184;300;23;71;94
89;27.07.2017;2017;07;12;Torstai;144;191;335;29;49;78
89;27.07.2017;2017;07;13;Torstai;175;227;402;33;47;80
89;27.07.2017;2017;07;14;Torstai;224;206;430;37;50;87
89;27.07.2017;2017;07;15;Torstai;252;221;473;41;49;90
89;27.07.2017;2017;07;16;Torstai;267;236;503;27;35;62
89;27.07.2017;2017;07;17;Torstai;241;189;430;32;46;78
89;27.07.2017;2017;07;18;Torstai;218;188;406;36;37;73
89;27.07.2017;2017;07;19;Torstai;211;176;387;56;48;104
89;27.07.2017;2017;07;20;Torstai;164;135;299;28;36;64
89;27.07.2017;2017;07;21;Torstai;112;101;213;26;28;54
89;27.07.2017;2017;07;22;Torstai;66;56;122;15;16;31
89;27.07.2017;2017;07;23;Torstai;66;20;86;19;15;34
89;28.07.2017;2017;07;00;Perjantai;38;19;57;6;7;13
89;28.07.2017;2017;07;01;Perjantai;11;16;27;3;5;8
89;28.07.2017;2017;07;02;Perjantai;5;7;12;6;9;15
89;28.07.2017;2017;07;03;Perjantai;7;4;11;3;1;4
89;28.07.2017;2017;07;04;Perjantai;6;4;10;1;0;1
89;28.07.2017;2017;07;05;Perjantai;4;12;16;0;1;1
89;28.07.2017;2017;07;06;Perjantai;16;43;59;4;6;10
89;28.07.2017;2017;07;07;Perjantai;17;91;108;1;9;10
89;28.07.2017;2017;07;08;Perjantai;27;118;145;9;18;27
89;28.07.2017;2017;07;09;Perjantai;34;118;152;9;25;34
89;28.07.2017;2017;07;10;Perjantai;82;149;231;19;41;60
89;28.07.2017;2017;07;11;Perjantai;110;162;272;20;32;52
89;28.07.2017;2017;07;12;Perjantai;116;211;327;31;45;76
89;28.07.2017;2017;07;13;Perjantai;140;167;307;23;37;60
89;28.07.2017;2017;07;14;Perjantai;192;220;412;35;36;71
89;28.07.2017;2017;07;15;Perjantai;216;228;444;38;41;79
89;28.07.2017;2017;07;16;Perjantai;205;207;412;26;33;59
89;28.07.2017;2017;07;17;Perjantai;192;239;431;27;55;82
89;28.07.2017;2017;07;18;Perjantai;175;236;411;42;56;98
89;28.07.2017;2017;07;19;Perjantai;152;240;392;29;57;86
89;28.07.2017;2017;07;20;Perjantai;116;224;340;36;50;86
89;28.07.2017;2017;07;21;Perjantai;118;147;265;34;54;88
89;28.07.2017;2017;07;22;Perjantai;111;102;213;14;25;39
89;28.07.2017;2017;07;23;Perjantai;117;47;164;17;18;35
89;29.07.2017;2017;07;00;Lauantai;130;40;170;26;23;49
89;29.07.2017;2017;07;01;Lauantai;160;35;195;26;17;43
89;29.07.2017;2017;07;02;Lauantai;95;11;106;27;4;31
89;29.07.2017;2017;07;03;Lauantai;76;7;83;30;1;31
89;29.07.2017;2017;07;04;Lauantai;41;8;49;12;4;16
89;29.07.2017;2017;07;05;Lauantai;15;6;21;6;3;9
89;29.07.2017;2017;07;06;Lauantai;8;13;21;3;3;6
89;29.07.2017;2017;07;07;Lauantai;16;16;32;5;2;7
89;29.07.2017;2017;07;08;Lauantai;17;26;43;7;12;19
89;29.07.2017;2017;07;09;Lauantai;21;60;81;13;15;28
89;29.07.2017;2017;07;10;Lauantai;33;62;95;11;23;34
89;29.07.2017;2017;07;11;Lauantai;56;93;149;16;28;44
89;29.07.2017;2017;07;12;Lauantai;64;88;152;28;32;60
89;29.07.2017;2017;07;13;Lauantai;46;80;126;17;21;38
89;29.07.2017;2017;07;14;Lauantai;75;136;211;20;31;51
89;29.07.2017;2017;07;15;Lauantai;80;93;173;18;27;45
89;29.07.2017;2017;07;16;Lauantai;64;124;188;17;17;34
89;29.07.2017;2017;07;17;Lauantai;113;131;244;29;34;63
89;29.07.2017;2017;07;18;Lauantai;103;123;226;23;42;65
89;29.07.2017;2017;07;19;Lauantai;111;151;262;26;30;56
89;29.07.2017;2017;07;20;Lauantai;85;127;212;14;35;49
89;29.07.2017;2017;07;21;Lauantai;63;106;169;12;32;44
89;29.07.2017;2017;07;22;Lauantai;64;89;153;10;17;27
89;29.07.2017;2017;07;23;Lauantai;65;61;126;8;6;14
89;30.07.2017;2017;07;00;Sunnuntai;85;25;110;12;6;18
89;30.07.2017;2017;07;01;Sunnuntai;192;42;234;18;13;31
89;30.07.2017;2017;07;02;Sunnuntai;99;15;114;20;6;26
89;30.07.2017;2017;07;03;Sunnuntai;52;8;60;20;4;24
89;30.07.2017;2017;07;04;Sunnuntai;58;5;63;25;2;27
89;30.07.2017;2017;07;05;Sunnuntai;24;6;30;14;3;17
89;30.07.2017;2017;07;06;Sunnuntai;12;8;20;4;1;5
89;30.07.2017;2017;07;07;Sunnuntai;10;7;17;2;5;7
89;30.07.2017;2017;07;08;Sunnuntai;7;14;21;9;9;18
89;30.07.2017;2017;07;09;Sunnuntai;20;42;62;7;19;26
89;30.07.2017;2017;07;10;Sunnuntai;42;76;118;12;34;46
89;30.07.2017;2017;07;11;Sunnuntai;62;110;172;29;55;84
89;30.07.2017;2017;07;12;Sunnuntai;114;148;262;33;51;84
89;30.07.2017;2017;07;13;Sunnuntai;125;194;319;40;59;99
89;30.07.2017;2017;07;14;Sunnuntai;170;157;327;52;68;120
89;30.07.2017;2017;07;15;Sunnuntai;178;158;336;65;54;119
89;30.07.2017;2017;07;16;Sunnuntai;180;159;339;50;56;106
89;30.07.2017;2017;07;17;Sunnuntai;155;175;330;56;52;108
89;30.07.2017;2017;07;18;Sunnuntai;165;146;311;37;51;88
89;30.07.2017;2017;07;19;Sunnuntai;155;128;283;58;70;128
89;30.07.2017;2017;07;20;Sunnuntai;125;95;220;40;26;66
89;30.07.2017;2017;07;21;Sunnuntai;79;56;135;23;25;48
89;30.07.2017;2017;07;22;Sunnuntai;43;27;70;9;23;32
89;30.07.2017;2017;07;23;Sunnuntai;24;23;47;4;8;12
89;31.07.2017;2017;07;00;Maanantai;12;10;22;1;7;8
89;31.07.2017;2017;07;01;Maanantai;16;10;26;6;0;6
89;31.07.2017;2017;07;02;Maanantai;4;1;5;0;1;1
89;31.07.2017;2017;07;03;Maanantai;6;7;13;4;2;6
89;31.07.2017;2017;07;04;Maanantai;2;6;8;0;0;0
89;31.07.2017;2017;07;05;Maanantai;4;22;26;1;2;3
89;31.07.2017;2017;07;06;Maanantai;21;66;87;2;3;5
89;31.07.2017;2017;07;07;Maanantai;25;120;145;7;16;23
89;31.07.2017;2017;07;08;Maanantai;29;136;165;3;21;24
89;31.07.2017;2017;07;09;Maanantai;47;115;162;16;25;41
89;31.07.2017;2017;07;10;Maanantai;36;78;114;15;29;44
89;31.07.2017;2017;07;11;Maanantai;74;117;191;35;47;82
89;31.07.2017;2017;07;12;Maanantai;120;117;237;34;31;65
89;31.07.2017;2017;07;13;Maanantai;148;147;295;41;42;83
89;31.07.2017;2017;07;14;Maanantai;155;153;308;44;42;86
89;31.07.2017;2017;07;15;Maanantai;202;200;402;56;56;112
89;31.07.2017;2017;07;16;Maanantai;213;211;424;60;58;118
89;31.07.2017;2017;07;17;Maanantai;205;202;407;56;58;114
89;31.07.2017;2017;07;18;Maanantai;178;175;353;51;49;100
89;31.07.2017;2017;07;19;Maanantai;135;133;268;36;39;75
89;31.07.2017;2017;07;20;Maanantai;76;75;151;22;20;42
89;31.07.2017;2017;07;21;Maanantai;47;44;91;12;14;26
89;31.07.2017;2017;07;22;Maanantai;24;21;45;7;5;12
89;31.07.2017;2017;07;23;Maanantai;15;13;28;2;6;8
89;01.08.2017;2017;08;00;Tiistai;5;4;9;3;0;3
89;01.08.2017;2017;08;01;Tiistai;3;1;4;0;1;1
89;01.08.2017;2017;08;02;Tiistai;4;2;6;1;0;1
89;01.08.2017;2017;08;03;Tiistai;3;2;5;0;1;1
89;01.08.2017;2017;08;04;Tiistai;5;3;8;3;0;3
89;01.08.2017;2017;08;05;Tiistai;12;9;21;1;5;6
89;01.08.2017;2017;08;06;Tiistai;35;33;68;11;8;19
89;01.08.2017;2017;08;07;Tiistai;75;73;148;19;22;41
89;01.08.2017;2017;08;08;Tiistai;89;89;178;26;23;49
89;01.08.2017;2017;08;09;Tiistai;68;66;134;18;20;38
89;01.08.2017;2017;08;10;Tiistai;84;82;166;24;22;46
89;01.08.2017;2017;08;11;Tiistai;98;97;195;26;29;55
89;01.08.2017;2017;08;12;Tiistai;126;123;249;37;33;70
89;01.08.2017;2017;08;13;Tiistai;137;135;272;36;39;75
89;01.08.2017;2017;08;14;Tiistai;133;130;263;38;36;74
89;01.08.2017;2017;08;15;Tiistai;177;174;351;47;50;97
89;01.08.2017;2017;08;16;Tiistai;188;187;375;55;51;106
89;01.08.2017;2017;08;17;Tiistai;164;163;327;45;46;91
89;01.08.2017;2017;08;18;Tiistai;182;179;361;52;49;101
89;01.08.2017;2017;08;19;Tiistai;138;136;274;38;39;77
89;01.08.2017;2017;08;20;Tiistai;107;105;212;31;28;59
89;01.08.2017;2017;08;21;Tiistai;60;59;119;16;17;33
89;01.08.2017;2017;08;22;Tiistai;32;30;62;9;8;17
89;01.08.2017;2017;08;23;Tiistai;15;14;29;3;5;8
89;02.08.2017;2017;08;00;Keskiviikko;13;11;24;5;1;6
89;02.08.2017;2017;08;01;Keskiviikko;10;9;19;1;5;6
89;02.08.2017;2017;08;02;Keskiviikko;5;4;9;3;0;3
89;02.08.2017;2017;08;03;Keskiviikko;5;4;9;0;3;3
89;02.08.2017;2017;08;04;Keskiviikko;7;5;12;3;0;3
89;02.08.2017;2017;08;05;Keskiviikko;15;13;28;3;6;9
89;02.08.2017;2017;08;06;Keskiviikko;39;37;76;11;9;20
89;02.08.2017;2017;08;07;Keskiviikko;83;79;162;22;23;45
89;02.08.2017;2017;08;08;Keskiviikko;82;80;162;24;22;46
89;02.08.2017;2017;08;09;Keskiviikko;73;72;145;20;22;42
89;02.08.2017;2017;08;10;Keskiviikko;78;76;154;22;21;43
89;02.08.2017;2017;08;11;Keskiviikko;128;126;254;35;36;71
89;02.08.2017;2017;08;12;Keskiviikko;141;138;279;41;37;78
89;02.08.2017;2017;08;13;Keskiviikko;139;138;277;37;40;77
89;02.08.2017;2017;08;14;Keskiviikko;138;136;274;39;37;76
89;02.08.2017;2017;08;15;Keskiviikko;185;183;368;50;53;103
89;02.08.2017;2017;08;16;Keskiviikko;204;203;407;58;56;114
89;02.08.2017;2017;08;17;Keskiviikko;155;154;309;42;45;87
89;02.08.2017;2017;08;18;Keskiviikko;121;119;240;35;32;67
89;02.08.2017;2017;08;19;Keskiviikko;115;113;228;31;32;63
89;02.08.2017;2017;08;20;Keskiviikko;79;76;155;22;21;43
89;02.08.2017;2017;08;21;Keskiviikko;60;58;118;15;18;33
89;02.08.2017;2017;08;22;Keskiviikko;36;34;70;11;8;19
89;02.08.2017;2017;08;23;Keskiviikko;27;25;52;7;7;14
89;03.08.2017;2017;08;00;Torstai;9;7;16;4;1;5
89;03.08.2017;2017;08;01;Torstai;9;7;16;0;4;4
89;03.08.2017;2017;08;02;Torstai;5;5;10;3;0;3
89;03.08.2017;2017;08;03;Torstai;5;3;8;0;2;2
89;03.08.2017;2017;08;04;Torstai;4;1;5;1;0;1
89;03.08.2017;2017;08;05;Torstai;6;5;11;1;3;4
89;03.08.2017;2017;08;06;Torstai;41;39;80;12;10;22
89;03.08.2017;2017;08;07;Torstai;72;69;141;18;22;40
89;03.08.2017;2017;08;08;Torstai;77;74;151;23;21;44
89;03.08.2017;2017;08;09;Torstai;84;82;166;22;25;47
89;03.08.2017;2017;08;10;Torstai;66;66;132;19;18;37
89;03.08.2017;2017;08;11;Torstai;88;88;176;22;26;48
89;03.08.2017;2017;08;12;Torstai;100;98;198;29;27;56
89;03.08.2017;2017;08;13;Torstai;115;113;228;31;33;64
89;03.08.2017;2017;08;14;Torstai;118;116;234;34;32;66
89;03.08.2017;2017;08;15;Torstai;151;150;301;41;43;84
89;03.08.2017;2017;08;16;Torstai;182;182;364;52;50;102
89;03.08.2017;2017;08;17;Torstai;170;167;337;47;47;94
89;03.08.2017;2017;08;18;Torstai;139;136;275;40;38;78
89;03.08.2017;2017;08;19;Torstai;126;124;250;35;36;71
89;03.08.2017;2017;08;20;Torstai;107;105;212;31;28;59
89;03.08.2017;2017;08;21;Torstai;67;63;130;16;20;36
89;03.08.2017;2017;08;22;Torstai;42;41;83;12;10;22
89;03.08.2017;2017;08;23;Torstai;21;20;41;4;8;12
89;04.08.2017;2017;08;00;Perjantai;14;11;25;4;3;7
89;04.08.2017;2017;08;01;Perjantai;6;4;10;0;2;2
89;04.08.2017;2017;08;02;Perjantai;5;4;9;3;0;3
89;04.08.2017;2017;08;03;Perjantai;10;7;17;1;4;5
89;04.08.2017;2017;08;04;Perjantai;6;2;8;1;0;1
89;04.08.2017;2017;08;05;Perjantai;12;9;21;1;4;5
89;04.08.2017;2017;08;06;Perjantai;37;35;72;10;9;19
89;04.08.2017;2017;08;07;Perjantai;65;63;128;17;19;36
89;04.08.2017;2017;08;08;Perjantai;70;68;138;21;19;40
89;04.08.2017;2017;08;09;Perjantai;70;69;139;19;20;39
89;04.08.2017;2017;08;10;Perjantai;69;68;137;19;19;38
89;04.08.2017;2017;08;11;Perjantai;100;100;200;26;29;55
89;04.08.2017;2017;08;12;Perjantai;135;131;266;39;36;75
89;04.08.2017;2017;08;13;Perjantai;133;132;265;37;38;75
89;04.08.2017;2017;08;14;Perjantai;143;141;284;41;39;80
89;04.08.2017;2017;08;15;Perjantai;168;167;335;46;47;93
89;04.08.2017;2017;08;16;Perjantai;173;170;343;48;48;96
89;04.08.2017;2017;08;17;Perjantai;173;173;346;49;49;98
89;04.08.2017;2017;08;18;Perjantai;137;136;273;38;38;76
89;04.08.2017;2017;08;19;Perjantai;119;117;236;31;34;65
89;04.08.2017;2017;08;20;Perjantai;101;99;200;28;27;55
89;04.08.2017;2017;08;21;Perjantai;93;91;184;25;27;52
89;04.08.2017;2017;08;22;Perjantai;68;66;134;20;18;38
89;04.08.2017;2017;08;23;Perjantai;86;84;170;23;24;47
89;05.08.2017;2017;08;00;Lauantai;58;58;116;17;15;32
89;05.08.2017;2017;08;01;Lauantai;40;40;80;10;12;22
89;05.08.2017;2017;08;02;Lauantai;16;12;28;6;3;9
89;05.08.2017;2017;08;03;Lauantai;12;10;22;2;4;6
89;05.08.2017;2017;08;04;Lauantai;13;9;22;4;1;5
89;05.08.2017;2017;08;05;Lauantai;8;6;14;1;4;5
89;05.08.2017;2017;08;06;Lauantai;9;8;17;4;0;4
89;05.08.2017;2017;08;07;Lauantai;14;11;25;3;5;8
89;05.08.2017;2017;08;08;Lauantai;22;19;41;7;5;12
89;05.08.2017;2017;08;09;Lauantai;41;39;80;9;13;22
89;05.08.2017;2017;08;10;Lauantai;55;55;110;17;14;31
89;05.08.2017;2017;08;11;Lauantai;54;53;107;14;16;30
89;05.08.2017;2017;08;12;Lauantai;60;57;117;19;15;34
89;05.08.2017;2017;08;13;Lauantai;92;89;181;24;26;50
89;05.08.2017;2017;08;14;Lauantai;91;89;180;25;25;50
89;05.08.2017;2017;08;15;Lauantai;104;101;205;28;30;58
89;05.08.2017;2017;08;16;Lauantai;108;105;213;31;28;59
89;05.08.2017;2017;08;17;Lauantai;100;98;198;26;29;55
89;05.08.2017;2017;08;18;Lauantai;72;70;142;21;19;40
89;05.08.2017;2017;08;19;Lauantai;50;47;97;13;14;27
89;05.08.2017;2017;08;20;Lauantai;47;45;92;14;12;26
89;05.08.2017;2017;08;21;Lauantai;38;36;74;9;11;20
89;05.08.2017;2017;08;22;Lauantai;30;28;58;9;8;17
89;05.08.2017;2017;08;23;Lauantai;48;48;96;13;14;27
89;06.08.2017;2017;08;00;Sunnuntai;96;94;190;28;26;54
89;06.08.2017;2017;08;01;Sunnuntai;18;16;34;4;6;10
89;06.08.2017;2017;08;02;Sunnuntai;20;18;38;6;4;10
89;06.08.2017;2017;08;03;Sunnuntai;13;10;23;1;5;6
89;06.08.2017;2017;08;04;Sunnuntai;19;18;37;6;4;10
89;06.08.2017;2017;08;05;Sunnuntai;7;5;12;1;2;3
89;06.08.2017;2017;08;06;Sunnuntai;5;2;7;2;0;2
89;06.08.2017;2017;08;07;Sunnuntai;7;5;12;0;4;4
89;06.08.2017;2017;08;08;Sunnuntai;9;7;16;4;1;5
89;06.08.2017;2017;08;09;Sunnuntai;22;19;41;4;7;11
89;06.08.2017;2017;08;10;Sunnuntai;38;36;74;11;10;21
89;06.08.2017;2017;08;11;Sunnuntai;47;47;94;12;14;26
89;06.08.2017;2017;08;12;Sunnuntai;48;46;94;14;13;27
89;06.08.2017;2017;08;13;Sunnuntai;76;74;150;20;22;42
89;06.08.2017;2017;08;14;Sunnuntai;65;62;127;18;17;35
89;06.08.2017;2017;08;15;Sunnuntai;76;73;149;19;23;42
89;06.08.2017;2017;08;16;Sunnuntai;83;82;165;24;22;46
89;06.08.2017;2017;08;17;Sunnuntai;76;74;150;20;22;42
89;06.08.2017;2017;08;18;Sunnuntai;53;51;104;15;14;29
89;06.08.2017;2017;08;19;Sunnuntai;46;44;90;12;13;25
89;06.08.2017;2017;08;20;Sunnuntai;49;47;96;15;13;28
89;06.08.2017;2017;08;21;Sunnuntai;33;33;66;9;9;18
89;06.08.2017;2017;08;22;Sunnuntai;14;13;27;5;3;8
89;06.08.2017;2017;08;23;Sunnuntai;11;10;21;2;4;6
89;07.08.2017;2017;08;00;Maanantai;13;11;24;5;2;7
89;07.08.2017;2017;08;01;Maanantai;5;2;7;0;2;2
89;07.08.2017;2017;08;02;Maanantai;3;3;6;3;0;3
89;07.08.2017;2017;08;03;Maanantai;7;5;12;0;4;4
89;07.08.2017;2017;08;04;Maanantai;8;5;13;2;1;3
89;07.08.2017;2017;08;05;Maanantai;12;9;21;2;4;6
89;07.08.2017;2017;08;06;Maanantai;38;36;74;12;9;21
89;07.08.2017;2017;08;07;Maanantai;102;99;201;28;28;56
89;07.08.2017;2017;08;08;Maanantai;99;97;196;28;26;54
89;07.08.2017;2017;08;09;Maanantai;79;78;157;21;23;44
89;07.08.2017;2017;08;10;Maanantai;79;77;156;23;20;43
89;07.08.2017;2017;08;11;Maanantai;98;96;194;26;29;55
89;07.08.2017;2017;08;12;Maanantai;103;100;203;29;27;56
89;07.08.2017;2017;08;13;Maanantai;94;93;187;25;27;52
89;07.08.2017;2017;08;14;Maanantai;119;117;236;34;32;66
89;07.08.2017;2017;08;15;Maanantai;144;143;287;39;40;79
89;07.08.2017;2017;08;16;Maanantai;166;164;330;47;45;92
89;07.08.2017;2017;08;17;Maanantai;134;131;265;36;39;75
89;07.08.2017;2017;08;18;Maanantai;113;112;225;32;30;62
89;07.08.2017;2017;08;19;Maanantai;88;86;174;24;25;49
89;07.08.2017;2017;08;20;Maanantai;65;62;127;18;17;35
89;07.08.2017;2017;08;21;Maanantai;42;39;81;11;12;23
89;07.08.2017;2017;08;22;Maanantai;25;22;47;8;5;13
89;07.08.2017;2017;08;23;Maanantai;18;16;34;4;6;10
89;08.08.2017;2017;08;00;Tiistai;10;7;17;3;2;5
89;08.08.2017;2017;08;01;Tiistai;7;3;10;0;2;2
89;08.08.2017;2017;08;02;Tiistai;2;0;2;0;0;0
89;08.08.2017;2017;08;03;Tiistai;2;0;2;0;0;0
89;08.08.2017;2017;08;04;Tiistai;5;2;7;1;0;1
89;08.08.2017;2017;08;05;Tiistai;11;8;19;2;3;5
89;08.08.2017;2017;08;06;Tiistai;41;39;80;12;10;22
89;08.08.2017;2017;08;07;Tiistai;96;93;189;25;28;53
89;08.08.2017;2017;08;08;Tiistai;118;116;234;33;33;66
89;08.08.2017;2017;08;09;Tiistai;71;68;139;18;20;38
89;08.08.2017;2017;08;10;Tiistai;87;85;172;25;23;48
89;08.08.2017;2017;08;11;Tiistai;100;97;197;27;29;56
89;08.08.2017;2017;08;12;Tiistai;121;119;240;34;34;68
89;08.08.2017;2017;08;13;Tiistai;136;133;269;37;39;76
89;08.08.2017;2017;08;14;Tiistai;128;126;254;36;34;70
89;08.08.2017;2017;08;15;Tiistai;165;164;329;46;46;92
89;08.08.2017;2017;08;16;Tiistai;203;201;404;58;56;114
89;08.08.2017;2017;08;17;Tiistai;174;173;347;48;50;98
89;08.08.2017;2017;08;18;Tiistai;100;99;199;28;27;55
89;08.08.2017;2017;08;19;Tiistai;64;62;126;16;19;35
89;08.08.2017;2017;08;20;Tiistai;60;59;119;17;16;33
89;08.08.2017;2017;08;21;Tiistai;40;37;77;9;12;21
89;08.08.2017;2017;08;22;Tiistai;27;25;52;8;6;14
89;08.08.2017;2017;08;23;Tiistai;10;8;18;2;4;6
89;09.08.2017;2017;08;00;Keskiviikko;9;7;16;4;1;5
89;09.08.2017;2017;08;01;Keskiviikko;5;2;7;0;2;2
89;09.08.2017;2017;08;02;Keskiviikko;3;2;5;2;0;2
89;09.08.2017;2017;08;03;Keskiviikko;3;1;4;0;1;1
89;09.08.2017;2017;08;04;Keskiviikko;5;2;7;2;0;2
89;09.08.2017;2017;08;05;Keskiviikko;9;7;16;1;3;4
89;09.08.2017;2017;08;06;Keskiviikko;31;28;59;9;7;16
89;09.08.2017;2017;08;07;Keskiviikko;99;95;194;26;28;54
89;09.08.2017;2017;08;08;Keskiviikko;116;115;231;33;31;64
89;09.08.2017;2017;08;09;Keskiviikko;100;97;197;26;29;55
89;09.08.2017;2017;08;10;Keskiviikko;82;79;161;24;22;46
89;09.08.2017;2017;08;11;Keskiviikko;120;119;239;33;34;67
89;09.08.2017;2017;08;12;Keskiviikko;128;125;253;37;35;72
89;09.08.2017;2017;08;13;Keskiviikko;145;143;288;40;42;82
89;09.08.2017;2017;08;14;Keskiviikko;174;172;346;50;47;97
89;09.08.2017;2017;08;15;Keskiviikko;196;195;391;54;56;110
89;09.08.2017;2017;08;16;Keskiviikko;214;214;428;61;58;119
89;09.08.2017;2017;08;17;Keskiviikko;187;184;371;50;53;103
89;09.08.2017;2017;08;18;Keskiviikko;155;151;306;44;41;85
89;09.08.2017;2017;08;19;Keskiviikko;122;120;242;33;35;68
89;09.08.2017;2017;08;20;Keskiviikko;89;86;175;26;24;50
89;09.08.2017;2017;08;21;Keskiviikko;63;59;122;17;17;34
89;09.08.2017;2017;08;22;Keskiviikko;28;27;55;8;7;15
89;09.08.2017;2017;08;23;Keskiviikko;25;21;46;5;8;13
89;10.08.2017;2017;08;00;Torstai;9;6;15;4;0;4
89;10.08.2017;2017;08;01;Torstai;3;3;6;0;2;2
89;10.08.2017;2017;08;02;Torstai;4;3;7;2;0;2
89;10.08.2017;2017;08;03;Torstai;7;5;12;0;4;4
89;10.08.2017;2017;08;04;Torstai;5;4;9;4;0;4
89;10.08.2017;2017;08;05;Torstai;9;6;15;1;4;5
89;10.08.2017;2017;08;06;Torstai;31;29;60;10;7;17
89;10.08.2017;2017;08;07;Torstai;85;83;168;22;25;47
89;10.08.2017;2017;08;08;Torstai;106;103;209;30;29;59
89;10.08.2017;2017;08;09;Torstai;87;85;172;23;25;48
89;10.08.2017;2017;08;10;Torstai;72;70;142;21;18;39
89;10.08.2017;2017;08;11;Torstai;65;61;126;16;19;35
89;10.08.2017;2017;08;12;Torstai;43;40;83;13;10;23
89;10.08.2017;2017;08;13;Torstai;42;40;82;10;13;23
89;10.08.2017;2017;08;14;Torstai;58;57;115;17;15;32
89;10.08.2017;2017;08;15;Torstai;88;86;174;23;26;49
89;10.08.2017;2017;08;16;Torstai;93;90;183;26;25;51
89;10.08.2017;2017;08;17;Torstai;84;82;166;22;24;46
89;10.08.2017;2017;08;18;Torstai;50;48;98;15;13;28
89;10.08.2017;2017;08;19;Torstai;53;51;104;14;15;29
89;10.08.2017;2017;08;20;Torstai;45;42;87;13;12;25
89;10.08.2017;2017;08;21;Torstai;30;30;60;8;9;17
89;10.08.2017;2017;08;22;Torstai;16;14;30;6;3;9
89;10.08.2017;2017;08;23;Torstai;10;8;18;1;4;5
89;11.08.2017;2017;08;00;Perjantai;6;4;10;3;0;3
89;11.08.2017;2017;08;01;Perjantai;2;1;3;0;1;1
89;11.08.2017;2017;08;02;Perjantai;4;2;6;2;0;2
89;11.08.2017;2017;08;03;Perjantai;4;3;7;0;2;2
89;11.08.2017;2017;08;04;Perjantai;2;1;3;1;0;1
89;11.08.2017;2017;08;05;Perjantai;9;9;18;2;3;5
89;11.08.2017;2017;08;06;Perjantai;30;27;57;9;7;16
89;11.08.2017;2017;08;07;Perjantai;94;91;185;25;28;53
89;11.08.2017;2017;08;08;Perjantai;120;118;238;34;32;66
89;11.08.2017;2017;08;09;Perjantai;86;83;169;22;25;47
89;11.08.2017;2017;08;10;Perjantai;73;71;144;21;19;40
89;11.08.2017;2017;08;11;Perjantai;84;82;166;22;24;46
89;11.08.2017;2017;08;12;Perjantai;107;106;213;31;28;59
89;11.08.2017;2017;08;13;Perjantai;127;124;251;35;36;71
89;11.08.2017;2017;08;14;Perjantai;147;145;292;41;40;81
89;11.08.2017;2017;08;15;Perjantai;142;140;282;39;40;79
89;11.08.2017;2017;08;16;Perjantai;147;144;291;41;40;81
89;11.08.2017;2017;08;17;Perjantai;124;121;245;33;36;69
89;11.08.2017;2017;08;18;Perjantai;110;107;217;32;29;61
89;11.08.2017;2017;08;19;Perjantai;98;96;194;26;29;55
89;11.08.2017;2017;08;20;Perjantai;81;79;160;24;22;46
89;11.08.2017;2017;08;21;Perjantai;73;71;144;19;21;40
89;11.08.2017;2017;08;22;Perjantai;38;36;74;10;9;19
89;11.08.2017;2017;08;23;Perjantai;28;26;54;6;9;15
89;12.08.2017;2017;08;00;Lauantai;24;21;45;8;6;14
89;12.08.2017;2017;08;01;Lauantai;20;18;38;5;6;11
89;12.08.2017;2017;08;02;Lauantai;13;10;23;5;2;7
89;12.08.2017;2017;08;03;Lauantai;11;8;19;1;4;5
89;12.08.2017;2017;08;04;Lauantai;13;11;24;5;1;6
89;12.08.2017;2017;08;05;Lauantai;8;6;14;1;3;4
89;12.08.2017;2017;08;06;Lauantai;8;5;13;2;1;3
89;12.08.2017;2017;08;07;Lauantai;8;6;14;0;4;4
89;12.08.2017;2017;08;08;Lauantai;31;30;61;9;7;16
89;12.08.2017;2017;08;09;Lauantai;47;46;93;12;15;27
89;12.08.2017;2017;08;10;Lauantai;81;80;161;23;22;45
89;12.08.2017;2017;08;11;Lauantai;124;122;246;33;35;68
89;12.08.2017;2017;08;12;Lauantai;142;140;282;40;39;79
89;12.08.2017;2017;08;13;Lauantai;170;170;340;47;48;95
89;12.08.2017;2017;08;14;Lauantai;167;164;331;46;46;92
89;12.08.2017;2017;08;15;Lauantai;161;158;319;44;45;89
89;12.08.2017;2017;08;16;Lauantai;135;132;267;39;35;74
89;12.08.2017;2017;08;17;Lauantai;119;118;237;32;35;67
89;12.08.2017;2017;08;18;Lauantai;108;104;212;30;29;59
89;12.08.2017;2017;08;19;Lauantai;103;102;205;29;29;58
89;12.08.2017;2017;08;20;Lauantai;78;75;153;23;20;43
89;12.08.2017;2017;08;21;Lauantai;61;58;119;16;18;34
89;12.08.2017;2017;08;22;Lauantai;44;43;87;12;12;24
89;12.08.2017;2017;08;23;Lauantai;41;38;79;10;12;22
89;13.08.2017;2017;08;00;Sunnuntai;36;35;71;11;8;19
89;13.08.2017;2017;08;01;Sunnuntai;25;23;48;6;8;14
89;13.08.2017;2017;08;02;Sunnuntai;17;16;33;6;4;10
89;13.08.2017;2017;08;03;Sunnuntai;17;14;31;3;5;8
89;13.08.2017;2017;08;04;Sunnuntai;14;10;24;5;1;6
89;13.08.2017;2017;08;05;Sunnuntai;6;5;11;0;4;4
89;13.08.2017;2017;08;06;Sunnuntai;9;6;15;4;1;5
89;13.08.2017;2017;08;07;Sunnuntai;4;2;6;0;2;2
89;13.08.2017;2017;08;08;Sunnuntai;5;3;8;1;1;2
89;13.08.2017;2017;08;09;Sunnuntai;11;8;19;2;4;6
89;13.08.2017;2017;08;10;Sunnuntai;26;25;51;8;6;14
89;13.08.2017;2017;08;11;Sunnuntai;30;28;58;6;9;15
89;13.08.2017;2017;08;12;Sunnuntai;25;22;47;7;5;12
89;13.08.2017;2017;08;13;Sunnuntai;29;27;56;7;8;15
89;13.08.2017;2017;08;14;Sunnuntai;30;29;59;9;7;16
89;13.08.2017;2017;08;15;Sunnuntai;40;38;78;9;13;22
89;13.08.2017;2017;08;16;Sunnuntai;30;28;58;9;8;17
89;13.08.2017;2017;08;17;Sunnuntai;43;40;83;10;13;23
89;13.08.2017;2017;08;18;Sunnuntai;39;37;76;11;10;21
89;13.08.2017;2017;08;19;Sunnuntai;40;37;77;11;11;22
89;13.08.2017;2017;08;20;Sunnuntai;36;36;72;11;10;21
89;13.08.2017;2017;08;21;Sunnuntai;29;26;55;6;9;15
89;13.08.2017;2017;08;22;Sunnuntai;13;13;26;5;3;8
89;13.08.2017;2017;08;23;Sunnuntai;8;5;13;1;2;3
89;14.08.2017;2017;08;00;Maanantai;6;2;8;2;0;2
89;14.08.2017;2017;08;01;Maanantai;4;2;6;0;1;1
89;14.08.2017;2017;08;02;Maanantai;3;2;5;2;0;2
89;14.08.2017;2017;08;03;Maanantai;3;2;5;0;2;2
89;14.08.2017;2017;08;04;Maanantai;5;3;8;3;0;3
89;14.08.2017;2017;08;05;Maanantai;9;6;15;1;3;4
89;14.08.2017;2017;08;06;Maanantai;31;30;61;10;7;17
89;14.08.2017;2017;08;07;Maanantai;114;113;227;30;33;63
89;14.08.2017;2017;08;08;Maanantai;122;120;242;34;33;67
89;14.08.2017;2017;08;09;Maanantai;89;86;175;23;26;49
89;14.08.2017;2017;08;10;Maanantai;68;67;135;19;19;38
89;14.08.2017;2017;08;11;Maanantai;76;74;150;20;22;42
89;14.08.2017;2017;08;12;Maanantai;102;100;202;28;28;56
89;14.08.2017;2017;08;13;Maanantai;88;86;174;24;24;48
89;14.08.2017;2017;08;14;Maanantai;143;141;284;40;39;79
89;14.08.2017;2017;08;15;Maanantai;161;159;320;44;46;90
89;14.08.2017;2017;08;16;Maanantai;171;169;340;48;47;95
89;14.08.2017;2017;08;17;Maanantai;141;139;280;39;40;79
89;14.08.2017;2017;08;18;Maanantai;100;97;197;29;26;55
89;14.08.2017;2017;08;19;Maanantai;101;99;200;27;29;56
89;14.08.2017;2017;08;20;Maanantai;65;63;128;18;17;35
89;14.08.2017;2017;08;21;Maanantai;33;30;63;8;10;18
89;14.08.2017;2017;08;22;Maanantai;23;21;44;7;5;12
89;14.08.2017;2017;08;23;Maanantai;24;20;44;4;8;12
89;15.08.2017;2017;08;00;Tiistai;7;5;12;3;1;4
89;15.08.2017;2017;08;01;Tiistai;4;2;6;0;2;2
89;15.08.2017;2017;08;02;Tiistai;1;1;2;1;0;1
89;15.08.2017;2017;08;03;Tiistai;3;1;4;0;1;1
89;15.08.2017;2017;08;04;Tiistai;3;2;5;2;0;2
89;15.08.2017;2017;08;05;Tiistai;7;7;14;1;3;4
89;15.08.2017;2017;08;06;Tiistai;41;39;80;12;11;23
89;15.08.2017;2017;08;07;Tiistai;122;119;241;32;35;67
89;15.08.2017;2017;08;08;Tiistai;142;141;283;41;38;79
89;15.08.2017;2017;08;09;Tiistai;93;92;185;25;26;51
89;15.08.2017;2017;08;10;Tiistai;66;63;129;19;17;36
89;15.08.2017;2017;08;11;Tiistai;80;76;156;22;22;44
89;15.08.2017;2017;08;12;Tiistai;95;94;189;27;26;53
89;15.08.2017;2017;08;13;Tiistai;105;104;209;27;30;57
89;15.08.2017;2017;08;14;Tiistai;127;125;252;36;35;71
89;15.08.2017;2017;08;15;Tiistai;132;130;262;36;38;74
89;15.08.2017;2017;08;16;Tiistai;170;169;339;48;46;94
89;15.08.2017;2017;08;17;Tiistai;143;140;283;39;40;79
89;15.08.2017;2017;08;18;Tiistai;110;108;218;31;31;62
89;15.08.2017;2017;08;19;Tiistai;91;89;180;25;26;51
89;15.08.2017;2017;08;20;Tiistai;71;70;141;21;19;40
89;15.08.2017;2017;08;21;Tiistai;49;47;96;13;14;27
89;15.08.2017;2017;08;22;Tiistai;24;22;46;8;5;13
89;15.08.2017;2017;08;23;Tiistai;9;7;16;1;3;4
89;16.08.2017;2017;08;00;Keskiviikko;6;4;10;3;0;3
89;16.08.2017;2017;08;01;Keskiviikko;6;5;11;0;3;3
89;16.08.2017;2017;08;02;Keskiviikko;3;2;5;1;0;1
89;16.08.2017;2017;08;03;Keskiviikko;4;1;5;0;1;1
89;16.08.2017;2017;08;04;Keskiviikko;5;2;7;1;0;1
89;16.08.2017;2017;08;05;Keskiviikko;14;11;25;2;5;7
89;16.08.2017;2017;08;06;Keskiviikko;39;37;76;11;10;21
89;16.08.2017;2017;08;07;Keskiviikko;119;119;238;33;34;67
89;16.08.2017;2017;08;08;Keskiviikko;145;143;288;41;40;81
89;16.08.2017;2017;08;09;Keskiviikko;86;84;170;23;24;47
89;16.08.2017;2017;08;10;Keskiviikko;78;77;155;22;21;43
89;16.08.2017;2017;08;11;Keskiviikko;98;95;193;26;28;54
89;16.08.2017;2017;08;12;Keskiviikko;102;100;202;30;27;57
89;16.08.2017;2017;08;13;Keskiviikko;105;103;208;27;30;57
89;16.08.2017;2017;08;14;Keskiviikko;139;138;277;39;38;77
89;16.08.2017;2017;08;15;Keskiviikko;166;163;329;45;47;92
89;16.08.2017;2017;08;16;Keskiviikko;207;205;412;58;56;114
89;16.08.2017;2017;08;17;Keskiviikko;140;139;279;38;41;79
89;16.08.2017;2017;08;18;Keskiviikko;119;116;235;34;32;66
89;16.08.2017;2017;08;19;Keskiviikko;101;100;201;27;29;56
89;16.08.2017;2017;08;20;Keskiviikko;88;88;176;26;24;50
89;16.08.2017;2017;08;21;Keskiviikko;58;55;113;14;17;31
89;16.08.2017;2017;08;22;Keskiviikko;23;21;44;7;6;13
89;16.08.2017;2017;08;23;Keskiviikko;22;20;42;5;7;12
89;17.08.2017;2017;08;00;Torstai;8;6;14;3;1;4
89;17.08.2017;2017;08;01;Torstai;6;4;10;1;1;2
89;17.08.2017;2017;08;02;Torstai;2;0;2;0;0;0
89;17.08.2017;2017;08;03;Torstai;2;1;3;0;1;1
89;17.08.2017;2017;08;04;Torstai;4;3;7;3;0;3
89;17.08.2017;2017;08;05;Torstai;9;8;17;1;4;5
89;17.08.2017;2017;08;06;Torstai;38;35;73;11;9;20
89;17.08.2017;2017;08;07;Torstai;101;98;199;27;28;55
89;17.08.2017;2017;08;08;Torstai;124;122;246;35;34;69
89;17.08.2017;2017;08;09;Torstai;70;68;138;18;21;39
89;17.08.2017;2017;08;10;Torstai;64;63;127;19;16;35
89;17.08.2017;2017;08;11;Torstai;84;81;165;22;24;46
89;17.08.2017;2017;08;12;Torstai;92;91;183;27;25;52
89;17.08.2017;2017;08;13;Torstai;118;117;235;31;35;66
89;17.08.2017;2017;08;14;Torstai;145;142;287;42;38;80
89;17.08.2017;2017;08;15;Torstai;185;183;368;51;52;103
89;17.08.2017;2017;08;16;Torstai;225;224;449;64;61;125
89;17.08.2017;2017;08;17;Torstai;209;209;418;57;60;117
89;17.08.2017;2017;08;18;Torstai;199;196;395;57;53;110
89;17.08.2017;2017;08;19;Torstai;210;209;419;58;60;118
89;17.08.2017;2017;08;20;Torstai;169;168;337;48;46;94
89;17.08.2017;2017;08;21;Torstai;129;126;255;35;37;72
89;17.08.2017;2017;08;22;Torstai;95;93;188;27;25;52
89;17.08.2017;2017;08;23;Torstai;60;59;119;17;17;34
89;18.08.2017;2017;08;00;Perjantai;33;30;63;9;8;17
89;18.08.2017;2017;08;01;Perjantai;14;13;27;2;5;7
89;18.08.2017;2017;08;02;Perjantai;12;11;23;6;2;8
89;18.08.2017;2017;08;03;Perjantai;10;8;18;2;4;6
89;18.08.2017;2017;08;04;Perjantai;9;5;14;4;0;4
89;18.08.2017;2017;08;05;Perjantai;9;6;15;0;4;4
89;18.08.2017;2017;08;06;Perjantai;37;34;71;12;8;20
89;18.08.2017;2017;08;07;Perjantai;100;99;199;27;29;56
89;18.08.2017;2017;08;08;Perjantai;101;100;201;29;27;56
89;18.08.2017;2017;08;09;Perjantai;81;77;158;20;24;44
89;18.08.2017;2017;08;10;Perjantai;63;61;124;18;16;34
89;18.08.2017;2017;08;11;Perjantai;86;82;168;22;25;47
89;18.08.2017;2017;08;12;Perjantai;103;102;205;29;28;57
89;18.08.2017;2017;08;13;Perjantai;114;112;226;31;32;63
89;18.08.2017;2017;08;14;Perjantai;130;127;257;37;36;73
89;18.08.2017;2017;08;15;Perjantai;131;127;258;35;37;72
89;18.08.2017;2017;08;16;Perjantai;126;126;252;36;35;71
89;18.08.2017;2017;08;17;Perjantai;119;117;236;31;35;66
89;18.08.2017;2017;08;18;Perjantai;87;85;172;25;23;48
89;18.08.2017;2017;08;19;Perjantai;87;85;172;24;25;49
89;18.08.2017;2017;08;20;Perjantai;73;71;144;21;18;39
89;18.08.2017;2017;08;21;Perjantai;72;70;142;19;21;40
89;18.08.2017;2017;08;22;Perjantai;25;23;48;9;5;14
89;18.08.2017;2017;08;23;Perjantai;22;19;41;4;7;11
89;19.08.2017;2017;08;00;Lauantai;26;23;49;8;6;14
89;19.08.2017;2017;08;01;Lauantai;13;13;26;2;5;7
89;19.08.2017;2017;08;02;Lauantai;11;9;20;4;1;5
89;19.08.2017;2017;08;03;Lauantai;8;6;14;0;4;4
89;19.08.2017;2017;08;04;Lauantai;9;6;15;4;0;4
89;19.08.2017;2017;08;05;Lauantai;5;2;7;0;2;2
89;19.08.2017;2017;08;06;Lauantai;9;7;16;4;0;4
89;19.08.2017;2017;08;07;Lauantai;9;8;17;0;4;4
89;19.08.2017;2017;08;08;Lauantai;19;17;36;6;4;10
89;19.08.2017;2017;08;09;Lauantai;46;44;90;11;14;25
89;19.08.2017;2017;08;10;Lauantai;59;58;117;17;16;33
89;19.08.2017;2017;08;11;Lauantai;98;96;194;26;29;55
89;19.08.2017;2017;08;12;Lauantai;130;129;259;37;35;72
89;19.08.2017;2017;08;13;Lauantai;144;143;287;39;42;81
89;19.08.2017;2017;08;14;Lauantai;138;137;275;40;37;77
89;19.08.2017;2017;08;15;Lauantai;130;129;259;35;38;73
89;19.08.2017;2017;08;16;Lauantai;96;94;190;28;25;53
89;19.08.2017;2017;08;17;Lauantai;90;89;179;23;26;49
89;19.08.2017;2017;08;18;Lauantai;55;54;109;16;14;30
89;19.08.2017;2017;08;19;Lauantai;39;37;76;10;12;22
89;19.08.2017;2017;08;20;Lauantai;29;27;56;9;7;16
89;19.08.2017;2017;08;21;Lauantai;34;30;64;8;11;19
89;19.08.2017;2017;08;22;Lauantai;24;23;47;7;6;13
89;19.08.2017;2017;08;23;Lauantai;20;18;38;4;6;10
89;20.08.2017;2017;08;00;Sunnuntai;20;18;38;6;5;11
89;20.08.2017;2017;08;01;Sunnuntai;17;15;32;4;6;10
89;20.08.2017;2017;08;02;Sunnuntai;9;7;16;4;0;4
89;20.08.2017;2017;08;03;Sunnuntai;13;10;23;1;5;6
89;20.08.2017;2017;08;04;Sunnuntai;10;8;18;4;1;5
89;20.08.2017;2017;08;05;Sunnuntai;8;7;15;1;3;4
89;20.08.2017;2017;08;06;Sunnuntai;8;7;15;2;2;4
89;20.08.2017;2017;08;07;Sunnuntai;9;6;15;1;3;4
89;20.08.2017;2017;08;08;Sunnuntai;13;9;22;4;2;6
89;20.08.2017;2017;08;09;Sunnuntai;27;25;52;6;9;15
89;20.08.2017;2017;08;10;Sunnuntai;41;39;80;12;11;23
89;20.08.2017;2017;08;11;Sunnuntai;84;84;168;23;25;48
89;20.08.2017;2017;08;12;Sunnuntai;87;84;171;25;23;48
89;20.08.2017;2017;08;13;Sunnuntai;96;96;192;25;28;53
89;20.08.2017;2017;08;14;Sunnuntai;93;91;184;26;25;51
89;20.08.2017;2017;08;15;Sunnuntai;80;79;159;21;23;44
89;20.08.2017;2017;08;16;Sunnuntai;69;67;136;20;18;38
89;20.08.2017;2017;08;17;Sunnuntai;70;67;137;19;19;38
89;20.08.2017;2017;08;18;Sunnuntai;62;60;122;18;16;34
89;20.08.2017;2017;08;19;Sunnuntai;59;56;115;15;18;33
89;20.08.2017;2017;08;20;Sunnuntai;54;52;106;16;13;29
89;20.08.2017;2017;08;21;Sunnuntai;33;31;64;8;10;18
89;20.08.2017;2017;08;22;Sunnuntai;18;18;36;6;5;11
89;20.08.2017;2017;08;23;Sunnuntai;10;9;19;1;5;6
89;21.08.2017;2017;08;00;Maanantai;8;6;14;4;0;4
89;21.08.2017;2017;08;01;Maanantai;4;4;8;0;2;2
89;21.08.2017;2017;08;02;Maanantai;3;1;4;1;0;1
89;21.08.2017;2017;08;03;Maanantai;3;2;5;0;2;2
89;21.08.2017;2017;08;04;Maanantai;9;6;15;4;0;4
89;21.08.2017;2017;08;05;Maanantai;11;9;20;1;4;5
89;21.08.2017;2017;08;06;Maanantai;41;40;81;12;11;23
89;21.08.2017;2017;08;07;Maanantai;114;112;226;31;33;64
89;21.08.2017;2017;08;08;Maanantai;138;136;274;40;38;78
89;21.08.2017;2017;08;09;Maanantai;76;73;149;20;22;42
89;21.08.2017;2017;08;10;Maanantai;74;72;146;22;19;41
89;21.08.2017;2017;08;11;Maanantai;76;74;150;20;22;42
89;21.08.2017;2017;08;12;Maanantai;73;71;144;21;19;40
89;21.08.2017;2017;08;13;Maanantai;98;96;194;26;28;54
89;21.08.2017;2017;08;14;Maanantai;121;117;238;34;32;66
89;21.08.2017;2017;08;15;Maanantai;141;138;279;39;40;79
89;21.08.2017;2017;08;16;Maanantai;188;185;373;54;50;104
89;21.08.2017;2017;08;17;Maanantai;120;118;238;32;34;66
89;21.08.2017;2017;08;18;Maanantai;111;110;221;32;30;62
89;21.08.2017;2017;08;19;Maanantai;86;84;170;23;25;48
89;21.08.2017;2017;08;20;Maanantai;58;54;112;16;15;31
89;21.08.2017;2017;08;21;Maanantai;28;27;55;6;9;15
89;21.08.2017;2017;08;22;Maanantai;19;18;37;6;4;10
89;21.08.2017;2017;08;23;Maanantai;9;6;15;1;3;4
89;22.08.2017;2017;08;00;Tiistai;3;2;5;2;0;2
89;22.08.2017;2017;08;01;Tiistai;4;2;6;0;2;2
89;22.08.2017;2017;08;02;Tiistai;2;0;2;0;0;0
89;22.08.2017;2017;08;03;Tiistai;1;0;1;0;0;0
89;22.08.2017;2017;08;04;Tiistai;4;2;6;2;0;2
89;22.08.2017;2017;08;05;Tiistai;10;7;17;2;3;5
89;22.08.2017;2017;08;06;Tiistai;43;41;84;12;11;23
89;22.08.2017;2017;08;07;Tiistai;106;103;209;29;30;59
89;22.08.2017;2017;08;08;Tiistai;139;137;276;39;38;77
89;22.08.2017;2017;08;09;Tiistai;72;71;143;20;21;41
89;22.08.2017;2017;08;10;Tiistai;67;66;133;19;19;38
89;22.08.2017;2017;08;11;Tiistai;79;78;157;20;23;43
89;22.08.2017;2017;08;12;Tiistai;85;82;167;24;22;46
89;22.08.2017;2017;08;13;Tiistai;79;75;154;20;23;43
89;22.08.2017;2017;08;14;Tiistai;109;107;216;31;29;60
89;22.08.2017;2017;08;15;Tiistai;144;143;287;40;41;81
89;22.08.2017;2017;08;16;Tiistai;178;177;355;50;48;98
89;22.08.2017;2017;08;17;Tiistai;126;123;249;33;36;69
89;22.08.2017;2017;08;18;Tiistai;91;89;180;27;24;51
89;22.08.2017;2017;08;19;Tiistai;83;82;165;22;25;47
89;22.08.2017;2017;08;20;Tiistai;60;59;119;17;16;33
89;22.08.2017;2017;08;21;Tiistai;34;33;67;8;10;18
89;22.08.2017;2017;08;22;Tiistai;25;22;47;7;6;13
89;22.08.2017;2017;08;23;Tiistai;10;9;19;2;3;5
89;23.08.2017;2017;08;00;Keskiviikko;9;6;15;4;1;5
89;23.08.2017;2017;08;01;Keskiviikko;2;0;2;0;0;0
89;23.08.2017;2017;08;02;Keskiviikko;1;0;1;0;0;0
89;23.08.2017;2017;08;03;Keskiviikko;2;0;2;0;0;0
89;23.08.2017;2017;08;04;Keskiviikko;3;1;4;1;0;1
89;23.08.2017;2017;08;05;Keskiviikko;13;10;23;2;5;7
89;23.08.2017;2017;08;06;Keskiviikko;34;32;66;10;8;18
89;23.08.2017;2017;08;07;Keskiviikko;118;115;233;33;33;66
89;23.08.2017;2017;08;08;Keskiviikko;128;125;253;38;34;72
89;23.08.2017;2017;08;09;Keskiviikko;82;79;161;21;23;44
89;23.08.2017;2017;08;10;Keskiviikko;62;59;121;18;16;34
89;23.08.2017;2017;08;11;Keskiviikko;77;74;151;20;22;42
89;23.08.2017;2017;08;12;Keskiviikko;92;89;181;27;23;50
89;23.08.2017;2017;08;13;Keskiviikko;100;99;199;26;29;55
89;23.08.2017;2017;08;14;Keskiviikko;123;122;245;35;33;68
89;23.08.2017;2017;08;15;Keskiviikko;140;139;279;38;40;78
89;23.08.2017;2017;08;16;Keskiviikko;161;160;321;45;44;89
89;23.08.2017;2017;08;17;Keskiviikko;127;125;252;33;37;70
89;23.08.2017;2017;08;18;Keskiviikko;94;91;185;27;25;52
89;23.08.2017;2017;08;19;Keskiviikko;68;66;134;18;20;38
89;23.08.2017;2017;08;20;Keskiviikko;63;60;123;18;17;35
89;23.08.2017;2017;08;21;Keskiviikko;39;37;76;9;12;21
89;23.08.2017;2017;08;22;Keskiviikko;16;14;30;6;2;8
89;23.08.2017;2017;08;23;Keskiviikko;14;13;27;2;5;7
89;24.08.2017;2017;08;00;Torstai;11;10;21;4;2;6
89;24.08.2017;2017;08;01;Torstai;2;0;2;0;0;0
89;24.08.2017;2017;08;02;Torstai;3;1;4;1;0;1
89;24.08.2017;2017;08;03;Torstai;4;1;5;0;1;1
89;24.08.2017;2017;08;04;Torstai;5;4;9;3;0;3
89;24.08.2017;2017;08;05;Torstai;12;9;21;1;5;6
89;24.08.2017;2017;08;06;Torstai;31;30;61;9;8;17
89;24.08.2017;2017;08;07;Torstai;104;102;206;27;30;57
89;24.08.2017;2017;08;08;Torstai;121;118;239;35;32;67
89;24.08.2017;2017;08;09;Torstai;67;66;133;18;20;38
89;24.08.2017;2017;08;10;Torstai;69;68;137;20;19;39
89;24.08.2017;2017;08;11;Torstai;79;78;157;21;23;44
89;24.08.2017;2017;08;12;Torstai;96;94;190;28;26;54
89;24.08.2017;2017;08;13;Torstai;115;113;228;32;33;65
89;24.08.2017;2017;08;14;Torstai;119;116;235;34;32;66
89;24.08.2017;2017;08;15;Torstai;154;151;305;42;42;84
89;24.08.2017;2017;08;16;Torstai;173;170;343;49;47;96
89;24.08.2017;2017;08;17;Torstai;148;145;293;40;41;81
89;24.08.2017;2017;08;18;Torstai;108;107;215;31;29;60
89;24.08.2017;2017;08;19;Torstai;97;94;191;26;27;53
89;24.08.2017;2017;08;20;Torstai;70;68;138;20;18;38
89;24.08.2017;2017;08;21;Torstai;46;45;91;12;14;26
89;24.08.2017;2017;08;22;Torstai;26;22;48;9;6;15
89;24.08.2017;2017;08;23;Torstai;15;14;29;3;4;7
89;25.08.2017;2017;08;00;Perjantai;7;4;11;3;0;3
89;25.08.2017;2017;08;01;Perjantai;10;8;18;1;3;4
89;25.08.2017;2017;08;02;Perjantai;2;2;4;1;0;1
89;25.08.2017;2017;08;03;Perjantai;4;2;6;0;2;2
89;25.08.2017;2017;08;04;Perjantai;5;2;7;2;0;2
89;25.08.2017;2017;08;05;Perjantai;9;6;15;1;3;4
89;25.08.2017;2017;08;06;Perjantai;30;28;58;9;7;16
89;25.08.2017;2017;08;07;Perjantai;89;88;177;24;26;50
89;25.08.2017;2017;08;08;Perjantai;71;70;141;20;20;40
89;25.08.2017;2017;08;09;Perjantai;56;55;111;15;15;30
89;25.08.2017;2017;08;10;Perjantai;41;40;81;12;11;23
89;25.08.2017;2017;08;11;Perjantai;48;45;93;12;14;26
89;25.08.2017;2017;08;12;Perjantai;41;40;81;12;10;22
89;25.08.2017;2017;08;13;Perjantai;54;51;105;13;16;29
89;25.08.2017;2017;08;14;Perjantai;75;72;147;22;20;42
89;25.08.2017;2017;08;15;Perjantai;94;92;186;24;28;52
89;25.08.2017;2017;08;16;Perjantai;92;89;181;25;25;50
89;25.08.2017;2017;08;17;Perjantai;78;76;154;21;22;43
89;25.08.2017;2017;08;18;Perjantai;53;51;104;16;13;29
89;25.08.2017;2017;08;19;Perjantai;55;53;108;14;16;30
89;25.08.2017;2017;08;20;Perjantai;42;40;82;12;11;23
89;25.08.2017;2017;08;21;Perjantai;31;30;61;8;9;17
89;25.08.2017;2017;08;22;Perjantai;25;21;46;7;6;13
89;25.08.2017;2017;08;23;Perjantai;16;13;29;2;6;8
89;26.08.2017;2017;08;00;Lauantai;15;13;28;5;3;8
89;26.08.2017;2017;08;01;Lauantai;8;8;16;2;3;5
89;26.08.2017;2017;08;02;Lauantai;16;15;31;5;4;9
89;26.08.2017;2017;08;03;Lauantai;7;5;12;0;3;3
89;26.08.2017;2017;08;04;Lauantai;7;5;12;3;1;4
89;26.08.2017;2017;08;05;Lauantai;5;3;8;0;2;2
89;26.08.2017;2017;08;06;Lauantai;4;1;5;1;0;1
89;26.08.2017;2017;08;07;Lauantai;6;4;10;0;3;3
89;26.08.2017;2017;08;08;Lauantai;11;11;22;4;2;6
89;26.08.2017;2017;08;09;Lauantai;24;21;45;5;8;13
89;26.08.2017;2017;08;10;Lauantai;51;50;101;15;13;28
89;26.08.2017;2017;08;11;Lauantai;80;76;156;22;22;44
89;26.08.2017;2017;08;12;Lauantai;87;84;171;25;22;47
89;26.08.2017;2017;08;13;Lauantai;95;92;187;24;28;52
89;26.08.2017;2017;08;14;Lauantai;99;97;196;29;26;55
89;26.08.2017;2017;08;15;Lauantai;98;95;193;26;28;54
89;26.08.2017;2017;08;16;Lauantai;82;81;163;24;21;45
89;26.08.2017;2017;08;17;Lauantai;102;100;202;27;30;57
89;26.08.2017;2017;08;18;Lauantai;86;84;170;25;23;48
89;26.08.2017;2017;08;19;Lauantai;69;68;137;18;20;38
89;26.08.2017;2017;08;20;Lauantai;53;53;106;16;13;29
89;26.08.2017;2017;08;21;Lauantai;38;35;73;10;11;21
89;26.08.2017;2017;08;22;Lauantai;24;21;45;8;5;13
89;26.08.2017;2017;08;23;Lauantai;30;27;57;7;9;16
89;27.08.2017;2017;08;00;Sunnuntai;34;32;66;10;9;19
89;27.08.2017;2017;08;01;Sunnuntai;16;16;32;3;6;9
89;27.08.2017;2017;08;02;Sunnuntai;21;19;40;7;5;12
89;27.08.2017;2017;08;03;Sunnuntai;14;13;27;3;5;8
89;27.08.2017;2017;08;04;Sunnuntai;10;8;18;4;2;6
89;27.08.2017;2017;08;05;Sunnuntai;6;3;9;0;3;3
89;27.08.2017;2017;08;06;Sunnuntai;5;4;9;3;0;3
89;27.08.2017;2017;08;07;Sunnuntai;7;4;11;0;3;3
89;27.08.2017;2017;08;08;Sunnuntai;12;9;21;4;1;5
89;27.08.2017;2017;08;09;Sunnuntai;17;14;31;3;6;9
89;27.08.2017;2017;08;10;Sunnuntai;38;35;73;11;10;21
89;27.08.2017;2017;08;11;Sunnuntai;54;53;107;14;16;30
89;27.08.2017;2017;08;12;Sunnuntai;64;61;125;18;18;36
89;27.08.2017;2017;08;13;Sunnuntai;91;90;181;25;26;51
89;27.08.2017;2017;08;14;Sunnuntai;70;67;137;20;19;39
89;27.08.2017;2017;08;15;Sunnuntai;93;90;183;25;27;52
89;27.08.2017;2017;08;16;Sunnuntai;84;81;165;24;22;46
89;27.08.2017;2017;08;17;Sunnuntai;82;81;163;22;24;46
89;27.08.2017;2017;08;18;Sunnuntai;68;66;134;19;18;37
89;27.08.2017;2017;08;19;Sunnuntai;49;47;96;13;14;27
89;27.08.2017;2017;08;20;Sunnuntai;39;38;77;11;10;21
89;27.08.2017;2017;08;21;Sunnuntai;26;23;49;6;8;14
89;27.08.2017;2017;08;22;Sunnuntai;15;14;29;6;2;8
89;27.08.2017;2017;08;23;Sunnuntai;10;9;19;1;4;5
89;28.08.2017;2017;08;00;Maanantai;5;4;9;3;0;3
89;28.08.2017;2017;08;01;Maanantai;3;2;5;0;2;2
89;28.08.2017;2017;08;02;Maanantai;2;1;3;1;0;1
89;28.08.2017;2017;08;03;Maanantai;2;0;2;0;0;0
89;28.08.2017;2017;08;04;Maanantai;5;3;8;2;0;2
89;28.08.2017;2017;08;05;Maanantai;12;10;22;2;4;6
89;28.08.2017;2017;08;06;Maanantai;34;34;68;11;7;18
89;28.08.2017;2017;08;07;Maanantai;110;108;218;30;32;62
89;28.08.2017;2017;08;08;Maanantai;123;120;243;36;32;68
89;28.08.2017;2017;08;09;Maanantai;74;70;144;19;21;40
89;28.08.2017;2017;08;10;Maanantai;70;69;139;20;19;39
89;28.08.2017;2017;08;11;Maanantai;82;79;161;22;22;44
89;28.08.2017;2017;08;12;Maanantai;92;90;182;26;24;50
89;28.08.2017;2017;08;13;Maanantai;105;104;209;28;30;58
89;28.08.2017;2017;08;14;Maanantai;117;114;231;34;31;65
89;28.08.2017;2017;08;15;Maanantai;148;145;293;40;42;82
89;28.08.2017;2017;08;16;Maanantai;185;183;368;52;52;104
89;28.08.2017;2017;08;17;Maanantai;118;117;235;33;34;67
89;28.08.2017;2017;08;18;Maanantai;99;98;197;29;26;55
89;28.08.2017;2017;08;19;Maanantai;100;100;200;27;30;57
89;28.08.2017;2017;08;20;Maanantai;73;71;144;22;19;41
89;28.08.2017;2017;08;21;Maanantai;38;35;73;9;11;20
89;28.08.2017;2017;08;22;Maanantai;18;17;35;6;5;11
89;28.08.2017;2017;08;23;Maanantai;8;4;12;0;3;3
89;29.08.2017;2017;08;00;Tiistai;7;4;11;2;1;3
89;29.08.2017;2017;08;01;Tiistai;2;1;3;0;1;1
89;29.08.2017;2017;08;02;Tiistai;3;1;4;1;0;1
89;29.08.2017;2017;08;03;Tiistai;2;0;2;0;0;0
89;29.08.2017;2017;08;04;Tiistai;5;3;8;2;0;2
89;29.08.2017;2017;08;05;Tiistai;11;11;22;3;4;7
89;29.08.2017;2017;08;06;Tiistai;32;30;62;10;7;17
89;29.08.2017;2017;08;07;Tiistai;114;112;226;31;33;64
89;29.08.2017;2017;08;08;Tiistai;124;122;246;35;34;69
89;29.08.2017;2017;08;09;Tiistai;69;69;138;19;20;39
89;29.08.2017;2017;08;10;Tiistai;68;65;133;20;17;37
89;29.08.2017;2017;08;11;Tiistai;79;77;156;21;23;44
89;29.08.2017;2017;08;12;Tiistai;94;92;186;27;25;52
89;29.08.2017;2017;08;13;Tiistai;80;79;159;21;23;44
89;29.08.2017;2017;08;14;Tiistai;92;90;182;27;24;51
89;29.08.2017;2017;08;15;Tiistai;108;105;213;30;30;60
89;29.08.2017;2017;08;16;Tiistai;110;108;218;30;30;60
89;29.08.2017;2017;08;17;Tiistai;68;66;134;17;20;37
89;29.08.2017;2017;08;18;Tiistai;41;38;79;12;10;22
89;29.08.2017;2017;08;19;Tiistai;45;43;88;11;14;25
89;29.08.2017;2017;08;20;Tiistai;29;27;56;9;7;16
89;29.08.2017;2017;08;21;Tiistai;19;17;36;4;6;10
89;29.08.2017;2017;08;22;Tiistai;12;11;23;5;3;8
89;29.08.2017;2017;08;23;Tiistai;6;4;10;0;3;3
89;30.08.2017;2017;08;00;Keskiviikko;5;3;8;2;0;2
89;30.08.2017;2017;08;01;Keskiviikko;6;4;10;0;2;2
89;30.08.2017;2017;08;02;Keskiviikko;2;1;3;1;0;1
89;30.08.2017;2017;08;03;Keskiviikko;2;0;2;0;0;0
89;30.08.2017;2017;08;04;Keskiviikko;3;1;4;1;0;1
89;30.08.2017;2017;08;05;Keskiviikko;9;7;16;0;4;4
89;30.08.2017;2017;08;06;Keskiviikko;17;15;32;6;3;9
89;30.08.2017;2017;08;07;Keskiviikko;83;80;163;21;24;45
89;30.08.2017;2017;08;08;Keskiviikko;102;100;202;29;28;57
89;30.08.2017;2017;08;09;Keskiviikko;50;50;100;14;14;28
89;30.08.2017;2017;08;10;Keskiviikko;19;19;38;6;4;10
89;30.08.2017;2017;08;11;Keskiviikko;31;28;59;7;10;17
89;30.08.2017;2017;08;12;Keskiviikko;36;35;71;10;10;20
89;30.08.2017;2017;08;13;Keskiviikko;61;60;121;16;18;34
89;30.08.2017;2017;08;14;Keskiviikko;80;79;159;24;21;45
89;30.08.2017;2017;08;15;Keskiviikko;99;98;197;27;29;56
89;30.08.2017;2017;08;16;Keskiviikko;125;123;248;35;34;69
89;30.08.2017;2017;08;17;Keskiviikko;111;110;221;30;32;62
89;30.08.2017;2017;08;18;Keskiviikko;82;78;160;23;21;44
89;30.08.2017;2017;08;19;Keskiviikko;87;85;172;24;25;49
89;30.08.2017;2017;08;20;Keskiviikko;62;60;122;18;16;34
89;30.08.2017;2017;08;21;Keskiviikko;45;42;87;12;13;25
89;30.08.2017;2017;08;22;Keskiviikko;17;14;31;5;3;8
89;30.08.2017;2017;08;23;Keskiviikko;13;10;23;2;4;6
89;31.08.2017;2017;08;00;Torstai;6;4;10;3;0;3
89;31.08.2017;2017;08;01;Torstai;4;2;6;0;2;2
89;31.08.2017;2017;08;02;Torstai;2;1;3;1;0;1
89;31.08.2017;2017;08;03;Torstai;1;1;2;0;1;1
89;31.08.2017;2017;08;04;Torstai;5;2;7;2;0;2
89;31.08.2017;2017;08;05;Torstai;14;11;25;2;4;6
89;31.08.2017;2017;08;06;Torstai;35;34;69;10;9;19
89;31.08.2017;2017;08;07;Torstai;107;105;212;28;30;58
89;31.08.2017;2017;08;08;Torstai;124;121;245;36;33;69
89;31.08.2017;2017;08;09;Torstai;87;84;171;23;25;48
89;31.08.2017;2017;08;10;Torstai;72;70;142;21;19;40
89;31.08.2017;2017;08;11;Torstai;95;92;187;24;28;52
89;31.08.2017;2017;08;12;Torstai;97;94;191;28;26;54
89;31.08.2017;2017;08;13;Torstai;114;112;226;31;33;64
89;31.08.2017;2017;08;14;Torstai;129;126;255;37;35;72
89;31.08.2017;2017;08;15;Torstai;154;152;306;43;44;87
89;31.08.2017;2017;08;16;Torstai;186;185;371;53;51;104
89;31.08.2017;2017;08;17;Torstai;150;147;297;41;43;84
89;31.08.2017;2017;08;18;Torstai;105;103;208;30;29;59
89;31.08.2017;2017;08;19;Torstai;95;94;189;27;27;54
89;31.08.2017;2017;08;20;Torstai;65;63;128;19;16;35
89;31.08.2017;2017;08;21;Torstai;38;36;74;9;11;20
89;31.08.2017;2017;08;22;Torstai;20;18;38;7;4;11
89;31.08.2017;2017;08;23;Torstai;9;7;16;1;4;5
89;01.09.2017;2017;09;00;Perjantai;13;9;22;4;2;6
89;01.09.2017;2017;09;01;Perjantai;6;2;8;0;2;2
89;01.09.2017;2017;09;02;Perjantai;5;3;8;3;0;3
89;01.09.2017;2017;09;03;Perjantai;2;0;2;0;0;0
89;01.09.2017;2017;09;04;Perjantai;2;1;3;1;0;1
89;01.09.2017;2017;09;05;Perjantai;6;4;10;0;3;3
89;01.09.2017;2017;09;06;Perjantai;18;16;34;6;3;9
89;01.09.2017;2017;09;07;Perjantai;43;41;84;12;12;24
89;01.09.2017;2017;09;08;Perjantai;64;63;127;18;17;35
89;01.09.2017;2017;09;09;Perjantai;26;25;51;6;8;14
89;01.09.2017;2017;09;10;Perjantai;22;20;42;7;5;12
89;01.09.2017;2017;09;11;Perjantai;29;26;55;7;9;16
89;01.09.2017;2017;09;12;Perjantai;38;38;76;12;9;21
89;01.09.2017;2017;09;13;Perjantai;41;41;82;11;13;24
89;01.09.2017;2017;09;14;Perjantai;53;52;105;15;15;30
89;01.09.2017;2017;09;15;Perjantai;62;58;120;16;19;35
89;01.09.2017;2017;09;16;Perjantai;71;68;139;20;19;39
89;01.09.2017;2017;09;17;Perjantai;49;47;96;12;15;27
89;01.09.2017;2017;09;18;Perjantai;40;37;77;11;10;21
89;01.09.2017;2017;09;19;Perjantai;46;44;90;12;14;26
89;01.09.2017;2017;09;20;Perjantai;37;34;71;11;9;20
89;01.09.2017;2017;09;21;Perjantai;35;32;67;8;10;18
89;01.09.2017;2017;09;22;Perjantai;28;27;55;9;6;15
89;01.09.2017;2017;09;23;Perjantai;25;23;48;6;8;14
89;02.09.2017;2017;09;00;Lauantai;14;12;26;5;2;7
89;02.09.2017;2017;09;01;Lauantai;18;14;32;4;5;9
89;02.09.2017;2017;09;02;Lauantai;14;11;25;4;3;7
89;02.09.2017;2017;09;03;Lauantai;10;9;19;1;5;6
89;02.09.2017;2017;09;04;Lauantai;7;7;14;3;2;5
89;02.09.2017;2017;09;05;Lauantai;5;2;7;0;2;2
89;02.09.2017;2017;09;06;Lauantai;7;4;11;2;1;3
89;02.09.2017;2017;09;07;Lauantai;10;9;19;2;4;6
89;02.09.2017;2017;09;08;Lauantai;21;19;40;6;5;11
89;02.09.2017;2017;09;09;Lauantai;33;31;64;8;10;18
89;02.09.2017;2017;09;10;Lauantai;57;54;111;16;14;30
89;02.09.2017;2017;09;11;Lauantai;69;66;135;17;20;37
89;02.09.2017;2017;09;12;Lauantai;83;82;165;25;22;47
89;02.09.2017;2017;09;13;Lauantai;90;87;177;23;26;49
89;02.09.2017;2017;09;14;Lauantai;118;116;234;33;32;65
89;02.09.2017;2017;09;15;Lauantai;106;104;210;27;31;58
89;02.09.2017;2017;09;16;Lauantai;124;124;248;36;33;69
89;02.09.2017;2017;09;17;Lauantai;117;115;232;31;34;65
89;02.09.2017;2017;09;18;Lauantai;94;91;185;27;25;52
89;02.09.2017;2017;09;19;Lauantai;84;82;166;22;25;47
89;02.09.2017;2017;09;20;Lauantai;57;55;112;17;15;32
89;02.09.2017;2017;09;21;Lauantai;43;40;83;11;13;24
89;02.09.2017;2017;09;22;Lauantai;39;35;74;11;10;21
89;02.09.2017;2017;09;23;Lauantai;36;33;69;9;10;19
89;03.09.2017;2017;09;00;Sunnuntai;30;28;58;10;7;17
89;03.09.2017;2017;09;01;Sunnuntai;24;21;45;5;7;12
89;03.09.2017;2017;09;02;Sunnuntai;19;16;35;6;4;10
89;03.09.2017;2017;09;03;Sunnuntai;18;17;35;4;6;10
89;03.09.2017;2017;09;04;Sunnuntai;10;7;17;4;1;5
89;03.09.2017;2017;09;05;Sunnuntai;3;1;4;0;1;1
89;03.09.2017;2017;09;06;Sunnuntai;8;7;15;4;1;5
89;03.09.2017;2017;09;07;Sunnuntai;6;3;9;1;1;2
89;03.09.2017;2017;09;08;Sunnuntai;7;3;10;3;0;3
89;03.09.2017;2017;09;09;Sunnuntai;22;21;43;5;7;12
89;03.09.2017;2017;09;10;Sunnuntai;37;34;71;11;9;20
89;03.09.2017;2017;09;11;Sunnuntai;54;53;107;14;15;29
89;03.09.2017;2017;09;12;Sunnuntai;76;74;150;22;20;42
89;03.09.2017;2017;09;13;Sunnuntai;98;95;193;26;27;53
89;03.09.2017;2017;09;14;Sunnuntai;100;99;199;29;26;55
89;03.09.2017;2017;09;15;Sunnuntai;119;118;237;32;35;67
89;03.09.2017;2017;09;16;Sunnuntai;118;117;235;35;31;66
89;03.09.2017;2017;09;17;Sunnuntai;106;104;210;28;31;59
89;03.09.2017;2017;09;18;Sunnuntai;86;86;172;25;23;48
89;03.09.2017;2017;09;19;Sunnuntai;82;80;162;22;24;46
89;03.09.2017;2017;09;20;Sunnuntai;45;44;89;13;11;24
89;03.09.2017;2017;09;21;Sunnuntai;31;28;59;7;9;16
89;03.09.2017;2017;09;22;Sunnuntai;10;9;19;4;2;6
89;03.09.2017;2017;09;23;Sunnuntai;7;5;12;0;3;3
89;04.09.2017;2017;09;00;Maanantai;7;5;12;2;2;4
89;04.09.2017;2017;09;01;Maanantai;0;0;0;0;0;0
89;04.09.2017;2017;09;02;Maanantai;6;3;9;0;0;0
89;04.09.2017;2017;09;03;Maanantai;4;2;6;1;0;1
89;04.09.2017;2017;09;04;Maanantai;3;1;4;1;0;1
89;04.09.2017;2017;09;05;Maanantai;11;10;21;1;1;2
89;04.09.2017;2017;09;06;Maanantai;29;26;55;0;4;4
89;04.09.2017;2017;09;07;Maanantai;107;105;212;6;15;21
89;04.09.2017;2017;09;08;Maanantai;136;134;270;11;23;34
89;04.09.2017;2017;09;09;Maanantai;93;91;184;18;29;47
89;04.09.2017;2017;09;10;Maanantai;69;67;136;21;46;67
89;04.09.2017;2017;09;11;Maanantai;82;80;162;24;17;41
89;04.09.2017;2017;09;12;Maanantai;91;89;180;11;31;42
89;04.09.2017;2017;09;13;Maanantai;103;100;203;35;32;67
89;04.09.2017;2017;09;14;Maanantai;139;138;277;29;24;53
89;04.09.2017;2017;09;15;Maanantai;154;152;306;23;32;55
89;04.09.2017;2017;09;16;Maanantai;197;195;392;47;41;88
89;04.09.2017;2017;09;17;Maanantai;144;142;286;31;40;71
89;04.09.2017;2017;09;18;Maanantai;120;117;237;48;51;99
89;04.09.2017;2017;09;19;Maanantai;106;103;209;45;52;97
89;04.09.2017;2017;09;20;Maanantai;66;65;131;49;37;86
89;04.09.2017;2017;09;21;Maanantai;30;28;58;14;10;24
89;04.09.2017;2017;09;22;Maanantai;22;20;42;6;2;8
89;04.09.2017;2017;09;23;Maanantai;8;5;13;2;0;2
89;05.09.2017;2017;09;00;Tiistai;8;7;15;1;1;2
89;05.09.2017;2017;09;01;Tiistai;4;2;6;2;0;2
89;05.09.2017;2017;09;02;Tiistai;10;9;19;0;1;1
89;05.09.2017;2017;09;03;Tiistai;3;2;5;0;0;0
89;05.09.2017;2017;09;04;Tiistai;5;3;8;0;0;0
89;05.09.2017;2017;09;05;Tiistai;10;10;20;0;0;0
89;05.09.2017;2017;09;06;Tiistai;37;34;71;1;8;9
89;05.09.2017;2017;09;07;Tiistai;106;104;210;9;18;27
89;05.09.2017;2017;09;08;Tiistai;141;140;281;11;29;40
89;05.09.2017;2017;09;09;Tiistai;101;100;201;21;41;62
89;05.09.2017;2017;09;10;Tiistai;55;53;108;26;44;70
89;05.09.2017;2017;09;11;Tiistai;84;108;192;24;37;61
89;05.09.2017;2017;09;12;Tiistai;81;101;182;23;39;62
89;05.09.2017;2017;09;13;Tiistai;115;90;205;47;45;92
89;05.09.2017;2017;09;14;Tiistai;163;103;266;42;25;67
89;05.09.2017;2017;09;15;Tiistai;209;119;328;71;32;103
89;05.09.2017;2017;09;16;Tiistai;264;145;409;68;32;100
89;05.09.2017;2017;09;17;Tiistai;180;167;347;62;36;98
89;05.09.2017;2017;09;18;Tiistai;126;117;243;49;51;100
89;05.09.2017;2017;09;19;Tiistai;123;74;197;39;37;76
89;05.09.2017;2017;09;20;Tiistai;96;45;141;38;35;73
89;05.09.2017;2017;09;21;Tiistai;68;27;95;15;12;27
89;05.09.2017;2017;09;22;Tiistai;15;11;26;5;3;8
89;05.09.2017;2017;09;23;Tiistai;16;10;26;2;0;2
89;06.09.2017;2017;09;00;Keskiviikko;5;3;8;1;1;2
89;06.09.2017;2017;09;01;Keskiviikko;7;1;8;2;0;2
89;06.09.2017;2017;09;02;Keskiviikko;1;2;3;0;1;1
89;06.09.2017;2017;09;03;Keskiviikko;5;1;6;0;0;0
89;06.09.2017;2017;09;04;Keskiviikko;0;3;3;0;0;0
89;06.09.2017;2017;09;05;Keskiviikko;0;17;17;0;0;0
89;06.09.2017;2017;09;06;Keskiviikko;14;49;63;1;8;9
89;06.09.2017;2017;09;07;Keskiviikko;38;187;225;9;18;27
89;06.09.2017;2017;09;08;Keskiviikko;45;172;217;11;29;40
89;06.09.2017;2017;09;09;Keskiviikko;59;110;169;21;41;62
89;06.09.2017;2017;09;10;Keskiviikko;32;89;121;22;27;49
89;06.09.2017;2017;09;11;Keskiviikko;88;110;198;35;28;63
89;06.09.2017;2017;09;12;Keskiviikko;97;105;202;38;59;97
89;06.09.2017;2017;09;13;Keskiviikko;122;106;228;30;27;57
89;06.09.2017;2017;09;14;Keskiviikko;158;105;263;71;29;100
89;06.09.2017;2017;09;15;Keskiviikko;206;131;337;81;25;106
89;06.09.2017;2017;09;16;Keskiviikko;242;136;378;46;22;68
89;06.09.2017;2017;09;17;Keskiviikko;155;90;245;43;33;76
89;06.09.2017;2017;09;18;Keskiviikko;145;91;236;34;45;79
89;06.09.2017;2017;09;19;Keskiviikko;127;74;201;30;48;78
89;06.09.2017;2017;09;20;Keskiviikko;145;53;198;41;30;71
89;06.09.2017;2017;09;21;Keskiviikko;62;21;83;8;8;16
89;06.09.2017;2017;09;22;Keskiviikko;20;14;34;5;2;7
89;06.09.2017;2017;09;23;Keskiviikko;16;33;49;8;3;11
89;07.09.2017;2017;09;00;Torstai;18;11;29;4;0;4
89;07.09.2017;2017;09;01;Torstai;11;16;27;0;1;1
89;07.09.2017;2017;09;02;Torstai;8;2;10;1;1;2
89;07.09.2017;2017;09;03;Torstai;6;2;8;5;0;5
89;07.09.2017;2017;09;04;Torstai;9;3;12;1;0;1
89;07.09.2017;2017;09;05;Torstai;2;11;13;2;1;3
89;07.09.2017;2017;09;06;Torstai;5;40;45;2;7;9
89;07.09.2017;2017;09;07;Torstai;31;110;141;2;13;15
89;07.09.2017;2017;09;08;Torstai;39;225;264;10;25;35
89;07.09.2017;2017;09;09;Torstai;60;118;178;6;26;32
89;07.09.2017;2017;09;10;Torstai;45;92;137;29;36;65
89;07.09.2017;2017;09;11;Torstai;79;63;142;22;24;46
89;07.09.2017;2017;09;12;Torstai;68;83;151;20;43;63
89;07.09.2017;2017;09;13;Torstai;71;83;154;26;20;46
89;07.09.2017;2017;09;14;Torstai;127;90;217;28;22;50
89;07.09.2017;2017;09;15;Torstai;144;86;230;63;30;93
89;07.09.2017;2017;09;16;Torstai;241;111;352;30;28;58
89;07.09.2017;2017;09;17;Torstai;148;101;249;26;16;42
89;07.09.2017;2017;09;18;Torstai;91;82;173;26;21;47
89;07.09.2017;2017;09;19;Torstai;99;91;190;22;22;44
89;07.09.2017;2017;09;20;Torstai;71;46;117;23;29;52
89;07.09.2017;2017;09;21;Torstai;53;31;84;20;6;26
89;07.09.2017;2017;09;22;Torstai;30;14;44;7;4;11
89;07.09.2017;2017;09;23;Torstai;18;9;27;5;1;6
89;08.09.2017;2017;09;00;Perjantai;13;6;19;4;0;4
89;08.09.2017;2017;09;01;Perjantai;11;0;11;2;2;4
89;08.09.2017;2017;09;02;Perjantai;16;1;17;5;1;6
89;08.09.2017;2017;09;03;Perjantai;8;6;14;2;1;3
89;08.09.2017;2017;09;04;Perjantai;13;5;18;6;0;6
89;08.09.2017;2017;09;05;Perjantai;3;12;15;0;0;0
89;08.09.2017;2017;09;06;Perjantai;10;33;43;1;9;10
89;08.09.2017;2017;09;07;Perjantai;21;97;118;1;18;19
89;08.09.2017;2017;09;08;Perjantai;32;134;166;12;21;33
89;08.09.2017;2017;09;09;Perjantai;40;74;114;13;19;32
89;08.09.2017;2017;09;10;Perjantai;39;56;95;12;15;27
89;08.09.2017;2017;09;11;Perjantai;48;54;102;17;49;66
89;08.09.2017;2017;09;12;Perjantai;51;58;109;13;18;31
89;08.09.2017;2017;09;13;Perjantai;60;65;125;13;23;36
89;08.09.2017;2017;09;14;Perjantai;117;67;184;17;16;33
89;08.09.2017;2017;09;15;Perjantai;138;76;214;29;21;50
89;08.09.2017;2017;09;16;Perjantai;145;71;216;27;26;53
89;08.09.2017;2017;09;17;Perjantai;80;61;141;19;17;36
89;08.09.2017;2017;09;18;Perjantai;71;45;116;17;21;38
89;08.09.2017;2017;09;19;Perjantai;48;46;94;25;23;48
89;08.09.2017;2017;09;20;Perjantai;43;53;96;17;20;37
89;08.09.2017;2017;09;21;Perjantai;41;28;69;10;20;30
89;08.09.2017;2017;09;22;Perjantai;28;23;51;7;3;10
89;08.09.2017;2017;09;23;Perjantai;36;15;51;3;5;8
89;09.09.2017;2017;09;00;Lauantai;11;15;26;2;7;9
89;09.09.2017;2017;09;01;Lauantai;15;8;23;8;1;9
89;09.09.2017;2017;09;02;Lauantai;14;9;23;0;0;0
89;09.09.2017;2017;09;03;Lauantai;7;3;10;4;0;4
89;09.09.2017;2017;09;04;Lauantai;10;2;12;4;0;4
89;09.09.2017;2017;09;05;Lauantai;3;9;12;0;2;2
89;09.09.2017;2017;09;06;Lauantai;3;14;17;1;0;1
89;09.09.2017;2017;09;07;Lauantai;7;9;16;5;7;12
89;09.09.2017;2017;09;08;Lauantai;4;14;18;6;9;15
89;09.09.2017;2017;09;09;Lauantai;11;43;54;8;21;29
89;09.09.2017;2017;09;10;Lauantai;13;61;74;17;29;46
89;09.09.2017;2017;09;11;Lauantai;47;52;99;33;49;82
89;09.09.2017;2017;09;12;Lauantai;41;73;114;20;29;49
89;09.09.2017;2017;09;13;Lauantai;74;60;134;24;24;48
89;09.09.2017;2017;09;14;Lauantai;71;61;132;28;22;50
89;09.09.2017;2017;09;15;Lauantai;85;63;148;20;29;49
89;09.09.2017;2017;09;16;Lauantai;66;49;115;29;26;55
89;09.09.2017;2017;09;17;Lauantai;66;53;119;37;28;65
89;09.09.2017;2017;09;18;Lauantai;69;53;122;29;34;63
89;09.09.2017;2017;09;19;Lauantai;33;42;75;10;28;38
89;09.09.2017;2017;09;20;Lauantai;27;33;60;10;8;18
89;09.09.2017;2017;09;21;Lauantai;47;28;75;4;4;8
89;09.09.2017;2017;09;22;Lauantai;22;28;50;16;11;27
89;09.09.2017;2017;09;23;Lauantai;24;25;49;9;10;19
89;10.09.2017;2017;09;00;Sunnuntai;12;24;36;8;6;14
89;10.09.2017;2017;09;01;Sunnuntai;16;12;28;5;6;11
89;10.09.2017;2017;09;02;Sunnuntai;21;7;28;6;1;7
89;10.09.2017;2017;09;03;Sunnuntai;14;0;14;8;1;9
89;10.09.2017;2017;09;04;Sunnuntai;19;3;22;9;0;9
89;10.09.2017;2017;09;05;Sunnuntai;6;0;6;2;2;4
89;10.09.2017;2017;09;06;Sunnuntai;3;10;13;0;0;0
89;10.09.2017;2017;09;07;Sunnuntai;2;6;8;5;2;7
89;10.09.2017;2017;09;08;Sunnuntai;5;8;13;7;5;12
89;10.09.2017;2017;09;09;Sunnuntai;8;14;22;12;16;28
89;10.09.2017;2017;09;10;Sunnuntai;8;22;30;7;9;16
89;10.09.2017;2017;09;11;Sunnuntai;17;17;34;111;96;207
89;10.09.2017;2017;09;12;Sunnuntai;18;20;38;22;41;63
89;10.09.2017;2017;09;13;Sunnuntai;28;19;47;8;9;17
89;10.09.2017;2017;09;14;Sunnuntai;20;16;36;28;13;41
89;10.09.2017;2017;09;15;Sunnuntai;19;7;26;12;6;18
89;10.09.2017;2017;09;16;Sunnuntai;13;6;19;5;10;15
89;10.09.2017;2017;09;17;Sunnuntai;19;32;51;21;17;38
89;10.09.2017;2017;09;18;Sunnuntai;18;11;29;18;17;35
89;10.09.2017;2017;09;19;Sunnuntai;31;29;60;25;20;45
89;10.09.2017;2017;09;20;Sunnuntai;12;11;23;11;18;29
89;10.09.2017;2017;09;21;Sunnuntai;14;7;21;7;7;14
89;10.09.2017;2017;09;22;Sunnuntai;6;5;11;5;4;9
89;10.09.2017;2017;09;23;Sunnuntai;5;4;9;2;2;4
89;11.09.2017;2017;09;00;Maanantai;0;3;3;2;2;4
89;11.09.2017;2017;09;01;Maanantai;3;0;3;0;0;0
89;11.09.2017;2017;09;02;Maanantai;2;2;4;0;0;0
89;11.09.2017;2017;09;03;Maanantai;0;3;3;1;0;1
89;11.09.2017;2017;09;04;Maanantai;1;4;5;1;0;1
89;11.09.2017;2017;09;05;Maanantai;3;9;12;1;1;2
89;11.09.2017;2017;09;06;Maanantai;10;44;54;0;4;4
89;11.09.2017;2017;09;07;Maanantai;45;170;215;6;15;21
89;11.09.2017;2017;09;08;Maanantai;48;179;227;11;23;34
89;11.09.2017;2017;09;09;Maanantai;60;143;203;18;29;47
89;11.09.2017;2017;09;10;Maanantai;49;112;161;21;46;67
89;11.09.2017;2017;09;11;Maanantai;79;130;209;24;17;41
89;11.09.2017;2017;09;12;Maanantai;96;98;194;11;31;42
89;11.09.2017;2017;09;13;Maanantai;128;89;217;35;32;67
89;11.09.2017;2017;09;14;Maanantai;128;91;219;29;24;53
89;11.09.2017;2017;09;15;Maanantai;193;88;281;23;32;55
89;11.09.2017;2017;09;16;Maanantai;220;121;341;47;41;88
89;11.09.2017;2017;09;17;Maanantai;142;106;248;31;40;71
89;11.09.2017;2017;09;18;Maanantai;120;61;181;48;51;99
89;11.09.2017;2017;09;19;Maanantai;102;58;160;45;52;97
89;11.09.2017;2017;09;20;Maanantai;61;28;89;49;37;86
89;11.09.2017;2017;09;21;Maanantai;40;23;63;14;10;24
89;11.09.2017;2017;09;22;Maanantai;15;7;22;6;2;8
89;11.09.2017;2017;09;23;Maanantai;7;2;9;2;0;2
89;12.09.2017;2017;09;00;Tiistai;9;2;11;3;4;7
89;12.09.2017;2017;09;01;Tiistai;0;0;0;0;1;1
89;12.09.2017;2017;09;02;Tiistai;1;2;3;1;0;1
89;12.09.2017;2017;09;03;Tiistai;2;0;2;0;0;0
89;12.09.2017;2017;09;04;Tiistai;3;2;5;0;1;1
89;12.09.2017;2017;09;05;Tiistai;3;9;12;0;1;1
89;12.09.2017;2017;09;06;Tiistai;17;36;53;1;7;8
89;12.09.2017;2017;09;07;Tiistai;35;165;200;8;17;25
89;12.09.2017;2017;09;08;Tiistai;47;213;260;9;26;35
89;12.09.2017;2017;09;09;Tiistai;55;118;173;18;31;49
89;12.09.2017;2017;09;10;Tiistai;63;106;169;22;37;59
89;12.09.2017;2017;09;11;Tiistai;77;98;175;20;27;47
89;12.09.2017;2017;09;12;Tiistai;90;103;193;26;55;81
89;12.09.2017;2017;09;13;Tiistai;135;74;209;47;38;85
89;12.09.2017;2017;09;14;Tiistai;103;71;174;21;32;53
89;12.09.2017;2017;09;15;Tiistai;150;63;213;27;11;38
89;12.09.2017;2017;09;16;Tiistai;160;56;216;17;9;26
89;12.09.2017;2017;09;17;Tiistai;85;32;117;12;7;19
89;12.09.2017;2017;09;18;Tiistai;65;31;96;23;21;44
89;12.09.2017;2017;09;19;Tiistai;45;19;64;22;15;37
89;12.09.2017;2017;09;20;Tiistai;45;28;73;17;8;25
89;12.09.2017;2017;09;21;Tiistai;33;14;47;9;7;16
89;12.09.2017;2017;09;22;Tiistai;13;13;26;11;4;15
89;12.09.2017;2017;09;23;Tiistai;11;3;14;4;5;9
89;13.09.2017;2017;09;00;Keskiviikko;6;8;14;2;0;2
89;13.09.2017;2017;09;01;Keskiviikko;5;4;9;0;1;1
89;13.09.2017;2017;09;02;Keskiviikko;1;1;2;1;3;4
89;13.09.2017;2017;09;03;Keskiviikko;5;1;6;1;0;1
89;13.09.2017;2017;09;04;Keskiviikko;4;4;8;0;0;0
89;13.09.2017;2017;09;05;Keskiviikko;4;11;15;2;0;2
89;13.09.2017;2017;09;06;Keskiviikko;12;38;50;2;7;9
89;13.09.2017;2017;09;07;Keskiviikko;46;158;204;9;16;25
89;13.09.2017;2017;09;08;Keskiviikko;42;194;236;6;23;29
89;13.09.2017;2017;09;09;Keskiviikko;67;117;184;19;31;50
89;13.09.2017;2017;09;10;Keskiviikko;59;81;140;9;21;30
89;13.09.2017;2017;09;11;Keskiviikko;78;117;195;20;25;45
89;13.09.2017;2017;09;12;Keskiviikko;97;101;198;20;33;53
89;13.09.2017;2017;09;13;Keskiviikko;113;94;207;22;20;42
89;13.09.2017;2017;09;14;Keskiviikko;147;67;214;30;25;55
89;13.09.2017;2017;09;15;Keskiviikko;170;83;253;22;28;50
89;13.09.2017;2017;09;16;Keskiviikko;195;92;287;32;32;64
89;13.09.2017;2017;09;17;Keskiviikko;111;109;220;32;42;74
89;13.09.2017;2017;09;18;Keskiviikko;115;94;209;32;33;65
89;13.09.2017;2017;09;19;Keskiviikko;99;52;151;50;44;94
89;13.09.2017;2017;09;20;Keskiviikko;100;41;141;25;31;56
89;13.09.2017;2017;09;21;Keskiviikko;43;22;65;16;6;22
89;13.09.2017;2017;09;22;Keskiviikko;19;15;34;7;4;11
89;13.09.2017;2017;09;23;Keskiviikko;12;4;16;1;0;1
89;14.09.2017;2017;09;00;Torstai;4;8;12;1;1;2
89;14.09.2017;2017;09;01;Torstai;9;1;10;2;1;3
89;14.09.2017;2017;09;02;Torstai;9;1;10;4;2;6
89;14.09.2017;2017;09;03;Torstai;3;3;6;3;0;3
89;14.09.2017;2017;09;04;Torstai;4;3;7;1;0;1
89;14.09.2017;2017;09;05;Torstai;3;12;15;0;1;1
89;14.09.2017;2017;09;06;Torstai;12;52;64;4;2;6
89;14.09.2017;2017;09;07;Torstai;42;172;214;3;20;23
89;14.09.2017;2017;09;08;Torstai;49;192;241;10;21;31
89;14.09.2017;2017;09;09;Torstai;53;89;142;10;34;44
89;14.09.2017;2017;09;10;Torstai;46;49;95;16;35;51
89;14.09.2017;2017;09;11;Torstai;51;77;128;19;17;36
89;14.09.2017;2017;09;12;Torstai;60;93;153;22;27;49
89;14.09.2017;2017;09;13;Torstai;93;66;159;21;25;46
89;14.09.2017;2017;09;14;Torstai;130;82;212;32;26;58
89;14.09.2017;2017;09;15;Torstai;160;86;246;26;19;45
89;14.09.2017;2017;09;16;Torstai;206;104;310;27;22;49
89;14.09.2017;2017;09;17;Torstai;130;92;222;33;40;73
89;14.09.2017;2017;09;18;Torstai;108;81;189;26;41;67
89;14.09.2017;2017;09;19;Torstai;114;61;175;29;36;65
89;14.09.2017;2017;09;20;Torstai;68;53;121;21;26;47
89;14.09.2017;2017;09;21;Torstai;63;25;88;12;17;29
89;14.09.2017;2017;09;22;Torstai;16;13;29;7;6;13
89;14.09.2017;2017;09;23;Torstai;15;8;23;3;2;5
89;15.09.2017;2017;09;00;Perjantai;16;3;19;2;3;5
89;15.09.2017;2017;09;01;Perjantai;9;1;10;1;0;1
89;15.09.2017;2017;09;02;Perjantai;3;0;3;3;2;5
89;15.09.2017;2017;09;03;Perjantai;13;3;16;1;0;1
89;15.09.2017;2017;09;04;Perjantai;3;2;5;0;1;1
89;15.09.2017;2017;09;05;Perjantai;3;9;12;1;1;2
89;15.09.2017;2017;09;06;Perjantai;4;43;47;1;4;5
89;15.09.2017;2017;09;07;Perjantai;33;121;154;4;11;15
89;15.09.2017;2017;09;08;Perjantai;45;160;205;11;17;28
89;15.09.2017;2017;09;09;Perjantai;44;97;141;14;26;40
89;15.09.2017;2017;09;10;Perjantai;55;72;127;18;26;44
89;15.09.2017;2017;09;11;Perjantai;52;88;140;15;34;49
89;15.09.2017;2017;09;12;Perjantai;78;78;156;21;17;38
89;15.09.2017;2017;09;13;Perjantai;81;76;157;26;15;41
89;15.09.2017;2017;09;14;Perjantai;130;77;207;18;20;38
89;15.09.2017;2017;09;15;Perjantai;140;78;218;19;26;45
89;15.09.2017;2017;09;16;Perjantai;128;79;207;12;19;31
89;15.09.2017;2017;09;17;Perjantai;94;77;171;25;23;48
89;15.09.2017;2017;09;18;Perjantai;85;48;133;30;33;63
89;15.09.2017;2017;09;19;Perjantai;68;36;104;27;17;44
89;15.09.2017;2017;09;20;Perjantai;49;34;83;16;28;44
89;15.09.2017;2017;09;21;Perjantai;32;27;59;11;3;14
89;15.09.2017;2017;09;22;Perjantai;21;18;39;2;14;16
89;15.09.2017;2017;09;23;Perjantai;18;15;33;7;7;14
89;16.09.2017;2017;09;00;Lauantai;11;25;36;4;8;12
89;16.09.2017;2017;09;01;Lauantai;13;4;17;4;3;7
89;16.09.2017;2017;09;02;Lauantai;10;13;23;4;3;7
89;16.09.2017;2017;09;03;Lauantai;11;1;12;2;1;3
89;16.09.2017;2017;09;04;Lauantai;11;5;16;5;2;7
89;16.09.2017;2017;09;05;Lauantai;4;3;7;2;0;2
89;16.09.2017;2017;09;06;Lauantai;2;10;12;0;0;0
89;16.09.2017;2017;09;07;Lauantai;7;12;19;2;8;10
89;16.09.2017;2017;09;08;Lauantai;11;16;27;7;9;16
89;16.09.2017;2017;09;09;Lauantai;13;53;66;12;16;28
89;16.09.2017;2017;09;10;Lauantai;33;77;110;12;24;36
89;16.09.2017;2017;09;11;Lauantai;45;65;110;30;47;77
89;16.09.2017;2017;09;12;Lauantai;51;73;124;14;35;49
89;16.09.2017;2017;09;13;Lauantai;46;73;119;22;17;39
89;16.09.2017;2017;09;14;Lauantai;70;66;136;17;32;49
89;16.09.2017;2017;09;15;Lauantai;79;68;147;33;24;57
89;16.09.2017;2017;09;16;Lauantai;61;53;114;23;41;64
89;16.09.2017;2017;09;17;Lauantai;72;55;127;24;32;56
89;16.09.2017;2017;09;18;Lauantai;66;52;118;33;25;58
89;16.09.2017;2017;09;19;Lauantai;83;41;124;31;23;54
89;16.09.2017;2017;09;20;Lauantai;50;45;95;20;13;33
89;16.09.2017;2017;09;21;Lauantai;32;31;63;16;26;42
89;16.09.2017;2017;09;22;Lauantai;24;36;60;4;9;13
89;16.09.2017;2017;09;23;Lauantai;43;18;61;5;9;14
89;17.09.2017;2017;09;00;Sunnuntai;22;35;57;5;11;16
89;17.09.2017;2017;09;01;Sunnuntai;20;4;24;11;5;16
89;17.09.2017;2017;09;02;Sunnuntai;19;11;30;4;4;8
89;17.09.2017;2017;09;03;Sunnuntai;12;4;16;9;2;11
89;17.09.2017;2017;09;04;Sunnuntai;16;2;18;7;0;7
89;17.09.2017;2017;09;05;Sunnuntai;4;1;5;3;0;3
89;17.09.2017;2017;09;06;Sunnuntai;2;3;5;5;0;5
89;17.09.2017;2017;09;07;Sunnuntai;3;3;6;5;6;11
89;17.09.2017;2017;09;08;Sunnuntai;1;5;6;10;5;15
89;17.09.2017;2017;09;09;Sunnuntai;18;19;37;17;17;34
89;17.09.2017;2017;09;10;Sunnuntai;13;35;48;11;28;39
89;17.09.2017;2017;09;11;Sunnuntai;33;67;100;25;33;58
89;17.09.2017;2017;09;12;Sunnuntai;36;66;102;36;38;74
89;17.09.2017;2017;09;13;Sunnuntai;57;77;134;30;48;78
89;17.09.2017;2017;09;14;Sunnuntai;60;61;121;31;40;71
89;17.09.2017;2017;09;15;Sunnuntai;88;74;162;38;33;71
89;17.09.2017;2017;09;16;Sunnuntai;92;70;162;24;39;63
89;17.09.2017;2017;09;17;Sunnuntai;84;39;123;38;38;76
89;17.09.2017;2017;09;18;Sunnuntai;64;57;121;34;27;61
89;17.09.2017;2017;09;19;Sunnuntai;53;44;97;34;36;70
89;17.09.2017;2017;09;20;Sunnuntai;29;31;60;26;23;49
89;17.09.2017;2017;09;21;Sunnuntai;15;14;29;7;8;15
89;17.09.2017;2017;09;22;Sunnuntai;7;3;10;6;3;9
89;17.09.2017;2017;09;23;Sunnuntai;1;2;3;1;2;3
89;18.09.2017;2017;09;00;Maanantai;3;3;6;5;0;5
89;18.09.2017;2017;09;01;Maanantai;2;0;2;1;0;1
89;18.09.2017;2017;09;02;Maanantai;0;1;1;1;1;2
89;18.09.2017;2017;09;03;Maanantai;1;0;1;1;0;1
89;18.09.2017;2017;09;04;Maanantai;4;4;8;0;0;0
89;18.09.2017;2017;09;05;Maanantai;2;9;11;0;0;0
89;18.09.2017;2017;09;06;Maanantai;6;44;50;3;4;7
89;18.09.2017;2017;09;07;Maanantai;25;129;154;2;12;14
89;18.09.2017;2017;09;08;Maanantai;35;188;223;8;19;27
89;18.09.2017;2017;09;09;Maanantai;43;82;125;11;33;44
89;18.09.2017;2017;09;10;Maanantai;43;71;114;16;13;29
89;18.09.2017;2017;09;11;Maanantai;44;76;120;15;23;38
89;18.09.2017;2017;09;12;Maanantai;46;76;122;16;20;36
89;18.09.2017;2017;09;13;Maanantai;78;55;133;26;21;47
89;18.09.2017;2017;09;14;Maanantai;128;89;217;23;19;42
89;18.09.2017;2017;09;15;Maanantai;178;78;256;36;22;58
89;18.09.2017;2017;09;16;Maanantai;195;113;308;37;21;58
89;18.09.2017;2017;09;17;Maanantai;136;76;212;38;24;62
89;18.09.2017;2017;09;18;Maanantai;101;70;171;33;29;62
89;18.09.2017;2017;09;19;Maanantai;83;55;138;32;31;63
89;18.09.2017;2017;09;20;Maanantai;52;36;88;21;15;36
89;18.09.2017;2017;09;21;Maanantai;37;19;56;11;11;22
89;18.09.2017;2017;09;22;Maanantai;27;12;39;3;5;8
89;18.09.2017;2017;09;23;Maanantai;6;2;8;1;3;4
89;19.09.2017;2017;09;00;Tiistai;1;1;2;1;0;1
89;19.09.2017;2017;09;01;Tiistai;6;4;10;0;0;0
89;19.09.2017;2017;09;02;Tiistai;0;0;0;0;0;0
89;19.09.2017;2017;09;03;Tiistai;2;1;3;0;0;0
89;19.09.2017;2017;09;04;Tiistai;1;2;3;0;0;0
89;19.09.2017;2017;09;05;Tiistai;0;5;5;1;1;2
89;19.09.2017;2017;09;06;Tiistai;8;49;57;2;8;10
89;19.09.2017;2017;09;07;Tiistai;38;134;172;4;21;25
89;19.09.2017;2017;09;08;Tiistai;45;190;235;7;30;37
89;19.09.2017;2017;09;09;Tiistai;33;87;120;8;19;27
89;19.09.2017;2017;09;10;Tiistai;19;40;59;15;23;38
89;19.09.2017;2017;09;11;Tiistai;31;43;74;16;11;27
89;19.09.2017;2017;09;12;Tiistai;73;59;132;20;15;35
89;19.09.2017;2017;09;13;Tiistai;56;54;110;12;15;27
89;19.09.2017;2017;09;14;Tiistai;105;51;156;18;23;41
89;19.09.2017;2017;09;15;Tiistai;169;56;225;29;19;48
89;19.09.2017;2017;09;16;Tiistai;183;84;267;28;20;48
89;19.09.2017;2017;09;17;Tiistai;110;75;185;25;19;44
89;19.09.2017;2017;09;18;Tiistai;97;61;158;31;29;60
89;19.09.2017;2017;09;19;Tiistai;77;45;122;28;30;58
89;19.09.2017;2017;09;20;Tiistai;56;30;86;24;18;42
89;19.09.2017;2017;09;21;Tiistai;32;19;51;15;11;26
89;19.09.2017;2017;09;22;Tiistai;18;9;27;5;0;5
89;19.09.2017;2017;09;23;Tiistai;8;2;10;0;3;3
89;20.09.2017;2017;09;00;Keskiviikko;2;5;7;0;4;4
89;20.09.2017;2017;09;01;Keskiviikko;4;0;4;1;1;2
89;20.09.2017;2017;09;02;Keskiviikko;3;3;6;4;1;5
89;20.09.2017;2017;09;03;Keskiviikko;1;0;1;0;0;0
89;20.09.2017;2017;09;04;Keskiviikko;1;3;4;0;0;0
89;20.09.2017;2017;09;05;Keskiviikko;2;8;10;0;3;3
89;20.09.2017;2017;09;06;Keskiviikko;12;55;67;2;7;9
89;20.09.2017;2017;09;07;Keskiviikko;47;144;191;6;21;27
89;20.09.2017;2017;09;08;Keskiviikko;49;164;213;5;20;25
89;20.09.2017;2017;09;09;Keskiviikko;47;100;147;18;34;52
89;20.09.2017;2017;09;10;Keskiviikko;40;85;125;18;27;45
89;20.09.2017;2017;09;11;Keskiviikko;60;84;144;16;28;44
89;20.09.2017;2017;09;12;Keskiviikko;67;100;167;22;23;45
89;20.09.2017;2017;09;13;Keskiviikko;89;61;150;24;28;52
89;20.09.2017;2017;09;14;Keskiviikko;128;79;207;27;26;53
89;20.09.2017;2017;09;15;Keskiviikko;169;70;239;34;13;47
89;20.09.2017;2017;09;16;Keskiviikko;177;101;278;23;24;47
89;20.09.2017;2017;09;17;Keskiviikko;134;98;232;27;34;61
89;20.09.2017;2017;09;18;Keskiviikko;112;56;168;29;28;57
89;20.09.2017;2017;09;19;Keskiviikko;110;46;156;36;29;65
89;20.09.2017;2017;09;20;Keskiviikko;53;35;88;19;18;37
89;20.09.2017;2017;09;21;Keskiviikko;29;22;51;10;10;20
89;20.09.2017;2017;09;22;Keskiviikko;18;5;23;5;8;13
89;20.09.2017;2017;09;23;Keskiviikko;11;10;21;6;0;6
89;21.09.2017;2017;09;00;Torstai;7;5;12;1;3;4
89;21.09.2017;2017;09;01;Torstai;9;1;10;0;1;1
89;21.09.2017;2017;09;02;Torstai;4;2;6;0;0;0
89;21.09.2017;2017;09;03;Torstai;2;6;8;1;0;1
89;21.09.2017;2017;09;04;Torstai;1;3;4;1;2;3
89;21.09.2017;2017;09;05;Torstai;6;9;15;0;2;2
89;21.09.2017;2017;09;06;Torstai;11;51;62;3;3;6
89;21.09.2017;2017;09;07;Torstai;43;136;179;3;16;19
89;21.09.2017;2017;09;08;Torstai;49;193;242;8;19;27
89;21.09.2017;2017;09;09;Torstai;43;89;132;19;36;55
89;21.09.2017;2017;09;10;Torstai;48;79;127;21;32;53
89;21.09.2017;2017;09;11;Torstai;60;75;135;25;31;56
89;21.09.2017;2017;09;12;Torstai;89;84;173;22;18;40
89;21.09.2017;2017;09;13;Torstai;94;91;185;34;21;55
89;21.09.2017;2017;09;14;Torstai;108;65;173;21;24;45
89;21.09.2017;2017;09;15;Torstai;170;71;241;24;17;41
89;21.09.2017;2017;09;16;Torstai;192;114;306;38;19;57
89;21.09.2017;2017;09;17;Torstai;126;90;216;21;24;45
89;21.09.2017;2017;09;18;Torstai;77;54;131;32;25;57
89;21.09.2017;2017;09;19;Torstai;87;36;123;24;31;55
89;21.09.2017;2017;09;20;Torstai;64;34;98;26;22;48
89;21.09.2017;2017;09;21;Torstai;45;26;71;18;12;30
89;21.09.2017;2017;09;22;Torstai;29;8;37;8;3;11
89;21.09.2017;2017;09;23;Torstai;5;7;12;2;2;4
89;22.09.2017;2017;09;00;Perjantai;8;6;14;2;0;2
89;22.09.2017;2017;09;01;Perjantai;7;1;8;0;0;0
89;22.09.2017;2017;09;02;Perjantai;12;0;12;0;1;1
89;22.09.2017;2017;09;03;Perjantai;4;3;7;0;0;0
89;22.09.2017;2017;09;04;Perjantai;1;1;2;0;0;0
89;22.09.2017;2017;09;05;Perjantai;1;15;16;0;1;1
89;22.09.2017;2017;09;06;Perjantai;7;50;57;5;8;13
89;22.09.2017;2017;09;07;Perjantai;36;121;157;1;16;17
89;22.09.2017;2017;09;08;Perjantai;32;167;199;21;26;47
89;22.09.2017;2017;09;09;Perjantai;38;97;135;5;18;23
89;22.09.2017;2017;09;10;Perjantai;45;65;110;18;21;39
89;22.09.2017;2017;09;11;Perjantai;54;76;130;18;36;54
89;22.09.2017;2017;09;12;Perjantai;104;98;202;29;62;91
89;22.09.2017;2017;09;13;Perjantai;102;81;183;36;25;61
89;22.09.2017;2017;09;14;Perjantai;124;89;213;36;58;94
89;22.09.2017;2017;09;15;Perjantai;164;100;264;53;24;77
89;22.09.2017;2017;09;16;Perjantai;189;81;270;33;26;59
89;22.09.2017;2017;09;17;Perjantai;108;105;213;38;44;82
89;22.09.2017;2017;09;18;Perjantai;101;82;183;31;43;74
89;22.09.2017;2017;09;19;Perjantai;92;52;144;31;38;69
89;22.09.2017;2017;09;20;Perjantai;71;44;115;30;16;46
89;22.09.2017;2017;09;21;Perjantai;44;30;74;12;12;24
89;22.09.2017;2017;09;22;Perjantai;21;15;36;4;12;16
89;22.09.2017;2017;09;23;Perjantai;19;32;51;9;5;14
89;23.09.2017;2017;09;00;Lauantai;22;15;37;1;6;7
89;23.09.2017;2017;09;01;Lauantai;21;8;29;6;1;7
89;23.09.2017;2017;09;02;Lauantai;15;9;24;4;1;5
89;23.09.2017;2017;09;03;Lauantai;14;5;19;3;1;4
89;23.09.2017;2017;09;04;Lauantai;11;2;13;1;1;2
89;23.09.2017;2017;09;05;Lauantai;8;9;17;2;0;2
89;23.09.2017;2017;09;06;Lauantai;4;8;12;1;1;2
89;23.09.2017;2017;09;07;Lauantai;2;12;14;4;10;14
89;23.09.2017;2017;09;08;Lauantai;11;28;39;9;7;16
89;23.09.2017;2017;09;09;Lauantai;20;53;73;12;24;36
89;23.09.2017;2017;09;10;Lauantai;19;51;70;25;27;52
89;23.09.2017;2017;09;11;Lauantai;46;80;126;32;160;192
89;23.09.2017;2017;09;12;Lauantai;62;89;151;30;50;80
89;23.09.2017;2017;09;13;Lauantai;69;60;129;22;39;61
89;23.09.2017;2017;09;14;Lauantai;73;57;130;28;43;71
89;23.09.2017;2017;09;15;Lauantai;93;60;153;26;25;51
89;23.09.2017;2017;09;16;Lauantai;79;61;140;35;37;72
89;23.09.2017;2017;09;17;Lauantai;77;69;146;30;46;76
89;23.09.2017;2017;09;18;Lauantai;75;45;120;38;25;63
89;23.09.2017;2017;09;19;Lauantai;65;39;104;30;17;47
89;23.09.2017;2017;09;20;Lauantai;35;39;74;15;25;40
89;23.09.2017;2017;09;21;Lauantai;17;24;41;7;18;25
89;23.09.2017;2017;09;22;Lauantai;16;34;50;6;19;25
89;23.09.2017;2017;09;23;Lauantai;17;32;49;3;14;17
89;24.09.2017;2017;09;00;Sunnuntai;22;28;50;5;4;9
89;24.09.2017;2017;09;01;Sunnuntai;17;12;29;2;2;4
89;24.09.2017;2017;09;02;Sunnuntai;18;2;20;5;2;7
89;24.09.2017;2017;09;03;Sunnuntai;22;0;22;9;2;11
89;24.09.2017;2017;09;04;Sunnuntai;22;4;26;7;0;7
89;24.09.2017;2017;09;05;Sunnuntai;5;3;8;2;1;3
89;24.09.2017;2017;09;06;Sunnuntai;6;6;12;1;1;2
89;24.09.2017;2017;09;07;Sunnuntai;4;6;10;4;6;10
89;24.09.2017;2017;09;08;Sunnuntai;8;4;12;6;9;15
89;24.09.2017;2017;09;09;Sunnuntai;14;29;43;13;11;24
89;24.09.2017;2017;09;10;Sunnuntai;23;33;56;17;34;51
89;24.09.2017;2017;09;11;Sunnuntai;31;55;86;25;38;63
89;24.09.2017;2017;09;12;Sunnuntai;41;60;101;35;49;84
89;24.09.2017;2017;09;13;Sunnuntai;55;70;125;49;44;93
89;24.09.2017;2017;09;14;Sunnuntai;56;61;117;31;42;73
89;24.09.2017;2017;09;15;Sunnuntai;74;49;123;43;38;81
89;24.09.2017;2017;09;16;Sunnuntai;69;51;120;32;57;89
89;24.09.2017;2017;09;17;Sunnuntai;55;54;109;33;39;72
89;24.09.2017;2017;09;18;Sunnuntai;69;40;109;42;40;82
89;24.09.2017;2017;09;19;Sunnuntai;36;26;62;25;34;59
89;24.09.2017;2017;09;20;Sunnuntai;38;26;64;11;15;26
89;24.09.2017;2017;09;21;Sunnuntai;24;18;42;19;12;31
89;24.09.2017;2017;09;22;Sunnuntai;11;7;18;5;3;8
89;24.09.2017;2017;09;23;Sunnuntai;7;4;11;2;2;4
89;25.09.2017;2017;09;00;Maanantai;3;0;3;1;0;1
89;25.09.2017;2017;09;01;Maanantai;0;1;1;2;2;4
89;25.09.2017;2017;09;02;Maanantai;2;3;5;4;0;4
89;25.09.2017;2017;09;03;Maanantai;1;1;2;0;0;0
89;25.09.2017;2017;09;04;Maanantai;1;2;3;1;0;1
89;25.09.2017;2017;09;05;Maanantai;4;10;14;1;0;1
89;25.09.2017;2017;09;06;Maanantai;11;44;55;1;6;7
89;25.09.2017;2017;09;07;Maanantai;51;129;180;6;14;20
89;25.09.2017;2017;09;08;Maanantai;49;198;247;13;39;52
89;25.09.2017;2017;09;09;Maanantai;48;97;145;10;30;40
89;25.09.2017;2017;09;10;Maanantai;40;91;131;14;21;35
89;25.09.2017;2017;09;11;Maanantai;62;80;142;28;24;52
89;25.09.2017;2017;09;12;Maanantai;93;72;165;20;22;42
89;25.09.2017;2017;09;13;Maanantai;94;90;184;22;28;50
89;25.09.2017;2017;09;14;Maanantai;116;76;192;39;33;72
89;25.09.2017;2017;09;15;Maanantai;183;110;293;32;29;61
89;25.09.2017;2017;09;16;Maanantai;196;110;306;35;37;72
89;25.09.2017;2017;09;17;Maanantai;157;121;278;34;51;85
89;25.09.2017;2017;09;18;Maanantai;121;97;218;65;63;128
89;25.09.2017;2017;09;19;Maanantai;112;52;164;63;47;110
89;25.09.2017;2017;09;20;Maanantai;72;34;106;33;27;60
89;25.09.2017;2017;09;21;Maanantai;46;23;69;24;14;38
89;25.09.2017;2017;09;22;Maanantai;17;8;25;5;4;9
89;25.09.2017;2017;09;23;Maanantai;6;3;9;0;4;4
89;26.09.2017;2017;09;00;Tiistai;5;4;9;1;2;3
89;26.09.2017;2017;09;01;Tiistai;4;2;6;0;1;1
89;26.09.2017;2017;09;02;Tiistai;1;0;1;2;1;3
89;26.09.2017;2017;09;03;Tiistai;2;0;2;1;1;2
89;26.09.2017;2017;09;04;Tiistai;1;3;4;0;0;0
89;26.09.2017;2017;09;05;Tiistai;2;10;12;0;2;2
89;26.09.2017;2017;09;06;Tiistai;12;45;57;1;9;10
89;26.09.2017;2017;09;07;Tiistai;41;142;183;8;15;23
89;26.09.2017;2017;09;08;Tiistai;43;193;236;14;29;43
89;26.09.2017;2017;09;09;Tiistai;40;100;140;7;18;25
89;26.09.2017;2017;09;10;Tiistai;40;56;96;14;20;34
89;26.09.2017;2017;09;11;Tiistai;58;91;149;22;27;49
89;26.09.2017;2017;09;12;Tiistai;95;78;173;20;22;42
89;26.09.2017;2017;09;13;Tiistai;86;83;169;20;20;40
89;26.09.2017;2017;09;14;Tiistai;107;98;205;28;32;60
89;26.09.2017;2017;09;15;Tiistai;186;81;267;19;25;44
89;26.09.2017;2017;09;16;Tiistai;210;91;301;38;29;67
89;26.09.2017;2017;09;17;Tiistai;148;102;250;19;20;39
89;26.09.2017;2017;09;18;Tiistai;105;66;171;44;33;77
89;26.09.2017;2017;09;19;Tiistai;85;45;130;38;35;73
89;26.09.2017;2017;09;20;Tiistai;62;31;93;18;13;31
89;26.09.2017;2017;09;21;Tiistai;38;27;65;16;9;25
89;26.09.2017;2017;09;22;Tiistai;26;8;34;8;4;12
89;26.09.2017;2017;09;23;Tiistai;11;14;25;1;2;3
89;27.09.2017;2017;09;00;Keskiviikko;5;5;10;0;0;0
89;27.09.2017;2017;09;01;Keskiviikko;2;1;3;1;1;2
89;27.09.2017;2017;09;02;Keskiviikko;1;0;1;0;0;0
89;27.09.2017;2017;09;03;Keskiviikko;5;0;5;1;0;1
89;27.09.2017;2017;09;04;Keskiviikko;5;3;8;2;0;2
89;27.09.2017;2017;09;05;Keskiviikko;2;10;12;0;2;2
89;27.09.2017;2017;09;06;Keskiviikko;14;40;54;0;4;4
89;27.09.2017;2017;09;07;Keskiviikko;43;152;195;8;16;24
89;27.09.2017;2017;09;08;Keskiviikko;42;207;249;9;24;33
89;27.09.2017;2017;09;09;Keskiviikko;44;102;146;9;23;32
89;27.09.2017;2017;09;10;Keskiviikko;45;76;121;20;27;47
89;27.09.2017;2017;09;11;Keskiviikko;71;86;157;25;23;48
89;27.09.2017;2017;09;12;Keskiviikko;82;91;173;27;32;59
89;27.09.2017;2017;09;13;Keskiviikko;93;88;181;25;36;61
89;27.09.2017;2017;09;14;Keskiviikko;128;64;192;32;26;58
89;27.09.2017;2017;09;15;Keskiviikko;161;85;246;36;20;56
89;27.09.2017;2017;09;16;Keskiviikko;213;89;302;28;18;46
89;27.09.2017;2017;09;17;Keskiviikko;142;95;237;34;26;60
89;27.09.2017;2017;09;18;Keskiviikko;103;56;159;37;40;77
89;27.09.2017;2017;09;19;Keskiviikko;85;34;119;42;36;78
89;27.09.2017;2017;09;20;Keskiviikko;60;37;97;15;23;38
89;27.09.2017;2017;09;21;Keskiviikko;45;26;71;13;10;23
89;27.09.2017;2017;09;22;Keskiviikko;20;13;33;0;4;4
89;27.09.2017;2017;09;23;Keskiviikko;16;23;39;4;3;7
89;28.09.2017;2017;09;00;Torstai;7;10;17;0;0;0
89;28.09.2017;2017;09;01;Torstai;4;3;7;1;0;1
89;28.09.2017;2017;09;02;Torstai;5;0;5;1;1;2
89;28.09.2017;2017;09;03;Torstai;4;2;6;0;0;0
89;28.09.2017;2017;09;04;Torstai;5;4;9;3;0;3
89;28.09.2017;2017;09;05;Torstai;5;8;13;0;1;1
89;28.09.2017;2017;09;06;Torstai;11;41;52;2;4;6
89;28.09.2017;2017;09;07;Torstai;40;130;170;8;17;25
89;28.09.2017;2017;09;08;Torstai;39;208;247;15;27;42
89;28.09.2017;2017;09;09;Torstai;34;109;143;19;26;45
89;28.09.2017;2017;09;10;Torstai;35;61;96;19;17;36
89;28.09.2017;2017;09;11;Torstai;120;75;195;35;40;75
89;28.09.2017;2017;09;12;Torstai;78;72;150;34;20;54
89;28.09.2017;2017;09;13;Torstai;70;77;147;31;19;50
89;28.09.2017;2017;09;14;Torstai;130;72;202;25;22;47
89;28.09.2017;2017;09;15;Torstai;163;73;236;27;27;54
89;28.09.2017;2017;09;16;Torstai;159;94;253;26;27;53
89;28.09.2017;2017;09;17;Torstai;110;93;203;41;34;75
89;28.09.2017;2017;09;18;Torstai;98;71;169;39;30;69
89;28.09.2017;2017;09;19;Torstai;101;42;143;36;35;71
89;28.09.2017;2017;09;20;Torstai;61;22;83;27;11;38
89;28.09.2017;2017;09;21;Torstai;49;24;73;11;16;27
89;28.09.2017;2017;09;22;Torstai;20;9;29;5;12;17
89;28.09.2017;2017;09;23;Torstai;15;5;20;1;1;2
89;29.09.2017;2017;09;00;Perjantai;9;2;11;0;2;2
89;29.09.2017;2017;09;01;Perjantai;9;8;17;0;1;1
89;29.09.2017;2017;09;02;Perjantai;3;2;5;2;0;2
89;29.09.2017;2017;09;03;Perjantai;3;4;7;2;0;2
89;29.09.2017;2017;09;04;Perjantai;2;2;4;3;1;4
89;29.09.2017;2017;09;05;Perjantai;4;11;15;0;1;1
89;29.09.2017;2017;09;06;Perjantai;9;43;52;2;6;8
89;29.09.2017;2017;09;07;Perjantai;38;119;157;13;15;28
89;29.09.2017;2017;09;08;Perjantai;30;152;182;14;23;37
89;29.09.2017;2017;09;09;Perjantai;48;101;149;11;21;32
89;29.09.2017;2017;09;10;Perjantai;37;78;115;16;22;38
89;29.09.2017;2017;09;11;Perjantai;60;89;149;29;22;51
89;29.09.2017;2017;09;12;Perjantai;96;88;184;55;45;100
89;29.09.2017;2017;09;13;Perjantai;78;89;167;23;31;54
89;29.09.2017;2017;09;14;Perjantai;170;85;255;21;21;42
89;29.09.2017;2017;09;15;Perjantai;177;82;259;21;29;50
89;29.09.2017;2017;09;16;Perjantai;132;98;230;22;16;38
89;29.09.2017;2017;09;17;Perjantai;96;89;185;27;23;50
89;29.09.2017;2017;09;18;Perjantai;94;51;145;26;26;52
89;29.09.2017;2017;09;19;Perjantai;56;43;99;19;21;40
89;29.09.2017;2017;09;20;Perjantai;55;43;98;12;14;26
89;29.09.2017;2017;09;21;Perjantai;36;26;62;13;11;24
89;29.09.2017;2017;09;22;Perjantai;37;40;77;6;10;16
89;29.09.2017;2017;09;23;Perjantai;24;14;38;11;6;17
89;30.09.2017;2017;09;00;Lauantai;22;14;36;8;18;26
89;30.09.2017;2017;09;01;Lauantai;21;5;26;4;9;13
89;30.09.2017;2017;09;02;Lauantai;14;5;19;6;2;8
89;30.09.2017;2017;09;03;Lauantai;23;8;31;4;2;6
89;30.09.2017;2017;09;04;Lauantai;18;11;29;5;0;5
89;30.09.2017;2017;09;05;Lauantai;4;5;9;1;1;2
89;30.09.2017;2017;09;06;Lauantai;8;7;15;1;3;4
89;30.09.2017;2017;09;07;Lauantai;7;10;17;7;9;16
89;30.09.2017;2017;09;08;Lauantai;6;25;31;6;12;18
89;30.09.2017;2017;09;09;Lauantai;19;55;74;16;19;35
89;30.09.2017;2017;09;10;Lauantai;24;62;86;22;34;56
89;30.09.2017;2017;09;11;Lauantai;43;58;101;17;40;57
89;30.09.2017;2017;09;12;Lauantai;63;78;141;22;27;49
89;30.09.2017;2017;09;13;Lauantai;67;73;140;23;39;62
89;30.09.2017;2017;09;14;Lauantai;93;74;167;34;33;67
89;30.09.2017;2017;09;15;Lauantai;81;62;143;27;37;64
89;30.09.2017;2017;09;16;Lauantai;91;65;156;42;26;68
89;30.09.2017;2017;09;17;Lauantai;63;54;117;22;27;49
89;30.09.2017;2017;09;18;Lauantai;59;60;119;30;33;63
89;30.09.2017;2017;09;19;Lauantai;74;43;117;23;36;59
89;30.09.2017;2017;09;20;Lauantai;24;37;61;24;16;40
89;30.09.2017;2017;09;21;Lauantai;27;32;59;16;11;27
89;30.09.2017;2017;09;22;Lauantai;31;26;57;3;13;16
89;30.09.2017;2017;09;23;Lauantai;25;18;43;5;5;10
89;01.10.2017;2017;10;00;Sunnuntai;31;26;57;9;5;14
89;01.10.2017;2017;10;01;Sunnuntai;22;14;36;4;7;11
89;01.10.2017;2017;10;02;Sunnuntai;14;4;18;8;3;11
89;01.10.2017;2017;10;03;Sunnuntai;18;0;18;3;1;4
89;01.10.2017;2017;10;04;Sunnuntai;20;3;23;4;0;4
89;01.10.2017;2017;10;05;Sunnuntai;7;2;9;1;0;1
89;01.10.2017;2017;10;06;Sunnuntai;5;2;7;1;0;1
89;01.10.2017;2017;10;07;Sunnuntai;2;4;6;2;11;13
89;01.10.2017;2017;10;08;Sunnuntai;2;12;14;3;7;10
89;01.10.2017;2017;10;09;Sunnuntai;14;25;39;16;15;31
89;01.10.2017;2017;10;10;Sunnuntai;10;35;45;23;26;49
89;01.10.2017;2017;10;11;Sunnuntai;30;58;88;34;48;82
89;01.10.2017;2017;10;12;Sunnuntai;58;66;124;37;46;83
89;01.10.2017;2017;10;13;Sunnuntai;47;92;139;26;45;71
89;01.10.2017;2017;10;14;Sunnuntai;68;41;109;40;31;71
89;01.10.2017;2017;10;15;Sunnuntai;52;43;95;36;23;59
89;01.10.2017;2017;10;16;Sunnuntai;56;63;119;36;40;76
89;01.10.2017;2017;10;17;Sunnuntai;64;52;116;25;36;61
89;01.10.2017;2017;10;18;Sunnuntai;67;50;117;27;30;57
89;01.10.2017;2017;10;19;Sunnuntai;40;25;65;21;22;43
89;01.10.2017;2017;10;20;Sunnuntai;38;21;59;22;18;40
89;01.10.2017;2017;10;21;Sunnuntai;18;20;38;14;2;16
89;01.10.2017;2017;10;22;Sunnuntai;7;8;15;8;2;10
89;01.10.2017;2017;10;23;Sunnuntai;3;5;8;1;0;1
89;02.10.2017;2017;10;00;Maanantai;9;3;12;1;0;1
89;02.10.2017;2017;10;01;Maanantai;4;0;4;2;0;2
89;02.10.2017;2017;10;02;Maanantai;3;1;4;0;1;1
89;02.10.2017;2017;10;03;Maanantai;2;2;4;2;0;2
89;02.10.2017;2017;10;04;Maanantai;4;2;6;1;0;1
89;02.10.2017;2017;10;05;Maanantai;2;12;14;0;0;0
89;02.10.2017;2017;10;06;Maanantai;9;43;52;1;3;4
89;02.10.2017;2017;10;07;Maanantai;39;146;185;4;18;22
89;02.10.2017;2017;10;08;Maanantai;37;203;240;9;39;48
89;02.10.2017;2017;10;09;Maanantai;47;94;141;22;25;47
89;02.10.2017;2017;10;10;Maanantai;46;70;116;25;24;49
89;02.10.2017;2017;10;11;Maanantai;68;96;164;24;31;55
89;02.10.2017;2017;10;12;Maanantai;62;56;118;20;29;49
89;02.10.2017;2017;10;13;Maanantai;88;70;158;18;18;36
89;02.10.2017;2017;10;14;Maanantai;105;95;200;30;25;55
89;02.10.2017;2017;10;15;Maanantai;171;80;251;22;13;35
89;02.10.2017;2017;10;16;Maanantai;211;92;303;26;31;57
89;02.10.2017;2017;10;17;Maanantai;114;86;200;25;23;48
89;02.10.2017;2017;10;18;Maanantai;103;58;161;33;41;74
89;02.10.2017;2017;10;19;Maanantai;80;32;112;37;31;68
89;02.10.2017;2017;10;20;Maanantai;59;27;86;24;24;48
89;02.10.2017;2017;10;21;Maanantai;41;21;62;10;10;20
89;02.10.2017;2017;10;22;Maanantai;14;8;22;4;4;8
89;02.10.2017;2017;10;23;Maanantai;9;6;15;3;2;5
89;03.10.2017;2017;10;00;Tiistai;1;1;2;1;1;2
89;03.10.2017;2017;10;01;Tiistai;2;1;3;0;0;0
89;03.10.2017;2017;10;02;Tiistai;0;0;0;0;1;1
89;03.10.2017;2017;10;03;Tiistai;1;4;5;2;0;2
89;03.10.2017;2017;10;04;Tiistai;1;4;5;0;1;1
89;03.10.2017;2017;10;05;Tiistai;3;11;14;1;2;3
89;03.10.2017;2017;10;06;Tiistai;9;40;49;4;6;10
89;03.10.2017;2017;10;07;Tiistai;40;128;168;5;19;24
89;03.10.2017;2017;10;08;Tiistai;36;226;262;14;27;41
89;03.10.2017;2017;10;09;Tiistai;34;100;134;21;33;54
89;03.10.2017;2017;10;10;Tiistai;41;71;112;23;32;55
89;03.10.2017;2017;10;11;Tiistai;65;57;122;25;26;51
89;03.10.2017;2017;10;12;Tiistai;57;60;117;17;46;63
89;03.10.2017;2017;10;13;Tiistai;64;57;121;40;16;56
89;03.10.2017;2017;10;14;Tiistai;96;73;169;30;18;48
89;03.10.2017;2017;10;15;Tiistai;133;54;187;26;16;42
89;03.10.2017;2017;10;16;Tiistai;210;74;284;23;24;47
89;03.10.2017;2017;10;17;Tiistai;108;55;163;21;22;43
89;03.10.2017;2017;10;18;Tiistai;72;49;121;30;31;61
89;03.10.2017;2017;10;19;Tiistai;73;21;94;32;25;57
89;03.10.2017;2017;10;20;Tiistai;45;21;66;15;8;23
89;03.10.2017;2017;10;21;Tiistai;34;14;48;7;6;13
89;03.10.2017;2017;10;22;Tiistai;7;8;15;2;5;7
89;03.10.2017;2017;10;23;Tiistai;7;3;10;4;0;4
89;04.10.2017;2017;10;00;Keskiviikko;6;2;8;1;1;2
89;04.10.2017;2017;10;01;Keskiviikko;1;2;3;0;0;0
89;04.10.2017;2017;10;02;Keskiviikko;2;1;3;0;2;2
89;04.10.2017;2017;10;03;Keskiviikko;2;0;2;0;0;0
89;04.10.2017;2017;10;04;Keskiviikko;1;2;3;2;1;3
89;04.10.2017;2017;10;05;Keskiviikko;2;10;12;0;0;0
89;04.10.2017;2017;10;06;Keskiviikko;9;35;44;1;8;9
89;04.10.2017;2017;10;07;Keskiviikko;34;122;156;6;15;21
89;04.10.2017;2017;10;08;Keskiviikko;41;161;202;8;15;23
89;04.10.2017;2017;10;09;Keskiviikko;39;88;127;17;36;53
89;04.10.2017;2017;10;10;Keskiviikko;27;59;86;13;22;35
89;04.10.2017;2017;10;11;Keskiviikko;48;69;117;23;18;41
89;04.10.2017;2017;10;12;Keskiviikko;64;76;140;22;35;57
89;04.10.2017;2017;10;13;Keskiviikko;62;50;112;32;11;43
89;04.10.2017;2017;10;14;Keskiviikko;122;64;186;24;21;45
89;04.10.2017;2017;10;15;Keskiviikko;138;58;196;19;20;39
89;04.10.2017;2017;10;16;Keskiviikko;158;86;244;30;35;65
89;04.10.2017;2017;10;17;Keskiviikko;127;63;190;28;20;48
89;04.10.2017;2017;10;18;Keskiviikko;86;50;136;34;24;58
89;04.10.2017;2017;10;19;Keskiviikko;73;27;100;16;23;39
89;04.10.2017;2017;10;20;Keskiviikko;41;26;67;29;15;44
89;04.10.2017;2017;10;21;Keskiviikko;43;11;54;7;15;22
89;04.10.2017;2017;10;22;Keskiviikko;14;9;23;6;3;9
89;04.10.2017;2017;10;23;Keskiviikko;16;13;29;4;3;7
89;05.10.2017;2017;10;00;Torstai;3;4;7;1;1;2
89;05.10.2017;2017;10;01;Torstai;6;0;6;1;0;1
89;05.10.2017;2017;10;02;Torstai;2;2;4;1;1;2
89;05.10.2017;2017;10;03;Torstai;4;2;6;0;0;0
89;05.10.2017;2017;10;04;Torstai;4;2;6;1;0;1
89;05.10.2017;2017;10;05;Torstai;3;9;12;2;2;4
89;05.10.2017;2017;10;06;Torstai;8;43;51;2;8;10
89;05.10.2017;2017;10;07;Torstai;37;124;161;4;16;20
89;05.10.2017;2017;10;08;Torstai;41;190;231;15;30;45
89;05.10.2017;2017;10;09;Torstai;43;64;107;11;15;26
89;05.10.2017;2017;10;10;Torstai;28;68;96;11;26;37
89;05.10.2017;2017;10;11;Torstai;65;72;137;17;20;37
89;05.10.2017;2017;10;12;Torstai;50;77;127;15;25;40
89;05.10.2017;2017;10;13;Torstai;71;61;132;18;21;39
89;05.10.2017;2017;10;14;Torstai;94;82;176;28;23;51
89;05.10.2017;2017;10;15;Torstai;150;69;219;22;35;57
89;05.10.2017;2017;10;16;Torstai;167;91;258;30;22;52
89;05.10.2017;2017;10;17;Torstai;116;77;193;28;42;70
89;05.10.2017;2017;10;18;Torstai;97;43;140;28;36;64
89;05.10.2017;2017;10;19;Torstai;79;55;134;35;33;68
89;05.10.2017;2017;10;20;Torstai;48;26;74;22;13;35
89;05.10.2017;2017;10;21;Torstai;52;38;90;15;11;26
89;05.10.2017;2017;10;22;Torstai;14;17;31;6;6;12
89;05.10.2017;2017;10;23;Torstai;10;3;13;1;0;1
89;06.10.2017;2017;10;00;Perjantai;13;4;17;3;3;6
89;06.10.2017;2017;10;01;Perjantai;7;4;11;0;0;0
89;06.10.2017;2017;10;02;Perjantai;3;2;5;2;0;2
89;06.10.2017;2017;10;03;Perjantai;14;2;16;6;1;7
89;06.10.2017;2017;10;04;Perjantai;6;3;9;1;1;2
89;06.10.2017;2017;10;05;Perjantai;2;12;14;5;3;8
89;06.10.2017;2017;10;06;Perjantai;8;38;46;2;4;6
89;06.10.2017;2017;10;07;Perjantai;27;126;153;4;22;26
89;06.10.2017;2017;10;08;Perjantai;28;155;183;13;22;35
89;06.10.2017;2017;10;09;Perjantai;39;97;136;19;78;97
89;06.10.2017;2017;10;10;Perjantai;36;71;107;35;21;56
89;06.10.2017;2017;10;11;Perjantai;74;79;153;20;29;49
89;06.10.2017;2017;10;12;Perjantai;72;73;145;24;29;53
89;06.10.2017;2017;10;13;Perjantai;90;75;165;24;36;60
89;06.10.2017;2017;10;14;Perjantai;149;99;248;28;26;54
89;06.10.2017;2017;10;15;Perjantai;182;75;257;35;20;55
89;06.10.2017;2017;10;16;Perjantai;140;88;228;23;13;36
89;06.10.2017;2017;10;17;Perjantai;62;66;128;15;12;27
89;06.10.2017;2017;10;18;Perjantai;68;46;114;23;21;44
89;06.10.2017;2017;10;19;Perjantai;70;24;94;19;27;46
89;06.10.2017;2017;10;20;Perjantai;43;36;79;18;13;31
89;06.10.2017;2017;10;21;Perjantai;30;27;57;13;11;24
89;06.10.2017;2017;10;22;Perjantai;11;13;24;7;12;19
89;06.10.2017;2017;10;23;Perjantai;30;17;47;2;16;18
89;07.10.2017;2017;10;00;Lauantai;19;14;33;5;11;16
89;07.10.2017;2017;10;01;Lauantai;6;9;15;3;3;6
89;07.10.2017;2017;10;02;Lauantai;9;4;13;3;2;5
89;07.10.2017;2017;10;03;Lauantai;12;8;20;8;1;9
89;07.10.2017;2017;10;04;Lauantai;6;0;6;6;0;6
89;07.10.2017;2017;10;05;Lauantai;4;5;9;6;1;7
89;07.10.2017;2017;10;06;Lauantai;6;8;14;2;3;5
89;07.10.2017;2017;10;07;Lauantai;3;12;15;1;5;6
89;07.10.2017;2017;10;08;Lauantai;15;36;51;17;13;30
89;07.10.2017;2017;10;09;Lauantai;17;45;62;13;16;29
89;07.10.2017;2017;10;10;Lauantai;19;62;81;16;27;43
89;07.10.2017;2017;10;11;Lauantai;59;93;152;25;52;77
89;07.10.2017;2017;10;12;Lauantai;56;87;143;22;31;53
89;07.10.2017;2017;10;13;Lauantai;61;69;130;33;38;71
89;07.10.2017;2017;10;14;Lauantai;75;67;142;37;26;63
89;07.10.2017;2017;10;15;Lauantai;68;61;129;44;33;77
89;07.10.2017;2017;10;16;Lauantai;95;72;167;38;34;72
89;07.10.2017;2017;10;17;Lauantai;64;53;117;39;46;85
89;07.10.2017;2017;10;18;Lauantai;67;49;116;34;33;67
89;07.10.2017;2017;10;19;Lauantai;53;35;88;20;12;32
89;07.10.2017;2017;10;20;Lauantai;36;49;85;11;16;27
89;07.10.2017;2017;10;21;Lauantai;22;39;61;6;9;15
89;07.10.2017;2017;10;22;Lauantai;31;32;63;1;6;7
89;07.10.2017;2017;10;23;Lauantai;19;32;51;5;10;15
89;08.10.2017;2017;10;00;Sunnuntai;23;29;52;11;7;18
89;08.10.2017;2017;10;01;Sunnuntai;18;8;26;5;1;6
89;08.10.2017;2017;10;02;Sunnuntai;21;6;27;6;2;8
89;08.10.2017;2017;10;03;Sunnuntai;24;0;24;3;1;4
89;08.10.2017;2017;10;04;Sunnuntai;12;0;12;4;1;5
89;08.10.2017;2017;10;05;Sunnuntai;4;2;6;4;3;7
89;08.10.2017;2017;10;06;Sunnuntai;3;5;8;2;0;2
89;08.10.2017;2017;10;07;Sunnuntai;4;4;8;6;3;9
89;08.10.2017;2017;10;08;Sunnuntai;3;11;14;7;11;18
89;08.10.2017;2017;10;09;Sunnuntai;14;26;40;17;8;25
89;08.10.2017;2017;10;10;Sunnuntai;19;41;60;34;44;78
89;08.10.2017;2017;10;11;Sunnuntai;39;67;106;45;58;103
89;08.10.2017;2017;10;12;Sunnuntai;42;72;114;46;59;105
89;08.10.2017;2017;10;13;Sunnuntai;58;78;136;40;57;97
89;08.10.2017;2017;10;14;Sunnuntai;85;58;143;45;43;88
89;08.10.2017;2017;10;15;Sunnuntai;85;64;149;45;49;94
89;08.10.2017;2017;10;16;Sunnuntai;70;49;119;40;32;72
89;08.10.2017;2017;10;17;Sunnuntai;79;65;144;43;52;95
89;08.10.2017;2017;10;18;Sunnuntai;62;52;114;46;44;90
89;08.10.2017;2017;10;19;Sunnuntai;38;34;72;22;20;42
89;08.10.2017;2017;10;20;Sunnuntai;36;16;52;23;13;36
89;08.10.2017;2017;10;21;Sunnuntai;16;11;27;7;11;18
89;08.10.2017;2017;10;22;Sunnuntai;8;5;13;3;4;7
89;08.10.2017;2017;10;23;Sunnuntai;3;2;5;2;3;5
89;09.10.2017;2017;10;00;Maanantai;4;0;4;4;2;6
89;09.10.2017;2017;10;01;Maanantai;1;0;1;1;0;1
89;09.10.2017;2017;10;02;Maanantai;2;2;4;2;0;2
89;09.10.2017;2017;10;03;Maanantai;2;1;3;0;0;0
89;09.10.2017;2017;10;04;Maanantai;1;2;3;0;3;3
89;09.10.2017;2017;10;05;Maanantai;5;13;18;2;3;5
89;09.10.2017;2017;10;06;Maanantai;11;31;42;1;9;10
89;09.10.2017;2017;10;07;Maanantai;37;137;174;4;17;21
89;09.10.2017;2017;10;08;Maanantai;26;197;223;5;38;43
89;09.10.2017;2017;10;09;Maanantai;39;107;146;16;27;43
89;09.10.2017;2017;10;10;Maanantai;46;60;106;21;36;57
89;09.10.2017;2017;10;11;Maanantai;61;80;141;12;40;52
89;09.10.2017;2017;10;12;Maanantai;66;73;139;14;24;38
89;09.10.2017;2017;10;13;Maanantai;89;55;144;37;27;64
89;09.10.2017;2017;10;14;Maanantai;128;57;185;32;16;48
89;09.10.2017;2017;10;15;Maanantai;160;69;229;26;22;48
89;09.10.2017;2017;10;16;Maanantai;206;75;281;34;21;55
89;09.10.2017;2017;10;17;Maanantai;138;84;222;37;19;56
89;09.10.2017;2017;10;18;Maanantai;114;40;154;38;41;79
89;09.10.2017;2017;10;19;Maanantai;83;43;126;34;34;68
89;09.10.2017;2017;10;20;Maanantai;55;25;80;19;13;32
89;09.10.2017;2017;10;21;Maanantai;30;19;49;11;10;21
89;09.10.2017;2017;10;22;Maanantai;11;9;20;3;1;4
89;09.10.2017;2017;10;23;Maanantai;9;1;10;1;1;2
89;10.10.2017;2017;10;00;Tiistai;7;2;9;0;1;1
89;10.10.2017;2017;10;01;Tiistai;2;0;2;3;1;4
89;10.10.2017;2017;10;02;Tiistai;2;0;2;1;0;1
89;10.10.2017;2017;10;03;Tiistai;0;0;0;1;1;2
89;10.10.2017;2017;10;04;Tiistai;2;4;6;0;0;0
89;10.10.2017;2017;10;05;Tiistai;2;4;6;0;1;1
89;10.10.2017;2017;10;06;Tiistai;8;40;48;2;6;8
89;10.10.2017;2017;10;07;Tiistai;31;93;124;4;17;21
89;10.10.2017;2017;10;08;Tiistai;21;154;175;2;29;31
89;10.10.2017;2017;10;09;Tiistai;14;54;68;8;21;29
89;10.10.2017;2017;10;10;Tiistai;19;43;62;5;12;17
89;10.10.2017;2017;10;11;Tiistai;27;41;68;12;16;28
89;10.10.2017;2017;10;12;Tiistai;34;40;74;18;9;27
89;10.10.2017;2017;10;13;Tiistai;54;33;87;26;6;32
89;10.10.2017;2017;10;14;Tiistai;87;37;124;24;7;31
89;10.10.2017;2017;10;15;Tiistai;101;55;156;20;19;39
89;10.10.2017;2017;10;16;Tiistai;129;70;199;21;17;38
89;10.10.2017;2017;10;17;Tiistai;88;56;144;29;28;57
89;10.10.2017;2017;10;18;Tiistai;62;30;92;28;31;59
89;10.10.2017;2017;10;19;Tiistai;47;27;74;28;21;49
89;10.10.2017;2017;10;20;Tiistai;41;19;60;14;13;27
89;10.10.2017;2017;10;21;Tiistai;23;6;29;7;8;15
89;10.10.2017;2017;10;22;Tiistai;10;8;18;2;2;4
89;10.10.2017;2017;10;23;Tiistai;8;5;13;3;1;4
89;11.10.2017;2017;10;00;Keskiviikko;2;2;4;2;0;2
89;11.10.2017;2017;10;01;Keskiviikko;2;1;3;1;0;1
89;11.10.2017;2017;10;02;Keskiviikko;1;2;3;0;1;1
89;11.10.2017;2017;10;03;Keskiviikko;1;2;3;0;1;1
89;11.10.2017;2017;10;04;Keskiviikko;2;1;3;0;0;0
89;11.10.2017;2017;10;05;Keskiviikko;5;9;14;0;2;2
89;11.10.2017;2017;10;06;Keskiviikko;6;45;51;4;7;11
89;11.10.2017;2017;10;07;Keskiviikko;41;115;156;4;22;26
89;11.10.2017;2017;10;08;Keskiviikko;44;207;251;7;26;33
89;11.10.2017;2017;10;09;Keskiviikko;30;105;135;15;27;42
89;11.10.2017;2017;10;10;Keskiviikko;38;70;108;29;32;61
89;11.10.2017;2017;10;11;Keskiviikko;79;84;163;18;27;45
89;11.10.2017;2017;10;12;Keskiviikko;78;75;153;25;28;53
89;11.10.2017;2017;10;13;Keskiviikko;84;72;156;20;22;42
89;11.10.2017;2017;10;14;Keskiviikko;147;72;219;36;28;64
89;11.10.2017;2017;10;15;Keskiviikko;148;78;226;25;27;52
89;11.10.2017;2017;10;16;Keskiviikko;191;103;294;34;24;58
89;11.10.2017;2017;10;17;Keskiviikko;115;91;206;35;43;78
89;11.10.2017;2017;10;18;Keskiviikko;89;58;147;30;48;78
89;11.10.2017;2017;10;19;Keskiviikko;98;36;134;45;41;86
89;11.10.2017;2017;10;20;Keskiviikko;53;28;81;23;24;47
89;11.10.2017;2017;10;21;Keskiviikko;44;23;67;11;6;17
89;11.10.2017;2017;10;22;Keskiviikko;13;13;26;5;4;9
89;11.10.2017;2017;10;23;Keskiviikko;9;11;20;4;1;5
89;12.10.2017;2017;10;00;Torstai;4;5;9;1;0;1
89;12.10.2017;2017;10;01;Torstai;7;2;9;0;1;1
89;12.10.2017;2017;10;02;Torstai;3;3;6;0;0;0
89;12.10.2017;2017;10;03;Torstai;6;0;6;1;3;4
89;12.10.2017;2017;10;04;Torstai;7;4;11;0;0;0
89;12.10.2017;2017;10;05;Torstai;2;9;11;1;2;3
89;12.10.2017;2017;10;06;Torstai;8;47;55;3;8;11
89;12.10.2017;2017;10;07;Torstai;41;120;161;6;22;28
89;12.10.2017;2017;10;08;Torstai;29;165;194;10;34;44
89;12.10.2017;2017;10;09;Torstai;41;97;138;14;39;53
89;12.10.2017;2017;10;10;Torstai;45;71;116;21;24;45
89;12.10.2017;2017;10;11;Torstai;51;76;127;26;27;53
89;12.10.2017;2017;10;12;Torstai;57;76;133;22;32;54
89;12.10.2017;2017;10;13;Torstai;68;68;136;32;37;69
89;12.10.2017;2017;10;14;Torstai;105;78;183;40;32;72
89;12.10.2017;2017;10;15;Torstai;182;53;235;35;17;52
89;12.10.2017;2017;10;16;Torstai;174;81;255;31;22;53
89;12.10.2017;2017;10;17;Torstai;123;106;229;36;27;63
89;12.10.2017;2017;10;18;Torstai;86;52;138;37;33;70
89;12.10.2017;2017;10;19;Torstai;61;44;105;42;33;75
89;12.10.2017;2017;10;20;Torstai;59;32;91;18;25;43
89;12.10.2017;2017;10;21;Torstai;31;19;50;12;12;24
89;12.10.2017;2017;10;22;Torstai;20;14;34;12;8;20
89;12.10.2017;2017;10;23;Torstai;7;8;15;3;3;6
89;13.10.2017;2017;10;00;Perjantai;9;6;15;5;3;8
89;13.10.2017;2017;10;01;Perjantai;5;1;6;8;1;9
89;13.10.2017;2017;10;02;Perjantai;3;4;7;3;1;4
89;13.10.2017;2017;10;03;Perjantai;12;1;13;0;0;0
89;13.10.2017;2017;10;04;Perjantai;3;1;4;0;0;0
89;13.10.2017;2017;10;05;Perjantai;2;6;8;0;1;1
89;13.10.2017;2017;10;06;Perjantai;9;48;57;6;7;13
89;13.10.2017;2017;10;07;Perjantai;35;110;145;5;17;22
89;13.10.2017;2017;10;08;Perjantai;30;153;183;6;26;32
89;13.10.2017;2017;10;09;Perjantai;34;98;132;8;20;28
89;13.10.2017;2017;10;10;Perjantai;42;75;117;19;25;44
89;13.10.2017;2017;10;11;Perjantai;59;91;150;16;33;49
89;13.10.2017;2017;10;12;Perjantai;69;83;152;16;28;44
89;13.10.2017;2017;10;13;Perjantai;91;69;160;28;16;44
89;13.10.2017;2017;10;14;Perjantai;135;78;213;33;24;57
89;13.10.2017;2017;10;15;Perjantai;159;72;231;32;31;63
89;13.10.2017;2017;10;16;Perjantai;151;94;245;22;22;44
89;13.10.2017;2017;10;17;Perjantai;106;75;181;25;44;69
89;13.10.2017;2017;10;18;Perjantai;80;50;130;33;25;58
89;13.10.2017;2017;10;19;Perjantai;55;61;116;19;23;42
89;13.10.2017;2017;10;20;Perjantai;44;43;87;15;20;35
89;13.10.2017;2017;10;21;Perjantai;24;36;60;10;10;20
89;13.10.2017;2017;10;22;Perjantai;16;13;29;8;7;15
89;13.10.2017;2017;10;23;Perjantai;28;23;51;2;13;15
89;14.10.2017;2017;10;00;Lauantai;23;9;32;6;9;15
89;14.10.2017;2017;10;01;Lauantai;24;11;35;3;7;10
89;14.10.2017;2017;10;02;Lauantai;22;5;27;1;0;1
89;14.10.2017;2017;10;03;Lauantai;11;2;13;2;0;2
89;14.10.2017;2017;10;04;Lauantai;11;1;12;7;0;7
89;14.10.2017;2017;10;05;Lauantai;8;5;13;2;1;3
89;14.10.2017;2017;10;06;Lauantai;5;8;13;2;3;5
89;14.10.2017;2017;10;07;Lauantai;3;11;14;4;5;9
89;14.10.2017;2017;10;08;Lauantai;10;19;29;2;5;7
89;14.10.2017;2017;10;09;Lauantai;19;62;81;15;19;34
89;14.10.2017;2017;10;10;Lauantai;26;76;102;19;33;52
89;14.10.2017;2017;10;11;Lauantai;45;87;132;39;35;74
89;14.10.2017;2017;10;12;Lauantai;64;83;147;28;39;67
89;14.10.2017;2017;10;13;Lauantai;79;83;162;32;31;63
89;14.10.2017;2017;10;14;Lauantai;84;69;153;30;33;63
89;14.10.2017;2017;10;15;Lauantai;113;69;182;35;31;66
89;14.10.2017;2017;10;16;Lauantai;65;34;99;20;23;43
89;14.10.2017;2017;10;17;Lauantai;50;26;76;13;20;33
89;14.10.2017;2017;10;18;Lauantai;47;12;59;12;14;26
89;14.10.2017;2017;10;19;Lauantai;34;22;56;8;6;14
89;14.10.2017;2017;10;20;Lauantai;23;25;48;13;8;21
89;14.10.2017;2017;10;21;Lauantai;19;9;28;13;7;20
89;14.10.2017;2017;10;22;Lauantai;11;15;26;9;3;12
89;14.10.2017;2017;10;23;Lauantai;10;28;38;2;5;7
89;15.10.2017;2017;10;00;Sunnuntai;22;26;48;2;6;8
89;15.10.2017;2017;10;01;Sunnuntai;10;3;13;3;5;8
89;15.10.2017;2017;10;02;Sunnuntai;17;12;29;2;2;4
89;15.10.2017;2017;10;03;Sunnuntai;21;3;24;5;0;5
89;15.10.2017;2017;10;04;Sunnuntai;14;2;16;6;0;6
89;15.10.2017;2017;10;05;Sunnuntai;3;0;3;1;0;1
89;15.10.2017;2017;10;06;Sunnuntai;1;2;3;4;6;10
89;15.10.2017;2017;10;07;Sunnuntai;0;10;10;3;5;8
89;15.10.2017;2017;10;08;Sunnuntai;3;6;9;4;6;10
89;15.10.2017;2017;10;09;Sunnuntai;19;15;34;20;31;51
89;15.10.2017;2017;10;10;Sunnuntai;14;43;57;37;58;95
89;15.10.2017;2017;10;11;Sunnuntai;32;60;92;52;50;102
89;15.10.2017;2017;10;12;Sunnuntai;41;63;104;41;42;83
89;15.10.2017;2017;10;13;Sunnuntai;52;79;131;49;61;110
89;15.10.2017;2017;10;14;Sunnuntai;77;81;158;49;73;122
89;15.10.2017;2017;10;15;Sunnuntai;89;68;157;79;71;150
89;15.10.2017;2017;10;16;Sunnuntai;88;61;149;58;68;126
89;15.10.2017;2017;10;17;Sunnuntai;89;45;134;46;39;85
89;15.10.2017;2017;10;18;Sunnuntai;47;46;93;38;25;63
89;15.10.2017;2017;10;19;Sunnuntai;34;22;56;23;25;48
89;15.10.2017;2017;10;20;Sunnuntai;28;14;42;18;17;35
89;15.10.2017;2017;10;21;Sunnuntai;27;21;48;7;6;13
89;15.10.2017;2017;10;22;Sunnuntai;8;8;16;5;3;8
89;15.10.2017;2017;10;23;Sunnuntai;4;8;12;1;1;2
89;16.10.2017;2017;10;00;Maanantai;5;1;6;4;1;5
89;16.10.2017;2017;10;01;Maanantai;1;3;4;0;0;0
89;16.10.2017;2017;10;02;Maanantai;3;3;6;4;0;4
89;16.10.2017;2017;10;03;Maanantai;1;1;2;2;2;4
89;16.10.2017;2017;10;04;Maanantai;4;3;7;0;1;1
89;16.10.2017;2017;10;05;Maanantai;3;11;14;0;0;0
89;16.10.2017;2017;10;06;Maanantai;13;36;49;2;6;8
89;16.10.2017;2017;10;07;Maanantai;30;119;149;3;10;13
89;16.10.2017;2017;10;08;Maanantai;29;132;161;5;20;25
89;16.10.2017;2017;10;09;Maanantai;24;66;90;5;20;25
89;16.10.2017;2017;10;10;Maanantai;23;33;56;8;14;22
89;16.10.2017;2017;10;11;Maanantai;23;41;64;8;13;21
89;16.10.2017;2017;10;12;Maanantai;33;41;74;12;17;29
89;16.10.2017;2017;10;13;Maanantai;41;37;78;20;5;25
89;16.10.2017;2017;10;14;Maanantai;76;37;113;22;8;30
89;16.10.2017;2017;10;15;Maanantai;134;65;199;37;31;68
89;16.10.2017;2017;10;16;Maanantai;168;85;253;34;36;70
89;16.10.2017;2017;10;17;Maanantai;95;86;181;42;29;71
89;16.10.2017;2017;10;18;Maanantai;88;58;146;47;41;88
89;16.10.2017;2017;10;19;Maanantai;62;38;100;33;36;69
89;16.10.2017;2017;10;20;Maanantai;49;13;62;22;16;38
89;16.10.2017;2017;10;21;Maanantai;32;14;46;10;11;21
89;16.10.2017;2017;10;22;Maanantai;20;7;27;2;4;6
89;16.10.2017;2017;10;23;Maanantai;4;3;7;2;3;5
89;17.10.2017;2017;10;00;Tiistai;1;4;5;1;2;3
89;17.10.2017;2017;10;01;Tiistai;0;4;4;0;0;0
89;17.10.2017;2017;10;02;Tiistai;1;1;2;0;1;1
89;17.10.2017;2017;10;03;Tiistai;2;2;4;1;0;1
89;17.10.2017;2017;10;04;Tiistai;1;2;3;1;1;2
89;17.10.2017;2017;10;05;Tiistai;1;9;10;0;0;0
89;17.10.2017;2017;10;06;Tiistai;10;50;60;1;4;5
89;17.10.2017;2017;10;07;Tiistai;33;119;152;7;16;23
89;17.10.2017;2017;10;08;Tiistai;30;214;244;5;45;50
89;17.10.2017;2017;10;09;Tiistai;33;108;141;27;30;57
89;17.10.2017;2017;10;10;Tiistai;43;74;117;20;46;66
89;17.10.2017;2017;10;11;Tiistai;59;99;158;30;50;80
89;17.10.2017;2017;10;12;Tiistai;74;57;131;30;47;77
89;17.10.2017;2017;10;13;Tiistai;83;81;164;36;35;71
89;17.10.2017;2017;10;14;Tiistai;138;74;212;58;48;106
89;17.10.2017;2017;10;15;Tiistai;152;72;224;29;30;59
89;17.10.2017;2017;10;16;Tiistai;204;101;305;40;47;87
89;17.10.2017;2017;10;17;Tiistai;133;82;215;51;35;86
89;17.10.2017;2017;10;18;Tiistai;88;54;142;38;40;78
89;17.10.2017;2017;10;19;Tiistai;71;35;106;31;35;66
89;17.10.2017;2017;10;20;Tiistai;57;27;84;28;21;49
89;17.10.2017;2017;10;21;Tiistai;40;19;59;10;12;22
89;17.10.2017;2017;10;22;Tiistai;17;9;26;5;5;10
89;17.10.2017;2017;10;23;Tiistai;5;4;9;2;2;4
89;18.10.2017;2017;10;00;Keskiviikko;6;4;10;4;1;5
89;18.10.2017;2017;10;01;Keskiviikko;4;2;6;0;0;0
89;18.10.2017;2017;10;02;Keskiviikko;2;3;5;1;0;1
89;18.10.2017;2017;10;03;Keskiviikko;1;1;2;0;0;0
89;18.10.2017;2017;10;04;Keskiviikko;0;3;3;1;0;1
89;18.10.2017;2017;10;05;Keskiviikko;0;7;7;0;1;1
89;18.10.2017;2017;10;06;Keskiviikko;13;39;52;2;5;7
89;18.10.2017;2017;10;07;Keskiviikko;26;127;153;8;21;29
89;18.10.2017;2017;10;08;Keskiviikko;40;163;203;12;20;32
89;18.10.2017;2017;10;09;Keskiviikko;29;107;136;13;30;43
89;18.10.2017;2017;10;10;Keskiviikko;40;69;109;16;27;43
89;18.10.2017;2017;10;11;Keskiviikko;51;62;113;21;28;49
89;18.10.2017;2017;10;12;Keskiviikko;61;68;129;20;40;60
89;18.10.2017;2017;10;13;Keskiviikko;91;67;158;34;34;68
89;18.10.2017;2017;10;14;Keskiviikko;96;61;157;29;26;55
89;18.10.2017;2017;10;15;Keskiviikko;136;58;194;31;21;52
89;18.10.2017;2017;10;16;Keskiviikko;201;108;309;37;37;74
89;18.10.2017;2017;10;17;Keskiviikko;112;71;183;33;23;56
89;18.10.2017;2017;10;18;Keskiviikko;72;47;119;26;27;53
89;18.10.2017;2017;10;19;Keskiviikko;84;40;124;22;16;38
89;18.10.2017;2017;10;20;Keskiviikko;53;23;76;16;13;29
89;18.10.2017;2017;10;21;Keskiviikko;50;18;68;10;6;16
89;18.10.2017;2017;10;22;Keskiviikko;21;5;26;3;2;5
89;18.10.2017;2017;10;23;Keskiviikko;8;9;17;4;0;4
89;19.10.2017;2017;10;00;Torstai;8;2;10;0;0;0
89;19.10.2017;2017;10;01;Torstai;4;3;7;0;0;0
89;19.10.2017;2017;10;02;Torstai;1;2;3;0;0;0
89;19.10.2017;2017;10;03;Torstai;3;3;6;2;0;2
89;19.10.2017;2017;10;04;Torstai;2;3;5;0;1;1
89;19.10.2017;2017;10;05;Torstai;0;6;6;0;1;1
89;19.10.2017;2017;10;06;Torstai;11;41;52;2;4;6
89;19.10.2017;2017;10;07;Torstai;26;115;141;5;17;22
89;19.10.2017;2017;10;08;Torstai;38;174;212;9;31;40
89;19.10.2017;2017;10;09;Torstai;36;88;124;24;49;73
89;19.10.2017;2017;10;10;Torstai;34;56;90;14;34;48
89;19.10.2017;2017;10;11;Torstai;50;101;151;26;45;71
89;19.10.2017;2017;10;12;Torstai;56;72;128;41;28;69
89;19.10.2017;2017;10;13;Torstai;90;55;145;21;28;49
89;19.10.2017;2017;10;14;Torstai;117;56;173;38;20;58
89;19.10.2017;2017;10;15;Torstai;133;89;222;39;38;77
89;19.10.2017;2017;10;16;Torstai;167;83;250;38;31;69
89;19.10.2017;2017;10;17;Torstai;92;91;183;21;40;61
89;19.10.2017;2017;10;18;Torstai;70;48;118;36;19;55
89;19.10.2017;2017;10;19;Torstai;53;36;89;30;24;54
89;19.10.2017;2017;10;20;Torstai;67;23;90;27;20;47
89;19.10.2017;2017;10;21;Torstai;43;14;57;21;9;30
89;19.10.2017;2017;10;22;Torstai;13;7;20;7;6;13
89;19.10.2017;2017;10;23;Torstai;11;15;26;4;1;5
89;20.10.2017;2017;10;00;Perjantai;11;5;16;4;1;5
89;20.10.2017;2017;10;01;Perjantai;13;2;15;2;1;3
89;20.10.2017;2017;10;02;Perjantai;8;1;9;3;2;5
89;20.10.2017;2017;10;03;Perjantai;5;2;7;0;0;0
89;20.10.2017;2017;10;04;Perjantai;10;2;12;0;0;0
89;20.10.2017;2017;10;05;Perjantai;3;14;17;0;1;1
89;20.10.2017;2017;10;06;Perjantai;9;38;47;3;8;11
89;20.10.2017;2017;10;07;Perjantai;25;115;140;5;22;27
89;20.10.2017;2017;10;08;Perjantai;27;135;162;10;16;26
89;20.10.2017;2017;10;09;Perjantai;25;74;99;9;25;34
89;20.10.2017;2017;10;10;Perjantai;30;41;71;18;18;36
89;20.10.2017;2017;10;11;Perjantai;38;51;89;15;26;41
89;20.10.2017;2017;10;12;Perjantai;34;66;100;26;24;50
89;20.10.2017;2017;10;13;Perjantai;68;55;123;28;23;51
89;20.10.2017;2017;10;14;Perjantai;118;51;169;28;28;56
89;20.10.2017;2017;10;15;Perjantai;131;56;187;23;23;46
89;20.10.2017;2017;10;16;Perjantai;112;74;186;22;29;51
89;20.10.2017;2017;10;17;Perjantai;71;55;126;47;33;80
89;20.10.2017;2017;10;18;Perjantai;62;48;110;33;23;56
89;20.10.2017;2017;10;19;Perjantai;39;32;71;16;25;41
89;20.10.2017;2017;10;20;Perjantai;33;15;48;14;13;27
89;20.10.2017;2017;10;21;Perjantai;31;20;51;12;11;23
89;20.10.2017;2017;10;22;Perjantai;18;16;34;16;18;34
89;20.10.2017;2017;10;23;Perjantai;13;11;24;5;19;24
89;21.10.2017;2017;10;00;Lauantai;12;13;25;8;3;11
89;21.10.2017;2017;10;01;Lauantai;9;2;11;7;3;10
89;21.10.2017;2017;10;02;Lauantai;2;6;8;6;1;7
89;21.10.2017;2017;10;03;Lauantai;8;0;8;1;2;3
89;21.10.2017;2017;10;04;Lauantai;11;2;13;8;2;10
89;21.10.2017;2017;10;05;Lauantai;3;3;6;0;0;0
89;21.10.2017;2017;10;06;Lauantai;1;6;7;4;3;7
89;21.10.2017;2017;10;07;Lauantai;4;6;10;3;8;11
89;21.10.2017;2017;10;08;Lauantai;4;13;17;6;10;16
89;21.10.2017;2017;10;09;Lauantai;11;37;48;5;27;32
89;21.10.2017;2017;10;10;Lauantai;13;53;66;14;37;51
89;21.10.2017;2017;10;11;Lauantai;22;53;75;27;48;75
89;21.10.2017;2017;10;12;Lauantai;38;52;90;27;38;65
89;21.10.2017;2017;10;13;Lauantai;38;51;89;35;31;66
89;21.10.2017;2017;10;14;Lauantai;47;56;103;22;46;68
89;21.10.2017;2017;10;15;Lauantai;56;33;89;27;30;57
89;21.10.2017;2017;10;16;Lauantai;30;39;69;28;32;60
89;21.10.2017;2017;10;17;Lauantai;41;36;77;34;29;63
89;21.10.2017;2017;10;18;Lauantai;43;32;75;28;19;47
89;21.10.2017;2017;10;19;Lauantai;22;21;43;14;17;31
89;21.10.2017;2017;10;20;Lauantai;30;20;50;9;20;29
89;21.10.2017;2017;10;21;Lauantai;28;18;46;9;9;18
89;21.10.2017;2017;10;22;Lauantai;19;22;41;4;11;15
89;21.10.2017;2017;10;23;Lauantai;17;8;25;8;9;17
89;22.10.2017;2017;10;00;Sunnuntai;13;6;19;5;6;11
89;22.10.2017;2017;10;01;Sunnuntai;7;8;15;3;0;3
89;22.10.2017;2017;10;02;Sunnuntai;10;9;19;3;2;5
89;22.10.2017;2017;10;03;Sunnuntai;18;2;20;4;0;4
89;22.10.2017;2017;10;04;Sunnuntai;12;2;14;3;1;4
89;22.10.2017;2017;10;05;Sunnuntai;5;1;6;0;1;1
89;22.10.2017;2017;10;06;Sunnuntai;3;3;6;1;3;4
89;22.10.2017;2017;10;07;Sunnuntai;2;2;4;1;6;7
89;22.10.2017;2017;10;08;Sunnuntai;6;5;11;4;11;15
89;22.10.2017;2017;10;09;Sunnuntai;9;8;17;19;13;32
89;22.10.2017;2017;10;10;Sunnuntai;9;22;31;17;34;51
89;22.10.2017;2017;10;11;Sunnuntai;19;44;63;39;44;83
89;22.10.2017;2017;10;12;Sunnuntai;38;43;81;52;54;106
89;22.10.2017;2017;10;13;Sunnuntai;31;57;88;54;63;117
89;22.10.2017;2017;10;14;Sunnuntai;63;38;101;54;40;94
89;22.10.2017;2017;10;15;Sunnuntai;61;29;90;33;29;62
89;22.10.2017;2017;10;16;Sunnuntai;39;42;81;44;41;85
89;22.10.2017;2017;10;17;Sunnuntai;30;38;68;35;40;75
89;22.10.2017;2017;10;18;Sunnuntai;38;25;63;26;27;53
89;22.10.2017;2017;10;19;Sunnuntai;20;11;31;21;22;43
89;22.10.2017;2017;10;20;Sunnuntai;16;12;28;8;12;20
89;22.10.2017;2017;10;21;Sunnuntai;12;9;21;10;3;13
89;22.10.2017;2017;10;22;Sunnuntai;6;7;13;9;2;11
89;22.10.2017;2017;10;23;Sunnuntai;4;4;8;0;1;1
89;23.10.2017;2017;10;00;Maanantai;5;1;6;2;0;2
89;23.10.2017;2017;10;01;Maanantai;1;0;1;1;0;1
89;23.10.2017;2017;10;02;Maanantai;0;2;2;2;1;3
89;23.10.2017;2017;10;03;Maanantai;1;0;1;1;0;1
89;23.10.2017;2017;10;04;Maanantai;5;2;7;1;0;1
89;23.10.2017;2017;10;05;Maanantai;2;7;9;0;1;1
89;23.10.2017;2017;10;06;Maanantai;7;30;37;0;3;3
89;23.10.2017;2017;10;07;Maanantai;14;77;91;7;15;22
89;23.10.2017;2017;10;08;Maanantai;16;71;87;4;18;22
89;23.10.2017;2017;10;09;Maanantai;22;52;74;15;28;43
89;23.10.2017;2017;10;10;Maanantai;39;57;96;16;33;49
89;23.10.2017;2017;10;11;Maanantai;43;54;97;28;37;65
89;23.10.2017;2017;10;12;Maanantai;37;49;86;25;38;63
89;23.10.2017;2017;10;13;Maanantai;55;47;102;31;35;66
89;23.10.2017;2017;10;14;Maanantai;71;64;135;32;49;81
89;23.10.2017;2017;10;15;Maanantai;93;45;138;30;18;48
89;23.10.2017;2017;10;16;Maanantai;116;63;179;29;29;58
89;23.10.2017;2017;10;17;Maanantai;81;47;128;35;25;60
89;23.10.2017;2017;10;18;Maanantai;55;27;82;28;30;58
89;23.10.2017;2017;10;19;Maanantai;47;21;68;32;13;45
89;23.10.2017;2017;10;20;Maanantai;32;11;43;15;14;29
89;23.10.2017;2017;10;21;Maanantai;20;10;30;6;5;11
89;23.10.2017;2017;10;22;Maanantai;7;2;9;2;3;5
89;23.10.2017;2017;10;23;Maanantai;3;4;7;2;0;2
89;24.10.2017;2017;10;00;Tiistai;4;1;5;6;5;11
89;24.10.2017;2017;10;01;Tiistai;0;3;3;0;0;0
89;24.10.2017;2017;10;02;Tiistai;1;1;2;0;0;0
89;24.10.2017;2017;10;03;Tiistai;0;1;1;1;1;2
89;24.10.2017;2017;10;04;Tiistai;2;3;5;0;1;1
89;24.10.2017;2017;10;05;Tiistai;1;5;6;1;2;3
89;24.10.2017;2017;10;06;Tiistai;6;28;34;2;8;10
89;24.10.2017;2017;10;07;Tiistai;16;82;98;3;24;27
89;24.10.2017;2017;10;08;Tiistai;22;77;99;6;21;27
89;24.10.2017;2017;10;09;Tiistai;26;44;70;12;28;40
89;24.10.2017;2017;10;10;Tiistai;24;49;73;14;45;59
89;24.10.2017;2017;10;11;Tiistai;25;49;74;27;38;65
89;24.10.2017;2017;10;12;Tiistai;52;56;108;32;34;66
89;24.10.2017;2017;10;13;Tiistai;51;50;101;35;31;66
89;24.10.2017;2017;10;14;Tiistai;60;36;96;36;39;75
89;24.10.2017;2017;10;15;Tiistai;86;51;137;33;20;53
89;24.10.2017;2017;10;16;Tiistai;134;59;193;40;28;68
89;24.10.2017;2017;10;17;Tiistai;78;54;132;37;27;64
89;24.10.2017;2017;10;18;Tiistai;53;37;90;29;26;55
89;24.10.2017;2017;10;19;Tiistai;47;24;71;26;25;51
89;24.10.2017;2017;10;20;Tiistai;29;14;43;18;13;31
89;24.10.2017;2017;10;21;Tiistai;40;14;54;17;10;27
89;24.10.2017;2017;10;22;Tiistai;13;4;17;7;4;11
89;24.10.2017;2017;10;23;Tiistai;3;7;10;0;2;2
89;25.10.2017;2017;10;00;Keskiviikko;5;7;12;1;6;7
89;25.10.2017;2017;10;01;Keskiviikko;2;1;3;1;2;3
89;25.10.2017;2017;10;02;Keskiviikko;3;3;6;2;3;5
89;25.10.2017;2017;10;03;Keskiviikko;3;3;6;0;1;1
89;25.10.2017;2017;10;04;Keskiviikko;1;5;6;1;0;1
89;25.10.2017;2017;10;05;Keskiviikko;1;4;5;0;0;0
89;25.10.2017;2017;10;06;Keskiviikko;6;31;37;3;6;9
89;25.10.2017;2017;10;07;Keskiviikko;18;71;89;5;18;23
89;25.10.2017;2017;10;08;Keskiviikko;15;84;99;5;14;19
89;25.10.2017;2017;10;09;Keskiviikko;16;53;69;18;35;53
89;25.10.2017;2017;10;10;Keskiviikko;20;58;78;20;38;58
89;25.10.2017;2017;10;11;Keskiviikko;28;49;77;32;34;66
89;25.10.2017;2017;10;12;Keskiviikko;40;55;95;19;31;50
89;25.10.2017;2017;10;13;Keskiviikko;74;52;126;23;27;50
89;25.10.2017;2017;10;14;Keskiviikko;53;52;105;29;31;60
89;25.10.2017;2017;10;15;Keskiviikko;106;34;140;36;27;63
89;25.10.2017;2017;10;16;Keskiviikko;136;63;199;42;19;61
89;25.10.2017;2017;10;17;Keskiviikko;96;57;153;24;42;66
89;25.10.2017;2017;10;18;Keskiviikko;62;27;89;30;19;49
89;25.10.2017;2017;10;19;Keskiviikko;56;11;67;25;28;53
89;25.10.2017;2017;10;20;Keskiviikko;31;10;41;12;20;32
89;25.10.2017;2017;10;21;Keskiviikko;20;8;28;5;3;8
89;25.10.2017;2017;10;22;Keskiviikko;9;6;15;6;5;11
89;25.10.2017;2017;10;23;Keskiviikko;13;6;19;4;5;9
89;26.10.2017;2017;10;00;Torstai;8;5;13;4;2;6
89;26.10.2017;2017;10;01;Torstai;0;3;3;2;0;2
89;26.10.2017;2017;10;02;Torstai;1;0;1;0;0;0
89;26.10.2017;2017;10;03;Torstai;7;3;10;0;0;0
89;26.10.2017;2017;10;04;Torstai;0;1;1;2;0;2
89;26.10.2017;2017;10;05;Torstai;0;1;1;1;2;3
89;26.10.2017;2017;10;06;Torstai;7;31;38;2;4;6
89;26.10.2017;2017;10;07;Torstai;9;68;77;6;20;26
89;26.10.2017;2017;10;08;Torstai;11;84;95;6;9;15
89;26.10.2017;2017;10;09;Torstai;14;41;55;10;18;28
89;26.10.2017;2017;10;10;Torstai;25;41;66;10;23;33
89;26.10.2017;2017;10;11;Torstai;25;42;67;34;33;67
89;26.10.2017;2017;10;12;Torstai;31;41;72;13;37;50
89;26.10.2017;2017;10;13;Torstai;37;40;77;19;27;46
89;26.10.2017;2017;10;14;Torstai;65;44;109;29;28;57
89;26.10.2017;2017;10;15;Torstai;69;41;110;21;28;49
89;26.10.2017;2017;10;16;Torstai;95;51;146;29;38;67
89;26.10.2017;2017;10;17;Torstai;83;58;141;32;31;63
89;26.10.2017;2017;10;18;Torstai;49;29;78;27;20;47
89;26.10.2017;2017;10;19;Torstai;38;31;69;24;25;49
89;26.10.2017;2017;10;20;Torstai;34;19;53;17;19;36
89;26.10.2017;2017;10;21;Torstai;33;11;44;14;13;27
89;26.10.2017;2017;10;22;Torstai;12;16;28;8;3;11
89;26.10.2017;2017;10;23;Torstai;2;4;6;4;2;6
89;27.10.2017;2017;10;00;Perjantai;3;6;9;2;2;4
89;27.10.2017;2017;10;01;Perjantai;4;2;6;1;1;2
89;27.10.2017;2017;10;02;Perjantai;1;3;4;0;0;0
89;27.10.2017;2017;10;03;Perjantai;1;1;2;0;0;0
89;27.10.2017;2017;10;04;Perjantai;6;2;8;1;0;1
89;27.10.2017;2017;10;05;Perjantai;2;4;6;1;3;4
89;27.10.2017;2017;10;06;Perjantai;5;32;37;1;8;9
89;27.10.2017;2017;10;07;Perjantai;14;79;93;4;16;20
89;27.10.2017;2017;10;08;Perjantai;16;61;77;10;18;28
89;27.10.2017;2017;10;09;Perjantai;19;51;70;19;16;35
89;27.10.2017;2017;10;10;Perjantai;30;44;74;8;24;32
89;27.10.2017;2017;10;11;Perjantai;29;60;89;25;27;52
89;27.10.2017;2017;10;12;Perjantai;48;48;96;30;41;71
89;27.10.2017;2017;10;13;Perjantai;46;47;93;27;25;52
89;27.10.2017;2017;10;14;Perjantai;72;61;133;27;29;56
89;27.10.2017;2017;10;15;Perjantai;84;44;128;26;33;59
89;27.10.2017;2017;10;16;Perjantai;105;44;149;33;18;51
89;27.10.2017;2017;10;17;Perjantai;52;33;85;36;23;59
89;27.10.2017;2017;10;18;Perjantai;49;25;74;21;18;39
89;27.10.2017;2017;10;19;Perjantai;50;19;69;16;22;38
89;27.10.2017;2017;10;20;Perjantai;36;29;65;12;11;23
89;27.10.2017;2017;10;21;Perjantai;32;24;56;10;11;21
89;27.10.2017;2017;10;22;Perjantai;13;15;28;3;13;16
89;27.10.2017;2017;10;23;Perjantai;9;9;18;8;0;8
89;28.10.2017;2017;10;00;Lauantai;12;16;28;7;7;14
89;28.10.2017;2017;10;01;Lauantai;4;10;14;0;5;5
89;28.10.2017;2017;10;02;Lauantai;12;1;13;7;1;8
89;28.10.2017;2017;10;03;Lauantai;7;0;7;3;1;4
89;28.10.2017;2017;10;04;Lauantai;5;0;5;4;1;5
89;28.10.2017;2017;10;05;Lauantai;3;3;6;2;0;2
89;28.10.2017;2017;10;06;Lauantai;1;4;5;2;1;3
89;28.10.2017;2017;10;07;Lauantai;1;4;5;2;8;10
89;28.10.2017;2017;10;08;Lauantai;5;13;18;4;5;9
89;28.10.2017;2017;10;09;Lauantai;7;24;31;16;10;26
89;28.10.2017;2017;10;10;Lauantai;15;32;47;11;25;36
89;28.10.2017;2017;10;11;Lauantai;20;28;48;16;21;37
89;28.10.2017;2017;10;12;Lauantai;23;19;42;30;20;50
89;28.10.2017;2017;10;13;Lauantai;31;34;65;8;19;27
89;28.10.2017;2017;10;14;Lauantai;35;23;58;12;10;22
89;28.10.2017;2017;10;15;Lauantai;34;26;60;12;13;25
89;28.10.2017;2017;10;16;Lauantai;18;19;37;16;15;31
89;28.10.2017;2017;10;17;Lauantai;29;18;47;15;14;29
89;28.10.2017;2017;10;18;Lauantai;22;21;43;6;14;20
89;28.10.2017;2017;10;19;Lauantai;14;15;29;10;14;24
89;28.10.2017;2017;10;20;Lauantai;18;17;35;14;8;22
89;28.10.2017;2017;10;21;Lauantai;11;11;22;3;5;8
89;28.10.2017;2017;10;22;Lauantai;2;7;9;5;6;11
89;28.10.2017;2017;10;23;Lauantai;2;16;18;4;9;13
89;29.10.2017;2017;10;00;Sunnuntai;19;7;26;2;1;3
89;29.10.2017;2017;10;01;Sunnuntai;8;2;10;5;5;10
89;29.10.2017;2017;10;02;Sunnuntai;10;4;14;7;1;8
89;29.10.2017;2017;10;03;Sunnuntai;13;0;13;6;1;7
89;29.10.2017;2017;10;04;Sunnuntai;7;0;7;7;1;8
89;29.10.2017;2017;10;05;Sunnuntai;1;1;2;2;0;2
89;29.10.2017;2017;10;06;Sunnuntai;1;3;4;3;2;5
89;29.10.2017;2017;10;07;Sunnuntai;0;3;3;2;6;8
89;29.10.2017;2017;10;08;Sunnuntai;8;7;15;9;12;21
89;29.10.2017;2017;10;09;Sunnuntai;8;11;19;7;19;26
89;29.10.2017;2017;10;10;Sunnuntai;9;26;35;25;34;59
89;29.10.2017;2017;10;11;Sunnuntai;14;20;34;22;27;49
89;29.10.2017;2017;10;12;Sunnuntai;11;15;26;23;23;46
89;29.10.2017;2017;10;13;Sunnuntai;23;17;40;20;24;44
89;29.10.2017;2017;10;14;Sunnuntai;18;18;36;33;30;63
89;29.10.2017;2017;10;15;Sunnuntai;22;15;37;18;27;45
89;29.10.2017;2017;10;16;Sunnuntai;16;12;28;22;28;50
89;29.10.2017;2017;10;17;Sunnuntai;22;16;38;24;19;43
89;29.10.2017;2017;10;18;Sunnuntai;26;15;41;18;20;38
89;29.10.2017;2017;10;19;Sunnuntai;10;6;16;5;11;16
89;29.10.2017;2017;10;20;Sunnuntai;10;5;15;12;5;17
89;29.10.2017;2017;10;21;Sunnuntai;11;5;16;8;2;10
89;29.10.2017;2017;10;22;Sunnuntai;3;10;13;5;4;9
89;29.10.2017;2017;10;23;Sunnuntai;2;2;4;3;2;5
89;30.10.2017;2017;10;00;Maanantai;2;1;3;1;2;3
89;30.10.2017;2017;10;01;Maanantai;0;0;0;0;1;1
89;30.10.2017;2017;10;02;Maanantai;0;1;1;3;3;6
89;30.10.2017;2017;10;03;Maanantai;0;5;5;1;0;1
89;30.10.2017;2017;10;04;Maanantai;1;2;3;0;0;0
89;30.10.2017;2017;10;05;Maanantai;1;8;9;0;3;3
89;30.10.2017;2017;10;06;Maanantai;5;29;34;0;8;8
89;30.10.2017;2017;10;07;Maanantai;24;78;102;4;25;29
89;30.10.2017;2017;10;08;Maanantai;26;116;142;9;33;42
89;30.10.2017;2017;10;09;Maanantai;24;61;85;20;51;71
89;30.10.2017;2017;10;10;Maanantai;21;51;72;36;40;76
89;30.10.2017;2017;10;11;Maanantai;45;47;92;30;54;84
89;30.10.2017;2017;10;12;Maanantai;33;28;61;35;30;65
89;30.10.2017;2017;10;13;Maanantai;53;33;86;43;21;64
89;30.10.2017;2017;10;14;Maanantai;64;38;102;40;31;71
89;30.10.2017;2017;10;15;Maanantai;74;39;113;42;59;101
89;30.10.2017;2017;10;16;Maanantai;143;44;187;51;32;83
89;30.10.2017;2017;10;17;Maanantai;60;38;98;39;51;90
89;30.10.2017;2017;10;18;Maanantai;48;26;74;28;30;58
89;30.10.2017;2017;10;19;Maanantai;39;15;54;45;15;60
89;30.10.2017;2017;10;20;Maanantai;24;17;41;19;12;31
89;30.10.2017;2017;10;21;Maanantai;23;15;38;13;11;24
89;30.10.2017;2017;10;22;Maanantai;9;4;13;3;4;7
89;30.10.2017;2017;10;23;Maanantai;3;3;6;2;2;4
89;31.10.2017;2017;10;00;Tiistai;3;1;4;4;0;4
89;31.10.2017;2017;10;01;Tiistai;0;1;1;1;0;1
89;31.10.2017;2017;10;02;Tiistai;0;1;1;1;0;1
89;31.10.2017;2017;10;03;Tiistai;3;1;4;0;0;0
89;31.10.2017;2017;10;04;Tiistai;0;2;2;1;0;1
89;31.10.2017;2017;10;05;Tiistai;2;6;8;1;0;1
89;31.10.2017;2017;10;06;Tiistai;6;28;34;1;8;9
89;31.10.2017;2017;10;07;Tiistai;20;86;106;10;31;41
89;31.10.2017;2017;10;08;Tiistai;24;126;150;16;42;58
89;31.10.2017;2017;10;09;Tiistai;23;56;79;20;27;47
89;31.10.2017;2017;10;10;Tiistai;13;49;62;25;54;79
89;31.10.2017;2017;10;11;Tiistai;42;30;72;28;41;69
89;31.10.2017;2017;10;12;Tiistai;31;34;65;36;39;75
89;31.10.2017;2017;10;13;Tiistai;46;33;79;37;40;77
89;31.10.2017;2017;10;14;Tiistai;44;34;78;56;41;97
89;31.10.2017;2017;10;15;Tiistai;102;41;143;35;26;61
89;31.10.2017;2017;10;16;Tiistai;111;68;179;42;30;72
89;31.10.2017;2017;10;17;Tiistai;84;45;129;31;21;52
89;31.10.2017;2017;10;18;Tiistai;38;21;59;32;32;64
89;31.10.2017;2017;10;19;Tiistai;46;16;62;33;16;49
89;31.10.2017;2017;10;20;Tiistai;44;9;53;18;11;29
89;31.10.2017;2017;10;21;Tiistai;22;10;32;11;8;19
89;31.10.2017;2017;10;22;Tiistai;10;4;14;6;6;12
89;31.10.2017;2017;10;23;Tiistai;3;4;7;2;0;2
89;01.11.2017;2017;11;00;Keskiviikko;7;3;10;0;1;1
89;01.11.2017;2017;11;01;Keskiviikko;1;1;2;2;0;2
89;01.11.2017;2017;11;02;Keskiviikko;0;1;1;3;0;3
89;01.11.2017;2017;11;03;Keskiviikko;0;2;2;0;0;0
89;01.11.2017;2017;11;04;Keskiviikko;1;4;5;1;1;2
89;01.11.2017;2017;11;05;Keskiviikko;2;6;8;0;2;2
89;01.11.2017;2017;11;06;Keskiviikko;9;24;33;1;8;9
89;01.11.2017;2017;11;07;Keskiviikko;18;90;108;5;31;36
89;01.11.2017;2017;11;08;Keskiviikko;27;112;139;9;30;39
89;01.11.2017;2017;11;09;Keskiviikko;22;52;74;18;30;48
89;01.11.2017;2017;11;10;Keskiviikko;27;40;67;25;46;71
89;01.11.2017;2017;11;11;Keskiviikko;36;40;76;41;42;83
89;01.11.2017;2017;11;12;Keskiviikko;41;42;83;35;48;83
89;01.11.2017;2017;11;13;Keskiviikko;47;50;97;37;25;62
89;01.11.2017;2017;11;14;Keskiviikko;67;33;100;53;29;82
89;01.11.2017;2017;11;15;Keskiviikko;108;33;141;58;43;101
89;01.11.2017;2017;11;16;Keskiviikko;130;64;194;50;32;82
89;01.11.2017;2017;11;17;Keskiviikko;57;43;100;31;23;54
89;01.11.2017;2017;11;18;Keskiviikko;44;30;74;24;19;43
89;01.11.2017;2017;11;19;Keskiviikko;56;16;72;37;21;58
89;01.11.2017;2017;11;20;Keskiviikko;26;23;49;18;13;31
89;01.11.2017;2017;11;21;Keskiviikko;37;9;46;17;6;23
89;01.11.2017;2017;11;22;Keskiviikko;13;7;20;4;2;6
89;01.11.2017;2017;11;23;Keskiviikko;11;2;13;2;2;4
89;02.11.2017;2017;11;00;Torstai;8;5;13;4;2;6
89;02.11.2017;2017;11;01;Torstai;0;3;3;2;0;2
89;02.11.2017;2017;11;02;Torstai;1;0;1;0;0;0
89;02.11.2017;2017;11;03;Torstai;7;3;10;0;0;0
89;02.11.2017;2017;11;04;Torstai;0;1;1;2;0;2
89;02.11.2017;2017;11;05;Torstai;0;1;1;1;2;3
89;02.11.2017;2017;11;06;Torstai;7;31;38;2;4;6
89;02.11.2017;2017;11;07;Torstai;9;68;77;6;20;26
89;02.11.2017;2017;11;08;Torstai;11;84;95;6;9;15
89;02.11.2017;2017;11;09;Torstai;14;41;55;10;18;28
89;02.11.2017;2017;11;10;Torstai;25;41;66;10;23;33
89;02.11.2017;2017;11;11;Torstai;25;42;67;34;33;67
89;02.11.2017;2017;11;12;Torstai;31;41;72;13;37;50
89;02.11.2017;2017;11;13;Torstai;37;40;77;19;27;46
89;02.11.2017;2017;11;14;Torstai;65;44;109;29;28;57
89;02.11.2017;2017;11;15;Torstai;69;41;110;21;28;49
89;02.11.2017;2017;11;16;Torstai;95;51;146;29;38;67
89;02.11.2017;2017;11;17;Torstai;83;58;141;32;31;63
89;02.11.2017;2017;11;18;Torstai;49;29;78;27;20;47
89;02.11.2017;2017;11;19;Torstai;38;31;69;24;25;49
89;02.11.2017;2017;11;20;Torstai;34;19;53;17;19;36
89;02.11.2017;2017;11;21;Torstai;33;11;44;14;13;27
89;02.11.2017;2017;11;22;Torstai;12;16;28;8;3;11
89;02.11.2017;2017;11;23;Torstai;2;4;6;4;2;6
89;03.11.2017;2017;11;00;Perjantai;10;4;14;5;1;6
89;03.11.2017;2017;11;01;Perjantai;7;2;9;1;0;1
89;03.11.2017;2017;11;02;Perjantai;5;1;6;0;5;5
89;03.11.2017;2017;11;03;Perjantai;4;4;8;4;0;4
89;03.11.2017;2017;11;04;Perjantai;3;2;5;5;1;6
89;03.11.2017;2017;11;05;Perjantai;2;7;9;0;1;1
89;03.11.2017;2017;11;06;Perjantai;8;40;48;3;6;9
89;03.11.2017;2017;11;07;Perjantai;18;74;92;12;33;45
89;03.11.2017;2017;11;08;Perjantai;26;111;137;8;31;39
89;03.11.2017;2017;11;09;Perjantai;28;62;90;14;41;55
89;03.11.2017;2017;11;10;Perjantai;18;41;59;21;31;52
89;03.11.2017;2017;11;11;Perjantai;28;54;82;23;28;51
89;03.11.2017;2017;11;12;Perjantai;45;56;101;28;36;64
89;03.11.2017;2017;11;13;Perjantai;75;43;118;45;32;77
89;03.11.2017;2017;11;14;Perjantai;87;51;138;54;39;93
89;03.11.2017;2017;11;15;Perjantai;104;45;149;49;42;91
89;03.11.2017;2017;11;16;Perjantai;101;63;164;26;22;48
89;03.11.2017;2017;11;17;Perjantai;58;44;102;34;38;72
89;03.11.2017;2017;11;18;Perjantai;56;39;95;24;23;47
89;03.11.2017;2017;11;19;Perjantai;43;20;63;21;16;37
89;03.11.2017;2017;11;20;Perjantai;37;26;63;18;17;35
89;03.11.2017;2017;11;21;Perjantai;24;11;35;20;14;34
89;03.11.2017;2017;11;22;Perjantai;22;11;33;17;11;28
89;03.11.2017;2017;11;23;Perjantai;24;15;39;6;8;14
89;04.11.2017;2017;11;00;Lauantai;16;14;30;7;5;12
89;04.11.2017;2017;11;01;Lauantai;7;7;14;4;3;7
89;04.11.2017;2017;11;02;Lauantai;7;0;7;10;1;11
89;04.11.2017;2017;11;03;Lauantai;10;3;13;6;2;8
89;04.11.2017;2017;11;04;Lauantai;4;4;8;2;0;2
89;04.11.2017;2017;11;05;Lauantai;3;3;6;3;1;4
89;04.11.2017;2017;11;06;Lauantai;0;8;8;1;2;3
89;04.11.2017;2017;11;07;Lauantai;1;3;4;6;4;10
89;04.11.2017;2017;11;08;Lauantai;2;12;14;7;14;21
89;04.11.2017;2017;11;09;Lauantai;11;20;31;17;18;35
89;04.11.2017;2017;11;10;Lauantai;11;14;25;23;24;47
89;04.11.2017;2017;11;11;Lauantai;23;32;55;39;36;75
89;04.11.2017;2017;11;12;Lauantai;22;38;60;34;45;79
89;04.11.2017;2017;11;13;Lauantai;30;35;65;28;48;76
89;04.11.2017;2017;11;14;Lauantai;34;32;66;40;37;77
89;04.11.2017;2017;11;15;Lauantai;39;29;68;34;25;59
89;04.11.2017;2017;11;16;Lauantai;31;32;63;30;28;58
89;04.11.2017;2017;11;17;Lauantai;41;31;72;24;16;40
89;04.11.2017;2017;11;18;Lauantai;32;23;55;26;26;52
89;04.11.2017;2017;11;19;Lauantai;45;29;74;12;24;36
89;04.11.2017;2017;11;20;Lauantai;31;27;58;13;14;27
89;04.11.2017;2017;11;21;Lauantai;20;17;37;20;3;23
89;04.11.2017;2017;11;22;Lauantai;25;25;50;10;17;27
89;04.11.2017;2017;11;23;Lauantai;14;29;43;9;14;23
89;05.11.2017;2017;11;00;Sunnuntai;17;13;30;7;5;12
89;05.11.2017;2017;11;01;Sunnuntai;7;6;13;7;3;10
89;05.11.2017;2017;11;02;Sunnuntai;19;2;21;8;5;13
89;05.11.2017;2017;11;03;Sunnuntai;14;0;14;8;1;9
89;05.11.2017;2017;11;04;Sunnuntai;11;4;15;7;1;8
89;05.11.2017;2017;11;05;Sunnuntai;1;0;1;6;0;6
89;05.11.2017;2017;11;06;Sunnuntai;2;4;6;1;3;4
89;05.11.2017;2017;11;07;Sunnuntai;7;4;11;4;1;5
89;05.11.2017;2017;11;08;Sunnuntai;3;11;14;4;9;13
89;05.11.2017;2017;11;09;Sunnuntai;12;19;31;22;14;36
89;05.11.2017;2017;11;10;Sunnuntai;6;26;32;30;32;62
89;05.11.2017;2017;11;11;Sunnuntai;11;43;54;46;59;105
89;05.11.2017;2017;11;12;Sunnuntai;30;42;72;35;38;73
89;05.11.2017;2017;11;13;Sunnuntai;42;45;87;45;27;72
89;05.11.2017;2017;11;14;Sunnuntai;43;34;77;39;35;74
89;05.11.2017;2017;11;15;Sunnuntai;44;32;76;41;27;68
89;05.11.2017;2017;11;16;Sunnuntai;39;25;64;27;38;65
89;05.11.2017;2017;11;17;Sunnuntai;26;22;48;27;32;59
89;05.11.2017;2017;11;18;Sunnuntai;33;18;51;40;25;65
89;05.11.2017;2017;11;19;Sunnuntai;22;14;36;14;19;33
89;05.11.2017;2017;11;20;Sunnuntai;17;9;26;10;3;13
89;05.11.2017;2017;11;21;Sunnuntai;14;8;22;4;7;11
89;05.11.2017;2017;11;22;Sunnuntai;8;2;10;0;9;9
89;05.11.2017;2017;11;23;Sunnuntai;2;4;6;2;2;4
89;06.11.2017;2017;11;00;Maanantai;3;1;4;1;0;1
89;06.11.2017;2017;11;01;Maanantai;1;1;2;1;0;1
89;06.11.2017;2017;11;02;Maanantai;1;2;3;0;1;1
89;06.11.2017;2017;11;03;Maanantai;1;1;2;1;0;1
89;06.11.2017;2017;11;04;Maanantai;3;1;4;1;0;1
89;06.11.2017;2017;11;05;Maanantai;1;8;9;0;1;1
89;06.11.2017;2017;11;06;Maanantai;6;29;35;2;3;5
89;06.11.2017;2017;11;07;Maanantai;25;100;125;9;24;33
89;06.11.2017;2017;11;08;Maanantai;26;129;155;7;45;52
89;06.11.2017;2017;11;09;Maanantai;33;83;116;17;42;59
89;06.11.2017;2017;11;10;Maanantai;27;49;76;30;36;66
89;06.11.2017;2017;11;11;Maanantai;39;60;99;28;34;62
89;06.11.2017;2017;11;12;Maanantai;49;53;102;34;30;64
89;06.11.2017;2017;11;13;Maanantai;80;46;126;35;21;56
89;06.11.2017;2017;11;14;Maanantai;74;30;104;24;17;41
89;06.11.2017;2017;11;15;Maanantai;98;35;133;30;18;48
89;06.11.2017;2017;11;16;Maanantai;146;51;197;44;21;65
89;06.11.2017;2017;11;17;Maanantai;85;56;141;25;30;55
89;06.11.2017;2017;11;18;Maanantai;59;37;96;44;32;76
89;06.11.2017;2017;11;19;Maanantai;66;27;93;39;29;68
89;06.11.2017;2017;11;20;Maanantai;44;20;64;29;12;41
89;06.11.2017;2017;11;21;Maanantai;28;14;42;13;12;25
89;06.11.2017;2017;11;22;Maanantai;12;7;19;6;3;9
89;06.11.2017;2017;11;23;Maanantai;5;2;7;1;2;3
89;07.11.2017;2017;11;00;Tiistai;8;2;10;3;0;3
89;07.11.2017;2017;11;01;Tiistai;3;1;4;0;0;0
89;07.11.2017;2017;11;02;Tiistai;0;0;0;2;0;2
89;07.11.2017;2017;11;03;Tiistai;0;3;3;0;0;0
89;07.11.2017;2017;11;04;Tiistai;2;1;3;1;3;4
89;07.11.2017;2017;11;05;Tiistai;0;7;7;1;0;1
89;07.11.2017;2017;11;06;Tiistai;10;36;46;1;5;6
89;07.11.2017;2017;11;07;Tiistai;31;109;140;9;26;35
89;07.11.2017;2017;11;08;Tiistai;25;164;189;9;44;53
89;07.11.2017;2017;11;09;Tiistai;37;80;117;13;47;60
89;07.11.2017;2017;11;10;Tiistai;43;47;90;27;50;77
89;07.11.2017;2017;11;11;Tiistai;42;60;102;37;41;78
89;07.11.2017;2017;11;12;Tiistai;62;70;132;32;30;62
89;07.11.2017;2017;11;13;Tiistai;76;61;137;34;39;73
89;07.11.2017;2017;11;14;Tiistai;84;53;137;45;36;81
89;07.11.2017;2017;11;15;Tiistai;119;42;161;54;32;86
89;07.11.2017;2017;11;16;Tiistai;153;54;207;42;34;76
89;07.11.2017;2017;11;17;Tiistai;94;55;149;33;28;61
89;07.11.2017;2017;11;18;Tiistai;51;28;79;36;44;80
89;07.11.2017;2017;11;19;Tiistai;63;20;83;46;35;81
89;07.11.2017;2017;11;20;Tiistai;50;10;60;33;17;50
89;07.11.2017;2017;11;21;Tiistai;35;20;55;15;6;21
89;07.11.2017;2017;11;22;Tiistai;10;7;17;2;2;4
89;07.11.2017;2017;11;23;Tiistai;6;6;12;4;8;12
89;08.11.2017;2017;11;00;Keskiviikko;5;4;9;1;2;3
89;08.11.2017;2017;11;01;Keskiviikko;3;3;6;1;0;1
89;08.11.2017;2017;11;02;Keskiviikko;1;2;3;0;1;1
89;08.11.2017;2017;11;03;Keskiviikko;2;3;5;2;0;2
89;08.11.2017;2017;11;04;Keskiviikko;0;1;1;2;3;5
89;08.11.2017;2017;11;05;Keskiviikko;1;7;8;1;0;1
89;08.11.2017;2017;11;06;Keskiviikko;9;34;43;1;6;7
89;08.11.2017;2017;11;07;Keskiviikko;32;103;135;11;34;45
89;08.11.2017;2017;11;08;Keskiviikko;34;141;175;11;44;55
89;08.11.2017;2017;11;09;Keskiviikko;26;85;111;12;68;80
89;08.11.2017;2017;11;10;Keskiviikko;28;62;90;25;37;62
89;08.11.2017;2017;11;11;Keskiviikko;48;59;107;22;41;63
89;08.11.2017;2017;11;12;Keskiviikko;71;58;129;34;35;69
89;08.11.2017;2017;11;13;Keskiviikko;70;43;113;43;26;69
89;08.11.2017;2017;11;14;Keskiviikko;76;46;122;40;22;62
89;08.11.2017;2017;11;15;Keskiviikko;104;53;157;28;34;62
89;08.11.2017;2017;11;16;Keskiviikko;147;73;220;55;32;87
89;08.11.2017;2017;11;17;Keskiviikko;78;56;134;27;34;61
89;08.11.2017;2017;11;18;Keskiviikko;66;37;103;47;41;88
89;08.11.2017;2017;11;19;Keskiviikko;68;27;95;39;19;58
89;08.11.2017;2017;11;20;Keskiviikko;40;24;64;17;19;36
89;08.11.2017;2017;11;21;Keskiviikko;28;12;40;11;8;19
89;08.11.2017;2017;11;22;Keskiviikko;23;15;38;5;4;9
89;08.11.2017;2017;11;23;Keskiviikko;8;8;16;4;3;7
89;09.11.2017;2017;11;00;Torstai;6;5;11;0;1;1
89;09.11.2017;2017;11;01;Torstai;3;1;4;0;0;0
89;09.11.2017;2017;11;02;Torstai;3;3;6;0;0;0
89;09.11.2017;2017;11;03;Torstai;2;2;4;1;0;1
89;09.11.2017;2017;11;04;Torstai;2;2;4;2;0;2
89;09.11.2017;2017;11;05;Torstai;0;9;9;2;0;2
89;09.11.2017;2017;11;06;Torstai;7;39;46;1;5;6
89;09.11.2017;2017;11;07;Torstai;32;119;151;12;23;35
89;09.11.2017;2017;11;08;Torstai;30;164;194;17;57;74
89;09.11.2017;2017;11;09;Torstai;32;67;99;22;42;64
89;09.11.2017;2017;11;10;Torstai;36;45;81;15;25;40
89;09.11.2017;2017;11;11;Torstai;30;68;98;24;31;55
89;09.11.2017;2017;11;12;Torstai;37;57;94;25;26;51
89;09.11.2017;2017;11;13;Torstai;64;42;106;28;17;45
89;09.11.2017;2017;11;14;Torstai;107;55;162;43;22;65
89;09.11.2017;2017;11;15;Torstai;134;46;180;29;19;48
89;09.11.2017;2017;11;16;Torstai;146;59;205;36;28;64
89;09.11.2017;2017;11;17;Torstai;91;67;158;30;33;63
89;09.11.2017;2017;11;18;Torstai;64;38;102;29;30;59
89;09.11.2017;2017;11;19;Torstai;60;27;87;35;12;47
89;09.11.2017;2017;11;20;Torstai;37;21;58;25;6;31
89;09.11.2017;2017;11;21;Torstai;48;16;64;18;12;30
89;09.11.2017;2017;11;22;Torstai;17;12;29;5;4;9
89;09.11.2017;2017;11;23;Torstai;5;4;9;5;1;6
89;10.11.2017;2017;11;00;Perjantai;6;4;10;1;1;2
89;10.11.2017;2017;11;01;Perjantai;3;1;4;0;2;2
89;10.11.2017;2017;11;02;Perjantai;6;0;6;2;0;2
89;10.11.2017;2017;11;03;Perjantai;12;3;15;1;0;1
89;10.11.2017;2017;11;04;Perjantai;6;1;7;3;1;4
89;10.11.2017;2017;11;05;Perjantai;2;6;8;2;2;4
89;10.11.2017;2017;11;06;Perjantai;7;47;54;1;8;9
89;10.11.2017;2017;11;07;Perjantai;25;101;126;8;32;40
89;10.11.2017;2017;11;08;Perjantai;21;132;153;9;41;50
89;10.11.2017;2017;11;09;Perjantai;31;89;120;12;27;39
89;10.11.2017;2017;11;10;Perjantai;36;48;84;14;34;48
89;10.11.2017;2017;11;11;Perjantai;57;45;102;19;34;53
89;10.11.2017;2017;11;12;Perjantai;46;62;108;47;26;73
89;10.11.2017;2017;11;13;Perjantai;58;61;119;27;26;53
89;10.11.2017;2017;11;14;Perjantai;128;61;189;28;22;50
89;10.11.2017;2017;11;15;Perjantai;120;66;186;31;37;68
89;10.11.2017;2017;11;16;Perjantai;102;58;160;40;33;73
89;10.11.2017;2017;11;17;Perjantai;84;58;142;23;34;57
89;10.11.2017;2017;11;18;Perjantai;54;32;86;28;26;54
89;10.11.2017;2017;11;19;Perjantai;49;25;74;31;21;52
89;10.11.2017;2017;11;20;Perjantai;35;28;63;14;12;26
89;10.11.2017;2017;11;21;Perjantai;41;11;52;13;7;20
89;10.11.2017;2017;11;22;Perjantai;20;14;34;10;9;19
89;10.11.2017;2017;11;23;Perjantai;14;10;24;5;4;9
89;11.11.2017;2017;11;00;Lauantai;15;6;21;5;9;14
89;11.11.2017;2017;11;01;Lauantai;9;13;22;2;2;4
89;11.11.2017;2017;11;02;Lauantai;14;2;16;4;0;4
89;11.11.2017;2017;11;03;Lauantai;13;4;17;8;0;8
89;11.11.2017;2017;11;04;Lauantai;11;5;16;2;2;4
89;11.11.2017;2017;11;05;Lauantai;2;6;8;2;0;2
89;11.11.2017;2017;11;06;Lauantai;1;8;9;1;0;1
89;11.11.2017;2017;11;07;Lauantai;1;6;7;2;7;9
89;11.11.2017;2017;11;08;Lauantai;3;33;36;7;5;12
89;11.11.2017;2017;11;09;Lauantai;12;52;64;16;27;43
89;11.11.2017;2017;11;10;Lauantai;14;40;54;17;39;56
89;11.11.2017;2017;11;11;Lauantai;34;77;111;25;54;79
89;11.11.2017;2017;11;12;Lauantai;55;58;113;38;50;88
89;11.11.2017;2017;11;13;Lauantai;63;70;133;31;41;72
89;11.11.2017;2017;11;14;Lauantai;56;67;123;60;43;103
89;11.11.2017;2017;11;15;Lauantai;71;38;109;26;43;69
89;11.11.2017;2017;11;16;Lauantai;66;34;100;44;33;77
89;11.11.2017;2017;11;17;Lauantai;38;33;71;31;19;50
89;11.11.2017;2017;11;18;Lauantai;38;31;69;24;19;43
89;11.11.2017;2017;11;19;Lauantai;26;17;43;11;20;31
89;11.11.2017;2017;11;20;Lauantai;28;28;56;10;14;24
89;11.11.2017;2017;11;21;Lauantai;15;18;33;11;14;25
89;11.11.2017;2017;11;22;Lauantai;21;13;34;10;8;18
89;11.11.2017;2017;11;23;Lauantai;17;25;42;5;14;19
89;12.11.2017;2017;11;00;Sunnuntai;14;13;27;7;3;10
89;12.11.2017;2017;11;01;Sunnuntai;10;9;19;2;9;11
89;12.11.2017;2017;11;02;Sunnuntai;4;7;11;5;3;8
89;12.11.2017;2017;11;03;Sunnuntai;11;1;12;2;6;8
89;12.11.2017;2017;11;04;Sunnuntai;8;1;9;0;1;1
89;12.11.2017;2017;11;05;Sunnuntai;4;1;5;1;0;1
89;12.11.2017;2017;11;06;Sunnuntai;4;5;9;2;0;2
89;12.11.2017;2017;11;07;Sunnuntai;2;1;3;10;7;17
89;12.11.2017;2017;11;08;Sunnuntai;4;4;8;9;6;15
89;12.11.2017;2017;11;09;Sunnuntai;16;15;31;14;10;24
89;12.11.2017;2017;11;10;Sunnuntai;21;24;45;25;30;55
89;12.11.2017;2017;11;11;Sunnuntai;18;48;66;52;59;111
89;12.11.2017;2017;11;12;Sunnuntai;44;21;65;42;34;76
89;12.11.2017;2017;11;13;Sunnuntai;33;42;75;39;31;70
89;12.11.2017;2017;11;14;Sunnuntai;29;35;64;37;43;80
89;12.11.2017;2017;11;15;Sunnuntai;46;32;78;40;24;64
89;12.11.2017;2017;11;16;Sunnuntai;39;35;74;26;22;48
89;12.11.2017;2017;11;17;Sunnuntai;25;23;48;15;30;45
89;12.11.2017;2017;11;18;Sunnuntai;28;17;45;21;22;43
89;12.11.2017;2017;11;19;Sunnuntai;18;15;33;25;18;43
89;12.11.2017;2017;11;20;Sunnuntai;24;5;29;15;11;26
89;12.11.2017;2017;11;21;Sunnuntai;14;10;24;10;6;16
89;12.11.2017;2017;11;22;Sunnuntai;7;9;16;3;5;8
89;12.11.2017;2017;11;23;Sunnuntai;6;7;13;1;2;3
89;13.11.2017;2017;11;00;Maanantai;3;1;4;2;0;2
89;13.11.2017;2017;11;01;Maanantai;2;2;4;0;1;1
89;13.11.2017;2017;11;02;Maanantai;1;2;3;1;0;1
89;13.11.2017;2017;11;03;Maanantai;1;2;3;2;0;2
89;13.11.2017;2017;11;04;Maanantai;1;2;3;1;1;2
89;13.11.2017;2017;11;05;Maanantai;5;11;16;0;3;3
89;13.11.2017;2017;11;06;Maanantai;10;39;49;3;5;8
89;13.11.2017;2017;11;07;Maanantai;28;113;141;12;17;29
89;13.11.2017;2017;11;08;Maanantai;27;141;168;5;104;109
89;13.11.2017;2017;11;09;Maanantai;30;87;117;11;44;55
89;13.11.2017;2017;11;10;Maanantai;25;57;82;45;31;76
89;13.11.2017;2017;11;11;Maanantai;42;58;100;28;48;76
89;13.11.2017;2017;11;12;Maanantai;44;50;94;29;35;64
89;13.11.2017;2017;11;13;Maanantai;58;55;113;43;31;74
89;13.11.2017;2017;11;14;Maanantai;80;68;148;38;21;59
89;13.11.2017;2017;11;15;Maanantai;114;42;156;35;29;64
89;13.11.2017;2017;11;16;Maanantai;151;65;216;55;38;93
89;13.11.2017;2017;11;17;Maanantai;85;35;120;36;29;65
89;13.11.2017;2017;11;18;Maanantai;52;32;84;33;30;63
89;13.11.2017;2017;11;19;Maanantai;52;19;71;35;25;60
89;13.11.2017;2017;11;20;Maanantai;35;15;50;28;12;40
89;13.11.2017;2017;11;21;Maanantai;29;20;49;6;7;13
89;13.11.2017;2017;11;22;Maanantai;9;6;15;6;4;10
89;13.11.2017;2017;11;23;Maanantai;1;4;5;2;0;2
89;14.11.2017;2017;11;00;Tiistai;4;0;4;1;1;2
89;14.11.2017;2017;11;01;Tiistai;0;0;0;2;0;2
89;14.11.2017;2017;11;02;Tiistai;0;3;3;0;0;0
89;14.11.2017;2017;11;03;Tiistai;3;1;4;0;0;0
89;14.11.2017;2017;11;04;Tiistai;1;4;5;1;0;1
89;14.11.2017;2017;11;05;Tiistai;2;6;8;0;1;1
89;14.11.2017;2017;11;06;Tiistai;10;43;53;1;5;6
89;14.11.2017;2017;11;07;Tiistai;24;139;163;11;28;39
89;14.11.2017;2017;11;08;Tiistai;24;167;191;11;60;71
89;14.11.2017;2017;11;09;Tiistai;29;80;109;12;43;55
89;14.11.2017;2017;11;10;Tiistai;20;41;61;32;52;84
89;14.11.2017;2017;11;11;Tiistai;38;41;79;28;29;57
89;14.11.2017;2017;11;12;Tiistai;51;45;96;35;30;65
89;14.11.2017;2017;11;13;Tiistai;69;47;116;35;21;56
89;14.11.2017;2017;11;14;Tiistai;67;42;109;32;18;50
89;14.11.2017;2017;11;15;Tiistai;107;42;149;50;25;75
89;14.11.2017;2017;11;16;Tiistai;134;52;186;50;19;69
89;14.11.2017;2017;11;17;Tiistai;78;51;129;36;30;66
89;14.11.2017;2017;11;18;Tiistai;63;42;105;37;40;77
89;14.11.2017;2017;11;19;Tiistai;46;22;68;34;31;65
89;14.11.2017;2017;11;20;Tiistai;51;9;60;22;12;34
89;14.11.2017;2017;11;21;Tiistai;26;15;41;12;8;20
89;14.11.2017;2017;11;22;Tiistai;11;7;18;2;4;6
89;14.11.2017;2017;11;23;Tiistai;4;4;8;1;1;2
89;15.11.2017;2017;11;00;Keskiviikko;5;4;9;1;2;3
89;15.11.2017;2017;11;01;Keskiviikko;3;3;6;1;0;1
89;15.11.2017;2017;11;02;Keskiviikko;1;2;3;0;1;1
89;15.11.2017;2017;11;03;Keskiviikko;2;3;5;2;0;2
89;15.11.2017;2017;11;04;Keskiviikko;0;1;1;2;3;5
89;15.11.2017;2017;11;05;Keskiviikko;1;7;8;1;0;1
89;15.11.2017;2017;11;06;Keskiviikko;9;34;43;1;6;7
89;15.11.2017;2017;11;07;Keskiviikko;32;103;135;11;34;45
89;15.11.2017;2017;11;08;Keskiviikko;34;141;175;11;44;55
89;15.11.2017;2017;11;09;Keskiviikko;26;85;111;12;68;80
89;15.11.2017;2017;11;10;Keskiviikko;28;62;90;25;37;62
89;15.11.2017;2017;11;11;Keskiviikko;48;59;107;22;41;63
89;15.11.2017;2017;11;12;Keskiviikko;71;58;129;34;35;69
89;15.11.2017;2017;11;13;Keskiviikko;70;43;113;43;26;69
89;15.11.2017;2017;11;14;Keskiviikko;76;46;122;40;22;62
89;15.11.2017;2017;11;15;Keskiviikko;104;53;157;28;34;62
89;15.11.2017;2017;11;16;Keskiviikko;147;73;220;55;32;87
89;15.11.2017;2017;11;17;Keskiviikko;78;56;134;27;34;61
89;15.11.2017;2017;11;18;Keskiviikko;66;37;103;47;41;88
89;15.11.2017;2017;11;19;Keskiviikko;68;27;95;39;19;58
89;15.11.2017;2017;11;20;Keskiviikko;40;24;64;17;19;36
89;15.11.2017;2017;11;21;Keskiviikko;28;12;40;11;8;19
89;15.11.2017;2017;11;22;Keskiviikko;23;15;38;5;4;9
89;15.11.2017;2017;11;23;Keskiviikko;8;8;16;4;3;7
89;16.11.2017;2017;11;00;Torstai;6;5;11;0;1;1
89;16.11.2017;2017;11;01;Torstai;3;1;4;0;0;0
89;16.11.2017;2017;11;02;Torstai;3;3;6;0;0;0
89;16.11.2017;2017;11;03;Torstai;2;2;4;1;0;1
89;16.11.2017;2017;11;04;Torstai;2;2;4;2;0;2
89;16.11.2017;2017;11;05;Torstai;0;9;9;2;0;2
89;16.11.2017;2017;11;06;Torstai;7;39;46;1;5;6
89;16.11.2017;2017;11;07;Torstai;32;119;151;12;23;35
89;16.11.2017;2017;11;08;Torstai;30;164;194;17;57;74
89;16.11.2017;2017;11;09;Torstai;32;67;99;22;42;64
89;16.11.2017;2017;11;10;Torstai;36;45;81;15;25;40
89;16.11.2017;2017;11;11;Torstai;30;68;98;24;31;55
89;16.11.2017;2017;11;12;Torstai;37;57;94;25;26;51
89;16.11.2017;2017;11;13;Torstai;64;42;106;28;17;45
89;16.11.2017;2017;11;14;Torstai;107;55;162;43;22;65
89;16.11.2017;2017;11;15;Torstai;134;46;180;29;19;48
89;16.11.2017;2017;11;16;Torstai;146;59;205;36;28;64
89;16.11.2017;2017;11;17;Torstai;91;67;158;30;33;63
89;16.11.2017;2017;11;18;Torstai;64;38;102;29;30;59
89;16.11.2017;2017;11;19;Torstai;60;27;87;35;12;47
89;16.11.2017;2017;11;20;Torstai;37;21;58;25;6;31
89;16.11.2017;2017;11;21;Torstai;48;16;64;18;12;30
89;16.11.2017;2017;11;22;Torstai;17;12;29;5;4;9
89;16.11.2017;2017;11;23;Torstai;5;4;9;5;1;6
89;17.11.2017;2017;11;00;Perjantai;5;7;12;3;1;4
89;17.11.2017;2017;11;01;Perjantai;1;2;3;4;0;4
89;17.11.2017;2017;11;02;Perjantai;5;3;8;1;0;1
89;17.11.2017;2017;11;03;Perjantai;5;3;8;0;0;0
89;17.11.2017;2017;11;04;Perjantai;3;4;7;1;1;2
89;17.11.2017;2017;11;05;Perjantai;2;8;10;2;0;2
89;17.11.2017;2017;11;06;Perjantai;9;39;48;2;6;8
89;17.11.2017;2017;11;07;Perjantai;20;89;109;6;30;36
89;17.11.2017;2017;11;08;Perjantai;27;134;161;16;56;72
89;17.11.2017;2017;11;09;Perjantai;21;65;86;8;35;43
89;17.11.2017;2017;11;10;Perjantai;27;47;74;12;31;43
89;17.11.2017;2017;11;11;Perjantai;35;41;76;25;23;48
89;17.11.2017;2017;11;12;Perjantai;29;51;80;24;20;44
89;17.11.2017;2017;11;13;Perjantai;55;42;97;25;22;47
89;17.11.2017;2017;11;14;Perjantai;80;33;113;38;21;59
89;17.11.2017;2017;11;15;Perjantai;93;53;146;23;14;37
89;17.11.2017;2017;11;16;Perjantai;85;46;131;33;22;55
89;17.11.2017;2017;11;17;Perjantai;30;28;58;16;24;40
89;17.11.2017;2017;11;18;Perjantai;27;31;58;21;31;52
89;17.11.2017;2017;11;19;Perjantai;32;26;58;36;21;57
89;17.11.2017;2017;11;20;Perjantai;33;20;53;16;16;32
89;17.11.2017;2017;11;21;Perjantai;31;20;51;18;9;27
89;17.11.2017;2017;11;22;Perjantai;12;9;21;9;8;17
89;17.11.2017;2017;11;23;Perjantai;14;6;20;2;6;8
89;18.11.2017;2017;11;00;Lauantai;13;8;21;8;3;11
89;18.11.2017;2017;11;01;Lauantai;8;5;13;9;3;12
89;18.11.2017;2017;11;02;Lauantai;10;0;10;9;2;11
89;18.11.2017;2017;11;03;Lauantai;8;3;11;6;1;7
89;18.11.2017;2017;11;04;Lauantai;9;4;13;6;3;9
89;18.11.2017;2017;11;05;Lauantai;2;2;4;0;0;0
89;18.11.2017;2017;11;06;Lauantai;1;2;3;1;7;8
89;18.11.2017;2017;11;07;Lauantai;3;7;10;2;8;10
89;18.11.2017;2017;11;08;Lauantai;5;15;20;5;12;17
89;18.11.2017;2017;11;09;Lauantai;8;29;37;11;25;36
89;18.11.2017;2017;11;10;Lauantai;18;33;51;25;50;75
89;18.11.2017;2017;11;11;Lauantai;14;59;73;26;52;78
89;18.11.2017;2017;11;12;Lauantai;30;44;74;36;45;81
89;18.11.2017;2017;11;13;Lauantai;43;43;86;40;42;82
89;18.11.2017;2017;11;14;Lauantai;47;48;95;55;38;93
89;18.11.2017;2017;11;15;Lauantai;43;37;80;44;35;79
89;18.11.2017;2017;11;16;Lauantai;38;36;74;31;53;84
89;18.11.2017;2017;11;17;Lauantai;40;40;80;52;39;91
89;18.11.2017;2017;11;18;Lauantai;47;39;86;39;49;88
89;18.11.2017;2017;11;19;Lauantai;32;23;55;48;21;69
89;18.11.2017;2017;11;20;Lauantai;17;13;30;23;15;38
89;18.11.2017;2017;11;21;Lauantai;16;30;46;20;11;31
89;18.11.2017;2017;11;22;Lauantai;17;17;34;17;12;29
89;18.11.2017;2017;11;23;Lauantai;17;18;35;5;9;14
89;19.11.2017;2017;11;00;Sunnuntai;8;11;19;12;5;17
89;19.11.2017;2017;11;01;Sunnuntai;10;4;14;6;3;9
89;19.11.2017;2017;11;02;Sunnuntai;11;5;16;7;0;7
89;19.11.2017;2017;11;03;Sunnuntai;15;4;19;6;2;8
89;19.11.2017;2017;11;04;Sunnuntai;14;2;16;4;0;4
89;19.11.2017;2017;11;05;Sunnuntai;2;0;2;3;1;4
89;19.11.2017;2017;11;06;Sunnuntai;2;4;6;0;1;1
89;19.11.2017;2017;11;07;Sunnuntai;2;4;6;2;10;12
89;19.11.2017;2017;11;08;Sunnuntai;1;4;5;11;7;18
89;19.11.2017;2017;11;09;Sunnuntai;7;7;14;16;15;31
89;19.11.2017;2017;11;10;Sunnuntai;11;17;28;32;38;70
89;19.11.2017;2017;11;11;Sunnuntai;16;20;36;43;42;85
89;19.11.2017;2017;11;12;Sunnuntai;15;25;40;36;53;89
89;19.11.2017;2017;11;13;Sunnuntai;29;29;58;45;33;78
89;19.11.2017;2017;11;14;Sunnuntai;17;20;37;32;33;65
89;19.11.2017;2017;11;15;Sunnuntai;27;39;66;32;41;73
89;19.11.2017;2017;11;16;Sunnuntai;20;26;46;34;37;71
89;19.11.2017;2017;11;17;Sunnuntai;33;24;57;49;51;100
89;19.11.2017;2017;11;18;Sunnuntai;32;20;52;44;37;81
89;19.11.2017;2017;11;19;Sunnuntai;17;20;37;26;24;50
89;19.11.2017;2017;11;20;Sunnuntai;22;13;35;23;15;38
89;19.11.2017;2017;11;21;Sunnuntai;16;10;26;14;12;26
89;19.11.2017;2017;11;22;Sunnuntai;5;5;10;9;4;13
89;19.11.2017;2017;11;23;Sunnuntai;6;1;7;1;4;5
89;20.11.2017;2017;11;00;Maanantai;2;0;2;1;2;3
89;20.11.2017;2017;11;01;Maanantai;0;0;0;0;0;0
89;20.11.2017;2017;11;02;Maanantai;1;3;4;0;0;0
89;20.11.2017;2017;11;03;Maanantai;3;1;4;2;1;3
89;20.11.2017;2017;11;04;Maanantai;2;2;4;0;1;1
89;20.11.2017;2017;11;05;Maanantai;8;9;17;1;2;3
89;20.11.2017;2017;11;06;Maanantai;5;39;44;1;5;6
89;20.11.2017;2017;11;07;Maanantai;24;94;118;7;29;36
89;20.11.2017;2017;11;08;Maanantai;29;157;186;7;51;58
89;20.11.2017;2017;11;09;Maanantai;26;65;91;21;36;57
89;20.11.2017;2017;11;10;Maanantai;26;35;61;13;28;41
89;20.11.2017;2017;11;11;Maanantai;25;48;73;19;37;56
89;20.11.2017;2017;11;12;Maanantai;37;40;77;33;33;66
89;20.11.2017;2017;11;13;Maanantai;52;48;100;30;31;61
89;20.11.2017;2017;11;14;Maanantai;67;49;116;47;30;77
89;20.11.2017;2017;11;15;Maanantai;124;37;161;40;18;58
89;20.11.2017;2017;11;16;Maanantai;127;63;190;43;34;77
89;20.11.2017;2017;11;17;Maanantai;68;51;119;36;24;60
89;20.11.2017;2017;11;18;Maanantai;60;40;100;34;23;57
89;20.11.2017;2017;11;19;Maanantai;45;22;67;33;29;62
89;20.11.2017;2017;11;20;Maanantai;37;24;61;24;25;49
89;20.11.2017;2017;11;21;Maanantai;18;12;30;20;5;25
89;20.11.2017;2017;11;22;Maanantai;12;7;19;7;6;13
89;20.11.2017;2017;11;23;Maanantai;5;4;9;2;0;2
89;21.11.2017;2017;11;00;Tiistai;1;3;4;0;2;2
89;21.11.2017;2017;11;01;Tiistai;3;1;4;0;1;1
89;21.11.2017;2017;11;02;Tiistai;1;1;2;0;0;0
89;21.11.2017;2017;11;03;Tiistai;3;3;6;0;0;0
89;21.11.2017;2017;11;04;Tiistai;0;1;1;2;0;2
89;21.11.2017;2017;11;05;Tiistai;2;6;8;0;1;1
89;21.11.2017;2017;11;06;Tiistai;7;41;48;1;7;8
89;21.11.2017;2017;11;07;Tiistai;25;88;113;9;28;37
89;21.11.2017;2017;11;08;Tiistai;24;150;174;19;56;75
89;21.11.2017;2017;11;09;Tiistai;28;62;90;19;42;61
89;21.11.2017;2017;11;10;Tiistai;25;44;69;27;47;74
89;21.11.2017;2017;11;11;Tiistai;29;46;75;35;44;79
89;21.11.2017;2017;11;12;Tiistai;67;59;126;70;51;121
89;21.11.2017;2017;11;13;Tiistai;48;68;116;33;27;60
89;21.11.2017;2017;11;14;Tiistai;68;47;115;39;29;68
89;21.11.2017;2017;11;15;Tiistai;80;36;116;29;30;59
89;21.11.2017;2017;11;16;Tiistai;124;71;195;50;37;87
89;21.11.2017;2017;11;17;Tiistai;81;46;127;28;44;72
89;21.11.2017;2017;11;18;Tiistai;51;34;85;35;34;69
89;21.11.2017;2017;11;19;Tiistai;38;19;57;30;19;49
89;21.11.2017;2017;11;20;Tiistai;31;9;40;25;16;41
89;21.11.2017;2017;11;21;Tiistai;30;6;36;15;11;26
89;21.11.2017;2017;11;22;Tiistai;12;8;20;2;5;7
89;21.11.2017;2017;11;23;Tiistai;5;2;7;0;8;8
89;22.11.2017;2017;11;00;Keskiviikko;2;1;3;4;2;6
89;22.11.2017;2017;11;01;Keskiviikko;3;0;3;2;1;3
89;22.11.2017;2017;11;02;Keskiviikko;2;2;4;1;0;1
89;22.11.2017;2017;11;03;Keskiviikko;3;2;5;1;0;1
89;22.11.2017;2017;11;04;Keskiviikko;1;2;3;0;0;0
89;22.11.2017;2017;11;05;Keskiviikko;2;8;10;0;1;1
89;22.11.2017;2017;11;06;Keskiviikko;8;40;48;3;11;14
89;22.11.2017;2017;11;07;Keskiviikko;23;92;115;6;41;47
89;22.11.2017;2017;11;08;Keskiviikko;23;152;175;14;54;68
89;22.11.2017;2017;11;09;Keskiviikko;23;67;90;12;34;46
89;22.11.2017;2017;11;10;Keskiviikko;28;34;62;16;32;48
89;22.11.2017;2017;11;11;Keskiviikko;38;40;78;19;34;53
89;22.11.2017;2017;11;12;Keskiviikko;33;59;92;25;36;61
89;22.11.2017;2017;11;13;Keskiviikko;57;36;93;44;41;85
89;22.11.2017;2017;11;14;Keskiviikko;80;45;125;48;23;71
89;22.11.2017;2017;11;15;Keskiviikko;84;46;130;28;24;52
89;22.11.2017;2017;11;16;Keskiviikko;136;62;198;51;28;79
89;22.11.2017;2017;11;17;Keskiviikko;62;68;130;26;27;53
89;22.11.2017;2017;11;18;Keskiviikko;67;22;89;37;39;76
89;22.11.2017;2017;11;19;Keskiviikko;49;15;64;27;18;45
89;22.11.2017;2017;11;20;Keskiviikko;36;27;63;10;13;23
89;22.11.2017;2017;11;21;Keskiviikko;28;9;37;11;12;23
89;22.11.2017;2017;11;22;Keskiviikko;15;2;17;6;2;8
89;22.11.2017;2017;11;23;Keskiviikko;9;6;15;1;0;1
89;23.11.2017;2017;11;00;Torstai;2;6;8;2;4;6
89;23.11.2017;2017;11;01;Torstai;3;2;5;2;0;2
89;23.11.2017;2017;11;02;Torstai;2;0;2;3;0;3
89;23.11.2017;2017;11;03;Torstai;5;5;10;4;0;4
89;23.11.2017;2017;11;04;Torstai;2;2;4;2;0;2
89;23.11.2017;2017;11;05;Torstai;1;4;5;1;0;1
89;23.11.2017;2017;11;06;Torstai;6;39;45;1;7;8
89;23.11.2017;2017;11;07;Torstai;17;93;110;11;25;36
89;23.11.2017;2017;11;08;Torstai;30;130;160;13;44;57
89;23.11.2017;2017;11;09;Torstai;19;48;67;10;42;52
89;23.11.2017;2017;11;10;Torstai;24;41;65;20;32;52
89;23.11.2017;2017;11;11;Torstai;36;39;75;19;27;46
89;23.11.2017;2017;11;12;Torstai;43;31;74;18;37;55
89;23.11.2017;2017;11;13;Torstai;41;42;83;25;29;54
89;23.11.2017;2017;11;14;Torstai;56;32;88;38;19;57
89;23.11.2017;2017;11;15;Torstai;79;33;112;40;20;60
89;23.11.2017;2017;11;16;Torstai;71;69;140;40;30;70
89;23.11.2017;2017;11;17;Torstai;43;40;83;35;25;60
89;23.11.2017;2017;11;18;Torstai;30;28;58;35;20;55
89;23.11.2017;2017;11;19;Torstai;21;19;40;30;30;60
89;23.11.2017;2017;11;20;Torstai;22;20;42;20;25;45
89;23.11.2017;2017;11;21;Torstai;16;12;28;20;5;25
89;23.11.2017;2017;11;22;Torstai;6;3;9;5;5;10
89;23.11.2017;2017;11;23;Torstai;7;6;13;2;0;2
89;24.11.2017;2017;11;00;Perjantai;5;3;8;1;2;3
89;24.11.2017;2017;11;01;Perjantai;3;2;5;0;0;0
89;24.11.2017;2017;11;02;Perjantai;3;1;4;0;0;0
89;24.11.2017;2017;11;03;Perjantai;4;2;6;2;1;3
89;24.11.2017;2017;11;04;Perjantai;1;1;2;0;1;1
89;24.11.2017;2017;11;05;Perjantai;6;6;12;1;2;3
89;24.11.2017;2017;11;06;Perjantai;21;19;40;1;5;6
89;24.11.2017;2017;11;07;Perjantai;37;35;72;7;30;37
89;24.11.2017;2017;11;08;Perjantai;55;52;107;7;50;57
89;24.11.2017;2017;11;09;Perjantai;34;31;65;20;35;55
89;24.11.2017;2017;11;10;Perjantai;23;21;44;15;30;45
89;24.11.2017;2017;11;11;Perjantai;32;28;60;20;35;55
89;24.11.2017;2017;11;12;Perjantai;48;39;87;30;30;60
89;24.11.2017;2017;11;13;Perjantai;73;3;76;30;30;60
89;24.11.2017;2017;11;14;Perjantai;63;33;96;46;17;63
89;24.11.2017;2017;11;15;Perjantai;77;39;116;42;22;64
89;24.11.2017;2017;11;16;Perjantai;65;46;111;31;30;61
89;24.11.2017;2017;11;17;Perjantai;46;32;78;24;26;50
89;24.11.2017;2017;11;18;Perjantai;40;33;73;39;24;63
89;24.11.2017;2017;11;19;Perjantai;24;23;47;24;29;53
89;24.11.2017;2017;11;20;Perjantai;24;18;42;25;21;46
89;24.11.2017;2017;11;21;Perjantai;25;9;34;15;9;24
89;24.11.2017;2017;11;22;Perjantai;10;4;14;17;4;21
89;24.11.2017;2017;11;23;Perjantai;10;6;16;7;12;19
89;25.11.2017;2017;11;00;Lauantai;12;9;21;8;2;10
89;25.11.2017;2017;11;01;Lauantai;12;4;16;7;3;10
89;25.11.2017;2017;11;02;Lauantai;7;2;9;9;1;10
89;25.11.2017;2017;11;03;Lauantai;10;1;11;13;0;13
89;25.11.2017;2017;11;04;Lauantai;3;1;4;7;1;8
89;25.11.2017;2017;11;05;Lauantai;4;7;11;5;0;5
89;25.11.2017;2017;11;06;Lauantai;0;6;6;2;3;5
89;25.11.2017;2017;11;07;Lauantai;1;8;9;6;8;14
89;25.11.2017;2017;11;08;Lauantai;2;9;11;8;12;20
89;25.11.2017;2017;11;09;Lauantai;11;27;38;12;15;27
89;25.11.2017;2017;11;10;Lauantai;8;26;34;14;26;40
89;25.11.2017;2017;11;11;Lauantai;24;36;60;35;33;68
89;25.11.2017;2017;11;12;Lauantai;26;45;71;26;36;62
89;25.11.2017;2017;11;13;Lauantai;30;30;60;35;37;72
89;25.11.2017;2017;11;14;Lauantai;37;44;81;39;29;68
89;25.11.2017;2017;11;15;Lauantai;41;34;75;45;38;83
89;25.11.2017;2017;11;16;Lauantai;38;22;60;47;34;81
89;25.11.2017;2017;11;17;Lauantai;27;15;42;24;30;54
89;25.11.2017;2017;11;18;Lauantai;34;17;51;20;18;38
89;25.11.2017;2017;11;19;Lauantai;19;17;36;23;16;39
89;25.11.2017;2017;11;20;Lauantai;21;19;40;20;24;44
89;25.11.2017;2017;11;21;Lauantai;9;10;19;21;10;31
89;25.11.2017;2017;11;22;Lauantai;6;20;26;7;16;23
89;25.11.2017;2017;11;23;Lauantai;7;3;10;12;7;19
89;26.11.2017;2017;11;00;Sunnuntai;20;14;34;11;11;22
89;26.11.2017;2017;11;01;Sunnuntai;7;1;8;8;0;8
89;26.11.2017;2017;11;02;Sunnuntai;11;0;11;9;1;10
89;26.11.2017;2017;11;03;Sunnuntai;12;4;16;11;0;11
89;26.11.2017;2017;11;04;Sunnuntai;9;0;9;9;2;11
89;26.11.2017;2017;11;05;Sunnuntai;2;2;4;4;0;4
89;26.11.2017;2017;11;06;Sunnuntai;3;8;11;2;1;3
89;26.11.2017;2017;11;07;Sunnuntai;1;3;4;3;3;6
89;26.11.2017;2017;11;08;Sunnuntai;3;3;6;9;11;20
89;26.11.2017;2017;11;09;Sunnuntai;4;8;12;14;21;35
89;26.11.2017;2017;11;10;Sunnuntai;10;14;24;24;27;51
89;26.11.2017;2017;11;11;Sunnuntai;10;25;35;47;68;115
89;26.11.2017;2017;11;12;Sunnuntai;17;29;46;42;68;110
89;26.11.2017;2017;11;13;Sunnuntai;27;42;69;52;26;78
89;26.11.2017;2017;11;14;Sunnuntai;34;29;63;47;41;88
89;26.11.2017;2017;11;15;Sunnuntai;30;29;59;50;49;99
89;26.11.2017;2017;11;16;Sunnuntai;28;25;53;39;43;82
89;26.11.2017;2017;11;17;Sunnuntai;34;28;62;28;22;50
89;26.11.2017;2017;11;18;Sunnuntai;22;10;32;42;31;73
89;26.11.2017;2017;11;19;Sunnuntai;19;14;33;36;24;60
89;26.11.2017;2017;11;20;Sunnuntai;15;9;24;44;23;67
89;26.11.2017;2017;11;21;Sunnuntai;11;8;19;24;12;36
89;26.11.2017;2017;11;22;Sunnuntai;4;6;10;5;4;9
89;26.11.2017;2017;11;23;Sunnuntai;4;3;7;3;1;4
89;27.11.2017;2017;11;00;Maanantai;7;2;9;0;2;2
89;27.11.2017;2017;11;01;Maanantai;0;0;0;0;0;0
89;27.11.2017;2017;11;02;Maanantai;1;1;2;1;0;1
89;27.11.2017;2017;11;03;Maanantai;1;5;6;1;0;1
89;27.11.2017;2017;11;04;Maanantai;3;3;6;3;0;3
89;27.11.2017;2017;11;05;Maanantai;1;8;9;1;1;2
89;27.11.2017;2017;11;06;Maanantai;2;31;33;1;8;9
89;27.11.2017;2017;11;07;Maanantai;20;94;114;5;27;32
89;27.11.2017;2017;11;08;Maanantai;24;139;163;7;55;62
89;27.11.2017;2017;11;09;Maanantai;21;69;90;17;50;67
89;27.11.2017;2017;11;10;Maanantai;33;44;77;32;43;75
89;27.11.2017;2017;11;11;Maanantai;31;56;87;35;36;71
89;27.11.2017;2017;11;12;Maanantai;43;49;92;34;35;69
89;27.11.2017;2017;11;13;Maanantai;50;43;93;36;30;66
89;27.11.2017;2017;11;14;Maanantai;78;38;116;36;29;65
89;27.11.2017;2017;11;15;Maanantai;113;34;147;59;23;82
89;27.11.2017;2017;11;16;Maanantai;106;58;164;49;28;77
89;27.11.2017;2017;11;17;Maanantai;63;34;97;44;27;71
89;27.11.2017;2017;11;18;Maanantai;46;18;64;27;15;42
89;27.11.2017;2017;11;19;Maanantai;43;18;61;34;16;50
89;27.11.2017;2017;11;20;Maanantai;16;11;27;25;10;35
89;27.11.2017;2017;11;21;Maanantai;26;16;42;14;3;17
89;27.11.2017;2017;11;22;Maanantai;11;3;14;6;6;12
89;27.11.2017;2017;11;23;Maanantai;4;2;6;3;2;5
89;28.11.2017;2017;11;00;Tiistai;1;3;4;2;1;3
89;28.11.2017;2017;11;01;Tiistai;2;0;2;0;0;0
89;28.11.2017;2017;11;02;Tiistai;2;1;3;0;1;1
89;28.11.2017;2017;11;03;Tiistai;6;3;9;0;0;0
89;28.11.2017;2017;11;04;Tiistai;3;1;4;0;1;1
89;28.11.2017;2017;11;05;Tiistai;1;9;10;2;1;3
89;28.11.2017;2017;11;06;Tiistai;9;35;44;1;8;9
89;28.11.2017;2017;11;07;Tiistai;19;91;110;6;25;31
89;28.11.2017;2017;11;08;Tiistai;29;129;158;18;58;76
89;28.11.2017;2017;11;09;Tiistai;17;72;89;9;40;49
89;28.11.2017;2017;11;10;Tiistai;25;34;59;18;34;52
89;28.11.2017;2017;11;11;Tiistai;37;31;68;29;39;68
89;28.11.2017;2017;11;12;Tiistai;33;40;73;24;27;51
89;28.11.2017;2017;11;13;Tiistai;40;34;74;43;29;72
89;28.11.2017;2017;11;14;Tiistai;66;28;94;41;14;55
89;28.11.2017;2017;11;15;Tiistai;94;37;131;54;34;88
89;28.11.2017;2017;11;16;Tiistai;97;50;147;54;29;83
89;28.11.2017;2017;11;17;Tiistai;75;42;117;41;28;69
89;28.11.2017;2017;11;18;Tiistai;59;29;88;46;42;88
89;28.11.2017;2017;11;19;Tiistai;44;31;75;37;32;69
89;28.11.2017;2017;11;20;Tiistai;25;19;44;26;21;47
89;28.11.2017;2017;11;21;Tiistai;29;16;45;30;23;53
89;28.11.2017;2017;11;22;Tiistai;7;10;17;8;11;19
89;28.11.2017;2017;11;23;Tiistai;4;3;7;12;2;14
89;29.11.2017;2017;11;00;Keskiviikko;2;6;8;5;4;9
89;29.11.2017;2017;11;01;Keskiviikko;3;0;3;2;0;2
89;29.11.2017;2017;11;02;Keskiviikko;4;2;6;1;0;1
89;29.11.2017;2017;11;03;Keskiviikko;5;1;6;2;1;3
89;29.11.2017;2017;11;04;Keskiviikko;2;2;4;1;2;3
89;29.11.2017;2017;11;05;Keskiviikko;5;8;13;2;0;2
89;29.11.2017;2017;11;06;Keskiviikko;5;41;46;9;9;18
89;29.11.2017;2017;11;07;Keskiviikko;25;99;124;8;51;59
89;29.11.2017;2017;11;08;Keskiviikko;26;136;162;11;38;49
89;29.11.2017;2017;11;09;Keskiviikko;24;76;100;8;25;33
89;29.11.2017;2017;11;10;Keskiviikko;22;53;75;20;29;49
89;29.11.2017;2017;11;11;Keskiviikko;26;46;72;26;35;61
89;29.11.2017;2017;11;12;Keskiviikko;50;53;103;35;40;75
89;29.11.2017;2017;11;13;Keskiviikko;73;30;103;63;25;88
89;29.11.2017;2017;11;14;Keskiviikko;67;34;101;54;20;74
89;29.11.2017;2017;11;15;Keskiviikko;91;38;129;60;31;91
89;29.11.2017;2017;11;16;Keskiviikko;128;70;198;68;26;94
89;29.11.2017;2017;11;17;Keskiviikko;62;45;107;28;26;54
89;29.11.2017;2017;11;18;Keskiviikko;48;31;79;36;30;66
89;29.11.2017;2017;11;19;Keskiviikko;51;23;74;27;26;53
89;29.11.2017;2017;11;20;Keskiviikko;42;18;60;19;24;43
89;29.11.2017;2017;11;21;Keskiviikko;28;17;45;23;6;29
89;29.11.2017;2017;11;22;Keskiviikko;10;6;16;13;13;26
89;29.11.2017;2017;11;23;Keskiviikko;6;3;9;1;3;4
89;30.11.2017;2017;11;00;Torstai;7;1;8;3;0;3
89;30.11.2017;2017;11;01;Torstai;0;2;2;1;1;2
89;30.11.2017;2017;11;02;Torstai;5;2;7;2;0;2
89;30.11.2017;2017;11;03;Torstai;1;2;3;1;0;1
89;30.11.2017;2017;11;04;Torstai;2;4;6;1;1;2
89;30.11.2017;2017;11;05;Torstai;1;9;10;0;1;1
89;30.11.2017;2017;11;06;Torstai;7;43;50;6;14;20
89;30.11.2017;2017;11;07;Torstai;17;93;110;4;22;26
89;30.11.2017;2017;11;08;Torstai;27;124;151;12;44;56
89;30.11.2017;2017;11;09;Torstai;33;78;111;21;44;65
89;30.11.2017;2017;11;10;Torstai;16;40;56;29;41;70
89;30.11.2017;2017;11;11;Torstai;35;57;92;24;41;65
89;30.11.2017;2017;11;12;Torstai;42;32;74;32;48;80
89;30.11.2017;2017;11;13;Torstai;45;42;87;51;15;66
89;30.11.2017;2017;11;14;Torstai;77;44;121;60;18;78
89;30.11.2017;2017;11;15;Torstai;89;44;133;52;26;78
89;30.11.2017;2017;11;16;Torstai;125;54;179;48;28;76
89;30.11.2017;2017;11;17;Torstai;75;51;126;36;40;76
89;30.11.2017;2017;11;18;Torstai;53;29;82;47;41;88
89;30.11.2017;2017;11;19;Torstai;37;21;58;48;26;74
89;30.11.2017;2017;11;20;Torstai;40;18;58;42;15;57
89;30.11.2017;2017;11;21;Torstai;30;10;40;34;8;42
89;30.11.2017;2017;11;22;Torstai;11;14;25;6;9;15
89;30.11.2017;2017;11;23;Torstai;12;3;15;9;3;12
89;01.12.2017;2017;12;00;Perjantai;13;6;19;1;2;3
89;01.12.2017;2017;12;01;Perjantai;4;3;7;3;1;4
89;01.12.2017;2017;12;02;Perjantai;2;4;6;3;0;3
89;01.12.2017;2017;12;03;Perjantai;7;2;9;3;0;3
89;01.12.2017;2017;12;04;Perjantai;1;4;5;3;2;5
89;01.12.2017;2017;12;05;Perjantai;2;8;10;1;2;3
89;01.12.2017;2017;12;06;Perjantai;7;42;49;4;8;12
89;01.12.2017;2017;12;07;Perjantai;14;85;99;8;29;37
89;01.12.2017;2017;12;08;Perjantai;21;123;144;9;26;35
89;01.12.2017;2017;12;09;Perjantai;27;58;85;8;35;43
89;01.12.2017;2017;12;10;Perjantai;30;53;83;19;21;40
89;01.12.2017;2017;12;11;Perjantai;36;46;82;25;50;75
89;01.12.2017;2017;12;12;Perjantai;45;62;107;36;36;72
89;01.12.2017;2017;12;13;Perjantai;67;39;106;26;41;67
89;01.12.2017;2017;12;14;Perjantai;85;48;133;37;29;66
89;01.12.2017;2017;12;15;Perjantai;112;46;158;43;33;76
89;01.12.2017;2017;12;16;Perjantai;91;42;133;35;18;53
89;01.12.2017;2017;12;17;Perjantai;44;38;82;26;35;61
89;01.12.2017;2017;12;18;Perjantai;51;32;83;40;24;64
89;01.12.2017;2017;12;19;Perjantai;36;23;59;30;25;55
89;01.12.2017;2017;12;20;Perjantai;31;21;52;26;15;41
89;01.12.2017;2017;12;21;Perjantai;26;22;48;25;21;46
89;01.12.2017;2017;12;22;Perjantai;25;12;37;19;9;28
89;01.12.2017;2017;12;23;Perjantai;11;17;28;9;5;14
89;02.12.2017;2017;12;00;Lauantai;12;11;23;12;3;15
89;02.12.2017;2017;12;01;Lauantai;15;5;20;7;4;11
89;02.12.2017;2017;12;02;Lauantai;13;3;16;6;5;11
89;02.12.2017;2017;12;03;Lauantai;9;1;10;6;0;6
89;02.12.2017;2017;12;04;Lauantai;7;4;11;1;1;2
89;02.12.2017;2017;12;05;Lauantai;4;1;5;0;2;2
89;02.12.2017;2017;12;06;Lauantai;7;7;14;5;2;7
89;02.12.2017;2017;12;07;Lauantai;3;8;11;5;5;10
89;02.12.2017;2017;12;08;Lauantai;7;25;32;11;12;23
89;02.12.2017;2017;12;09;Lauantai;9;36;45;11;29;40
89;02.12.2017;2017;12;10;Lauantai;11;56;67;20;44;64
89;02.12.2017;2017;12;11;Lauantai;30;33;63;38;38;76
89;02.12.2017;2017;12;12;Lauantai;37;34;71;30;42;72
89;02.12.2017;2017;12;13;Lauantai;28;32;60;29;35;64
89;02.12.2017;2017;12;14;Lauantai;32;57;89;32;32;64
89;02.12.2017;2017;12;15;Lauantai;35;37;72;25;46;71
89;02.12.2017;2017;12;16;Lauantai;36;22;58;41;38;79
89;02.12.2017;2017;12;17;Lauantai;23;34;57;30;33;63
89;02.12.2017;2017;12;18;Lauantai;23;18;41;26;29;55
89;02.12.2017;2017;12;19;Lauantai;31;26;57;32;33;65
89;02.12.2017;2017;12;20;Lauantai;20;27;47;28;14;42
89;02.12.2017;2017;12;21;Lauantai;19;15;34;15;10;25
89;02.12.2017;2017;12;22;Lauantai;12;10;22;16;11;27
89;02.12.2017;2017;12;23;Lauantai;10;11;21;11;4;15
89;03.12.2017;2017;12;00;Sunnuntai;12;13;25;11;5;16
89;03.12.2017;2017;12;01;Sunnuntai;11;7;18;11;5;16
89;03.12.2017;2017;12;02;Sunnuntai;13;3;16;11;0;11
89;03.12.2017;2017;12;03;Sunnuntai;9;3;12;10;0;10
89;03.12.2017;2017;12;04;Sunnuntai;16;0;16;15;3;18
89;03.12.2017;2017;12;05;Sunnuntai;3;2;5;2;1;3
89;03.12.2017;2017;12;06;Sunnuntai;2;6;8;1;3;4
89;03.12.2017;2017;12;07;Sunnuntai;4;2;6;3;3;6
89;03.12.2017;2017;12;08;Sunnuntai;3;5;8;3;6;9
89;03.12.2017;2017;12;09;Sunnuntai;6;12;18;14;14;28
89;03.12.2017;2017;12;10;Sunnuntai;8;26;34;22;21;43
89;03.12.2017;2017;12;11;Sunnuntai;14;18;32;19;40;59
89;03.12.2017;2017;12;12;Sunnuntai;19;43;62;35;39;74
89;03.12.2017;2017;12;13;Sunnuntai;30;42;72;40;34;74
89;03.12.2017;2017;12;14;Sunnuntai;38;32;70;38;35;73
89;03.12.2017;2017;12;15;Sunnuntai;31;32;63;41;37;78
89;03.12.2017;2017;12;16;Sunnuntai;30;17;47;36;42;78
89;03.12.2017;2017;12;17;Sunnuntai;29;23;52;34;32;66
89;03.12.2017;2017;12;18;Sunnuntai;23;14;37;39;48;87
89;03.12.2017;2017;12;19;Sunnuntai;18;14;32;33;27;60
89;03.12.2017;2017;12;20;Sunnuntai;16;16;32;22;18;40
89;03.12.2017;2017;12;21;Sunnuntai;17;10;27;12;11;23
89;03.12.2017;2017;12;22;Sunnuntai;9;10;19;3;3;6
89;03.12.2017;2017;12;23;Sunnuntai;7;3;10;4;5;9
89;04.12.2017;2017;12;00;Maanantai;2;2;4;4;3;7
89;04.12.2017;2017;12;01;Maanantai;3;3;6;3;0;3
89;04.12.2017;2017;12;02;Maanantai;2;3;5;2;1;3
89;04.12.2017;2017;12;03;Maanantai;1;1;2;0;0;0
89;04.12.2017;2017;12;04;Maanantai;2;0;2;1;1;2
89;04.12.2017;2017;12;05;Maanantai;3;9;12;3;1;4
89;04.12.2017;2017;12;06;Maanantai;8;31;39;0;4;4
89;04.12.2017;2017;12;07;Maanantai;22;86;108;9;32;41
89;04.12.2017;2017;12;08;Maanantai;24;129;153;5;42;47
89;04.12.2017;2017;12;09;Maanantai;28;69;97;13;43;56
89;04.12.2017;2017;12;10;Maanantai;22;50;72;21;35;56
89;04.12.2017;2017;12;11;Maanantai;42;40;82;24;44;68
89;04.12.2017;2017;12;12;Maanantai;34;42;76;37;31;68
89;04.12.2017;2017;12;13;Maanantai;50;48;98;37;34;71
89;04.12.2017;2017;12;14;Maanantai;45;44;89;46;25;71
89;04.12.2017;2017;12;15;Maanantai;88;42;130;53;23;76
89;04.12.2017;2017;12;16;Maanantai;116;46;162;39;29;68
89;04.12.2017;2017;12;17;Maanantai;66;40;106;33;32;65
89;04.12.2017;2017;12;18;Maanantai;50;35;85;30;23;53
89;04.12.2017;2017;12;19;Maanantai;45;31;76;47;27;74
89;04.12.2017;2017;12;20;Maanantai;30;9;39;34;8;42
89;04.12.2017;2017;12;21;Maanantai;28;10;38;13;10;23
89;04.12.2017;2017;12;22;Maanantai;10;14;24;8;6;14
89;04.12.2017;2017;12;23;Maanantai;5;5;10;5;1;6
89;05.12.2017;2017;12;00;Tiistai;8;2;10;1;0;1
89;05.12.2017;2017;12;01;Tiistai;2;1;3;2;0;2
89;05.12.2017;2017;12;02;Tiistai;1;7;8;0;2;2
89;05.12.2017;2017;12;03;Tiistai;2;2;4;0;0;0
89;05.12.2017;2017;12;04;Tiistai;0;1;1;0;0;0
89;05.12.2017;2017;12;05;Tiistai;4;9;13;2;3;5
89;05.12.2017;2017;12;06;Tiistai;11;33;44;1;10;11
89;05.12.2017;2017;12;07;Tiistai;19;84;103;7;29;36
89;05.12.2017;2017;12;08;Tiistai;21;121;142;6;50;56
89;05.12.2017;2017;12;09;Tiistai;35;54;89;51;42;93
89;05.12.2017;2017;12;10;Tiistai;24;44;68;13;44;57
89;05.12.2017;2017;12;11;Tiistai;28;50;78;30;77;107
89;05.12.2017;2017;12;12;Tiistai;36;47;83;34;28;62
89;05.12.2017;2017;12;13;Tiistai;44;42;86;40;27;67
89;05.12.2017;2017;12;14;Tiistai;71;46;117;42;25;67
89;05.12.2017;2017;12;15;Tiistai;98;39;137;39;34;73
89;05.12.2017;2017;12;16;Tiistai;97;54;151;36;25;61
89;05.12.2017;2017;12;17;Tiistai;57;38;95;22;19;41
89;05.12.2017;2017;12;18;Tiistai;54;38;92;34;29;63
89;05.12.2017;2017;12;19;Tiistai;38;26;64;21;13;34
89;05.12.2017;2017;12;20;Tiistai;36;15;51;22;14;36
89;05.12.2017;2017;12;21;Tiistai;26;8;34;13;13;26
89;05.12.2017;2017;12;22;Tiistai;12;14;26;11;12;23
89;05.12.2017;2017;12;23;Tiistai;8;7;15;8;6;14
89;06.12.2017;2017;12;00;Keskiviikko;9;8;17;7;4;11
89;06.12.2017;2017;12;01;Keskiviikko;8;5;13;6;1;7
89;06.12.2017;2017;12;02;Keskiviikko;3;2;5;8;3;11
89;06.12.2017;2017;12;03;Keskiviikko;12;2;14;7;3;10
89;06.12.2017;2017;12;04;Keskiviikko;4;2;6;11;0;11
89;06.12.2017;2017;12;05;Keskiviikko;1;4;5;5;1;6
89;06.12.2017;2017;12;06;Keskiviikko;4;2;6;1;2;3
89;06.12.2017;2017;12;07;Keskiviikko;3;5;8;1;5;6
89;06.12.2017;2017;12;08;Keskiviikko;5;7;12;8;17;25
89;06.12.2017;2017;12;09;Keskiviikko;11;7;18;17;29;46
89;06.12.2017;2017;12;10;Keskiviikko;9;20;29;21;26;47
89;06.12.2017;2017;12;11;Keskiviikko;19;41;60;26;45;71
89;06.12.2017;2017;12;12;Keskiviikko;51;25;76;51;32;83
89;06.12.2017;2017;12;13;Keskiviikko;16;27;43;45;49;94
89;06.12.2017;2017;12;14;Keskiviikko;26;43;69;38;113;151
89;06.12.2017;2017;12;15;Keskiviikko;43;55;98;63;52;115
89;06.12.2017;2017;12;16;Keskiviikko;28;19;47;61;51;112
89;06.12.2017;2017;12;17;Keskiviikko;44;26;70;34;36;70
89;06.12.2017;2017;12;18;Keskiviikko;36;22;58;26;34;60
89;06.12.2017;2017;12;19;Keskiviikko;16;10;26;19;13;32
89;06.12.2017;2017;12;20;Keskiviikko;13;10;23;11;8;19
89;06.12.2017;2017;12;21;Keskiviikko;13;10;23;16;6;22
89;06.12.2017;2017;12;22;Keskiviikko;9;6;15;8;8;16
89;06.12.2017;2017;12;23;Keskiviikko;5;14;19;3;4;7
89;07.12.2017;2017;12;00;Torstai;2;3;5;3;3;6
89;07.12.2017;2017;12;01;Torstai;2;3;5;1;3;4
89;07.12.2017;2017;12;02;Torstai;0;1;1;1;4;5
89;07.12.2017;2017;12;03;Torstai;4;1;5;0;1;1
89;07.12.2017;2017;12;04;Torstai;1;2;3;0;0;0
89;07.12.2017;2017;12;05;Torstai;2;6;8;2;1;3
89;07.12.2017;2017;12;06;Torstai;10;40;50;2;8;10
89;07.12.2017;2017;12;07;Torstai;18;92;110;7;34;41
89;07.12.2017;2017;12;08;Torstai;14;122;136;3;40;43
89;07.12.2017;2017;12;09;Torstai;26;62;88;16;35;51
89;07.12.2017;2017;12;10;Torstai;18;33;51;19;37;56
89;07.12.2017;2017;12;11;Torstai;31;49;80;27;30;57
89;07.12.2017;2017;12;12;Torstai;32;44;76;26;35;61
89;07.12.2017;2017;12;13;Torstai;50;44;94;21;31;52
89;07.12.2017;2017;12;14;Torstai;75;41;116;54;24;78
89;07.12.2017;2017;12;15;Torstai;74;41;115;34;23;57
89;07.12.2017;2017;12;16;Torstai;111;35;146;35;16;51
89;07.12.2017;2017;12;17;Torstai;72;32;104;30;28;58
89;07.12.2017;2017;12;18;Torstai;66;30;96;32;23;55
89;07.12.2017;2017;12;19;Torstai;47;16;63;24;24;48
89;07.12.2017;2017;12;20;Torstai;24;18;42;22;5;27
89;07.12.2017;2017;12;21;Torstai;35;12;47;14;10;24
89;07.12.2017;2017;12;22;Torstai;12;7;19;5;6;11
89;07.12.2017;2017;12;23;Torstai;4;0;4;7;2;9
89;08.12.2017;2017;12;00;Perjantai;3;5;8;3;1;4
89;08.12.2017;2017;12;01;Perjantai;2;1;3;4;0;4
89;08.12.2017;2017;12;02;Perjantai;3;0;3;3;0;3
89;08.12.2017;2017;12;03;Perjantai;5;1;6;3;0;3
89;08.12.2017;2017;12;04;Perjantai;1;0;1;5;0;5
89;08.12.2017;2017;12;05;Perjantai;7;4;11;3;0;3
89;08.12.2017;2017;12;06;Perjantai;32;30;62;12;0;12
89;08.12.2017;2017;12;07;Perjantai;43;41;84;37;0;37
89;08.12.2017;2017;12;08;Perjantai;59;56;115;35;0;35
89;08.12.2017;2017;12;09;Perjantai;36;34;70;43;0;43
89;08.12.2017;2017;12;10;Perjantai;24;24;48;40;0;40
89;08.12.2017;2017;12;11;Perjantai;28;26;54;75;0;75
89;08.12.2017;2017;12;12;Perjantai;23;22;45;72;0;72
89;08.12.2017;2017;12;13;Perjantai;25;24;49;67;0;67
89;08.12.2017;2017;12;14;Perjantai;37;36;73;66;0;66
89;08.12.2017;2017;12;15;Perjantai;53;50;103;76;0;76
89;08.12.2017;2017;12;16;Perjantai;47;45;92;53;0;53
89;08.12.2017;2017;12;17;Perjantai;44;41;85;61;0;61
89;08.12.2017;2017;12;18;Perjantai;26;23;49;64;0;64
89;08.12.2017;2017;12;19;Perjantai;27;25;52;55;0;55
89;08.12.2017;2017;12;20;Perjantai;17;14;31;41;0;41
89;08.12.2017;2017;12;21;Perjantai;19;18;37;46;0;46
89;08.12.2017;2017;12;22;Perjantai;16;15;31;28;0;28
89;08.12.2017;2017;12;23;Perjantai;18;15;33;14;0;14
89;09.12.2017;2017;12;00;Lauantai;12;11;23;10;8;18
89;09.12.2017;2017;12;01;Lauantai;6;5;11;8;0;8
89;09.12.2017;2017;12;02;Lauantai;10;8;18;7;0;7
89;09.12.2017;2017;12;03;Lauantai;6;4;10;9;1;10
89;09.12.2017;2017;12;04;Lauantai;8;8;16;5;0;5
89;09.12.2017;2017;12;05;Lauantai;5;3;8;2;0;2
89;09.12.2017;2017;12;06;Lauantai;2;1;3;2;1;3
89;09.12.2017;2017;12;07;Lauantai;6;1;7;8;4;12
89;09.12.2017;2017;12;08;Lauantai;5;12;17;14;14;28
89;09.12.2017;2017;12;09;Lauantai;8;25;33;17;26;43
89;09.12.2017;2017;12;10;Lauantai;10;20;30;24;41;65
89;09.12.2017;2017;12;11;Lauantai;18;53;71;30;38;68
89;09.12.2017;2017;12;12;Lauantai;29;25;54;24;46;70
89;09.12.2017;2017;12;13;Lauantai;33;36;69;35;52;87
89;09.12.2017;2017;12;14;Lauantai;34;18;52;38;40;78
89;09.12.2017;2017;12;15;Lauantai;39;26;65;56;24;80
89;09.12.2017;2017;12;16;Lauantai;33;22;55;21;14;35
89;09.12.2017;2017;12;17;Lauantai;21;20;41;23;18;41
89;09.12.2017;2017;12;18;Lauantai;15;9;24;25;24;49
89;09.12.2017;2017;12;19;Lauantai;19;18;37;15;11;26
89;09.12.2017;2017;12;20;Lauantai;14;13;27;15;10;25
89;09.12.2017;2017;12;21;Lauantai;19;9;28;11;8;19
89;09.12.2017;2017;12;22;Lauantai;11;7;18;13;5;18
89;09.12.2017;2017;12;23;Lauantai;5;8;13;7;12;19
89;10.12.2017;2017;12;00;Sunnuntai;9;10;19;10;8;18
89;10.12.2017;2017;12;01;Sunnuntai;9;4;13;8;0;8
89;10.12.2017;2017;12;02;Sunnuntai;9;1;10;7;0;7
89;10.12.2017;2017;12;03;Sunnuntai;6;2;8;9;1;10
89;10.12.2017;2017;12;04;Sunnuntai;6;0;6;5;0;5
89;10.12.2017;2017;12;05;Sunnuntai;2;3;5;2;0;2
89;10.12.2017;2017;12;06;Sunnuntai;0;5;5;2;1;3
89;10.12.2017;2017;12;07;Sunnuntai;2;1;3;3;4;7
89;10.12.2017;2017;12;08;Sunnuntai;1;1;2;9;6;15
89;10.12.2017;2017;12;09;Sunnuntai;4;7;11;9;15;24
89;10.12.2017;2017;12;10;Sunnuntai;2;19;21;9;19;28
89;10.12.2017;2017;12;11;Sunnuntai;8;16;24;31;34;65
89;10.12.2017;2017;12;12;Sunnuntai;11;36;47;24;43;67
89;10.12.2017;2017;12;13;Sunnuntai;27;31;58;31;37;68
89;10.12.2017;2017;12;14;Sunnuntai;27;23;50;49;40;89
89;10.12.2017;2017;12;15;Sunnuntai;30;21;51;39;29;68
89;10.12.2017;2017;12;16;Sunnuntai;21;11;32;32;22;54
89;10.12.2017;2017;12;17;Sunnuntai;31;11;42;30;30;60
89;10.12.2017;2017;12;18;Sunnuntai;24;14;38;17;33;50
89;10.12.2017;2017;12;19;Sunnuntai;14;9;23;23;24;47
89;10.12.2017;2017;12;20;Sunnuntai;10;14;24;25;11;36
89;10.12.2017;2017;12;21;Sunnuntai;14;5;19;13;4;17
89;10.12.2017;2017;12;22;Sunnuntai;6;3;9;6;9;15
89;10.12.2017;2017;12;23;Sunnuntai;2;6;8;3;0;3
89;11.12.2017;2017;12;00;Maanantai;3;2;5;1;3;4
89;11.12.2017;2017;12;01;Maanantai;2;0;2;1;0;1
89;11.12.2017;2017;12;02;Maanantai;1;4;5;1;0;1
89;11.12.2017;2017;12;03;Maanantai;2;2;4;1;1;2
89;11.12.2017;2017;12;04;Maanantai;0;2;2;1;0;1
89;11.12.2017;2017;12;05;Maanantai;2;12;14;1;1;2
89;11.12.2017;2017;12;06;Maanantai;4;34;38;3;9;12
89;11.12.2017;2017;12;07;Maanantai;11;82;93;5;23;28
89;11.12.2017;2017;12;08;Maanantai;19;119;138;12;52;64
89;11.12.2017;2017;12;09;Maanantai;16;70;86;4;42;46
89;11.12.2017;2017;12;10;Maanantai;17;53;70;10;51;61
89;11.12.2017;2017;12;11;Maanantai;36;30;66;31;47;78
89;11.12.2017;2017;12;12;Maanantai;29;37;66;29;27;56
89;11.12.2017;2017;12;13;Maanantai;40;52;92;31;25;56
89;11.12.2017;2017;12;14;Maanantai;66;34;100;45;17;62
89;11.12.2017;2017;12;15;Maanantai;89;37;126;47;21;68
89;11.12.2017;2017;12;16;Maanantai;109;38;147;42;23;65
89;11.12.2017;2017;12;17;Maanantai;73;31;104;40;24;64
89;11.12.2017;2017;12;18;Maanantai;40;25;65;40;27;67
89;11.12.2017;2017;12;19;Maanantai;41;18;59;32;23;55
89;11.12.2017;2017;12;20;Maanantai;26;10;36;30;17;47
89;11.12.2017;2017;12;21;Maanantai;30;9;39;14;9;23
89;11.12.2017;2017;12;22;Maanantai;5;5;10;4;3;7
89;11.12.2017;2017;12;23;Maanantai;2;2;4;6;1;7
89;12.12.2017;2017;12;00;Tiistai;3;1;4;0;1;1
89;12.12.2017;2017;12;01;Tiistai;2;0;2;1;0;1
89;12.12.2017;2017;12;02;Tiistai;0;3;3;0;0;0
89;12.12.2017;2017;12;03;Tiistai;1;3;4;0;0;0
89;12.12.2017;2017;12;04;Tiistai;0;1;1;0;0;0
89;12.12.2017;2017;12;05;Tiistai;1;7;8;2;1;3
89;12.12.2017;2017;12;06;Tiistai;5;33;38;2;5;7
89;12.12.2017;2017;12;07;Tiistai;13;90;103;4;17;21
89;12.12.2017;2017;12;08;Tiistai;15;125;140;8;52;60
89;12.12.2017;2017;12;09;Tiistai;13;62;75;11;43;54
89;12.12.2017;2017;12;10;Tiistai;20;32;52;24;39;63
89;12.12.2017;2017;12;11;Tiistai;28;33;61;24;31;55
89;12.12.2017;2017;12;12;Tiistai;32;40;72;26;39;65
89;12.12.2017;2017;12;13;Tiistai;41;28;69;20;19;39
89;12.12.2017;2017;12;14;Tiistai;50;26;76;50;17;67
89;12.12.2017;2017;12;15;Tiistai;68;19;87;30;19;49
89;12.12.2017;2017;12;16;Tiistai;97;41;138;41;23;64
89;12.12.2017;2017;12;17;Tiistai;68;28;96;28;23;51
89;12.12.2017;2017;12;18;Tiistai;38;25;63;35;24;59
89;12.12.2017;2017;12;19;Tiistai;33;19;52;30;16;46
89;12.12.2017;2017;12;20;Tiistai;21;12;33;22;8;30
89;12.12.2017;2017;12;21;Tiistai;14;7;21;18;10;28
89;12.12.2017;2017;12;22;Tiistai;5;2;7;5;5;10
89;12.12.2017;2017;12;23;Tiistai;5;4;9;5;1;6
89;13.12.2017;2017;12;00;Keskiviikko;1;3;4;5;0;5
89;13.12.2017;2017;12;01;Keskiviikko;1;0;1;1;0;1
89;13.12.2017;2017;12;02;Keskiviikko;0;0;0;2;0;2
89;13.12.2017;2017;12;03;Keskiviikko;1;1;2;1;0;1
89;13.12.2017;2017;12;04;Keskiviikko;2;0;2;0;0;0
89;13.12.2017;2017;12;05;Keskiviikko;1;6;7;4;6;10
89;13.12.2017;2017;12;06;Keskiviikko;2;36;38;2;5;7
89;13.12.2017;2017;12;07;Keskiviikko;11;64;75;4;40;44
89;13.12.2017;2017;12;08;Keskiviikko;10;95;105;7;47;54
89;13.12.2017;2017;12;09;Keskiviikko;9;48;57;15;37;52
89;13.12.2017;2017;12;10;Keskiviikko;10;42;52;9;31;40
89;13.12.2017;2017;12;11;Keskiviikko;22;45;67;24;32;56
89;13.12.2017;2017;12;12;Keskiviikko;28;30;58;44;37;81
89;13.12.2017;2017;12;13;Keskiviikko;40;39;79;39;20;59
89;13.12.2017;2017;12;14;Keskiviikko;59;29;88;45;25;70
89;13.12.2017;2017;12;15;Keskiviikko;50;25;75;32;22;54
89;13.12.2017;2017;12;16;Keskiviikko;93;46;139;44;22;66
89;13.12.2017;2017;12;17;Keskiviikko;63;46;109;40;30;70
89;13.12.2017;2017;12;18;Keskiviikko;48;28;76;48;28;76
89;13.12.2017;2017;12;19;Keskiviikko;47;15;62;55;28;83
89;13.12.2017;2017;12;20;Keskiviikko;22;19;41;24;21;45
89;13.12.2017;2017;12;21;Keskiviikko;30;19;49;17;15;32
89;13.12.2017;2017;12;22;Keskiviikko;14;5;19;9;10;19
89;13.12.2017;2017;12;23;Keskiviikko;9;4;13;3;3;6
89;14.12.2017;2017;12;00;Torstai;5;4;9;6;1;7
89;14.12.2017;2017;12;01;Torstai;5;2;7;1;1;2
89;14.12.2017;2017;12;02;Torstai;1;1;2;2;1;3
89;14.12.2017;2017;12;03;Torstai;2;3;5;2;0;2
89;14.12.2017;2017;12;04;Torstai;1;1;2;6;0;6
89;14.12.2017;2017;12;05;Torstai;2;3;5;0;0;0
89;14.12.2017;2017;12;06;Torstai;10;44;54;4;7;11
89;14.12.2017;2017;12;07;Torstai;13;77;90;8;26;34
89;14.12.2017;2017;12;08;Torstai;17;97;114;11;48;59
89;14.12.2017;2017;12;09;Torstai;23;56;79;19;35;54
89;14.12.2017;2017;12;10;Torstai;18;22;40;22;39;61
89;14.12.2017;2017;12;11;Torstai;20;39;59;20;29;49
89;14.12.2017;2017;12;12;Torstai;24;27;51;18;33;51
89;14.12.2017;2017;12;13;Torstai;27;25;52;12;21;33
89;14.12.2017;2017;12;14;Torstai;47;35;82;46;26;72
89;14.12.2017;2017;12;15;Torstai;80;35;115;43;27;70
89;14.12.2017;2017;12;16;Torstai;100;39;139;52;18;70
89;14.12.2017;2017;12;17;Torstai;55;39;94;39;36;75
89;14.12.2017;2017;12;18;Torstai;42;25;67;36;37;73
89;14.12.2017;2017;12;19;Torstai;45;10;55;34;34;68
89;14.12.2017;2017;12;20;Torstai;35;20;55;32;20;52
89;14.12.2017;2017;12;21;Torstai;25;14;39;18;12;30
89;14.12.2017;2017;12;22;Torstai;7;8;15;9;8;17
89;14.12.2017;2017;12;23;Torstai;6;9;15;2;6;8
89;15.12.2017;2017;12;00;Perjantai;5;3;8;3;3;6
89;15.12.2017;2017;12;01;Perjantai;3;0;3;2;1;3
89;15.12.2017;2017;12;02;Perjantai;2;1;3;2;2;4
89;15.12.2017;2017;12;03;Perjantai;7;2;9;3;1;4
89;15.12.2017;2017;12;04;Perjantai;7;2;9;3;2;5
89;15.12.2017;2017;12;05;Perjantai;2;7;9;1;2;3
89;15.12.2017;2017;12;06;Perjantai;8;35;43;1;10;11
89;15.12.2017;2017;12;07;Perjantai;14;59;73;8;32;40
89;15.12.2017;2017;12;08;Perjantai;7;96;103;6;53;59
89;15.12.2017;2017;12;09;Perjantai;18;47;65;11;29;40
89;15.12.2017;2017;12;10;Perjantai;24;31;55;10;43;53
89;15.12.2017;2017;12;11;Perjantai;27;46;73;11;26;37
89;15.12.2017;2017;12;12;Perjantai;26;48;74;23;40;63
89;15.12.2017;2017;12;13;Perjantai;42;35;77;41;31;72
89;15.12.2017;2017;12;14;Perjantai;80;27;107;50;22;72
89;15.12.2017;2017;12;15;Perjantai;81;33;114;52;35;87
89;15.12.2017;2017;12;16;Perjantai;78;36;114;30;36;66
89;15.12.2017;2017;12;17;Perjantai;49;52;101;19;32;51
89;15.12.2017;2017;12;18;Perjantai;49;34;83;40;39;79
89;15.12.2017;2017;12;19;Perjantai;39;23;62;25;18;43
89;15.12.2017;2017;12;20;Perjantai;36;15;51;31;14;45
89;15.12.2017;2017;12;21;Perjantai;26;12;38;11;9;20
89;15.12.2017;2017;12;22;Perjantai;16;7;23;9;9;18
89;15.12.2017;2017;12;23;Perjantai;16;16;32;14;13;27
89;16.12.2017;2017;12;00;Lauantai;14;9;23;12;5;17
89;16.12.2017;2017;12;01;Lauantai;11;1;12;7;2;9
89;16.12.2017;2017;12;02;Lauantai;9;5;14;7;6;13
89;16.12.2017;2017;12;03;Lauantai;6;1;7;6;4;10
89;16.12.2017;2017;12;04;Lauantai;7;3;10;5;2;7
89;16.12.2017;2017;12;05;Lauantai;3;3;6;3;0;3
89;16.12.2017;2017;12;06;Lauantai;2;2;4;1;3;4
89;16.12.2017;2017;12;07;Lauantai;2;4;6;4;4;8
89;16.12.2017;2017;12;08;Lauantai;4;13;17;10;12;22
89;16.12.2017;2017;12;09;Lauantai;6;31;37;10;21;31
89;16.12.2017;2017;12;10;Lauantai;4;35;39;11;35;46
89;16.12.2017;2017;12;11;Lauantai;20;37;57;25;34;59
89;16.12.2017;2017;12;12;Lauantai;24;52;76;30;40;70
89;16.12.2017;2017;12;13;Lauantai;29;53;82;41;60;101
89;16.12.2017;2017;12;14;Lauantai;45;36;81;35;75;110
89;16.12.2017;2017;12;15;Lauantai;46;37;83;67;67;134
89;16.12.2017;2017;12;16;Lauantai;49;24;73;65;37;102
89;16.12.2017;2017;12;17;Lauantai;22;28;50;53;31;84
89;16.12.2017;2017;12;18;Lauantai;23;18;41;40;17;57
89;16.12.2017;2017;12;19;Lauantai;13;20;33;26;23;49
89;16.12.2017;2017;12;20;Lauantai;33;22;55;22;18;40
89;16.12.2017;2017;12;21;Lauantai;20;11;31;10;4;14
89;16.12.2017;2017;12;22;Lauantai;9;11;20;11;16;27
89;16.12.2017;2017;12;23;Lauantai;16;22;38;13;10;23
89;17.12.2017;2017;12;00;Sunnuntai;9;18;27;6;21;27
89;17.12.2017;2017;12;01;Sunnuntai;12;12;24;7;7;14
89;17.12.2017;2017;12;02;Sunnuntai;13;5;18;9;3;12
89;17.12.2017;2017;12;03;Sunnuntai;5;2;7;9;5;14
89;17.12.2017;2017;12;04;Sunnuntai;9;2;11;14;1;15
89;17.12.2017;2017;12;05;Sunnuntai;3;1;4;1;1;2
89;17.12.2017;2017;12;06;Sunnuntai;6;7;13;1;1;2
89;17.12.2017;2017;12;07;Sunnuntai;0;2;2;1;4;5
89;17.12.2017;2017;12;08;Sunnuntai;2;1;3;6;8;14
89;17.12.2017;2017;12;09;Sunnuntai;6;7;13;14;21;35
89;17.12.2017;2017;12;10;Sunnuntai;7;11;18;28;26;54
89;17.12.2017;2017;12;11;Sunnuntai;14;20;34;26;31;57
89;17.12.2017;2017;12;12;Sunnuntai;18;29;47;26;46;72
89;17.12.2017;2017;12;13;Sunnuntai;18;33;51;53;46;99
89;17.12.2017;2017;12;14;Sunnuntai;29;28;57;30;57;87
89;17.12.2017;2017;12;15;Sunnuntai;28;22;50;36;32;68
89;17.12.2017;2017;12;16;Sunnuntai;40;20;60;50;34;84
89;17.12.2017;2017;12;17;Sunnuntai;25;18;43;32;30;62
89;17.12.2017;2017;12;18;Sunnuntai;24;18;42;35;36;71
89;17.12.2017;2017;12;19;Sunnuntai;10;19;29;25;27;52
89;17.12.2017;2017;12;20;Sunnuntai;14;16;30;20;16;36
89;17.12.2017;2017;12;21;Sunnuntai;18;4;22;23;15;38
89;17.12.2017;2017;12;22;Sunnuntai;5;5;10;7;6;13
89;17.12.2017;2017;12;23;Sunnuntai;4;3;7;8;3;11
89;18.12.2017;2017;12;00;Maanantai;4;1;5;3;2;5
89;18.12.2017;2017;12;01;Maanantai;1;3;4;3;3;6
89;18.12.2017;2017;12;02;Maanantai;2;3;5;0;0;0
89;18.12.2017;2017;12;03;Maanantai;3;3;6;1;0;1
89;18.12.2017;2017;12;04;Maanantai;5;1;6;2;3;5
89;18.12.2017;2017;12;05;Maanantai;3;8;11;2;3;5
89;18.12.2017;2017;12;06;Maanantai;7;41;48;3;8;11
89;18.12.2017;2017;12;07;Maanantai;22;80;102;7;22;29
89;18.12.2017;2017;12;08;Maanantai;18;106;124;9;53;62
89;18.12.2017;2017;12;09;Maanantai;14;68;82;17;47;64
89;18.12.2017;2017;12;10;Maanantai;16;41;57;17;30;47
89;18.12.2017;2017;12;11;Maanantai;19;44;63;23;30;53
89;18.12.2017;2017;12;12;Maanantai;39;51;90;18;33;51
89;18.12.2017;2017;12;13;Maanantai;45;38;83;18;34;52
89;18.12.2017;2017;12;14;Maanantai;66;42;108;76;36;112
89;18.12.2017;2017;12;15;Maanantai;88;26;114;32;23;55
89;18.12.2017;2017;12;16;Maanantai;99;45;144;47;32;79
89;18.12.2017;2017;12;17;Maanantai;68;44;112;34;35;69
89;18.12.2017;2017;12;18;Maanantai;62;23;85;40;21;61
89;18.12.2017;2017;12;19;Maanantai;49;27;76;40;39;79
89;18.12.2017;2017;12;20;Maanantai;28;14;42;17;20;37
89;18.12.2017;2017;12;21;Maanantai;25;10;35;22;7;29
89;18.12.2017;2017;12;22;Maanantai;11;8;19;8;6;14
89;18.12.2017;2017;12;23;Maanantai;4;3;7;6;7;13
89;19.12.2017;2017;12;00;Tiistai;6;2;8;5;1;6
89;19.12.2017;2017;12;01;Tiistai;2;1;3;1;1;2
89;19.12.2017;2017;12;02;Tiistai;2;1;3;0;0;0
89;19.12.2017;2017;12;03;Tiistai;2;4;6;0;0;0
89;19.12.2017;2017;12;04;Tiistai;4;2;6;0;0;0
89;19.12.2017;2017;12;05;Tiistai;1;4;5;1;0;1
89;19.12.2017;2017;12;06;Tiistai;7;44;51;2;9;11
89;19.12.2017;2017;12;07;Tiistai;19;68;87;7;27;34
89;19.12.2017;2017;12;08;Tiistai;14;90;104;14;41;55
89;19.12.2017;2017;12;09;Tiistai;18;54;72;10;42;52
89;19.12.2017;2017;12;10;Tiistai;15;47;62;10;42;52
89;19.12.2017;2017;12;11;Tiistai;29;37;66;11;23;34
89;19.12.2017;2017;12;12;Tiistai;33;40;73;21;22;43
89;19.12.2017;2017;12;13;Tiistai;53;41;94;33;19;52
89;19.12.2017;2017;12;14;Tiistai;64;36;100;46;37;83
89;19.12.2017;2017;12;15;Tiistai;69;40;109;28;30;58
89;19.12.2017;2017;12;16;Tiistai;115;57;172;33;21;54
89;19.12.2017;2017;12;17;Tiistai;66;44;110;32;28;60
89;19.12.2017;2017;12;18;Tiistai;46;27;73;27;21;48
89;19.12.2017;2017;12;19;Tiistai;50;22;72;24;22;46
89;19.12.2017;2017;12;20;Tiistai;35;14;49;32;12;44
89;19.12.2017;2017;12;21;Tiistai;43;11;54;17;13;30
89;19.12.2017;2017;12;22;Tiistai;15;8;23;4;4;8
89;19.12.2017;2017;12;23;Tiistai;8;3;11;3;0;3
89;20.12.2017;2017;12;00;Keskiviikko;4;1;5;1;0;1
89;20.12.2017;2017;12;01;Keskiviikko;3;1;4;1;0;1
89;20.12.2017;2017;12;02;Keskiviikko;2;1;3;1;0;1
89;20.12.2017;2017;12;03;Keskiviikko;3;4;7;3;0;3
89;20.12.2017;2017;12;04;Keskiviikko;1;1;2;0;0;0
89;20.12.2017;2017;12;05;Keskiviikko;4;8;12;1;1;2
89;20.12.2017;2017;12;06;Keskiviikko;3;36;39;3;10;13
89;20.12.2017;2017;12;07;Keskiviikko;9;70;79;7;28;35
89;20.12.2017;2017;12;08;Keskiviikko;15;88;103;3;45;48
89;20.12.2017;2017;12;09;Keskiviikko;14;47;61;13;30;43
89;20.12.2017;2017;12;10;Keskiviikko;15;28;43;8;27;35
89;20.12.2017;2017;12;11;Keskiviikko;14;18;32;15;15;30
89;20.12.2017;2017;12;12;Keskiviikko;33;29;62;20;13;33
89;20.12.2017;2017;12;13;Keskiviikko;37;24;61;26;14;40
89;20.12.2017;2017;12;14;Keskiviikko;37;23;60;25;11;36
89;20.12.2017;2017;12;15;Keskiviikko;50;25;75;32;17;49
89;20.12.2017;2017;12;16;Keskiviikko;75;22;97;27;18;45
89;20.12.2017;2017;12;17;Keskiviikko;59;22;81;13;10;23
89;20.12.2017;2017;12;18;Keskiviikko;35;10;45;17;12;29
89;20.12.2017;2017;12;19;Keskiviikko;28;7;35;26;8;34
89;20.12.2017;2017;12;20;Keskiviikko;20;5;25;12;9;21
89;20.12.2017;2017;12;21;Keskiviikko;14;9;23;14;13;27
89;20.12.2017;2017;12;22;Keskiviikko;5;6;11;2;5;7
89;20.12.2017;2017;12;23;Keskiviikko;4;1;5;4;2;6
89;21.12.2017;2017;12;00;Torstai;2;2;4;3;2;5
89;21.12.2017;2017;12;01;Torstai;1;0;1;4;0;4
89;21.12.2017;2017;12;02;Torstai;1;1;2;4;1;5
89;21.12.2017;2017;12;03;Torstai;2;3;5;1;3;4
89;21.12.2017;2017;12;04;Torstai;1;1;2;4;0;4
89;21.12.2017;2017;12;05;Torstai;2;3;5;0;0;0
89;21.12.2017;2017;12;06;Torstai;5;31;36;1;4;5
89;21.12.2017;2017;12;07;Torstai;11;45;56;5;19;24
89;21.12.2017;2017;12;08;Torstai;4;81;85;10;45;55
89;21.12.2017;2017;12;09;Torstai;12;52;64;9;37;46
89;21.12.2017;2017;12;10;Torstai;16;32;48;12;32;44
89;21.12.2017;2017;12;11;Torstai;31;20;51;28;26;54
89;21.12.2017;2017;12;12;Torstai;27;47;74;26;27;53
89;21.12.2017;2017;12;13;Torstai;39;37;76;28;28;56
89;21.12.2017;2017;12;14;Torstai;43;39;82;51;38;89
89;21.12.2017;2017;12;15;Torstai;57;31;88;25;23;48
89;21.12.2017;2017;12;16;Torstai;74;41;115;18;29;47
89;21.12.2017;2017;12;17;Torstai;70;21;91;46;25;71
89;21.12.2017;2017;12;18;Torstai;36;29;65;30;26;56
89;21.12.2017;2017;12;19;Torstai;33;17;50;18;18;36
89;21.12.2017;2017;12;20;Torstai;26;5;31;26;17;43
89;21.12.2017;2017;12;21;Torstai;18;11;29;8;14;22
89;21.12.2017;2017;12;22;Torstai;5;5;10;6;7;13
89;21.12.2017;2017;12;23;Torstai;11;3;14;2;1;3
89;22.12.2017;2017;12;00;Perjantai;16;2;18;6;2;8
89;22.12.2017;2017;12;01;Perjantai;6;2;8;1;1;2
89;22.12.2017;2017;12;02;Perjantai;3;2;5;0;0;0
89;22.12.2017;2017;12;03;Perjantai;2;3;5;6;0;6
89;22.12.2017;2017;12;04;Perjantai;3;1;4;1;1;2
89;22.12.2017;2017;12;05;Perjantai;2;7;9;1;2;3
89;22.12.2017;2017;12;06;Perjantai;1;33;34;0;7;7
89;22.12.2017;2017;12;07;Perjantai;8;48;56;4;18;22
89;22.12.2017;2017;12;08;Perjantai;13;63;76;11;30;41
89;22.12.2017;2017;12;09;Perjantai;14;32;46;15;34;49
89;22.12.2017;2017;12;10;Perjantai;18;39;57;26;24;50
89;22.12.2017;2017;12;11;Perjantai;32;47;79;21;33;54
89;22.12.2017;2017;12;12;Perjantai;23;43;66;25;43;68
89;22.12.2017;2017;12;13;Perjantai;36;32;68;39;24;63
89;22.12.2017;2017;12;14;Perjantai;57;33;90;35;33;68
89;22.12.2017;2017;12;15;Perjantai;59;38;97;36;21;57
89;22.12.2017;2017;12;16;Perjantai;58;18;76;29;28;57
89;22.12.2017;2017;12;17;Perjantai;35;18;53;22;22;44
89;22.12.2017;2017;12;18;Perjantai;32;19;51;22;19;41
89;22.12.2017;2017;12;19;Perjantai;15;19;34;12;15;27
89;22.12.2017;2017;12;20;Perjantai;27;18;45;15;10;25
89;22.12.2017;2017;12;21;Perjantai;24;11;35;19;18;37
89;22.12.2017;2017;12;22;Perjantai;10;10;20;4;8;12
89;22.12.2017;2017;12;23;Perjantai;4;6;10;3;7;10
89;23.12.2017;2017;12;00;Lauantai;9;4;13;3;2;5
89;23.12.2017;2017;12;01;Lauantai;7;1;8;8;3;11
89;23.12.2017;2017;12;02;Lauantai;3;4;7;1;1;2
89;23.12.2017;2017;12;03;Lauantai;11;2;13;3;0;3
89;23.12.2017;2017;12;04;Lauantai;3;0;3;2;2;4
89;23.12.2017;2017;12;05;Lauantai;1;6;7;1;0;1
89;23.12.2017;2017;12;06;Lauantai;2;3;5;1;3;4
89;23.12.2017;2017;12;07;Lauantai;2;7;9;4;7;11
89;23.12.2017;2017;12;08;Lauantai;4;11;15;6;15;21
89;23.12.2017;2017;12;09;Lauantai;5;12;17;10;15;25
89;23.12.2017;2017;12;10;Lauantai;7;11;18;8;22;30
89;23.12.2017;2017;12;11;Lauantai;8;5;13;11;20;31
89;23.12.2017;2017;12;12;Lauantai;4;7;11;11;14;25
89;23.12.2017;2017;12;13;Lauantai;6;7;13;13;16;29
89;23.12.2017;2017;12;14;Lauantai;9;11;20;19;17;36
89;23.12.2017;2017;12;15;Lauantai;5;8;13;13;6;19
89;23.12.2017;2017;12;16;Lauantai;11;9;20;22;11;33
89;23.12.2017;2017;12;17;Lauantai;9;10;19;10;14;24
89;23.12.2017;2017;12;18;Lauantai;21;6;27;18;24;42
89;23.12.2017;2017;12;19;Lauantai;9;9;18;16;15;31
89;23.12.2017;2017;12;20;Lauantai;9;3;12;11;13;24
89;23.12.2017;2017;12;21;Lauantai;10;10;20;8;8;16
89;23.12.2017;2017;12;22;Lauantai;5;2;7;3;3;6
89;23.12.2017;2017;12;23;Lauantai;5;2;7;2;5;7
89;24.12.2017;2017;12;00;Sunnuntai;3;4;7;4;6;10
89;24.12.2017;2017;12;01;Sunnuntai;3;1;4;3;0;3
89;24.12.2017;2017;12;02;Sunnuntai;0;1;1;0;1;1
89;24.12.2017;2017;12;03;Sunnuntai;0;2;2;2;0;2
89;24.12.2017;2017;12;04;Sunnuntai;0;0;0;0;0;0
89;24.12.2017;2017;12;05;Sunnuntai;0;1;1;0;1;1
89;24.12.2017;2017;12;06;Sunnuntai;1;6;7;1;1;2
89;24.12.2017;2017;12;07;Sunnuntai;0;2;2;4;7;11
89;24.12.2017;2017;12;08;Sunnuntai;1;3;4;8;10;18
89;24.12.2017;2017;12;09;Sunnuntai;3;9;12;9;11;20
89;24.12.2017;2017;12;10;Sunnuntai;9;21;30;27;29;56
89;24.12.2017;2017;12;11;Sunnuntai;8;9;17;28;23;51
89;24.12.2017;2017;12;12;Sunnuntai;19;13;32;25;29;54
89;24.12.2017;2017;12;13;Sunnuntai;12;14;26;41;34;75
89;24.12.2017;2017;12;14;Sunnuntai;11;12;23;37;28;65
89;24.12.2017;2017;12;15;Sunnuntai;11;8;19;17;18;35
89;24.12.2017;2017;12;16;Sunnuntai;3;3;6;18;18;36
89;24.12.2017;2017;12;17;Sunnuntai;3;8;11;12;10;22
89;24.12.2017;2017;12;18;Sunnuntai;0;2;2;19;9;28
89;24.12.2017;2017;12;19;Sunnuntai;2;2;4;7;8;15
89;24.12.2017;2017;12;20;Sunnuntai;4;4;8;11;10;21
89;24.12.2017;2017;12;21;Sunnuntai;1;4;5;10;6;16
89;24.12.2017;2017;12;22;Sunnuntai;6;0;6;7;7;14
89;24.12.2017;2017;12;23;Sunnuntai;4;0;4;3;4;7
89;25.12.2017;2017;12;00;Maanantai;2;1;3;3;1;4
89;25.12.2017;2017;12;01;Maanantai;2;0;2;2;3;5
89;25.12.2017;2017;12;02;Maanantai;0;0;0;1;3;4
89;25.12.2017;2017;12;03;Maanantai;2;1;3;1;0;1
89;25.12.2017;2017;12;04;Maanantai;0;0;0;2;2;4
89;25.12.2017;2017;12;05;Maanantai;1;2;3;0;0;0
89;25.12.2017;2017;12;06;Maanantai;1;2;3;0;1;1
89;25.12.2017;2017;12;07;Maanantai;2;3;5;1;1;2
89;25.12.2017;2017;12;08;Maanantai;1;2;3;2;4;6
89;25.12.2017;2017;12;09;Maanantai;5;4;9;4;11;15
89;25.12.2017;2017;12;10;Maanantai;0;2;2;20;16;36
89;25.12.2017;2017;12;11;Maanantai;9;9;18;40;35;75
89;25.12.2017;2017;12;12;Maanantai;2;9;11;47;48;95
89;25.12.2017;2017;12;13;Maanantai;3;11;14;44;48;92
89;25.12.2017;2017;12;14;Maanantai;11;9;20;45;29;74
89;25.12.2017;2017;12;15;Maanantai;9;7;16;38;27;65
89;25.12.2017;2017;12;16;Maanantai;7;11;18;34;37;71
89;25.12.2017;2017;12;17;Maanantai;12;4;16;30;21;51
89;25.12.2017;2017;12;18;Maanantai;7;7;14;26;22;48
89;25.12.2017;2017;12;19;Maanantai;13;10;23;29;20;49
89;25.12.2017;2017;12;20;Maanantai;4;2;6;18;23;41
89;25.12.2017;2017;12;21;Maanantai;10;3;13;17;10;27
89;25.12.2017;2017;12;22;Maanantai;4;6;10;13;4;17
89;25.12.2017;2017;12;23;Maanantai;0;3;3;1;5;6
89;26.12.2017;2017;12;00;Tiistai;2;2;4;1;3;4
89;26.12.2017;2017;12;01;Tiistai;0;3;3;4;1;5
89;26.12.2017;2017;12;02;Tiistai;1;0;1;1;1;2
89;26.12.2017;2017;12;03;Tiistai;5;0;5;2;0;2
89;26.12.2017;2017;12;04;Tiistai;2;0;2;4;0;4
89;26.12.2017;2017;12;05;Tiistai;1;1;2;0;2;2
89;26.12.2017;2017;12;06;Tiistai;2;5;7;2;2;4
89;26.12.2017;2017;12;07;Tiistai;3;4;7;1;3;4
89;26.12.2017;2017;12;08;Tiistai;1;5;6;3;4;7
89;26.12.2017;2017;12;09;Tiistai;2;5;7;16;15;31
89;26.12.2017;2017;12;10;Tiistai;7;14;21;20;24;44
89;26.12.2017;2017;12;11;Tiistai;12;12;24;45;32;77
89;26.12.2017;2017;12;12;Tiistai;6;15;21;44;34;78
89;26.12.2017;2017;12;13;Tiistai;15;21;36;69;46;115
89;26.12.2017;2017;12;14;Tiistai;13;12;25;43;35;78
89;26.12.2017;2017;12;15;Tiistai;14;4;18;17;24;41
89;26.12.2017;2017;12;16;Tiistai;12;11;23;17;16;33
89;26.12.2017;2017;12;17;Tiistai;9;14;23;21;15;36
89;26.12.2017;2017;12;18;Tiistai;6;6;12;22;9;31
89;26.12.2017;2017;12;19;Tiistai;15;8;23;10;8;18
89;26.12.2017;2017;12;20;Tiistai;6;14;20;9;8;17
89;26.12.2017;2017;12;21;Tiistai;10;3;13;10;9;19
89;26.12.2017;2017;12;22;Tiistai;6;8;14;5;7;12
89;26.12.2017;2017;12;23;Tiistai;1;3;4;3;0;3
89;27.12.2017;2017;12;00;Keskiviikko;4;3;7;4;0;4
89;27.12.2017;2017;12;01;Keskiviikko;2;1;3;3;3;6
89;27.12.2017;2017;12;02;Keskiviikko;6;1;7;6;3;9
89;27.12.2017;2017;12;03;Keskiviikko;5;2;7;7;0;7
89;27.12.2017;2017;12;04;Keskiviikko;3;0;3;5;3;8
89;27.12.2017;2017;12;05;Keskiviikko;2;5;7;5;4;9
89;27.12.2017;2017;12;06;Keskiviikko;1;17;18;2;5;7
89;27.12.2017;2017;12;07;Keskiviikko;5;30;35;4;8;12
89;27.12.2017;2017;12;08;Keskiviikko;4;42;46;3;17;20
89;27.12.2017;2017;12;09;Keskiviikko;5;18;23;7;12;19
89;27.12.2017;2017;12;10;Keskiviikko;10;19;29;15;25;40
89;27.12.2017;2017;12;11;Keskiviikko;15;30;45;14;39;53
89;27.12.2017;2017;12;12;Keskiviikko;21;24;45;27;26;53
89;27.12.2017;2017;12;13;Keskiviikko;16;27;43;24;27;51
89;27.12.2017;2017;12;14;Keskiviikko;21;14;35;29;28;57
89;27.12.2017;2017;12;15;Keskiviikko;38;22;60;42;23;65
89;27.12.2017;2017;12;16;Keskiviikko;49;29;78;39;21;60
89;27.12.2017;2017;12;17;Keskiviikko;35;19;54;26;12;38
89;27.12.2017;2017;12;18;Keskiviikko;24;11;35;28;25;53
89;27.12.2017;2017;12;19;Keskiviikko;20;7;27;27;14;41
89;27.12.2017;2017;12;20;Keskiviikko;16;8;24;18;16;34
89;27.12.2017;2017;12;21;Keskiviikko;22;7;29;17;8;25
89;27.12.2017;2017;12;22;Keskiviikko;10;4;14;10;9;19
89;27.12.2017;2017;12;23;Keskiviikko;6;6;12;3;2;5
89;28.12.2017;2017;12;00;Torstai;0;5;5;2;3;5
89;28.12.2017;2017;12;01;Torstai;0;0;0;2;2;4
89;28.12.2017;2017;12;02;Torstai;0;5;5;2;0;2
89;28.12.2017;2017;12;03;Torstai;1;5;6;1;1;2
89;28.12.2017;2017;12;04;Torstai;5;1;6;0;1;1
89;28.12.2017;2017;12;05;Torstai;0;5;5;2;1;3
89;28.12.2017;2017;12;06;Torstai;4;19;23;1;6;7
89;28.12.2017;2017;12;07;Torstai;10;31;41;6;14;20
89;28.12.2017;2017;12;08;Torstai;3;37;40;18;20;38
89;28.12.2017;2017;12;09;Torstai;9;28;37;13;20;33
89;28.12.2017;2017;12;10;Torstai;9;30;39;14;21;35
89;28.12.2017;2017;12;11;Torstai;13;42;55;26;42;68
89;28.12.2017;2017;12;12;Torstai;16;23;39;31;49;80
89;28.12.2017;2017;12;13;Torstai;22;24;46;41;39;80
89;28.12.2017;2017;12;14;Torstai;25;27;52;27;39;66
89;28.12.2017;2017;12;15;Torstai;42;28;70;47;19;66
89;28.12.2017;2017;12;16;Torstai;50;26;76;47;24;71
89;28.12.2017;2017;12;17;Torstai;37;21;58;29;23;52
89;28.12.2017;2017;12;18;Torstai;21;15;36;31;27;58
89;28.12.2017;2017;12;19;Torstai;28;15;43;28;27;55
89;28.12.2017;2017;12;20;Torstai;20;9;29;15;16;31
89;28.12.2017;2017;12;21;Torstai;16;7;23;19;11;30
89;28.12.2017;2017;12;22;Torstai;11;9;20;7;7;14
89;28.12.2017;2017;12;23;Torstai;11;4;15;6;7;13
89;29.12.2017;2017;12;00;Perjantai;1;1;2;6;6;12
89;29.12.2017;2017;12;01;Perjantai;7;0;7;2;0;2
89;29.12.2017;2017;12;02;Perjantai;2;0;2;1;3;4
89;29.12.2017;2017;12;03;Perjantai;8;3;11;5;0;5
89;29.12.2017;2017;12;04;Perjantai;4;1;5;2;0;2
89;29.12.2017;2017;12;05;Perjantai;0;8;8;0;4;4
89;29.12.2017;2017;12;06;Perjantai;7;17;24;2;5;7
89;29.12.2017;2017;12;07;Perjantai;2;14;16;0;15;15
89;29.12.2017;2017;12;08;Perjantai;4;35;39;2;7;9
89;29.12.2017;2017;12;09;Perjantai;7;16;23;9;7;16
89;29.12.2017;2017;12;10;Perjantai;5;18;23;9;31;40
89;29.12.2017;2017;12;11;Perjantai;6;20;26;17;20;37
89;29.12.2017;2017;12;12;Perjantai;20;33;53;18;46;64
89;29.12.2017;2017;12;13;Perjantai;14;31;45;26;31;57
89;29.12.2017;2017;12;14;Perjantai;36;34;70;33;28;61
89;29.12.2017;2017;12;15;Perjantai;51;25;76;32;26;58
89;29.12.2017;2017;12;16;Perjantai;53;24;77;30;23;53
89;29.12.2017;2017;12;17;Perjantai;35;21;56;25;26;51
89;29.12.2017;2017;12;18;Perjantai;26;20;46;26;25;51
89;29.12.2017;2017;12;19;Perjantai;25;10;35;29;23;52
89;29.12.2017;2017;12;20;Perjantai;12;15;27;17;25;42
89;29.12.2017;2017;12;21;Perjantai;17;10;27;25;14;39
89;29.12.2017;2017;12;22;Perjantai;4;13;17;9;5;14
89;29.12.2017;2017;12;23;Perjantai;11;5;16;8;6;14
89;30.12.2017;2017;12;00;Lauantai;9;7;16;2;3;5
89;30.12.2017;2017;12;01;Lauantai;6;5;11;3;1;4
89;30.12.2017;2017;12;02;Lauantai;4;0;4;3;4;7
89;30.12.2017;2017;12;03;Lauantai;10;1;11;8;0;8
89;30.12.2017;2017;12;04;Lauantai;5;0;5;3;1;4
89;30.12.2017;2017;12;05;Lauantai;1;3;4;0;1;1
89;30.12.2017;2017;12;06;Lauantai;1;12;13;0;2;2
89;30.12.2017;2017;12;07;Lauantai;0;4;4;3;3;6
89;30.12.2017;2017;12;08;Lauantai;1;4;5;4;10;14
89;30.12.2017;2017;12;09;Lauantai;4;17;21;10;22;32
89;30.12.2017;2017;12;10;Lauantai;4;22;26;11;30;41
89;30.12.2017;2017;12;11;Lauantai;7;27;34;20;37;57
89;30.12.2017;2017;12;12;Lauantai;24;24;48;17;30;47
89;30.12.2017;2017;12;13;Lauantai;23;23;46;40;33;73
89;30.12.2017;2017;12;14;Lauantai;33;20;53;29;25;54
89;30.12.2017;2017;12;15;Lauantai;21;18;39;42;27;69
89;30.12.2017;2017;12;16;Lauantai;17;14;31;41;22;63
89;30.12.2017;2017;12;17;Lauantai;15;14;29;27;25;52
89;30.12.2017;2017;12;18;Lauantai;13;12;25;27;23;50
89;30.12.2017;2017;12;19;Lauantai;16;8;24;26;25;51
89;30.12.2017;2017;12;20;Lauantai;8;18;26;18;18;36
89;30.12.2017;2017;12;21;Lauantai;6;12;18;12;8;20
89;30.12.2017;2017;12;22;Lauantai;5;11;16;7;6;13
89;30.12.2017;2017;12;23;Lauantai;10;2;12;7;4;11
89;31.12.2017;2017;12;00;Sunnuntai;11;4;15;0;2;2
89;31.12.2017;2017;12;01;Sunnuntai;7;1;8;3;1;4
89;31.12.2017;2017;12;02;Sunnuntai;1;0;1;3;1;4
89;31.12.2017;2017;12;03;Sunnuntai;3;4;7;9;1;10
89;31.12.2017;2017;12;04;Sunnuntai;4;1;5;1;1;2
89;31.12.2017;2017;12;05;Sunnuntai;2;0;2;2;1;3
89;31.12.2017;2017;12;06;Sunnuntai;0;6;6;3;1;4
89;31.12.2017;2017;12;07;Sunnuntai;1;0;1;2;0;2
89;31.12.2017;2017;12;08;Sunnuntai;0;3;3;4;4;8
89;31.12.2017;2017;12;09;Sunnuntai;2;6;8;14;7;21
89;31.12.2017;2017;12;10;Sunnuntai;3;10;13;13;25;38
89;31.12.2017;2017;12;11;Sunnuntai;14;16;30;19;40;59
89;31.12.2017;2017;12;12;Sunnuntai;17;16;33;37;53;90
89;31.12.2017;2017;12;13;Sunnuntai;10;24;34;60;44;104
89;31.12.2017;2017;12;14;Sunnuntai;30;29;59;50;44;94
89;31.12.2017;2017;12;15;Sunnuntai;22;22;44;46;37;83
89;31.12.2017;2017;12;16;Sunnuntai;19;10;29;28;20;48
89;31.12.2017;2017;12;17;Sunnuntai;19;20;39;27;17;44
89;31.12.2017;2017;12;18;Sunnuntai;18;25;43;12;18;30
89;31.12.2017;2017;12;19;Sunnuntai;12;69;81;29;143;172
89;31.12.2017;2017;12;20;Sunnuntai;65;23;88;121;40;161
89;31.12.2017;2017;12;21;Sunnuntai;13;19;32;60;15;75
89;31.12.2017;2017;12;22;Sunnuntai;7;14;21;16;17;33
89;31.12.2017;2017;12;23;Sunnuntai;5;17;22;26;28;54
89;01.01.2018;2018;01;00;Maanantai;13;13;26;23;35;58
89;01.01.2018;2018;01;01;Maanantai;10;7;17;17;8;25
89;01.01.2018;2018;01;02;Maanantai;12;5;17;30;9;39
89;01.01.2018;2018;01;03;Maanantai;19;6;25;24;1;25
89;01.01.2018;2018;01;04;Maanantai;6;2;8;31;0;31
89;01.01.2018;2018;01;05;Maanantai;12;2;14;9;1;10
89;01.01.2018;2018;01;06;Maanantai;3;3;6;4;1;5
89;01.01.2018;2018;01;07;Maanantai;5;2;7;6;0;6
89;01.01.2018;2018;01;08;Maanantai;5;8;13;9;8;17
89;01.01.2018;2018;01;09;Maanantai;1;0;1;13;11;24
89;01.01.2018;2018;01;10;Maanantai;5;7;12;17;22;39
89;01.01.2018;2018;01;11;Maanantai;8;13;21;30;41;71
89;01.01.2018;2018;01;12;Maanantai;17;13;30;39;38;77
89;01.01.2018;2018;01;13;Maanantai;14;16;30;51;51;102
89;01.01.2018;2018;01;14;Maanantai;17;18;35;49;43;92
89;01.01.2018;2018;01;15;Maanantai;13;15;28;48;23;71
89;01.01.2018;2018;01;16;Maanantai;9;15;24;38;53;91
89;01.01.2018;2018;01;17;Maanantai;19;13;32;46;37;83
89;01.01.2018;2018;01;18;Maanantai;12;8;20;31;26;57
89;01.01.2018;2018;01;19;Maanantai;9;8;17;35;11;46
89;01.01.2018;2018;01;20;Maanantai;7;12;19;22;16;38
89;01.01.2018;2018;01;21;Maanantai;10;10;20;11;15;26
89;01.01.2018;2018;01;22;Maanantai;1;4;5;6;2;8
89;01.01.2018;2018;01;23;Maanantai;0;0;0;2;3;5
89;02.01.2018;2018;01;00;Tiistai;1;1;2;7;1;8
89;02.01.2018;2018;01;01;Tiistai;2;3;5;0;2;2
89;02.01.2018;2018;01;02;Tiistai;1;1;2;2;1;3
89;02.01.2018;2018;01;03;Tiistai;2;2;4;1;0;1
89;02.01.2018;2018;01;04;Tiistai;1;1;2;1;0;1
89;02.01.2018;2018;01;05;Tiistai;1;10;11;1;0;1
89;02.01.2018;2018;01;06;Tiistai;3;35;38;4;6;10
89;02.01.2018;2018;01;07;Tiistai;14;60;74;5;22;27
89;02.01.2018;2018;01;08;Tiistai;8;81;89;7;26;33
89;02.01.2018;2018;01;09;Tiistai;11;29;40;14;29;43
89;02.01.2018;2018;01;10;Tiistai;24;37;61;13;42;55
89;02.01.2018;2018;01;11;Tiistai;18;27;45;28;34;62
89;02.01.2018;2018;01;12;Tiistai;28;34;62;31;47;78
89;02.01.2018;2018;01;13;Tiistai;30;33;63;35;44;79
89;02.01.2018;2018;01;14;Tiistai;47;34;81;35;39;74
89;02.01.2018;2018;01;15;Tiistai;74;21;95;37;24;61
89;02.01.2018;2018;01;16;Tiistai;76;32;108;45;33;78
89;02.01.2018;2018;01;17;Tiistai;74;36;110;27;25;52
89;02.01.2018;2018;01;18;Tiistai;33;19;52;41;28;69
89;02.01.2018;2018;01;19;Tiistai;27;10;37;36;23;59
89;02.01.2018;2018;01;20;Tiistai;27;8;35;34;15;49
89;02.01.2018;2018;01;21;Tiistai;22;13;35;11;15;26
89;02.01.2018;2018;01;22;Tiistai;9;12;21;7;4;11
89;02.01.2018;2018;01;23;Tiistai;1;4;5;6;7;13
89;03.01.2018;2018;01;00;Keskiviikko;4;0;4;1;1;2
89;03.01.2018;2018;01;01;Keskiviikko;0;0;0;0;0;0
89;03.01.2018;2018;01;02;Keskiviikko;2;0;2;0;2;2
89;03.01.2018;2018;01;03;Keskiviikko;1;1;2;1;1;2
89;03.01.2018;2018;01;04;Keskiviikko;1;2;3;1;0;1
89;03.01.2018;2018;01;05;Keskiviikko;0;10;10;3;0;3
89;03.01.2018;2018;01;06;Keskiviikko;5;28;33;0;6;6
89;03.01.2018;2018;01;07;Keskiviikko;17;53;70;10;24;34
89;03.01.2018;2018;01;08;Keskiviikko;16;79;95;7;30;37
89;03.01.2018;2018;01;09;Keskiviikko;13;43;56;12;32;44
89;03.01.2018;2018;01;10;Keskiviikko;16;40;56;22;37;59
89;03.01.2018;2018;01;11;Keskiviikko;22;42;64;28;45;73
89;03.01.2018;2018;01;12;Keskiviikko;25;51;76;35;40;75
89;03.01.2018;2018;01;13;Keskiviikko;31;42;73;42;48;90
89;03.01.2018;2018;01;14;Keskiviikko;42;25;67;51;40;91
89;03.01.2018;2018;01;15;Keskiviikko;73;24;97;44;32;76
89;03.01.2018;2018;01;16;Keskiviikko;85;35;120;40;29;69
89;03.01.2018;2018;01;17;Keskiviikko;54;29;83;38;20;58
89;03.01.2018;2018;01;18;Keskiviikko;35;18;53;36;36;72
89;03.01.2018;2018;01;19;Keskiviikko;42;15;57;31;24;55
89;03.01.2018;2018;01;20;Keskiviikko;28;8;36;23;20;43
89;03.01.2018;2018;01;21;Keskiviikko;27;15;42;24;18;42
89;03.01.2018;2018;01;22;Keskiviikko;10;7;17;11;6;17
89;03.01.2018;2018;01;23;Keskiviikko;4;3;7;1;5;6
89;04.01.2018;2018;01;00;Torstai;5;0;5;5;0;5
89;04.01.2018;2018;01;01;Torstai;0;0;0;4;0;4
89;04.01.2018;2018;01;02;Torstai;5;0;5;2;0;2
89;04.01.2018;2018;01;03;Torstai;6;0;6;2;0;2
89;04.01.2018;2018;01;04;Torstai;6;0;6;1;0;1
89;04.01.2018;2018;01;05;Torstai;5;0;5;3;0;3
89;04.01.2018;2018;01;06;Torstai;23;0;23;7;0;7
89;04.01.2018;2018;01;07;Torstai;41;0;41;20;0;20
89;04.01.2018;2018;01;08;Torstai;40;0;40;38;0;38
89;04.01.2018;2018;01;09;Torstai;37;0;37;33;0;33
89;04.01.2018;2018;01;10;Torstai;39;0;39;35;0;35
89;04.01.2018;2018;01;11;Torstai;55;0;55;68;0;68
89;04.01.2018;2018;01;12;Torstai;39;0;39;80;0;80
89;04.01.2018;2018;01;13;Torstai;46;0;46;80;0;80
89;04.01.2018;2018;01;14;Torstai;52;0;52;66;0;66
89;04.01.2018;2018;01;15;Torstai;70;0;70;66;0;66
89;04.01.2018;2018;01;16;Torstai;76;0;76;71;0;71
89;04.01.2018;2018;01;17;Torstai;58;0;58;52;0;52
89;04.01.2018;2018;01;18;Torstai;36;0;36;58;0;58
89;04.01.2018;2018;01;19;Torstai;43;0;43;55;0;55
89;04.01.2018;2018;01;20;Torstai;29;0;29;31;0;31
89;04.01.2018;2018;01;21;Torstai;23;0;23;30;0;30
89;04.01.2018;2018;01;22;Torstai;20;0;20;14;0;14
89;04.01.2018;2018;01;23;Torstai;15;0;15;13;0;13
89;05.01.2018;2018;01;00;Perjantai;6;3;9;6;7;13
89;05.01.2018;2018;01;01;Perjantai;2;1;3;3;2;5
89;05.01.2018;2018;01;02;Perjantai;2;4;6;1;0;1
89;05.01.2018;2018;01;03;Perjantai;1;3;4;3;0;3
89;05.01.2018;2018;01;04;Perjantai;3;2;5;0;1;1
89;05.01.2018;2018;01;05;Perjantai;3;10;13;2;5;7
89;05.01.2018;2018;01;06;Perjantai;5;27;32;2;6;8
89;05.01.2018;2018;01;07;Perjantai;12;47;59;5;16;21
89;05.01.2018;2018;01;08;Perjantai;7;61;68;9;22;31
89;05.01.2018;2018;01;09;Perjantai;6;33;39;10;19;29
89;05.01.2018;2018;01;10;Perjantai;15;23;38;10;15;25
89;05.01.2018;2018;01;11;Perjantai;13;24;37;13;27;40
89;05.01.2018;2018;01;12;Perjantai;13;36;49;17;31;48
89;05.01.2018;2018;01;13;Perjantai;31;18;49;24;21;45
89;05.01.2018;2018;01;14;Perjantai;29;18;47;29;24;53
89;05.01.2018;2018;01;15;Perjantai;45;25;70;25;27;52
89;05.01.2018;2018;01;16;Perjantai;73;29;102;41;32;73
89;05.01.2018;2018;01;17;Perjantai;32;21;53;36;24;60
89;05.01.2018;2018;01;18;Perjantai;27;18;45;30;22;52
89;05.01.2018;2018;01;19;Perjantai;19;20;39;26;16;42
89;05.01.2018;2018;01;20;Perjantai;19;13;32;45;26;71
89;05.01.2018;2018;01;21;Perjantai;15;12;27;19;15;34
89;05.01.2018;2018;01;22;Perjantai;7;8;15;11;3;14
89;05.01.2018;2018;01;23;Perjantai;9;7;16;5;16;21
89;06.01.2018;2018;01;00;Lauantai;4;1;5;7;4;11
89;06.01.2018;2018;01;01;Lauantai;4;2;6;3;2;5
89;06.01.2018;2018;01;02;Lauantai;1;0;1;2;4;6
89;06.01.2018;2018;01;03;Lauantai;4;0;4;7;5;12
89;06.01.2018;2018;01;04;Lauantai;6;2;8;9;0;9
89;06.01.2018;2018;01;05;Lauantai;2;3;5;1;1;2
89;06.01.2018;2018;01;06;Lauantai;2;6;8;2;1;3
89;06.01.2018;2018;01;07;Lauantai;4;7;11;2;8;10
89;06.01.2018;2018;01;08;Lauantai;5;8;13;9;1;10
89;06.01.2018;2018;01;09;Lauantai;7;12;19;10;16;26
89;06.01.2018;2018;01;10;Lauantai;9;12;21;23;31;54
89;06.01.2018;2018;01;11;Lauantai;13;29;42;19;32;51
89;06.01.2018;2018;01;12;Lauantai;23;16;39;20;30;50
89;06.01.2018;2018;01;13;Lauantai;16;28;44;46;34;80
89;06.01.2018;2018;01;14;Lauantai;21;37;58;31;35;66
89;06.01.2018;2018;01;15;Lauantai;22;19;41;38;30;68
89;06.01.2018;2018;01;16;Lauantai;15;19;34;35;30;65
89;06.01.2018;2018;01;17;Lauantai;17;15;32;29;26;55
89;06.01.2018;2018;01;18;Lauantai;13;14;27;30;23;53
89;06.01.2018;2018;01;19;Lauantai;22;12;34;18;15;33
89;06.01.2018;2018;01;20;Lauantai;15;11;26;21;28;49
89;06.01.2018;2018;01;21;Lauantai;11;10;21;12;12;24
89;06.01.2018;2018;01;22;Lauantai;10;12;22;14;10;24
89;06.01.2018;2018;01;23;Lauantai;8;5;13;9;6;15
89;07.01.2018;2018;01;00;Sunnuntai;11;6;17;11;3;14
89;07.01.2018;2018;01;01;Sunnuntai;8;6;14;3;6;9
89;07.01.2018;2018;01;02;Sunnuntai;0;2;2;4;5;9
89;07.01.2018;2018;01;03;Sunnuntai;5;3;8;7;0;7
89;07.01.2018;2018;01;04;Sunnuntai;5;0;5;10;4;14
89;07.01.2018;2018;01;05;Sunnuntai;3;1;4;0;0;0
89;07.01.2018;2018;01;06;Sunnuntai;2;3;5;1;2;3
89;07.01.2018;2018;01;07;Sunnuntai;3;2;5;5;9;14
89;07.01.2018;2018;01;08;Sunnuntai;3;2;5;5;4;9
89;07.01.2018;2018;01;09;Sunnuntai;7;7;14;16;17;33
89;07.01.2018;2018;01;10;Sunnuntai;6;17;23;25;29;54
89;07.01.2018;2018;01;11;Sunnuntai;4;26;30;35;38;73
89;07.01.2018;2018;01;12;Sunnuntai;18;25;43;54;66;120
89;07.01.2018;2018;01;13;Sunnuntai;21;27;48;84;83;167
89;07.01.2018;2018;01;14;Sunnuntai;31;19;50;62;86;148
89;07.01.2018;2018;01;15;Sunnuntai;39;29;68;48;41;89
89;07.01.2018;2018;01;16;Sunnuntai;14;13;27;49;14;63
89;07.01.2018;2018;01;17;Sunnuntai;17;20;37;23;27;50
89;07.01.2018;2018;01;18;Sunnuntai;18;15;33;37;30;67
89;07.01.2018;2018;01;19;Sunnuntai;16;11;27;32;16;48
89;07.01.2018;2018;01;20;Sunnuntai;11;8;19;24;13;37
89;07.01.2018;2018;01;21;Sunnuntai;11;7;18;11;8;19
89;07.01.2018;2018;01;22;Sunnuntai;4;0;4;2;2;4
89;07.01.2018;2018;01;23;Sunnuntai;2;9;11;5;3;8
89;08.01.2018;2018;01;00;Maanantai;2;2;4;5;3;8
89;08.01.2018;2018;01;01;Maanantai;0;0;0;1;1;2
89;08.01.2018;2018;01;02;Maanantai;3;0;3;2;1;3
89;08.01.2018;2018;01;03;Maanantai;0;1;1;2;1;3
89;08.01.2018;2018;01;04;Maanantai;0;2;2;3;0;3
89;08.01.2018;2018;01;05;Maanantai;4;8;12;3;3;6
89;08.01.2018;2018;01;06;Maanantai;4;22;26;2;5;7
89;08.01.2018;2018;01;07;Maanantai;24;74;98;10;34;44
89;08.01.2018;2018;01;08;Maanantai;16;97;113;8;65;73
89;08.01.2018;2018;01;09;Maanantai;12;51;63;7;52;59
89;08.01.2018;2018;01;10;Maanantai;11;22;33;21;33;54
89;08.01.2018;2018;01;11;Maanantai;18;22;40;16;30;46
89;08.01.2018;2018;01;12;Maanantai;32;30;62;36;25;61
89;08.01.2018;2018;01;13;Maanantai;26;27;53;34;35;69
89;08.01.2018;2018;01;14;Maanantai;49;26;75;74;33;107
89;08.01.2018;2018;01;15;Maanantai;57;20;77;56;29;85
89;08.01.2018;2018;01;16;Maanantai;99;40;139;55;24;79
89;08.01.2018;2018;01;17;Maanantai;41;26;67;38;33;71
89;08.01.2018;2018;01;18;Maanantai;32;21;53;39;30;69
89;08.01.2018;2018;01;19;Maanantai;39;21;60;36;21;57
89;08.01.2018;2018;01;20;Maanantai;23;14;37;34;25;59
89;08.01.2018;2018;01;21;Maanantai;19;10;29;23;5;28
89;08.01.2018;2018;01;22;Maanantai;9;10;19;7;6;13
89;08.01.2018;2018;01;23;Maanantai;2;2;4;0;1;1
89;09.01.2018;2018;01;00;Tiistai;1;3;4;1;1;2
89;09.01.2018;2018;01;01;Tiistai;0;0;0;1;0;1
89;09.01.2018;2018;01;02;Tiistai;1;2;3;2;1;3
89;09.01.2018;2018;01;03;Tiistai;0;3;3;0;1;1
89;09.01.2018;2018;01;04;Tiistai;0;1;1;1;2;3
89;09.01.2018;2018;01;05;Tiistai;1;6;7;2;2;4
89;09.01.2018;2018;01;06;Tiistai;3;30;33;5;11;16
89;09.01.2018;2018;01;07;Tiistai;23;85;108;14;31;45
89;09.01.2018;2018;01;08;Tiistai;11;127;138;6;79;85
89;09.01.2018;2018;01;09;Tiistai;16;54;70;17;38;55
89;09.01.2018;2018;01;10;Tiistai;21;33;54;25;38;63
89;09.01.2018;2018;01;11;Tiistai;26;34;60;24;41;65
89;09.01.2018;2018;01;12;Tiistai;27;30;57;40;24;64
89;09.01.2018;2018;01;13;Tiistai;30;35;65;42;33;75
89;09.01.2018;2018;01;14;Tiistai;69;40;109;53;32;85
89;09.01.2018;2018;01;15;Tiistai;100;22;122;51;19;70
89;09.01.2018;2018;01;16;Tiistai;106;45;151;66;33;99
89;09.01.2018;2018;01;17;Tiistai;70;34;104;35;29;64
89;09.01.2018;2018;01;18;Tiistai;43;23;66;40;32;72
89;09.01.2018;2018;01;19;Tiistai;30;13;43;38;32;70
89;09.01.2018;2018;01;20;Tiistai;19;10;29;31;21;52
89;09.01.2018;2018;01;21;Tiistai;23;11;34;14;6;20
89;09.01.2018;2018;01;22;Tiistai;7;10;17;8;7;15
89;09.01.2018;2018;01;23;Tiistai;2;3;5;4;5;9
89;10.01.2018;2018;01;00;Keskiviikko;1;0;1;3;3;6
89;10.01.2018;2018;01;01;Keskiviikko;2;0;2;1;2;3
89;10.01.2018;2018;01;02;Keskiviikko;0;2;2;0;0;0
89;10.01.2018;2018;01;03;Keskiviikko;2;3;5;0;0;0
89;10.01.2018;2018;01;04;Keskiviikko;0;1;1;2;1;3
89;10.01.2018;2018;01;05;Keskiviikko;1;9;10;3;1;4
89;10.01.2018;2018;01;06;Keskiviikko;5;36;41;1;6;7
89;10.01.2018;2018;01;07;Keskiviikko;15;83;98;7;35;42
89;10.01.2018;2018;01;08;Keskiviikko;20;109;129;19;76;95
89;10.01.2018;2018;01;09;Keskiviikko;18;55;73;11;51;62
89;10.01.2018;2018;01;10;Keskiviikko;18;34;52;23;34;57
89;10.01.2018;2018;01;11;Keskiviikko;29;33;62;33;43;76
89;10.01.2018;2018;01;12;Keskiviikko;35;39;74;42;38;80
89;10.01.2018;2018;01;13;Keskiviikko;30;27;57;49;31;80
89;10.01.2018;2018;01;14;Keskiviikko;44;21;65;42;32;74
89;10.01.2018;2018;01;15;Keskiviikko;84;29;113;32;23;55
89;10.01.2018;2018;01;16;Keskiviikko;102;50;152;51;36;87
89;10.01.2018;2018;01;17;Keskiviikko;67;36;103;50;22;72
89;10.01.2018;2018;01;18;Keskiviikko;35;30;65;41;38;79
89;10.01.2018;2018;01;19;Keskiviikko;43;22;65;45;31;76
89;10.01.2018;2018;01;20;Keskiviikko;22;18;40;36;17;53
89;10.01.2018;2018;01;21;Keskiviikko;23;14;37;27;4;31
89;10.01.2018;2018;01;22;Keskiviikko;8;7;15;8;5;13
89;10.01.2018;2018;01;23;Keskiviikko;9;3;12;4;5;9
89;11.01.2018;2018;01;00;Torstai;3;2;5;2;1;3
89;11.01.2018;2018;01;01;Torstai;0;2;2;1;0;1
89;11.01.2018;2018;01;02;Torstai;0;1;1;0;0;0
89;11.01.2018;2018;01;03;Torstai;4;3;7;2;1;3
89;11.01.2018;2018;01;04;Torstai;0;1;1;2;0;2
89;11.01.2018;2018;01;05;Torstai;2;8;10;0;3;3
89;11.01.2018;2018;01;06;Torstai;2;29;31;4;7;11
89;11.01.2018;2018;01;07;Torstai;15;72;87;6;28;34
89;11.01.2018;2018;01;08;Torstai;16;101;117;8;55;63
89;11.01.2018;2018;01;09;Torstai;15;50;65;11;33;44
89;11.01.2018;2018;01;10;Torstai;23;38;61;15;35;50
89;11.01.2018;2018;01;11;Torstai;35;31;66;22;37;59
89;11.01.2018;2018;01;12;Torstai;26;36;62;36;25;61
89;11.01.2018;2018;01;13;Torstai;27;25;52;17;31;48
89;11.01.2018;2018;01;14;Torstai;74;37;111;63;24;87
89;11.01.2018;2018;01;15;Torstai;67;25;92;42;21;63
89;11.01.2018;2018;01;16;Torstai;94;39;133;49;29;78
89;11.01.2018;2018;01;17;Torstai;61;30;91;38;28;66
89;11.01.2018;2018;01;18;Torstai;43;23;66;26;26;52
89;11.01.2018;2018;01;19;Torstai;28;21;49;41;22;63
89;11.01.2018;2018;01;20;Torstai;27;4;31;36;10;46
89;11.01.2018;2018;01;21;Torstai;11;9;20;15;4;19
89;11.01.2018;2018;01;22;Torstai;7;3;10;9;4;13
89;11.01.2018;2018;01;23;Torstai;9;4;13;2;2;4
89;12.01.2018;2018;01;00;Perjantai;5;1;6;2;2;4
89;12.01.2018;2018;01;01;Perjantai;6;2;8;0;2;2
89;12.01.2018;2018;01;02;Perjantai;2;2;4;3;0;3
89;12.01.2018;2018;01;03;Perjantai;2;4;6;1;1;2
89;12.01.2018;2018;01;04;Perjantai;1;1;2;1;1;2
89;12.01.2018;2018;01;05;Perjantai;1;10;11;1;1;2
89;12.01.2018;2018;01;06;Perjantai;5;25;30;3;12;15
89;12.01.2018;2018;01;07;Perjantai;15;67;82;12;36;48
89;12.01.2018;2018;01;08;Perjantai;6;94;100;8;65;73
89;12.01.2018;2018;01;09;Perjantai;11;47;58;13;47;60
89;12.01.2018;2018;01;10;Perjantai;20;20;40;19;31;50
89;12.01.2018;2018;01;11;Perjantai;19;39;58;26;40;66
89;12.01.2018;2018;01;12;Perjantai;26;35;61;20;36;56
89;12.01.2018;2018;01;13;Perjantai;51;39;90;47;22;69
89;12.01.2018;2018;01;14;Perjantai;50;37;87;41;22;63
89;12.01.2018;2018;01;15;Perjantai;69;34;103;42;20;62
89;12.01.2018;2018;01;16;Perjantai;72;36;108;46;28;74
89;12.01.2018;2018;01;17;Perjantai;50;31;81;19;25;44
89;12.01.2018;2018;01;18;Perjantai;47;25;72;41;24;65
89;12.01.2018;2018;01;19;Perjantai;38;18;56;38;23;61
89;12.01.2018;2018;01;20;Perjantai;23;21;44;24;14;38
89;12.01.2018;2018;01;21;Perjantai;17;20;37;13;9;22
89;12.01.2018;2018;01;22;Perjantai;15;18;33;12;10;22
89;12.01.2018;2018;01;23;Perjantai;14;10;24;7;7;14
89;13.01.2018;2018;01;00;Lauantai;9;1;10;9;0;9
89;13.01.2018;2018;01;01;Lauantai;3;4;7;7;2;9
89;13.01.2018;2018;01;02;Lauantai;5;2;7;2;1;3
89;13.01.2018;2018;01;03;Lauantai;6;1;7;6;2;8
89;13.01.2018;2018;01;04;Lauantai;3;0;3;2;0;2
89;13.01.2018;2018;01;05;Lauantai;7;2;9;2;2;4
89;13.01.2018;2018;01;06;Lauantai;4;4;8;1;2;3
89;13.01.2018;2018;01;07;Lauantai;4;7;11;4;4;8
89;13.01.2018;2018;01;08;Lauantai;1;12;13;3;16;19
89;13.01.2018;2018;01;09;Lauantai;5;32;37;15;19;34
89;13.01.2018;2018;01;10;Lauantai;9;25;34;20;35;55
89;13.01.2018;2018;01;11;Lauantai;23;33;56;31;48;79
89;13.01.2018;2018;01;12;Lauantai;22;38;60;28;64;92
89;13.01.2018;2018;01;13;Lauantai;27;40;67;41;48;89
89;13.01.2018;2018;01;14;Lauantai;51;24;75;67;29;96
89;13.01.2018;2018;01;15;Lauantai;31;28;59;44;36;80
89;13.01.2018;2018;01;16;Lauantai;26;26;52;43;39;82
89;13.01.2018;2018;01;17;Lauantai;21;20;41;37;29;66
89;13.01.2018;2018;01;18;Lauantai;27;20;47;25;18;43
89;13.01.2018;2018;01;19;Lauantai;24;13;37;21;27;48
89;13.01.2018;2018;01;20;Lauantai;24;13;37;27;24;51
89;13.01.2018;2018;01;21;Lauantai;23;18;41;20;10;30
89;13.01.2018;2018;01;22;Lauantai;10;9;19;18;10;28
89;13.01.2018;2018;01;23;Lauantai;10;9;19;6;10;16
89;14.01.2018;2018;01;00;Sunnuntai;7;10;17;5;5;10
89;14.01.2018;2018;01;01;Sunnuntai;6;3;9;13;3;16
89;14.01.2018;2018;01;02;Sunnuntai;10;2;12;6;5;11
89;14.01.2018;2018;01;03;Sunnuntai;7;0;7;8;3;11
89;14.01.2018;2018;01;04;Sunnuntai;6;0;6;8;2;10
89;14.01.2018;2018;01;05;Sunnuntai;3;4;7;0;1;1
89;14.01.2018;2018;01;06;Sunnuntai;1;2;3;2;7;9
89;14.01.2018;2018;01;07;Sunnuntai;1;4;5;4;3;7
89;14.01.2018;2018;01;08;Sunnuntai;2;3;5;5;9;14
89;14.01.2018;2018;01;09;Sunnuntai;9;8;17;8;16;24
89;14.01.2018;2018;01;10;Sunnuntai;7;21;28;25;32;57
89;14.01.2018;2018;01;11;Sunnuntai;10;20;30;39;54;93
89;14.01.2018;2018;01;12;Sunnuntai;17;21;38;39;47;86
89;14.01.2018;2018;01;13;Sunnuntai;26;26;52;61;51;112
89;14.01.2018;2018;01;14;Sunnuntai;31;28;59;38;38;76
89;14.01.2018;2018;01;15;Sunnuntai;24;37;61;43;49;92
89;14.01.2018;2018;01;16;Sunnuntai;21;27;48;32;34;66
89;14.01.2018;2018;01;17;Sunnuntai;23;12;35;40;27;67
89;14.01.2018;2018;01;18;Sunnuntai;14;18;32;39;32;71
89;14.01.2018;2018;01;19;Sunnuntai;13;5;18;26;27;53
89;14.01.2018;2018;01;20;Sunnuntai;22;16;38;12;15;27
89;14.01.2018;2018;01;21;Sunnuntai;12;8;20;12;8;20
89;14.01.2018;2018;01;22;Sunnuntai;7;5;12;6;3;9
89;14.01.2018;2018;01;23;Sunnuntai;2;5;7;4;5;9
89;15.01.2018;2018;01;00;Maanantai;2;1;3;1;0;1
89;15.01.2018;2018;01;01;Maanantai;0;0;0;2;0;2
89;15.01.2018;2018;01;02;Maanantai;1;0;1;2;1;3
89;15.01.2018;2018;01;03;Maanantai;1;2;3;0;1;1
89;15.01.2018;2018;01;04;Maanantai;2;4;6;1;0;1
89;15.01.2018;2018;01;05;Maanantai;2;10;12;3;2;5
89;15.01.2018;2018;01;06;Maanantai;4;34;38;3;5;8
89;15.01.2018;2018;01;07;Maanantai;20;62;82;8;35;43
89;15.01.2018;2018;01;08;Maanantai;25;101;126;6;73;79
89;15.01.2018;2018;01;09;Maanantai;11;58;69;13;23;36
89;15.01.2018;2018;01;10;Maanantai;17;35;52;15;34;49
89;15.01.2018;2018;01;11;Maanantai;14;30;44;32;37;69
89;15.01.2018;2018;01;12;Maanantai;34;38;72;24;25;49
89;15.01.2018;2018;01;13;Maanantai;38;36;74;31;24;55
89;15.01.2018;2018;01;14;Maanantai;54;29;83;43;18;61
89;15.01.2018;2018;01;15;Maanantai;64;31;95;46;22;68
89;15.01.2018;2018;01;16;Maanantai;100;48;148;49;26;75
89;15.01.2018;2018;01;17;Maanantai;61;31;92;29;21;50
89;15.01.2018;2018;01;18;Maanantai;40;21;61;22;27;49
89;15.01.2018;2018;01;19;Maanantai;34;16;50;29;19;48
89;15.01.2018;2018;01;20;Maanantai;26;12;38;25;17;42
89;15.01.2018;2018;01;21;Maanantai;20;10;30;9;5;14
89;15.01.2018;2018;01;22;Maanantai;4;2;6;7;5;12
89;15.01.2018;2018;01;23;Maanantai;2;4;6;0;3;3
89;16.01.2018;2018;01;00;Tiistai;3;1;4;1;1;2
89;16.01.2018;2018;01;01;Tiistai;1;2;3;2;1;3
89;16.01.2018;2018;01;02;Tiistai;1;3;4;0;0;0
89;16.01.2018;2018;01;03;Tiistai;1;2;3;1;1;2
89;16.01.2018;2018;01;04;Tiistai;0;3;3;0;0;0
89;16.01.2018;2018;01;05;Tiistai;0;7;7;0;4;4
89;16.01.2018;2018;01;06;Tiistai;4;25;29;3;12;15
89;16.01.2018;2018;01;07;Tiistai;27;61;88;10;26;36
89;16.01.2018;2018;01;08;Tiistai;17;104;121;13;66;79
89;16.01.2018;2018;01;09;Tiistai;12;61;73;24;53;77
89;16.01.2018;2018;01;10;Tiistai;15;34;49;13;24;37
89;16.01.2018;2018;01;11;Tiistai;26;23;49;18;31;49
89;16.01.2018;2018;01;12;Tiistai;25;33;58;28;19;47
89;16.01.2018;2018;01;13;Tiistai;43;28;71;30;16;46
89;16.01.2018;2018;01;14;Tiistai;56;35;91;48;19;67
89;16.01.2018;2018;01;15;Tiistai;74;32;106;43;29;72
89;16.01.2018;2018;01;16;Tiistai;80;44;124;49;21;70
89;16.01.2018;2018;01;17;Tiistai;50;25;75;37;17;54
89;16.01.2018;2018;01;18;Tiistai;37;18;55;28;25;53
89;16.01.2018;2018;01;19;Tiistai;41;8;49;26;24;50
89;16.01.2018;2018;01;20;Tiistai;23;6;29;31;18;49
89;16.01.2018;2018;01;21;Tiistai;19;12;31;15;6;21
89;16.01.2018;2018;01;22;Tiistai;11;11;22;7;9;16
89;16.01.2018;2018;01;23;Tiistai;6;1;7;1;2;3
89;17.01.2018;2018;01;00;Keskiviikko;5;2;7;2;0;2
89;17.01.2018;2018;01;01;Keskiviikko;1;0;1;0;0;0
89;17.01.2018;2018;01;02;Keskiviikko;0;2;2;2;0;2
89;17.01.2018;2018;01;03;Keskiviikko;0;3;3;0;0;0
89;17.01.2018;2018;01;04;Keskiviikko;3;3;6;2;2;4
89;17.01.2018;2018;01;05;Keskiviikko;3;6;9;2;1;3
89;17.01.2018;2018;01;06;Keskiviikko;5;28;33;5;11;16
89;17.01.2018;2018;01;07;Keskiviikko;18;82;100;12;52;64
89;17.01.2018;2018;01;08;Keskiviikko;15;85;100;6;50;56
89;17.01.2018;2018;01;09;Keskiviikko;13;55;68;13;35;48
89;17.01.2018;2018;01;10;Keskiviikko;18;39;57;19;43;62
89;17.01.2018;2018;01;11;Keskiviikko;25;37;62;25;38;63
89;17.01.2018;2018;01;12;Keskiviikko;32;32;64;43;32;75
89;17.01.2018;2018;01;13;Keskiviikko;47;37;84;39;30;69
89;17.01.2018;2018;01;14;Keskiviikko;51;30;81;49;32;81
89;17.01.2018;2018;01;15;Keskiviikko;60;41;101;41;16;57
89;17.01.2018;2018;01;16;Keskiviikko;93;48;141;53;24;77
89;17.01.2018;2018;01;17;Keskiviikko;40;32;72;34;22;56
89;17.01.2018;2018;01;18;Keskiviikko;44;19;63;37;28;65
89;17.01.2018;2018;01;19;Keskiviikko;33;21;54;43;26;69
89;17.01.2018;2018;01;20;Keskiviikko;33;10;43;28;14;42
89;17.01.2018;2018;01;21;Keskiviikko;18;13;31;18;8;26
89;17.01.2018;2018;01;22;Keskiviikko;7;2;9;3;2;5
89;17.01.2018;2018;01;23;Keskiviikko;3;1;4;3;2;5
89;18.01.2018;2018;01;00;Torstai;2;3;5;1;3;4
89;18.01.2018;2018;01;01;Torstai;5;0;5;3;1;4
89;18.01.2018;2018;01;02;Torstai;2;1;3;0;3;3
89;18.01.2018;2018;01;03;Torstai;2;3;5;4;0;4
89;18.01.2018;2018;01;04;Torstai;0;3;3;4;0;4
89;18.01.2018;2018;01;05;Torstai;1;5;6;1;4;5
89;18.01.2018;2018;01;06;Torstai;2;29;31;4;11;15
89;18.01.2018;2018;01;07;Torstai;21;71;92;11;35;46
89;18.01.2018;2018;01;08;Torstai;16;84;100;17;55;72
89;18.01.2018;2018;01;09;Torstai;14;51;65;4;32;36
89;18.01.2018;2018;01;10;Torstai;17;33;50;13;33;46
89;18.01.2018;2018;01;11;Torstai;26;26;52;23;37;60
89;18.01.2018;2018;01;12;Torstai;23;27;50;43;40;83
89;18.01.2018;2018;01;13;Torstai;26;35;61;45;43;88
89;18.01.2018;2018;01;14;Torstai;46;33;79;42;22;64
89;18.01.2018;2018;01;15;Torstai;69;28;97;45;24;69
89;18.01.2018;2018;01;16;Torstai;89;34;123;53;32;85
89;18.01.2018;2018;01;17;Torstai;58;37;95;32;31;63
89;18.01.2018;2018;01;18;Torstai;42;28;70;47;24;71
89;18.01.2018;2018;01;19;Torstai;35;21;56;36;33;69
89;18.01.2018;2018;01;20;Torstai;27;12;39;21;13;34
89;18.01.2018;2018;01;21;Torstai;17;7;24;18;9;27
89;18.01.2018;2018;01;22;Torstai;10;5;15;8;4;12
89;18.01.2018;2018;01;23;Torstai;4;4;8;6;2;8
89;19.01.2018;2018;01;00;Perjantai;2;1;3;4;3;7
89;19.01.2018;2018;01;01;Perjantai;1;0;1;1;1;2
89;19.01.2018;2018;01;02;Perjantai;2;0;2;0;0;0
89;19.01.2018;2018;01;03;Perjantai;3;2;5;1;1;2
89;19.01.2018;2018;01;04;Perjantai;2;3;5;1;0;1
89;19.01.2018;2018;01;05;Perjantai;0;6;6;0;2;2
89;19.01.2018;2018;01;06;Perjantai;6;26;32;0;14;14
89;19.01.2018;2018;01;07;Perjantai;22;63;85;13;48;61
89;19.01.2018;2018;01;08;Perjantai;11;73;84;7;71;78
89;19.01.2018;2018;01;09;Perjantai;19;44;63;13;38;51
89;19.01.2018;2018;01;10;Perjantai;11;26;37;13;33;46
89;19.01.2018;2018;01;11;Perjantai;17;31;48;23;26;49
89;19.01.2018;2018;01;12;Perjantai;22;34;56;28;36;64
89;19.01.2018;2018;01;13;Perjantai;55;36;91;38;27;65
89;19.01.2018;2018;01;14;Perjantai;65;26;91;44;20;64
89;19.01.2018;2018;01;15;Perjantai;72;25;97;23;21;44
89;19.01.2018;2018;01;16;Perjantai;72;43;115;38;22;60
89;19.01.2018;2018;01;17;Perjantai;50;21;71;21;21;42
89;19.01.2018;2018;01;18;Perjantai;31;12;43;20;21;41
89;19.01.2018;2018;01;19;Perjantai;19;22;41;17;14;31
89;19.01.2018;2018;01;20;Perjantai;20;14;34;11;6;17
89;19.01.2018;2018;01;21;Perjantai;16;15;31;16;11;27
89;19.01.2018;2018;01;22;Perjantai;5;12;17;12;7;19
89;19.01.2018;2018;01;23;Perjantai;14;5;19;7;5;12
89;20.01.2018;2018;01;00;Lauantai;4;6;10;4;10;14
89;20.01.2018;2018;01;01;Lauantai;8;3;11;3;5;8
89;20.01.2018;2018;01;02;Lauantai;1;2;3;5;3;8
89;20.01.2018;2018;01;03;Lauantai;10;0;10;7;1;8
89;20.01.2018;2018;01;04;Lauantai;7;1;8;1;0;1
89;20.01.2018;2018;01;05;Lauantai;2;3;5;0;2;2
89;20.01.2018;2018;01;06;Lauantai;0;1;1;0;2;2
89;20.01.2018;2018;01;07;Lauantai;3;3;6;5;8;13
89;20.01.2018;2018;01;08;Lauantai;2;10;12;7;9;16
89;20.01.2018;2018;01;09;Lauantai;2;15;17;12;18;30
89;20.01.2018;2018;01;10;Lauantai;5;38;43;22;28;50
89;20.01.2018;2018;01;11;Lauantai;25;39;64;27;44;71
89;20.01.2018;2018;01;12;Lauantai;33;38;71;30;39;69
89;20.01.2018;2018;01;13;Lauantai;30;23;53;60;39;99
89;20.01.2018;2018;01;14;Lauantai;29;20;49;33;30;63
89;20.01.2018;2018;01;15;Lauantai;26;38;64;45;26;71
89;20.01.2018;2018;01;16;Lauantai;28;19;47;36;19;55
89;20.01.2018;2018;01;17;Lauantai;23;20;43;28;34;62
89;20.01.2018;2018;01;18;Lauantai;17;18;35;14;25;39
89;20.01.2018;2018;01;19;Lauantai;19;24;43;10;18;28
89;20.01.2018;2018;01;20;Lauantai;16;15;31;10;8;18
89;20.01.2018;2018;01;21;Lauantai;14;14;28;17;11;28
89;20.01.2018;2018;01;22;Lauantai;11;6;17;8;3;11
89;20.01.2018;2018;01;23;Lauantai;8;11;19;6;9;15
89;21.01.2018;2018;01;00;Sunnuntai;12;7;19;14;7;21
89;21.01.2018;2018;01;01;Sunnuntai;4;4;8;4;1;5
89;21.01.2018;2018;01;02;Sunnuntai;6;1;7;7;1;8
89;21.01.2018;2018;01;03;Sunnuntai;6;0;6;9;0;9
89;21.01.2018;2018;01;04;Sunnuntai;8;1;9;8;0;8
89;21.01.2018;2018;01;05;Sunnuntai;4;2;6;2;2;4
89;21.01.2018;2018;01;06;Sunnuntai;3;6;9;2;2;4
89;21.01.2018;2018;01;07;Sunnuntai;1;2;3;3;3;6
89;21.01.2018;2018;01;08;Sunnuntai;0;3;3;10;11;21
89;21.01.2018;2018;01;09;Sunnuntai;7;6;13;13;10;23
89;21.01.2018;2018;01;10;Sunnuntai;1;12;13;16;23;39
89;21.01.2018;2018;01;11;Sunnuntai;13;21;34;37;56;93
89;21.01.2018;2018;01;12;Sunnuntai;14;31;45;44;48;92
89;21.01.2018;2018;01;13;Sunnuntai;20;31;51;55;38;93
89;21.01.2018;2018;01;14;Sunnuntai;29;19;48;34;37;71
89;21.01.2018;2018;01;15;Sunnuntai;33;20;53;46;42;88
89;21.01.2018;2018;01;16;Sunnuntai;21;20;41;24;25;49
89;21.01.2018;2018;01;17;Sunnuntai;24;9;33;23;20;43
89;21.01.2018;2018;01;18;Sunnuntai;15;13;28;23;29;52
89;21.01.2018;2018;01;19;Sunnuntai;12;8;20;19;24;43
89;21.01.2018;2018;01;20;Sunnuntai;13;6;19;17;10;27
89;21.01.2018;2018;01;21;Sunnuntai;8;6;14;8;5;13
89;21.01.2018;2018;01;22;Sunnuntai;5;3;8;4;4;8
89;21.01.2018;2018;01;23;Sunnuntai;3;6;9;2;0;2
89;22.01.2018;2018;01;00;Maanantai;2;1;3;0;0;0
89;22.01.2018;2018;01;01;Maanantai;2;0;2;1;0;1
89;22.01.2018;2018;01;02;Maanantai;1;1;2;0;0;0
89;22.01.2018;2018;01;03;Maanantai;3;2;5;1;0;1
89;22.01.2018;2018;01;04;Maanantai;0;1;1;1;0;1
89;22.01.2018;2018;01;05;Maanantai;6;4;10;1;1;2
89;22.01.2018;2018;01;06;Maanantai;5;22;27;2;6;8
89;22.01.2018;2018;01;07;Maanantai;21;76;97;7;30;37
89;22.01.2018;2018;01;08;Maanantai;12;85;97;13;72;85
89;22.01.2018;2018;01;09;Maanantai;22;49;71;38;57;95
89;22.01.2018;2018;01;10;Maanantai;23;21;44;49;1;50
89;22.01.2018;2018;01;11;Maanantai;18;16;34;69;0;69
89;22.01.2018;2018;01;12;Maanantai;21;20;41;49;0;49
89;22.01.2018;2018;01;13;Maanantai;21;17;38;55;0;55
89;22.01.2018;2018;01;14;Maanantai;33;31;64;61;0;61
89;22.01.2018;2018;01;15;Maanantai;44;43;87;68;0;68
89;22.01.2018;2018;01;16;Maanantai;65;65;130;75;0;75
89;22.01.2018;2018;01;17;Maanantai;29;28;57;50;0;50
89;22.01.2018;2018;01;18;Maanantai;18;15;33;49;0;49
89;22.01.2018;2018;01;19;Maanantai;20;18;38;48;0;48
89;22.01.2018;2018;01;20;Maanantai;16;12;28;42;0;42
89;22.01.2018;2018;01;21;Maanantai;10;9;19;14;0;14
89;22.01.2018;2018;01;22;Maanantai;6;4;10;12;0;12
89;22.01.2018;2018;01;23;Maanantai;5;2;7;3;0;3
89;23.01.2018;2018;01;00;Tiistai;1;1;2;2;0;2
89;23.01.2018;2018;01;01;Tiistai;0;0;0;3;0;3
89;23.01.2018;2018;01;02;Tiistai;0;0;0;0;0;0
89;23.01.2018;2018;01;03;Tiistai;2;1;3;2;0;2
89;23.01.2018;2018;01;04;Tiistai;0;0;0;0;0;0
89;23.01.2018;2018;01;05;Tiistai;6;3;9;4;0;4
89;23.01.2018;2018;01;06;Tiistai;15;11;26;15;0;15
89;23.01.2018;2018;01;07;Tiistai;38;37;75;36;0;36
89;23.01.2018;2018;01;08;Tiistai;59;57;116;79;0;79
89;23.01.2018;2018;01;09;Tiistai;24;22;46;77;0;77
89;23.01.2018;2018;01;10;Tiistai;13;12;25;37;0;37
89;23.01.2018;2018;01;11;Tiistai;21;20;41;49;0;49
89;23.01.2018;2018;01;12;Tiistai;24;23;47;47;0;47
89;23.01.2018;2018;01;13;Tiistai;29;26;55;46;0;46
89;23.01.2018;2018;01;14;Tiistai;28;27;55;67;0;67
89;23.01.2018;2018;01;15;Tiistai;41;39;80;72;0;72
89;23.01.2018;2018;01;16;Tiistai;62;59;121;70;0;70
89;23.01.2018;2018;01;17;Tiistai;33;31;64;54;0;54
89;23.01.2018;2018;01;18;Tiistai;24;21;45;53;0;53
89;23.01.2018;2018;01;19;Tiistai;21;20;41;50;0;50
89;23.01.2018;2018;01;20;Tiistai;19;15;34;49;0;49
89;23.01.2018;2018;01;21;Tiistai;11;7;18;21;0;21
89;23.01.2018;2018;01;22;Tiistai;9;5;14;16;0;16
89;23.01.2018;2018;01;23;Tiistai;3;0;3;3;0;3
89;24.01.2018;2018;01;00;Keskiviikko;3;0;3;2;0;2
89;24.01.2018;2018;01;01;Keskiviikko;1;0;1;0;0;0
89;24.01.2018;2018;01;02;Keskiviikko;0;0;0;2;0;2
89;24.01.2018;2018;01;03;Keskiviikko;2;0;2;0;0;0
89;24.01.2018;2018;01;04;Keskiviikko;2;1;3;4;0;4
89;24.01.2018;2018;01;05;Keskiviikko;6;4;10;3;0;3
89;24.01.2018;2018;01;06;Keskiviikko;15;13;28;16;0;16
89;24.01.2018;2018;01;07;Keskiviikko;50;48;98;64;0;64
89;24.01.2018;2018;01;08;Keskiviikko;62;61;123;56;0;56
89;24.01.2018;2018;01;09;Keskiviikko;28;27;55;48;0;48
89;24.01.2018;2018;01;10;Keskiviikko;23;21;44;62;0;62
89;24.01.2018;2018;01;11;Keskiviikko;26;23;49;63;1;64
89;24.01.2018;2018;01;12;Keskiviikko;30;27;57;75;1;76
89;24.01.2018;2018;01;13;Keskiviikko;40;23;63;44;29;73
89;24.01.2018;2018;01;14;Keskiviikko;43;27;70;41;25;66
89;24.01.2018;2018;01;15;Keskiviikko;61;20;81;30;23;53
89;24.01.2018;2018;01;16;Keskiviikko;85;39;124;37;30;67
89;24.01.2018;2018;01;17;Keskiviikko;50;32;82;30;20;50
89;24.01.2018;2018;01;18;Keskiviikko;44;24;68;38;23;61
89;24.01.2018;2018;01;19;Keskiviikko;29;5;34;38;16;54
89;24.01.2018;2018;01;20;Keskiviikko;29;9;38;45;10;55
89;24.01.2018;2018;01;21;Keskiviikko;8;8;16;20;6;26
89;24.01.2018;2018;01;22;Keskiviikko;7;6;13;6;4;10
89;24.01.2018;2018;01;23;Keskiviikko;3;10;13;5;3;8
89;25.01.2018;2018;01;00;Torstai;5;2;7;1;0;1
89;25.01.2018;2018;01;01;Torstai;2;0;2;2;1;3
89;25.01.2018;2018;01;02;Torstai;0;0;0;5;4;9
89;25.01.2018;2018;01;03;Torstai;1;0;1;5;1;6
89;25.01.2018;2018;01;04;Torstai;1;0;1;2;3;5
89;25.01.2018;2018;01;05;Torstai;3;3;6;3;1;4
89;25.01.2018;2018;01;06;Torstai;14;14;28;2;10;12
89;25.01.2018;2018;01;07;Torstai;33;30;63;9;41;50
89;25.01.2018;2018;01;08;Torstai;53;50;103;5;59;64
89;25.01.2018;2018;01;09;Torstai;38;34;72;15;39;54
89;25.01.2018;2018;01;10;Torstai;32;9;41;30;15;45
89;25.01.2018;2018;01;11;Torstai;26;25;51;26;24;50
89;25.01.2018;2018;01;12;Torstai;29;31;60;47;49;96
89;25.01.2018;2018;01;13;Torstai;31;25;56;35;24;59
89;25.01.2018;2018;01;14;Torstai;44;28;72;39;15;54
89;25.01.2018;2018;01;15;Torstai;55;19;74;36;14;50
89;25.01.2018;2018;01;16;Torstai;73;22;95;42;18;60
89;25.01.2018;2018;01;17;Torstai;39;20;59;13;13;26
89;25.01.2018;2018;01;18;Torstai;22;9;31;24;21;45
89;25.01.2018;2018;01;19;Torstai;21;14;35;30;13;43
89;25.01.2018;2018;01;20;Torstai;12;9;21;19;7;26
89;25.01.2018;2018;01;21;Torstai;8;10;18;20;9;29
89;25.01.2018;2018;01;22;Torstai;8;6;14;6;6;12
89;25.01.2018;2018;01;23;Torstai;3;2;5;4;0;4
89;26.01.2018;2018;01;00;Perjantai;0;1;1;1;0;1
89;26.01.2018;2018;01;01;Perjantai;2;1;3;0;0;0
89;26.01.2018;2018;01;02;Perjantai;1;0;1;5;4;9
89;26.01.2018;2018;01;03;Perjantai;0;1;1;5;1;6
89;26.01.2018;2018;01;04;Perjantai;0;1;1;2;3;5
89;26.01.2018;2018;01;05;Perjantai;2;4;6;3;1;4
89;26.01.2018;2018;01;06;Perjantai;1;25;26;2;10;12
89;26.01.2018;2018;01;07;Perjantai;13;40;53;9;41;50
89;26.01.2018;2018;01;08;Perjantai;12;78;90;5;59;64
89;26.01.2018;2018;01;09;Perjantai;14;55;69;15;39;54
89;26.01.2018;2018;01;10;Perjantai;10;27;37;18;27;45
89;26.01.2018;2018;01;11;Perjantai;17;25;42;34;28;62
89;26.01.2018;2018;01;12;Perjantai;33;32;65;39;53;92
89;26.01.2018;2018;01;13;Perjantai;37;36;73;51;48;99
89;26.01.2018;2018;01;14;Perjantai;49;33;82;49;40;89
89;26.01.2018;2018;01;15;Perjantai;60;32;92;45;40;85
89;26.01.2018;2018;01;16;Perjantai;71;28;99;58;25;83
89;26.01.2018;2018;01;17;Perjantai;47;31;78;46;42;88
89;26.01.2018;2018;01;18;Perjantai;32;18;50;22;23;45
89;26.01.2018;2018;01;19;Perjantai;31;16;47;29;31;60
89;26.01.2018;2018;01;20;Perjantai;12;8;20;9;14;23
89;26.01.2018;2018;01;21;Perjantai;27;11;38;20;5;25
89;26.01.2018;2018;01;22;Perjantai;9;9;18;13;12;25
89;26.01.2018;2018;01;23;Perjantai;11;5;16;6;11;17
89;27.01.2018;2018;01;00;Lauantai;7;3;10;9;8;17
89;27.01.2018;2018;01;01;Lauantai;6;2;8;6;8;14
89;27.01.2018;2018;01;02;Lauantai;5;0;5;4;7;11
89;27.01.2018;2018;01;03;Lauantai;3;0;3;7;1;8
89;27.01.2018;2018;01;04;Lauantai;5;1;6;11;0;11
89;27.01.2018;2018;01;05;Lauantai;3;8;11;5;3;8
89;27.01.2018;2018;01;06;Lauantai;1;4;5;2;1;3
89;27.01.2018;2018;01;07;Lauantai;2;6;8;7;6;13
89;27.01.2018;2018;01;08;Lauantai;1;8;9;3;13;16
89;27.01.2018;2018;01;09;Lauantai;5;22;27;16;25;41
89;27.01.2018;2018;01;10;Lauantai;10;28;38;30;26;56
89;27.01.2018;2018;01;11;Lauantai;16;22;38;23;51;74
89;27.01.2018;2018;01;12;Lauantai;24;41;65;29;37;66
89;27.01.2018;2018;01;13;Lauantai;25;35;60;33;48;81
89;27.01.2018;2018;01;14;Lauantai;29;22;51;34;52;86
89;27.01.2018;2018;01;15;Lauantai;42;17;59;39;35;74
89;27.01.2018;2018;01;16;Lauantai;19;18;37;43;32;75
89;27.01.2018;2018;01;17;Lauantai;19;15;34;38;32;70
89;27.01.2018;2018;01;18;Lauantai;21;21;42;28;19;47
89;27.01.2018;2018;01;19;Lauantai;21;11;32;24;23;47
89;27.01.2018;2018;01;20;Lauantai;18;12;30;16;13;29
89;27.01.2018;2018;01;21;Lauantai;12;4;16;11;12;23
89;27.01.2018;2018;01;22;Lauantai;13;13;26;10;12;22
89;27.01.2018;2018;01;23;Lauantai;13;8;21;6;5;11
89;28.01.2018;2018;01;00;Sunnuntai;6;5;11;13;7;20
89;28.01.2018;2018;01;01;Sunnuntai;3;1;4;2;2;4
89;28.01.2018;2018;01;02;Sunnuntai;1;2;3;6;4;10
89;28.01.2018;2018;01;03;Sunnuntai;12;1;13;12;1;13
89;28.01.2018;2018;01;04;Sunnuntai;3;0;3;9;1;10
89;28.01.2018;2018;01;05;Sunnuntai;2;3;5;2;2;4
89;28.01.2018;2018;01;06;Sunnuntai;3;5;8;0;0;0
89;28.01.2018;2018;01;07;Sunnuntai;3;3;6;8;4;12
89;28.01.2018;2018;01;08;Sunnuntai;1;4;5;4;1;5
89;28.01.2018;2018;01;09;Sunnuntai;3;7;10;24;18;42
89;28.01.2018;2018;01;10;Sunnuntai;6;18;24;38;28;66
89;28.01.2018;2018;01;11;Sunnuntai;10;15;25;29;48;77
89;28.01.2018;2018;01;12;Sunnuntai;12;21;33;48;46;94
89;28.01.2018;2018;01;13;Sunnuntai;22;25;47;56;44;100
89;28.01.2018;2018;01;14;Sunnuntai;41;16;57;52;39;91
89;28.01.2018;2018;01;15;Sunnuntai;27;16;43;29;37;66
89;28.01.2018;2018;01;16;Sunnuntai;22;24;46;37;36;73
89;28.01.2018;2018;01;17;Sunnuntai;21;16;37;33;25;58
89;28.01.2018;2018;01;18;Sunnuntai;14;15;29;29;29;58
89;28.01.2018;2018;01;19;Sunnuntai;17;10;27;20;23;43
89;28.01.2018;2018;01;20;Sunnuntai;16;5;21;15;15;30
89;28.01.2018;2018;01;21;Sunnuntai;12;6;18;18;15;33
89;28.01.2018;2018;01;22;Sunnuntai;11;1;12;3;2;5
89;28.01.2018;2018;01;23;Sunnuntai;1;4;5;2;4;6
89;29.01.2018;2018;01;00;Maanantai;0;1;1;4;1;5
89;29.01.2018;2018;01;01;Maanantai;3;3;6;1;2;3
89;29.01.2018;2018;01;02;Maanantai;2;1;3;1;0;1
89;29.01.2018;2018;01;03;Maanantai;2;2;4;4;3;7
89;29.01.2018;2018;01;04;Maanantai;2;3;5;5;0;5
89;29.01.2018;2018;01;05;Maanantai;1;11;12;1;2;3
89;29.01.2018;2018;01;06;Maanantai;5;30;35;1;12;13
89;29.01.2018;2018;01;07;Maanantai;21;70;91;13;25;38
89;29.01.2018;2018;01;08;Maanantai;16;98;114;6;69;75
89;29.01.2018;2018;01;09;Maanantai;13;60;73;14;51;65
89;29.01.2018;2018;01;10;Maanantai;19;35;54;15;34;49
89;29.01.2018;2018;01;11;Maanantai;26;30;56;26;34;60
89;29.01.2018;2018;01;12;Maanantai;22;31;53;33;36;69
89;29.01.2018;2018;01;13;Maanantai;36;36;72;29;42;71
89;29.01.2018;2018;01;14;Maanantai;74;37;111;76;23;99
89;29.01.2018;2018;01;15;Maanantai;74;35;109;47;33;80
89;29.01.2018;2018;01;16;Maanantai;90;52;142;53;30;83
89;29.01.2018;2018;01;17;Maanantai;68;30;98;41;27;68
89;29.01.2018;2018;01;18;Maanantai;28;34;62;36;49;85
89;29.01.2018;2018;01;19;Maanantai;42;9;51;32;24;56
89;29.01.2018;2018;01;20;Maanantai;37;11;48;29;12;41
89;29.01.2018;2018;01;21;Maanantai;17;6;23;15;10;25
89;29.01.2018;2018;01;22;Maanantai;6;7;13;5;9;14
89;29.01.2018;2018;01;23;Maanantai;6;2;8;2;3;5
89;30.01.2018;2018;01;00;Tiistai;0;0;0;4;0;4
89;30.01.2018;2018;01;01;Tiistai;1;0;1;0;2;2
89;30.01.2018;2018;01;02;Tiistai;0;0;0;1;1;2
89;30.01.2018;2018;01;03;Tiistai;3;2;5;0;0;0
89;30.01.2018;2018;01;04;Tiistai;1;2;3;0;0;0
89;30.01.2018;2018;01;05;Tiistai;0;5;5;1;0;1
89;30.01.2018;2018;01;06;Tiistai;4;37;41;4;6;10
89;30.01.2018;2018;01;07;Tiistai;18;75;93;11;25;36
89;30.01.2018;2018;01;08;Tiistai;22;97;119;17;80;97
89;30.01.2018;2018;01;09;Tiistai;24;50;74;15;38;53
89;30.01.2018;2018;01;10;Tiistai;19;29;48;16;29;45
89;30.01.2018;2018;01;11;Tiistai;23;39;62;14;20;34
89;30.01.2018;2018;01;12;Tiistai;33;30;63;24;35;59
89;30.01.2018;2018;01;13;Tiistai;29;38;67;40;33;73
89;30.01.2018;2018;01;14;Tiistai;66;31;97;51;26;77
89;30.01.2018;2018;01;15;Tiistai;69;35;104;63;46;109
89;30.01.2018;2018;01;16;Tiistai;98;38;136;53;21;74
89;30.01.2018;2018;01;17;Tiistai;68;31;99;34;37;71
89;30.01.2018;2018;01;18;Tiistai;42;24;66;40;27;67
89;30.01.2018;2018;01;19;Tiistai;44;7;51;50;27;77
89;30.01.2018;2018;01;20;Tiistai;26;3;29;23;17;40
89;30.01.2018;2018;01;21;Tiistai;24;5;29;29;10;39
89;30.01.2018;2018;01;22;Tiistai;6;3;9;5;7;12
89;30.01.2018;2018;01;23;Tiistai;1;2;3;3;4;7
89;31.01.2018;2018;01;00;Keskiviikko;3;2;5;2;2;4
89;31.01.2018;2018;01;01;Keskiviikko;1;0;1;0;0;0
89;31.01.2018;2018;01;02;Keskiviikko;0;3;3;1;2;3
89;31.01.2018;2018;01;03;Keskiviikko;0;2;2;0;0;0
89;31.01.2018;2018;01;04;Keskiviikko;1;3;4;1;0;1
89;31.01.2018;2018;01;05;Keskiviikko;2;4;6;1;3;4
89;31.01.2018;2018;01;06;Keskiviikko;3;25;28;2;7;9
89;31.01.2018;2018;01;07;Keskiviikko;22;82;104;8;53;61
89;31.01.2018;2018;01;08;Keskiviikko;19;103;122;12;53;65
89;31.01.2018;2018;01;09;Keskiviikko;21;57;78;17;49;66
89;31.01.2018;2018;01;10;Keskiviikko;28;33;61;18;50;68
89;31.01.2018;2018;01;11;Keskiviikko;26;32;58;36;50;86
89;31.01.2018;2018;01;12;Keskiviikko;43;49;92;45;41;86
89;31.01.2018;2018;01;13;Keskiviikko;28;41;69;62;48;110
89;31.01.2018;2018;01;14;Keskiviikko;59;41;100;68;36;104
89;31.01.2018;2018;01;15;Keskiviikko;86;25;111;42;26;68
89;31.01.2018;2018;01;16;Keskiviikko;87;54;141;52;37;89
89;31.01.2018;2018;01;17;Keskiviikko;56;44;100;47;33;80
89;31.01.2018;2018;01;18;Keskiviikko;42;23;65;41;28;69
89;31.01.2018;2018;01;19;Keskiviikko;68;7;75;33;20;53
89;31.01.2018;2018;01;20;Keskiviikko;25;14;39;34;12;46
89;31.01.2018;2018;01;21;Keskiviikko;21;5;26;17;9;26
89;31.01.2018;2018;01;22;Keskiviikko;6;8;14;6;3;9
89;31.01.2018;2018;01;23;Keskiviikko;4;1;5;1;0;1
89;01.02.2018;2018;02;00;Torstai;3;1;4;3;1;4
89;01.02.2018;2018;02;01;Torstai;4;0;4;3;0;3
89;01.02.2018;2018;02;02;Torstai;1;2;3;3;1;4
89;01.02.2018;2018;02;03;Torstai;2;4;6;2;0;2
89;01.02.2018;2018;02;04;Torstai;3;2;5;1;0;1
89;01.02.2018;2018;02;05;Torstai;1;5;6;1;2;3
89;01.02.2018;2018;02;06;Torstai;6;30;36;7;6;13
89;01.02.2018;2018;02;07;Torstai;17;60;77;10;42;52
89;01.02.2018;2018;02;08;Torstai;17;86;103;7;59;66
89;01.02.2018;2018;02;09;Torstai;11;55;66;10;37;47
89;01.02.2018;2018;02;10;Torstai;18;20;38;10;31;41
89;01.02.2018;2018;02;11;Torstai;25;43;68;15;23;38
89;01.02.2018;2018;02;12;Torstai;22;27;49;25;38;63
89;01.02.2018;2018;02;13;Torstai;38;21;59;35;29;64
89;01.02.2018;2018;02;14;Torstai;56;43;99;52;48;100
89;01.02.2018;2018;02;15;Torstai;72;24;96;44;29;73
89;01.02.2018;2018;02;16;Torstai;66;49;115;50;26;76
89;01.02.2018;2018;02;17;Torstai;42;15;57;27;24;51
89;01.02.2018;2018;02;18;Torstai;30;22;52;34;13;47
89;01.02.2018;2018;02;19;Torstai;26;10;36;22;21;43
89;01.02.2018;2018;02;20;Torstai;17;9;26;27;5;32
89;01.02.2018;2018;02;21;Torstai;19;5;24;17;11;28
89;01.02.2018;2018;02;22;Torstai;8;3;11;4;4;8
89;01.02.2018;2018;02;23;Torstai;1;4;5;2;0;2
89;02.02.2018;2018;02;00;Perjantai;1;1;2;0;0;0
89;02.02.2018;2018;02;01;Perjantai;0;0;0;1;2;3
89;02.02.2018;2018;02;02;Perjantai;1;0;1;2;0;2
89;02.02.2018;2018;02;03;Perjantai;5;4;9;0;0;0
89;02.02.2018;2018;02;04;Perjantai;0;2;2;2;0;2
89;02.02.2018;2018;02;05;Perjantai;4;8;12;2;0;2
89;02.02.2018;2018;02;06;Perjantai;2;14;16;3;7;10
89;02.02.2018;2018;02;07;Perjantai;12;53;65;7;45;52
89;02.02.2018;2018;02;08;Perjantai;8;81;89;14;66;80
89;02.02.2018;2018;02;09;Perjantai;11;42;53;3;47;50
89;02.02.2018;2018;02;10;Perjantai;12;29;41;11;30;41
89;02.02.2018;2018;02;11;Perjantai;23;28;51;19;27;46
89;02.02.2018;2018;02;12;Perjantai;24;23;47;29;31;60
89;02.02.2018;2018;02;13;Perjantai;26;25;51;37;30;67
89;02.02.2018;2018;02;14;Perjantai;48;21;69;47;22;69
89;02.02.2018;2018;02;15;Perjantai;68;29;97;48;32;80
89;02.02.2018;2018;02;16;Perjantai;70;31;101;33;16;49
89;02.02.2018;2018;02;17;Perjantai;39;25;64;31;23;54
89;02.02.2018;2018;02;18;Perjantai;25;11;36;36;14;50
89;02.02.2018;2018;02;19;Perjantai;26;18;44;17;19;36
89;02.02.2018;2018;02;20;Perjantai;19;13;32;13;5;18
89;02.02.2018;2018;02;21;Perjantai;17;9;26;15;15;30
89;02.02.2018;2018;02;22;Perjantai;9;11;20;9;3;12
89;02.02.2018;2018;02;23;Perjantai;7;5;12;5;4;9
89;03.02.2018;2018;02;00;Lauantai;3;2;5;6;4;10
89;03.02.2018;2018;02;01;Lauantai;6;3;9;4;0;4
89;03.02.2018;2018;02;02;Lauantai;4;1;5;5;1;6
89;03.02.2018;2018;02;03;Lauantai;3;1;4;0;0;0
89;03.02.2018;2018;02;04;Lauantai;4;2;6;2;1;3
89;03.02.2018;2018;02;05;Lauantai;1;6;7;3;1;4
89;03.02.2018;2018;02;06;Lauantai;0;3;3;2;1;3
89;03.02.2018;2018;02;07;Lauantai;3;6;9;3;5;8
89;03.02.2018;2018;02;08;Lauantai;3;15;18;7;12;19
89;03.02.2018;2018;02;09;Lauantai;2;20;22;6;22;28
89;03.02.2018;2018;02;10;Lauantai;9;19;28;14;25;39
89;03.02.2018;2018;02;11;Lauantai;5;23;28;22;30;52
89;03.02.2018;2018;02;12;Lauantai;15;16;31;39;63;102
89;03.02.2018;2018;02;13;Lauantai;18;28;46;48;57;105
89;03.02.2018;2018;02;14;Lauantai;26;25;51;62;39;101
89;03.02.2018;2018;02;15;Lauantai;29;16;45;46;28;74
89;03.02.2018;2018;02;16;Lauantai;17;10;27;31;24;55
89;03.02.2018;2018;02;17;Lauantai;21;12;33;28;22;50
89;03.02.2018;2018;02;18;Lauantai;19;8;27;17;16;33
89;03.02.2018;2018;02;19;Lauantai;8;9;17;20;19;39
89;03.02.2018;2018;02;20;Lauantai;17;12;29;9;7;16
89;03.02.2018;2018;02;21;Lauantai;13;10;23;9;12;21
89;03.02.2018;2018;02;22;Lauantai;5;6;11;6;7;13
89;03.02.2018;2018;02;23;Lauantai;5;6;11;6;3;9
89;04.02.2018;2018;02;00;Sunnuntai;14;3;17;2;5;7
89;04.02.2018;2018;02;01;Sunnuntai;3;2;5;2;4;6
89;04.02.2018;2018;02;02;Sunnuntai;6;2;8;6;1;7
89;04.02.2018;2018;02;03;Sunnuntai;4;0;4;1;0;1
89;04.02.2018;2018;02;04;Sunnuntai;3;2;5;8;3;11
89;04.02.2018;2018;02;05;Sunnuntai;1;2;3;2;2;4
89;04.02.2018;2018;02;06;Sunnuntai;0;6;6;1;1;2
89;04.02.2018;2018;02;07;Sunnuntai;2;3;5;0;1;1
89;04.02.2018;2018;02;08;Sunnuntai;1;2;3;5;5;10
89;04.02.2018;2018;02;09;Sunnuntai;2;2;4;9;17;26
89;04.02.2018;2018;02;10;Sunnuntai;4;10;14;12;22;34
89;04.02.2018;2018;02;11;Sunnuntai;5;17;22;21;24;45
89;04.02.2018;2018;02;12;Sunnuntai;11;6;17;17;31;48
89;04.02.2018;2018;02;13;Sunnuntai;15;13;28;35;38;73
89;04.02.2018;2018;02;14;Sunnuntai;14;18;32;49;42;91
89;04.02.2018;2018;02;15;Sunnuntai;15;10;25;38;26;64
89;04.02.2018;2018;02;16;Sunnuntai;16;10;26;33;34;67
89;04.02.2018;2018;02;17;Sunnuntai;13;3;16;19;12;31
89;04.02.2018;2018;02;18;Sunnuntai;7;4;11;14;11;25
89;04.02.2018;2018;02;19;Sunnuntai;9;3;12;5;8;13
89;04.02.2018;2018;02;20;Sunnuntai;5;5;10;9;9;18
89;04.02.2018;2018;02;21;Sunnuntai;4;7;11;8;5;13
89;04.02.2018;2018;02;22;Sunnuntai;5;3;8;1;4;5
89;04.02.2018;2018;02;23;Sunnuntai;2;1;3;3;3;6
89;05.02.2018;2018;02;00;Maanantai;1;1;2;1;0;1
89;05.02.2018;2018;02;01;Maanantai;0;1;1;3;2;5
89;05.02.2018;2018;02;02;Maanantai;1;1;2;2;0;2
89;05.02.2018;2018;02;03;Maanantai;1;2;3;0;0;0
89;05.02.2018;2018;02;04;Maanantai;1;1;2;1;1;2
89;05.02.2018;2018;02;05;Maanantai;2;7;9;2;1;3
89;05.02.2018;2018;02;06;Maanantai;3;19;22;5;9;14
89;05.02.2018;2018;02;07;Maanantai;11;54;65;8;32;40
89;05.02.2018;2018;02;08;Maanantai;15;76;91;7;57;64
89;05.02.2018;2018;02;09;Maanantai;9;28;37;10;41;51
89;05.02.2018;2018;02;10;Maanantai;7;21;28;13;21;34
89;05.02.2018;2018;02;11;Maanantai;13;22;35;15;25;40
89;05.02.2018;2018;02;12;Maanantai;16;16;32;22;26;48
89;05.02.2018;2018;02;13;Maanantai;21;23;44;30;28;58
89;05.02.2018;2018;02;14;Maanantai;44;29;73;47;20;67
89;05.02.2018;2018;02;15;Maanantai;59;15;74;37;22;59
89;05.02.2018;2018;02;16;Maanantai;58;45;103;44;24;68
89;05.02.2018;2018;02;17;Maanantai;33;19;52;29;12;41
89;05.02.2018;2018;02;18;Maanantai;31;18;49;32;16;48
89;05.02.2018;2018;02;19;Maanantai;26;11;37;25;16;41
89;05.02.2018;2018;02;20;Maanantai;15;12;27;23;6;29
89;05.02.2018;2018;02;21;Maanantai;13;1;14;16;8;24
89;05.02.2018;2018;02;22;Maanantai;6;5;11;10;2;12
89;05.02.2018;2018;02;23;Maanantai;3;3;6;1;2;3
89;06.02.2018;2018;02;00;Tiistai;2;0;2;0;0;0
89;06.02.2018;2018;02;01;Tiistai;1;0;1;0;2;2
89;06.02.2018;2018;02;02;Tiistai;0;0;0;2;0;2
89;06.02.2018;2018;02;03;Tiistai;0;2;2;1;1;2
89;06.02.2018;2018;02;04;Tiistai;0;0;0;1;0;1
89;06.02.2018;2018;02;05;Tiistai;0;5;5;2;1;3
89;06.02.2018;2018;02;06;Tiistai;6;28;34;3;10;13
89;06.02.2018;2018;02;07;Tiistai;13;51;64;8;35;43
89;06.02.2018;2018;02;08;Tiistai;13;92;105;3;60;63
89;06.02.2018;2018;02;09;Tiistai;14;38;52;8;39;47
89;06.02.2018;2018;02;10;Tiistai;13;23;36;11;34;45
89;06.02.2018;2018;02;11;Tiistai;20;27;47;16;29;45
89;06.02.2018;2018;02;12;Tiistai;28;19;47;33;27;60
89;06.02.2018;2018;02;13;Tiistai;31;26;57;34;22;56
89;06.02.2018;2018;02;14;Tiistai;34;30;64;30;17;47
89;06.02.2018;2018;02;15;Tiistai;57;35;92;25;23;48
89;06.02.2018;2018;02;16;Tiistai;88;40;128;46;20;66
89;06.02.2018;2018;02;17;Tiistai;40;21;61;39;28;67
89;06.02.2018;2018;02;18;Tiistai;33;14;47;47;33;80
89;06.02.2018;2018;02;19;Tiistai;31;12;43;35;22;57
89;06.02.2018;2018;02;20;Tiistai;16;12;28;29;10;39
89;06.02.2018;2018;02;21;Tiistai;14;4;18;17;5;22
89;06.02.2018;2018;02;22;Tiistai;8;5;13;5;4;9
89;06.02.2018;2018;02;23;Tiistai;3;1;4;2;2;4
89;07.02.2018;2018;02;00;Keskiviikko;3;1;4;1;0;1
89;07.02.2018;2018;02;01;Keskiviikko;1;0;1;1;2;3
89;07.02.2018;2018;02;02;Keskiviikko;1;0;1;0;0;0
89;07.02.2018;2018;02;03;Keskiviikko;3;1;4;3;4;7
89;07.02.2018;2018;02;04;Keskiviikko;0;1;1;1;0;1
89;07.02.2018;2018;02;05;Keskiviikko;2;12;14;1;4;5
89;07.02.2018;2018;02;06;Keskiviikko;3;29;32;5;11;16
89;07.02.2018;2018;02;07;Keskiviikko;18;55;73;13;46;59
89;07.02.2018;2018;02;08;Keskiviikko;12;89;101;12;56;68
89;07.02.2018;2018;02;09;Keskiviikko;10;39;49;11;37;48
89;07.02.2018;2018;02;10;Keskiviikko;11;30;41;20;43;63
89;07.02.2018;2018;02;11;Keskiviikko;12;24;36;26;37;63
89;07.02.2018;2018;02;12;Keskiviikko;35;31;66;37;38;75
89;07.02.2018;2018;02;13;Keskiviikko;34;24;58;45;22;67
89;07.02.2018;2018;02;14;Keskiviikko;36;29;65;37;22;59
89;07.02.2018;2018;02;15;Keskiviikko;65;36;101;42;20;62
89;07.02.2018;2018;02;16;Keskiviikko;88;44;132;46;23;69
89;07.02.2018;2018;02;17;Keskiviikko;46;23;69;36;16;52
89;07.02.2018;2018;02;18;Keskiviikko;28;20;48;39;16;55
89;07.02.2018;2018;02;19;Keskiviikko;44;15;59;32;23;55
89;07.02.2018;2018;02;20;Keskiviikko;19;12;31;30;19;49
89;07.02.2018;2018;02;21;Keskiviikko;18;8;26;13;9;22
89;07.02.2018;2018;02;22;Keskiviikko;6;8;14;5;4;9
89;07.02.2018;2018;02;23;Keskiviikko;2;1;3;8;2;10
89;08.02.2018;2018;02;00;Torstai;0;2;2;5;7;12
89;08.02.2018;2018;02;01;Torstai;1;0;1;4;0;4
89;08.02.2018;2018;02;02;Torstai;4;1;5;6;1;7
89;08.02.2018;2018;02;03;Torstai;2;2;4;3;1;4
89;08.02.2018;2018;02;04;Torstai;4;2;6;1;0;1
89;08.02.2018;2018;02;05;Torstai;0;3;3;1;2;3
89;08.02.2018;2018;02;06;Torstai;4;20;24;7;12;19
89;08.02.2018;2018;02;07;Torstai;15;62;77;12;41;53
89;08.02.2018;2018;02;08;Torstai;20;77;97;9;61;70
89;08.02.2018;2018;02;09;Torstai;9;55;64;14;30;44
89;08.02.2018;2018;02;10;Torstai;8;33;41;14;32;46
89;08.02.2018;2018;02;11;Torstai;12;38;50;18;32;50
89;08.02.2018;2018;02;12;Torstai;22;34;56;34;29;63
89;08.02.2018;2018;02;13;Torstai;23;31;54;41;21;62
89;08.02.2018;2018;02;14;Torstai;47;21;68;44;30;74
89;08.02.2018;2018;02;15;Torstai;67;32;99;55;27;82
89;08.02.2018;2018;02;16;Torstai;82;48;130;44;17;61
89;08.02.2018;2018;02;17;Torstai;38;26;64;41;22;63
89;08.02.2018;2018;02;18;Torstai;38;23;61;46;22;68
89;08.02.2018;2018;02;19;Torstai;21;11;32;43;25;68
89;08.02.2018;2018;02;20;Torstai;29;11;40;32;18;50
89;08.02.2018;2018;02;21;Torstai;25;11;36;21;7;28
89;08.02.2018;2018;02;22;Torstai;13;10;23;7;3;10
89;08.02.2018;2018;02;23;Torstai;5;3;8;3;0;3
89;09.02.2018;2018;02;00;Perjantai;2;1;3;3;0;3
89;09.02.2018;2018;02;01;Perjantai;7;2;9;1;0;1
89;09.02.2018;2018;02;02;Perjantai;7;0;7;4;1;5
89;09.02.2018;2018;02;03;Perjantai;2;4;6;3;2;5
89;09.02.2018;2018;02;04;Perjantai;0;1;1;1;0;1
89;09.02.2018;2018;02;05;Perjantai;1;5;6;3;1;4
89;09.02.2018;2018;02;06;Perjantai;6;19;25;4;12;16
89;09.02.2018;2018;02;07;Perjantai;17;64;81;7;34;41
89;09.02.2018;2018;02;08;Perjantai;14;76;90;10;52;62
89;09.02.2018;2018;02;09;Perjantai;11;53;64;11;50;61
89;09.02.2018;2018;02;10;Perjantai;20;30;50;20;38;58
89;09.02.2018;2018;02;11;Perjantai;30;28;58;26;27;53
89;09.02.2018;2018;02;12;Perjantai;21;36;57;32;38;70
89;09.02.2018;2018;02;13;Perjantai;41;31;72;43;26;69
89;09.02.2018;2018;02;14;Perjantai;62;31;93;41;26;67
89;09.02.2018;2018;02;15;Perjantai;83;34;117;46;23;69
89;09.02.2018;2018;02;16;Perjantai;67;50;117;36;31;67
89;09.02.2018;2018;02;17;Perjantai;37;25;62;45;40;85
89;09.02.2018;2018;02;18;Perjantai;29;31;60;27;17;44
89;09.02.2018;2018;02;19;Perjantai;21;13;34;41;20;61
89;09.02.2018;2018;02;20;Perjantai;13;14;27;15;8;23
89;09.02.2018;2018;02;21;Perjantai;15;15;30;14;10;24
89;09.02.2018;2018;02;22;Perjantai;13;9;22;9;12;21
89;09.02.2018;2018;02;23;Perjantai;13;6;19;8;14;22
89;10.02.2018;2018;02;00;Lauantai;10;6;16;11;5;16
89;10.02.2018;2018;02;01;Lauantai;7;6;13;5;3;8
89;10.02.2018;2018;02;02;Lauantai;5;1;6;6;2;8
89;10.02.2018;2018;02;03;Lauantai;5;0;5;10;1;11
89;10.02.2018;2018;02;04;Lauantai;7;2;9;15;0;15
89;10.02.2018;2018;02;05;Lauantai;2;2;4;2;2;4
89;10.02.2018;2018;02;06;Lauantai;1;3;4;5;5;10
89;10.02.2018;2018;02;07;Lauantai;2;7;9;5;12;17
89;10.02.2018;2018;02;08;Lauantai;6;14;20;6;7;13
89;10.02.2018;2018;02;09;Lauantai;6;27;33;9;23;32
89;10.02.2018;2018;02;10;Lauantai;13;20;33;33;38;71
89;10.02.2018;2018;02;11;Lauantai;15;21;36;71;42;113
89;10.02.2018;2018;02;12;Lauantai;27;45;72;42;56;98
89;10.02.2018;2018;02;13;Lauantai;29;30;59;46;37;83
89;10.02.2018;2018;02;14;Lauantai;19;27;46;36;33;69
89;10.02.2018;2018;02;15;Lauantai;28;26;54;34;22;56
89;10.02.2018;2018;02;16;Lauantai;29;14;43;37;27;64
89;10.02.2018;2018;02;17;Lauantai;30;16;46;32;30;62
89;10.02.2018;2018;02;18;Lauantai;20;11;31;35;15;50
89;10.02.2018;2018;02;19;Lauantai;16;11;27;28;26;54
89;10.02.2018;2018;02;20;Lauantai;16;6;22;10;14;24
89;10.02.2018;2018;02;21;Lauantai;11;16;27;14;13;27
89;10.02.2018;2018;02;22;Lauantai;13;12;25;8;13;21
89;10.02.2018;2018;02;23;Lauantai;8;6;14;5;7;12
89;11.02.2018;2018;02;00;Sunnuntai;5;7;12;1;3;4
89;11.02.2018;2018;02;01;Sunnuntai;5;2;7;5;3;8
89;11.02.2018;2018;02;02;Sunnuntai;8;2;10;4;4;8
89;11.02.2018;2018;02;03;Sunnuntai;7;2;9;6;0;6
89;11.02.2018;2018;02;04;Sunnuntai;10;1;11;6;0;6
89;11.02.2018;2018;02;05;Sunnuntai;1;3;4;1;0;1
89;11.02.2018;2018;02;06;Sunnuntai;1;1;2;0;2;2
89;11.02.2018;2018;02;07;Sunnuntai;1;4;5;6;6;12
89;11.02.2018;2018;02;08;Sunnuntai;0;6;6;6;12;18
89;11.02.2018;2018;02;09;Sunnuntai;2;11;13;7;3;10
89;11.02.2018;2018;02;10;Sunnuntai;4;12;16;17;31;48
89;11.02.2018;2018;02;11;Sunnuntai;9;8;17;37;49;86
89;11.02.2018;2018;02;12;Sunnuntai;14;23;37;32;51;83
89;11.02.2018;2018;02;13;Sunnuntai;17;24;41;38;40;78
89;11.02.2018;2018;02;14;Sunnuntai;15;25;40;41;36;77
89;11.02.2018;2018;02;15;Sunnuntai;26;16;42;32;40;72
89;11.02.2018;2018;02;16;Sunnuntai;26;10;36;35;28;63
89;11.02.2018;2018;02;17;Sunnuntai;17;15;32;48;54;102
89;11.02.2018;2018;02;18;Sunnuntai;13;8;21;26;21;47
89;11.02.2018;2018;02;19;Sunnuntai;8;5;13;26;15;41
89;11.02.2018;2018;02;20;Sunnuntai;11;13;24;9;13;22
89;11.02.2018;2018;02;21;Sunnuntai;5;2;7;20;10;30
89;11.02.2018;2018;02;22;Sunnuntai;2;4;6;5;6;11
89;11.02.2018;2018;02;23;Sunnuntai;5;0;5;4;1;5
89;12.02.2018;2018;02;00;Maanantai;3;1;4;2;0;2
89;12.02.2018;2018;02;01;Maanantai;1;0;1;2;2;4
89;12.02.2018;2018;02;02;Maanantai;1;2;3;0;2;2
89;12.02.2018;2018;02;03;Maanantai;4;2;6;2;0;2
89;12.02.2018;2018;02;04;Maanantai;2;2;4;0;0;0
89;12.02.2018;2018;02;05;Maanantai;1;9;10;1;3;4
89;12.02.2018;2018;02;06;Maanantai;4;31;35;2;11;13
89;12.02.2018;2018;02;07;Maanantai;19;67;86;13;39;52
89;12.02.2018;2018;02;08;Maanantai;21;101;122;4;61;65
89;12.02.2018;2018;02;09;Maanantai;12;54;66;16;40;56
89;12.02.2018;2018;02;10;Maanantai;18;20;38;15;35;50
89;12.02.2018;2018;02;11;Maanantai;19;32;51;30;27;57
89;12.02.2018;2018;02;12;Maanantai;25;21;46;24;35;59
89;12.02.2018;2018;02;13;Maanantai;24;30;54;36;34;70
89;12.02.2018;2018;02;14;Maanantai;54;25;79;56;19;75
89;12.02.2018;2018;02;15;Maanantai;84;17;101;56;26;82
89;12.02.2018;2018;02;16;Maanantai;85;33;118;54;37;91
89;12.02.2018;2018;02;17;Maanantai;49;38;87;44;26;70
89;12.02.2018;2018;02;18;Maanantai;41;19;60;41;33;74
89;12.02.2018;2018;02;19;Maanantai;32;12;44;33;25;58
89;12.02.2018;2018;02;20;Maanantai;18;15;33;32;19;51
89;12.02.2018;2018;02;21;Maanantai;22;5;27;18;6;24
89;12.02.2018;2018;02;22;Maanantai;4;7;11;10;11;21
89;12.02.2018;2018;02;23;Maanantai;0;3;3;2;0;2
89;13.02.2018;2018;02;00;Tiistai;2;1;3;3;2;5
89;13.02.2018;2018;02;01;Tiistai;0;0;0;3;0;3
89;13.02.2018;2018;02;02;Tiistai;1;1;2;0;0;0
89;13.02.2018;2018;02;03;Tiistai;1;2;3;1;1;2
89;13.02.2018;2018;02;04;Tiistai;1;1;2;2;0;2
89;13.02.2018;2018;02;05;Tiistai;0;6;6;2;1;3
89;13.02.2018;2018;02;06;Tiistai;7;33;40;2;16;18
89;13.02.2018;2018;02;07;Tiistai;21;67;88;11;42;53
89;13.02.2018;2018;02;08;Tiistai;13;107;120;9;70;79
89;13.02.2018;2018;02;09;Tiistai;20;46;66;20;42;62
89;13.02.2018;2018;02;10;Tiistai;18;31;49;16;35;51
89;13.02.2018;2018;02;11;Tiistai;23;28;51;23;36;59
89;13.02.2018;2018;02;12;Tiistai;30;47;77;28;42;70
89;13.02.2018;2018;02;13;Tiistai;36;36;72;33;20;53
89;13.02.2018;2018;02;14;Tiistai;61;28;89;52;31;83
89;13.02.2018;2018;02;15;Tiistai;71;23;94;41;28;69
89;13.02.2018;2018;02;16;Tiistai;89;42;131;59;21;80
89;13.02.2018;2018;02;17;Tiistai;64;29;93;48;25;73
89;13.02.2018;2018;02;18;Tiistai;37;32;69;35;35;70
89;13.02.2018;2018;02;19;Tiistai;35;14;49;44;33;77
89;13.02.2018;2018;02;20;Tiistai;27;13;40;23;13;36
89;13.02.2018;2018;02;21;Tiistai;15;8;23;20;5;25
89;13.02.2018;2018;02;22;Tiistai;6;13;19;4;7;11
89;13.02.2018;2018;02;23;Tiistai;6;2;8;2;4;6
89;14.02.2018;2018;02;00;Keskiviikko;4;0;4;1;0;1
89;14.02.2018;2018;02;01;Keskiviikko;1;0;1;3;0;3
89;14.02.2018;2018;02;02;Keskiviikko;1;0;1;0;0;0
89;14.02.2018;2018;02;03;Keskiviikko;4;0;4;7;0;7
89;14.02.2018;2018;02;04;Keskiviikko;1;0;1;1;0;1
89;14.02.2018;2018;02;05;Keskiviikko;14;0;14;5;0;5
89;14.02.2018;2018;02;06;Keskiviikko;32;0;32;16;0;16
89;14.02.2018;2018;02;07;Keskiviikko;73;0;73;59;0;59
89;14.02.2018;2018;02;08;Keskiviikko;101;0;101;68;0;68
89;14.02.2018;2018;02;09;Keskiviikko;49;0;49;48;0;48
89;14.02.2018;2018;02;10;Keskiviikko;41;0;41;63;0;63
89;14.02.2018;2018;02;11;Keskiviikko;36;0;36;63;0;63
89;14.02.2018;2018;02;12;Keskiviikko;66;0;66;75;0;75
89;14.02.2018;2018;02;13;Keskiviikko;58;0;58;67;0;67
89;14.02.2018;2018;02;14;Keskiviikko;65;0;65;59;0;59
89;14.02.2018;2018;02;15;Keskiviikko;101;0;101;62;0;62
89;14.02.2018;2018;02;16;Keskiviikko;132;0;132;69;0;69
89;14.02.2018;2018;02;17;Keskiviikko;69;0;69;52;0;52
89;14.02.2018;2018;02;18;Keskiviikko;48;0;48;55;0;55
89;14.02.2018;2018;02;19;Keskiviikko;59;0;59;55;0;55
89;14.02.2018;2018;02;20;Keskiviikko;31;0;31;49;0;49
89;14.02.2018;2018;02;21;Keskiviikko;26;0;26;22;0;22
89;14.02.2018;2018;02;22;Keskiviikko;14;0;14;9;0;9
89;14.02.2018;2018;02;23;Keskiviikko;3;0;3;10;0;10
89;15.02.2018;2018;02;00;Torstai;2;0;2;12;0;12
89;15.02.2018;2018;02;01;Torstai;1;0;1;4;0;4
89;15.02.2018;2018;02;02;Torstai;5;0;5;7;0;7
89;15.02.2018;2018;02;03;Torstai;4;0;4;4;0;4
89;15.02.2018;2018;02;04;Torstai;6;0;6;1;0;1
89;15.02.2018;2018;02;05;Torstai;3;0;3;3;0;3
89;15.02.2018;2018;02;06;Torstai;24;0;24;19;0;19
89;15.02.2018;2018;02;07;Torstai;77;0;77;53;0;53
89;15.02.2018;2018;02;08;Torstai;97;0;97;70;0;70
89;15.02.2018;2018;02;09;Torstai;64;0;64;44;0;44
89;15.02.2018;2018;02;10;Torstai;41;0;41;46;0;46
89;15.02.2018;2018;02;11;Torstai;50;0;50;50;0;50
89;15.02.2018;2018;02;12;Torstai;56;0;56;63;0;63
89;15.02.2018;2018;02;13;Torstai;54;0;54;62;0;62
89;15.02.2018;2018;02;14;Torstai;68;0;68;74;0;74
89;15.02.2018;2018;02;15;Torstai;99;0;99;82;0;82
89;15.02.2018;2018;02;16;Torstai;130;0;130;61;0;61
89;15.02.2018;2018;02;17;Torstai;64;0;64;63;0;63
89;15.02.2018;2018;02;18;Torstai;61;0;61;68;0;68
89;15.02.2018;2018;02;19;Torstai;32;0;32;68;0;68
89;15.02.2018;2018;02;20;Torstai;40;0;40;50;0;50
89;15.02.2018;2018;02;21;Torstai;36;0;36;28;0;28
89;15.02.2018;2018;02;22;Torstai;23;0;23;10;0;10
89;15.02.2018;2018;02;23;Torstai;8;0;8;3;0;3
89;16.02.2018;2018;02;00;Perjantai;4;1;5;2;2;4
89;16.02.2018;2018;02;01;Perjantai;2;2;4;2;2;4
89;16.02.2018;2018;02;02;Perjantai;3;4;7;3;9;12
89;16.02.2018;2018;02;03;Perjantai;2;3;5;5;0;5
89;16.02.2018;2018;02;04;Perjantai;2;3;5;1;0;1
89;16.02.2018;2018;02;05;Perjantai;2;6;8;1;2;3
89;16.02.2018;2018;02;06;Perjantai;7;29;36;3;13;16
89;16.02.2018;2018;02;07;Perjantai;14;65;79;15;24;39
89;16.02.2018;2018;02;08;Perjantai;19;86;105;7;47;54
89;16.02.2018;2018;02;09;Perjantai;13;40;53;8;44;52
89;16.02.2018;2018;02;10;Perjantai;14;25;39;11;29;40
89;16.02.2018;2018;02;11;Perjantai;24;28;52;31;22;53
89;16.02.2018;2018;02;12;Perjantai;18;49;67;33;44;77
89;16.02.2018;2018;02;13;Perjantai;47;31;78;29;24;53
89;16.02.2018;2018;02;14;Perjantai;57;41;98;42;39;81
89;16.02.2018;2018;02;15;Perjantai;74;39;113;43;23;66
89;16.02.2018;2018;02;16;Perjantai;75;39;114;37;32;69
89;16.02.2018;2018;02;17;Perjantai;60;31;91;26;32;58
89;16.02.2018;2018;02;18;Perjantai;36;20;56;32;31;63
89;16.02.2018;2018;02;19;Perjantai;26;21;47;45;38;83
89;16.02.2018;2018;02;20;Perjantai;20;9;29;20;18;38
89;16.02.2018;2018;02;21;Perjantai;17;11;28;21;15;36
89;16.02.2018;2018;02;22;Perjantai;10;8;18;13;13;26
89;16.02.2018;2018;02;23;Perjantai;5;8;13;8;4;12
89;17.02.2018;2018;02;00;Lauantai;7;2;9;6;1;7
89;17.02.2018;2018;02;01;Lauantai;8;4;12;3;4;7
89;17.02.2018;2018;02;02;Lauantai;3;3;6;1;4;5
89;17.02.2018;2018;02;03;Lauantai;6;2;8;5;0;5
89;17.02.2018;2018;02;04;Lauantai;5;0;5;5;0;5
89;17.02.2018;2018;02;05;Lauantai;1;7;8;2;1;3
89;17.02.2018;2018;02;06;Lauantai;1;3;4;1;1;2
89;17.02.2018;2018;02;07;Lauantai;2;7;9;5;10;15
89;17.02.2018;2018;02;08;Lauantai;1;9;10;10;13;23
89;17.02.2018;2018;02;09;Lauantai;3;21;24;16;22;38
89;17.02.2018;2018;02;10;Lauantai;7;26;33;17;35;52
89;17.02.2018;2018;02;11;Lauantai;8;24;32;22;52;74
89;17.02.2018;2018;02;12;Lauantai;15;18;33;21;48;69
89;17.02.2018;2018;02;13;Lauantai;23;38;61;40;37;77
89;17.02.2018;2018;02;14;Lauantai;22;24;46;45;36;81
89;17.02.2018;2018;02;15;Lauantai;40;15;55;47;38;85
89;17.02.2018;2018;02;16;Lauantai;24;13;37;54;40;94
89;17.02.2018;2018;02;17;Lauantai;22;22;44;35;21;56
89;17.02.2018;2018;02;18;Lauantai;22;13;35;19;24;43
89;17.02.2018;2018;02;19;Lauantai;21;9;30;24;16;40
89;17.02.2018;2018;02;20;Lauantai;12;12;24;22;21;43
89;17.02.2018;2018;02;21;Lauantai;7;15;22;17;11;28
89;17.02.2018;2018;02;22;Lauantai;9;11;20;8;11;19
89;17.02.2018;2018;02;23;Lauantai;11;12;23;10;11;21
89;18.02.2018;2018;02;00;Sunnuntai;6;5;11;9;6;15
89;18.02.2018;2018;02;01;Sunnuntai;7;5;12;9;2;11
89;18.02.2018;2018;02;02;Sunnuntai;7;1;8;3;1;4
89;18.02.2018;2018;02;03;Sunnuntai;6;0;6;4;0;4
89;18.02.2018;2018;02;04;Sunnuntai;5;1;6;4;1;5
89;18.02.2018;2018;02;05;Sunnuntai;2;2;4;1;2;3
89;18.02.2018;2018;02;06;Sunnuntai;1;1;2;1;1;2
89;18.02.2018;2018;02;07;Sunnuntai;2;1;3;5;4;9
89;18.02.2018;2018;02;08;Sunnuntai;1;4;5;4;10;14
89;18.02.2018;2018;02;09;Sunnuntai;2;3;5;6;7;13
89;18.02.2018;2018;02;10;Sunnuntai;5;10;15;20;21;41
89;18.02.2018;2018;02;11;Sunnuntai;6;19;25;26;57;83
89;18.02.2018;2018;02;12;Sunnuntai;8;23;31;44;61;105
89;18.02.2018;2018;02;13;Sunnuntai;19;19;38;56;63;119
89;18.02.2018;2018;02;14;Sunnuntai;17;20;37;44;52;96
89;18.02.2018;2018;02;15;Sunnuntai;15;15;30;40;35;75
89;18.02.2018;2018;02;16;Sunnuntai;20;14;34;31;19;50
89;18.02.2018;2018;02;17;Sunnuntai;22;17;39;28;20;48
89;18.02.2018;2018;02;18;Sunnuntai;16;12;28;36;15;51
89;18.02.2018;2018;02;19;Sunnuntai;11;11;22;14;13;27
89;18.02.2018;2018;02;20;Sunnuntai;7;5;12;20;8;28
89;18.02.2018;2018;02;21;Sunnuntai;8;4;12;9;8;17
89;18.02.2018;2018;02;22;Sunnuntai;5;2;7;4;2;6
89;18.02.2018;2018;02;23;Sunnuntai;3;2;5;2;1;3
89;19.02.2018;2018;02;00;Maanantai;2;3;5;0;1;1
89;19.02.2018;2018;02;01;Maanantai;0;0;0;1;1;2
89;19.02.2018;2018;02;02;Maanantai;3;1;4;2;0;2
89;19.02.2018;2018;02;03;Maanantai;1;2;3;0;2;2
89;19.02.2018;2018;02;04;Maanantai;0;3;3;4;0;4
89;19.02.2018;2018;02;05;Maanantai;3;6;9;1;0;1
89;19.02.2018;2018;02;06;Maanantai;3;14;17;1;9;10
89;19.02.2018;2018;02;07;Maanantai;9;41;50;8;24;32
89;19.02.2018;2018;02;08;Maanantai;19;90;109;10;50;60
89;19.02.2018;2018;02;09;Maanantai;12;47;59;7;52;59
89;19.02.2018;2018;02;10;Maanantai;10;30;40;14;21;35
89;19.02.2018;2018;02;11;Maanantai;11;21;32;21;38;59
89;19.02.2018;2018;02;12;Maanantai;28;23;51;23;34;57
89;19.02.2018;2018;02;13;Maanantai;26;38;64;44;30;74
89;19.02.2018;2018;02;14;Maanantai;35;16;51;47;18;65
89;19.02.2018;2018;02;15;Maanantai;66;25;91;45;34;79
89;19.02.2018;2018;02;16;Maanantai;77;38;115;43;31;74
89;19.02.2018;2018;02;17;Maanantai;49;27;76;34;19;53
89;19.02.2018;2018;02;18;Maanantai;31;27;58;29;29;58
89;19.02.2018;2018;02;19;Maanantai;25;4;29;26;16;42
89;19.02.2018;2018;02;20;Maanantai;20;11;31;30;14;44
89;19.02.2018;2018;02;21;Maanantai;9;12;21;28;7;35
89;19.02.2018;2018;02;22;Maanantai;7;4;11;9;4;13
89;19.02.2018;2018;02;23;Maanantai;2;2;4;3;0;3
89;20.02.2018;2018;02;00;Tiistai;1;1;2;3;4;7
89;20.02.2018;2018;02;01;Tiistai;1;0;1;0;0;0
89;20.02.2018;2018;02;02;Tiistai;1;2;3;0;1;1
89;20.02.2018;2018;02;03;Tiistai;4;1;5;0;0;0
89;20.02.2018;2018;02;04;Tiistai;0;1;1;0;0;0
89;20.02.2018;2018;02;05;Tiistai;0;4;4;1;1;2
89;20.02.2018;2018;02;06;Tiistai;3;17;20;9;6;15
89;20.02.2018;2018;02;07;Tiistai;7;41;48;6;26;32
89;20.02.2018;2018;02;08;Tiistai;16;91;107;3;44;47
89;20.02.2018;2018;02;09;Tiistai;11;56;67;8;44;52
89;20.02.2018;2018;02;10;Tiistai;10;19;29;14;31;45
89;20.02.2018;2018;02;11;Tiistai;21;29;50;19;34;53
89;20.02.2018;2018;02;12;Tiistai;17;22;39;24;18;42
89;20.02.2018;2018;02;13;Tiistai;18;27;45;21;20;41
89;20.02.2018;2018;02;14;Tiistai;36;19;55;34;23;57
89;20.02.2018;2018;02;15;Tiistai;59;23;82;40;20;60
89;20.02.2018;2018;02;16;Tiistai;63;36;99;28;30;58
89;20.02.2018;2018;02;17;Tiistai;61;28;89;55;28;83
89;20.02.2018;2018;02;18;Tiistai;27;19;46;17;25;42
89;20.02.2018;2018;02;19;Tiistai;35;7;42;34;24;58
89;20.02.2018;2018;02;20;Tiistai;11;4;15;19;13;32
89;20.02.2018;2018;02;21;Tiistai;12;5;17;14;8;22
89;20.02.2018;2018;02;22;Tiistai;5;6;11;6;5;11
89;20.02.2018;2018;02;23;Tiistai;2;0;2;2;0;2
89;21.02.2018;2018;02;00;Keskiviikko;2;1;3;4;2;6
89;21.02.2018;2018;02;01;Keskiviikko;0;0;0;0;0;0
89;21.02.2018;2018;02;02;Keskiviikko;0;2;2;1;0;1
89;21.02.2018;2018;02;03;Keskiviikko;3;2;5;2;1;3
89;21.02.2018;2018;02;04;Keskiviikko;0;2;2;2;1;3
89;21.02.2018;2018;02;05;Keskiviikko;1;8;9;3;2;5
89;21.02.2018;2018;02;06;Keskiviikko;3;22;25;5;13;18
89;21.02.2018;2018;02;07;Keskiviikko;9;66;75;11;45;56
89;21.02.2018;2018;02;08;Keskiviikko;11;86;97;5;49;54
89;21.02.2018;2018;02;09;Keskiviikko;16;38;54;17;28;45
89;21.02.2018;2018;02;10;Keskiviikko;8;26;34;17;31;48
89;21.02.2018;2018;02;11;Keskiviikko;14;26;40;19;31;50
89;21.02.2018;2018;02;12;Keskiviikko;26;38;64;32;31;63
89;21.02.2018;2018;02;13;Keskiviikko;27;23;50;36;40;76
89;21.02.2018;2018;02;14;Keskiviikko;46;17;63;48;31;79
89;21.02.2018;2018;02;15;Keskiviikko;51;18;69;44;25;69
89;21.02.2018;2018;02;16;Keskiviikko;76;37;113;47;27;74
89;21.02.2018;2018;02;17;Keskiviikko;44;33;77;42;28;70
89;21.02.2018;2018;02;18;Keskiviikko;26;24;50;50;27;77
89;21.02.2018;2018;02;19;Keskiviikko;26;12;38;28;17;45
89;21.02.2018;2018;02;20;Keskiviikko;23;11;34;40;18;58
89;21.02.2018;2018;02;21;Keskiviikko;13;5;18;13;6;19
89;21.02.2018;2018;02;22;Keskiviikko;8;2;10;3;5;8
89;21.02.2018;2018;02;23;Keskiviikko;5;0;5;4;2;6
89;22.02.2018;2018;02;00;Torstai;1;1;2;2;0;2
89;22.02.2018;2018;02;01;Torstai;0;0;0;2;0;2
89;22.02.2018;2018;02;02;Torstai;1;3;4;0;0;0
89;22.02.2018;2018;02;03;Torstai;1;2;3;1;1;2
89;22.02.2018;2018;02;04;Torstai;0;2;2;3;1;4
89;22.02.2018;2018;02;05;Torstai;0;5;5;1;3;4
89;22.02.2018;2018;02;06;Torstai;5;25;30;5;12;17
89;22.02.2018;2018;02;07;Torstai;15;53;68;5;43;48
89;22.02.2018;2018;02;08;Torstai;17;99;116;8;55;63
89;22.02.2018;2018;02;09;Torstai;16;46;62;40;65;105
89;22.02.2018;2018;02;10;Torstai;8;21;29;26;45;71
89;22.02.2018;2018;02;11;Torstai;17;26;43;14;29;43
89;22.02.2018;2018;02;12;Torstai;26;27;53;37;15;52
89;22.02.2018;2018;02;13;Torstai;35;37;72;41;33;74
89;22.02.2018;2018;02;14;Torstai;49;37;86;45;24;69
89;22.02.2018;2018;02;15;Torstai;75;21;96;49;48;97
89;22.02.2018;2018;02;16;Torstai;78;46;124;57;32;89
89;22.02.2018;2018;02;17;Torstai;38;27;65;45;32;77
89;22.02.2018;2018;02;18;Torstai;31;24;55;51;27;78
89;22.02.2018;2018;02;19;Torstai;30;13;43;34;25;59
89;22.02.2018;2018;02;20;Torstai;15;7;22;24;5;29
89;22.02.2018;2018;02;21;Torstai;20;7;27;12;7;19
89;22.02.2018;2018;02;22;Torstai;10;3;13;8;3;11
89;22.02.2018;2018;02;23;Torstai;4;3;7;1;1;2
89;23.02.2018;2018;02;00;Perjantai;3;0;3;5;1;6
89;23.02.2018;2018;02;01;Perjantai;1;0;1;1;0;1
89;23.02.2018;2018;02;02;Perjantai;1;1;2;1;0;1
89;23.02.2018;2018;02;03;Perjantai;4;2;6;2;1;3
89;23.02.2018;2018;02;04;Perjantai;1;0;1;1;2;3
89;23.02.2018;2018;02;05;Perjantai;1;9;10;1;5;6
89;23.02.2018;2018;02;06;Perjantai;7;20;27;2;11;13
89;23.02.2018;2018;02;07;Perjantai;14;60;74;9;34;43
89;23.02.2018;2018;02;08;Perjantai;14;62;76;7;52;59
89;23.02.2018;2018;02;09;Perjantai;15;26;41;18;52;70
89;23.02.2018;2018;02;10;Perjantai;17;27;44;25;32;57
89;23.02.2018;2018;02;11;Perjantai;12;33;45;20;30;50
89;23.02.2018;2018;02;12;Perjantai;24;28;52;34;32;66
89;23.02.2018;2018;02;13;Perjantai;35;40;75;32;26;58
89;23.02.2018;2018;02;14;Perjantai;51;22;73;64;26;90
89;23.02.2018;2018;02;15;Perjantai;64;39;103;51;37;88
89;23.02.2018;2018;02;16;Perjantai;73;25;98;35;25;60
89;23.02.2018;2018;02;17;Perjantai;51;20;71;38;28;66
89;23.02.2018;2018;02;18;Perjantai;23;14;37;24;23;47
89;23.02.2018;2018;02;19;Perjantai;18;15;33;27;15;42
89;23.02.2018;2018;02;20;Perjantai;19;8;27;13;17;30
89;23.02.2018;2018;02;21;Perjantai;15;5;20;17;7;24
89;23.02.2018;2018;02;22;Perjantai;13;9;22;12;8;20
89;23.02.2018;2018;02;23;Perjantai;13;8;21;5;8;13
89;24.02.2018;2018;02;00;Lauantai;6;4;10;6;4;10
89;24.02.2018;2018;02;01;Lauantai;4;2;6;4;2;6
89;24.02.2018;2018;02;02;Lauantai;5;4;9;3;4;7
89;24.02.2018;2018;02;03;Lauantai;2;0;2;5;1;6
89;24.02.2018;2018;02;04;Lauantai;5;1;6;2;0;2
89;24.02.2018;2018;02;05;Lauantai;1;6;7;0;1;1
89;24.02.2018;2018;02;06;Lauantai;1;1;2;1;3;4
89;24.02.2018;2018;02;07;Lauantai;2;3;5;3;4;7
89;24.02.2018;2018;02;08;Lauantai;3;13;16;4;7;11
89;24.02.2018;2018;02;09;Lauantai;1;21;22;6;19;25
89;24.02.2018;2018;02;10;Lauantai;0;14;14;15;33;48
89;24.02.2018;2018;02;11;Lauantai;9;17;26;34;30;64
89;24.02.2018;2018;02;12;Lauantai;11;15;26;37;44;81
89;24.02.2018;2018;02;13;Lauantai;15;20;35;47;43;90
89;24.02.2018;2018;02;14;Lauantai;22;17;39;35;41;76
89;24.02.2018;2018;02;15;Lauantai;31;20;51;47;23;70
89;24.02.2018;2018;02;16;Lauantai;18;16;34;31;36;67
89;24.02.2018;2018;02;17;Lauantai;16;17;33;37;24;61
89;24.02.2018;2018;02;18;Lauantai;15;5;20;19;13;32
89;24.02.2018;2018;02;19;Lauantai;13;8;21;17;6;23
89;24.02.2018;2018;02;20;Lauantai;10;4;14;9;10;19
89;24.02.2018;2018;02;21;Lauantai;7;13;20;14;7;21
89;24.02.2018;2018;02;22;Lauantai;8;7;15;4;12;16
89;24.02.2018;2018;02;23;Lauantai;8;6;14;6;5;11
89;25.02.2018;2018;02;00;Sunnuntai;5;4;9;8;4;12
89;25.02.2018;2018;02;01;Sunnuntai;4;1;5;4;2;6
89;25.02.2018;2018;02;02;Sunnuntai;3;1;4;3;2;5
89;25.02.2018;2018;02;03;Sunnuntai;9;2;11;6;0;6
89;25.02.2018;2018;02;04;Sunnuntai;6;0;6;16;0;16
89;25.02.2018;2018;02;05;Sunnuntai;0;2;2;4;2;6
89;25.02.2018;2018;02;06;Sunnuntai;0;2;2;3;4;7
89;25.02.2018;2018;02;07;Sunnuntai;1;1;2;2;1;3
89;25.02.2018;2018;02;08;Sunnuntai;0;1;1;0;7;7
89;25.02.2018;2018;02;09;Sunnuntai;2;4;6;6;6;12
89;25.02.2018;2018;02;10;Sunnuntai;5;15;20;16;22;38
89;25.02.2018;2018;02;11;Sunnuntai;7;17;24;31;51;82
89;25.02.2018;2018;02;12;Sunnuntai;13;26;39;43;44;87
89;25.02.2018;2018;02;13;Sunnuntai;6;22;28;30;38;68
89;25.02.2018;2018;02;14;Sunnuntai;27;19;46;28;37;65
89;25.02.2018;2018;02;15;Sunnuntai;21;19;40;36;50;86
89;25.02.2018;2018;02;16;Sunnuntai;29;13;42;31;29;60
89;25.02.2018;2018;02;17;Sunnuntai;21;13;34;42;24;66
89;25.02.2018;2018;02;18;Sunnuntai;21;11;32;24;19;43
89;25.02.2018;2018;02;19;Sunnuntai;12;10;22;23;22;45
89;25.02.2018;2018;02;20;Sunnuntai;6;3;9;23;8;31
89;25.02.2018;2018;02;21;Sunnuntai;12;5;17;6;4;10
89;25.02.2018;2018;02;22;Sunnuntai;4;1;5;5;2;7
89;25.02.2018;2018;02;23;Sunnuntai;1;4;5;3;0;3
89;26.02.2018;2018;02;00;Maanantai;5;2;7;2;1;3
89;26.02.2018;2018;02;01;Maanantai;0;0;0;1;1;2
89;26.02.2018;2018;02;02;Maanantai;0;0;0;0;0;0
89;26.02.2018;2018;02;03;Maanantai;0;1;1;0;0;0
89;26.02.2018;2018;02;04;Maanantai;1;2;3;1;1;2
89;26.02.2018;2018;02;05;Maanantai;2;7;9;1;1;2
89;26.02.2018;2018;02;06;Maanantai;6;35;41;3;8;11
89;26.02.2018;2018;02;07;Maanantai;20;69;89;6;28;34
89;26.02.2018;2018;02;08;Maanantai;20;81;101;12;76;88
89;26.02.2018;2018;02;09;Maanantai;20;48;68;20;60;80
89;26.02.2018;2018;02;10;Maanantai;14;26;40;28;54;82
89;26.02.2018;2018;02;11;Maanantai;17;34;51;41;32;73
89;26.02.2018;2018;02;12;Maanantai;25;39;64;28;35;63
89;26.02.2018;2018;02;13;Maanantai;38;34;72;31;32;63
89;26.02.2018;2018;02;14;Maanantai;43;31;74;57;23;80
89;26.02.2018;2018;02;15;Maanantai;81;28;109;45;24;69
89;26.02.2018;2018;02;16;Maanantai;89;41;130;41;30;71
89;26.02.2018;2018;02;17;Maanantai;53;35;88;38;21;59
89;26.02.2018;2018;02;18;Maanantai;37;18;55;41;26;67
89;26.02.2018;2018;02;19;Maanantai;39;14;53;27;17;44
89;26.02.2018;2018;02;20;Maanantai;26;10;36;20;13;33
89;26.02.2018;2018;02;21;Maanantai;17;9;26;13;9;22
89;26.02.2018;2018;02;22;Maanantai;8;1;9;8;4;12
89;26.02.2018;2018;02;23;Maanantai;1;2;3;1;2;3
89;27.02.2018;2018;02;00;Tiistai;0;1;1;2;1;3
89;27.02.2018;2018;02;01;Tiistai;1;3;4;1;0;1
89;27.02.2018;2018;02;02;Tiistai;1;0;1;1;0;1
89;27.02.2018;2018;02;03;Tiistai;0;3;3;1;0;1
89;27.02.2018;2018;02;04;Tiistai;1;0;1;0;0;0
89;27.02.2018;2018;02;05;Tiistai;0;6;6;2;1;3
89;27.02.2018;2018;02;06;Tiistai;5;26;31;3;14;17
89;27.02.2018;2018;02;07;Tiistai;15;57;72;5;34;39
89;27.02.2018;2018;02;08;Tiistai;11;92;103;5;48;53
89;27.02.2018;2018;02;09;Tiistai;16;36;52;16;38;54
89;27.02.2018;2018;02;10;Tiistai;16;28;44;18;46;64
89;27.02.2018;2018;02;11;Tiistai;14;20;34;18;34;52
89;27.02.2018;2018;02;12;Tiistai;21;21;42;28;25;53
89;27.02.2018;2018;02;13;Tiistai;19;19;38;36;28;64
89;27.02.2018;2018;02;14;Tiistai;38;27;65;54;26;80
89;27.02.2018;2018;02;15;Tiistai;61;25;86;46;23;69
89;27.02.2018;2018;02;16;Tiistai;76;31;107;45;31;76
89;27.02.2018;2018;02;17;Tiistai;43;30;73;31;30;61
89;27.02.2018;2018;02;18;Tiistai;40;19;59;31;24;55
89;27.02.2018;2018;02;19;Tiistai;35;5;40;34;14;48
89;27.02.2018;2018;02;20;Tiistai;14;6;20;18;9;27
89;27.02.2018;2018;02;21;Tiistai;13;7;20;8;9;17
89;27.02.2018;2018;02;22;Tiistai;8;2;10;6;5;11
89;27.02.2018;2018;02;23;Tiistai;6;5;11;0;1;1
89;28.02.2018;2018;02;00;Keskiviikko;0;2;2;2;0;2
89;28.02.2018;2018;02;01;Keskiviikko;0;0;0;0;0;0
89;28.02.2018;2018;02;02;Keskiviikko;1;0;1;1;0;1
89;28.02.2018;2018;02;03;Keskiviikko;0;1;1;0;1;1
89;28.02.2018;2018;02;04;Keskiviikko;0;0;0;2;1;3
89;28.02.2018;2018;02;05;Keskiviikko;0;5;5;2;2;4
89;28.02.2018;2018;02;06;Keskiviikko;4;19;23;4;11;15
89;28.02.2018;2018;02;07;Keskiviikko;11;54;65;8;35;43
89;28.02.2018;2018;02;08;Keskiviikko;9;66;75;10;44;54
89;28.02.2018;2018;02;09;Keskiviikko;15;38;53;6;39;45
89;28.02.2018;2018;02;10;Keskiviikko;6;16;22;17;21;38
89;28.02.2018;2018;02;11;Keskiviikko;12;33;45;30;36;66
89;28.02.2018;2018;02;12;Keskiviikko;21;25;46;45;34;79
89;28.02.2018;2018;02;13;Keskiviikko;28;29;57;41;23;64
89;28.02.2018;2018;02;14;Keskiviikko;30;24;54;53;28;81
89;28.02.2018;2018;02;15;Keskiviikko;65;41;106;48;38;86
89;28.02.2018;2018;02;16;Keskiviikko;62;31;93;56;27;83
89;28.02.2018;2018;02;17;Keskiviikko;55;30;85;39;28;67
89;28.02.2018;2018;02;18;Keskiviikko;36;20;56;41;28;69
89;28.02.2018;2018;02;19;Keskiviikko;39;17;56;32;15;47
89;28.02.2018;2018;02;20;Keskiviikko;17;6;23;19;6;25
89;28.02.2018;2018;02;21;Keskiviikko;19;8;27;9;6;15
89;28.02.2018;2018;02;22;Keskiviikko;5;9;14;3;2;5
89;28.02.2018;2018;02;23;Keskiviikko;2;2;4;3;2;5
89;01.03.2018;2018;03;00;Torstai;1;0;1;0;4;4
89;01.03.2018;2018;03;01;Torstai;1;0;1;1;0;1
89;01.03.2018;2018;03;02;Torstai;1;1;2;5;0;5
89;01.03.2018;2018;03;03;Torstai;3;3;6;0;0;0
89;01.03.2018;2018;03;04;Torstai;2;3;5;0;0;0
89;01.03.2018;2018;03;05;Torstai;1;3;4;3;1;4
89;01.03.2018;2018;03;06;Torstai;9;21;30;3;16;19
89;01.03.2018;2018;03;07;Torstai;11;68;79;8;28;36
89;01.03.2018;2018;03;08;Torstai;16;88;104;4;61;65
89;01.03.2018;2018;03;09;Torstai;20;40;60;10;38;48
89;01.03.2018;2018;03;10;Torstai;18;27;45;16;29;45
89;01.03.2018;2018;03;11;Torstai;17;35;52;21;25;46
89;01.03.2018;2018;03;12;Torstai;18;38;56;28;32;60
89;01.03.2018;2018;03;13;Torstai;24;26;50;30;21;51
89;01.03.2018;2018;03;14;Torstai;35;41;76;45;24;69
89;01.03.2018;2018;03;15;Torstai;94;24;118;37;25;62
89;01.03.2018;2018;03;16;Torstai;83;38;121;55;33;88
89;01.03.2018;2018;03;17;Torstai;56;37;93;37;22;59
89;01.03.2018;2018;03;18;Torstai;41;15;56;41;20;61
89;01.03.2018;2018;03;19;Torstai;29;23;52;42;21;63
89;01.03.2018;2018;03;20;Torstai;19;6;25;32;18;50
89;01.03.2018;2018;03;21;Torstai;17;3;20;14;5;19
89;01.03.2018;2018;03;22;Torstai;11;8;19;6;7;13
89;01.03.2018;2018;03;23;Torstai;0;9;9;5;5;10
89;02.03.2018;2018;03;00;Perjantai;2;4;6;5;2;7
89;02.03.2018;2018;03;01;Perjantai;1;1;2;0;0;0
89;02.03.2018;2018;03;02;Perjantai;9;1;10;3;1;4
89;02.03.2018;2018;03;03;Perjantai;7;2;9;3;2;5
89;02.03.2018;2018;03;04;Perjantai;2;4;6;3;0;3
89;02.03.2018;2018;03;05;Perjantai;1;8;9;1;3;4
89;02.03.2018;2018;03;06;Perjantai;5;23;28;3;17;20
89;02.03.2018;2018;03;07;Perjantai;14;54;68;7;34;41
89;02.03.2018;2018;03;08;Perjantai;15;77;92;9;42;51
89;02.03.2018;2018;03;09;Perjantai;10;38;48;9;46;55
89;02.03.2018;2018;03;10;Perjantai;21;32;53;15;33;48
89;02.03.2018;2018;03;11;Perjantai;20;46;66;24;23;47
89;02.03.2018;2018;03;12;Perjantai;34;32;66;33;30;63
89;02.03.2018;2018;03;13;Perjantai;34;35;69;42;27;69
89;02.03.2018;2018;03;14;Perjantai;40;36;76;33;21;54
89;02.03.2018;2018;03;15;Perjantai;68;30;98;46;31;77
89;02.03.2018;2018;03;16;Perjantai;57;36;93;41;27;68
89;02.03.2018;2018;03;17;Perjantai;50;32;82;28;20;48
89;02.03.2018;2018;03;18;Perjantai;35;17;52;41;37;78
89;02.03.2018;2018;03;19;Perjantai;33;14;47;31;22;53
89;02.03.2018;2018;03;20;Perjantai;19;13;32;14;16;30
89;02.03.2018;2018;03;21;Perjantai;12;11;23;15;11;26
89;02.03.2018;2018;03;22;Perjantai;11;10;21;11;9;20
89;02.03.2018;2018;03;23;Perjantai;8;4;12;9;6;15
89;03.03.2018;2018;03;00;Lauantai;9;6;15;6;4;10
89;03.03.2018;2018;03;01;Lauantai;4;3;7;9;5;14
89;03.03.2018;2018;03;02;Lauantai;10;0;10;4;5;9
89;03.03.2018;2018;03;03;Lauantai;8;1;9;5;0;5
89;03.03.2018;2018;03;04;Lauantai;4;1;5;2;2;4
89;03.03.2018;2018;03;05;Lauantai;1;2;3;3;1;4
89;03.03.2018;2018;03;06;Lauantai;0;2;2;2;1;3
89;03.03.2018;2018;03;07;Lauantai;3;7;10;2;5;7
89;03.03.2018;2018;03;08;Lauantai;2;12;14;7;13;20
89;03.03.2018;2018;03;09;Lauantai;5;29;34;11;23;34
89;03.03.2018;2018;03;10;Lauantai;9;30;39;25;27;52
89;03.03.2018;2018;03;11;Lauantai;20;31;51;38;46;84
89;03.03.2018;2018;03;12;Lauantai;28;25;53;40;38;78
89;03.03.2018;2018;03;13;Lauantai;26;37;63;24;56;80
89;03.03.2018;2018;03;14;Lauantai;32;31;63;31;51;82
89;03.03.2018;2018;03;15;Lauantai;25;18;43;35;21;56
89;03.03.2018;2018;03;16;Lauantai;35;10;45;34;32;66
89;03.03.2018;2018;03;17;Lauantai;23;21;44;25;21;46
89;03.03.2018;2018;03;18;Lauantai;14;12;26;30;29;59
89;03.03.2018;2018;03;19;Lauantai;25;8;33;24;14;38
89;03.03.2018;2018;03;20;Lauantai;10;8;18;16;12;28
89;03.03.2018;2018;03;21;Lauantai;11;5;16;14;9;23
89;03.03.2018;2018;03;22;Lauantai;7;7;14;11;7;18
89;03.03.2018;2018;03;23;Lauantai;9;8;17;10;10;20
89;04.03.2018;2018;03;00;Sunnuntai;8;6;14;6;3;9
89;04.03.2018;2018;03;01;Sunnuntai;3;0;3;4;3;7
89;04.03.2018;2018;03;02;Sunnuntai;1;5;6;11;1;12
89;04.03.2018;2018;03;03;Sunnuntai;4;0;4;8;0;8
89;04.03.2018;2018;03;04;Sunnuntai;7;0;7;10;0;10
89;04.03.2018;2018;03;05;Sunnuntai;1;1;2;3;0;3
89;04.03.2018;2018;03;06;Sunnuntai;1;1;2;1;4;5
89;04.03.2018;2018;03;07;Sunnuntai;2;4;6;4;7;11
89;04.03.2018;2018;03;08;Sunnuntai;2;3;5;11;15;26
89;04.03.2018;2018;03;09;Sunnuntai;4;7;11;13;15;28
89;04.03.2018;2018;03;10;Sunnuntai;5;15;20;34;39;73
89;04.03.2018;2018;03;11;Sunnuntai;14;16;30;41;58;99
89;04.03.2018;2018;03;12;Sunnuntai;10;18;28;43;66;109
89;04.03.2018;2018;03;13;Sunnuntai;19;24;43;75;64;139
89;04.03.2018;2018;03;14;Sunnuntai;15;28;43;50;53;103
89;04.03.2018;2018;03;15;Sunnuntai;37;21;58;40;58;98
89;04.03.2018;2018;03;16;Sunnuntai;27;26;53;44;34;78
89;04.03.2018;2018;03;17;Sunnuntai;18;16;34;30;24;54
89;04.03.2018;2018;03;18;Sunnuntai;20;17;37;37;17;54
89;04.03.2018;2018;03;19;Sunnuntai;16;13;29;18;17;35
89;04.03.2018;2018;03;20;Sunnuntai;9;2;11;13;9;22
89;04.03.2018;2018;03;21;Sunnuntai;14;3;17;8;4;12
89;04.03.2018;2018;03;22;Sunnuntai;7;2;9;2;5;7
89;04.03.2018;2018;03;23;Sunnuntai;3;5;8;3;3;6
89;05.03.2018;2018;03;00;Maanantai;2;3;5;4;0;4
89;05.03.2018;2018;03;01;Maanantai;0;0;0;1;0;1
89;05.03.2018;2018;03;02;Maanantai;4;2;6;3;0;3
89;05.03.2018;2018;03;03;Maanantai;1;2;3;0;0;0
89;05.03.2018;2018;03;04;Maanantai;1;2;3;0;0;0
89;05.03.2018;2018;03;05;Maanantai;2;9;11;3;1;4
89;05.03.2018;2018;03;06;Maanantai;7;19;26;1;9;10
89;05.03.2018;2018;03;07;Maanantai;13;44;57;3;18;21
89;05.03.2018;2018;03;08;Maanantai;9;54;63;3;26;29
89;05.03.2018;2018;03;09;Maanantai;9;33;42;2;23;25
89;05.03.2018;2018;03;10;Maanantai;15;15;30;21;33;54
89;05.03.2018;2018;03;11;Maanantai;12;29;41;29;37;66
89;05.03.2018;2018;03;12;Maanantai;16;36;52;24;27;51
89;05.03.2018;2018;03;13;Maanantai;28;25;53;46;29;75
89;05.03.2018;2018;03;14;Maanantai;38;28;66;33;21;54
89;05.03.2018;2018;03;15;Maanantai;63;26;89;39;32;71
89;05.03.2018;2018;03;16;Maanantai;65;29;94;47;27;74
89;05.03.2018;2018;03;17;Maanantai;44;35;79;31;30;61
89;05.03.2018;2018;03;18;Maanantai;23;12;35;33;14;47
89;05.03.2018;2018;03;19;Maanantai;26;7;33;28;22;50
89;05.03.2018;2018;03;20;Maanantai;13;4;17;11;10;21
89;05.03.2018;2018;03;21;Maanantai;7;3;10;14;6;20
89;05.03.2018;2018;03;22;Maanantai;6;0;6;4;4;8
89;05.03.2018;2018;03;23;Maanantai;3;4;7;2;1;3
89;06.03.2018;2018;03;00;Tiistai;1;1;2;2;2;4
89;06.03.2018;2018;03;01;Tiistai;0;0;0;0;0;0
89;06.03.2018;2018;03;02;Tiistai;0;0;0;1;0;1
89;06.03.2018;2018;03;03;Tiistai;1;3;4;0;1;1
89;06.03.2018;2018;03;04;Tiistai;1;1;2;1;0;1
89;06.03.2018;2018;03;05;Tiistai;0;5;5;1;3;4
89;06.03.2018;2018;03;06;Tiistai;4;23;27;4;10;14
89;06.03.2018;2018;03;07;Tiistai;11;43;54;3;26;29
89;06.03.2018;2018;03;08;Tiistai;12;59;71;3;24;27
89;06.03.2018;2018;03;09;Tiistai;9;32;41;8;32;40
89;06.03.2018;2018;03;10;Tiistai;6;28;34;14;33;47
89;06.03.2018;2018;03;11;Tiistai;8;20;28;24;31;55
89;06.03.2018;2018;03;12;Tiistai;19;25;44;26;24;50
89;06.03.2018;2018;03;13;Tiistai;15;23;38;27;34;61
89;06.03.2018;2018;03;14;Tiistai;20;29;49;40;28;68
89;06.03.2018;2018;03;15;Tiistai;53;22;75;41;24;65
89;06.03.2018;2018;03;16;Tiistai;47;39;86;48;31;79
89;06.03.2018;2018;03;17;Tiistai;37;18;55;40;31;71
89;06.03.2018;2018;03;18;Tiistai;32;11;43;33;23;56
89;06.03.2018;2018;03;19;Tiistai;17;6;23;44;12;56
89;06.03.2018;2018;03;20;Tiistai;16;12;28;20;7;27
89;06.03.2018;2018;03;21;Tiistai;21;3;24;16;8;24
89;06.03.2018;2018;03;22;Tiistai;4;4;8;8;2;10
89;06.03.2018;2018;03;23;Tiistai;1;1;2;9;1;10
89;07.03.2018;2018;03;00;Keskiviikko;2;2;4;2;1;3
89;07.03.2018;2018;03;01;Keskiviikko;2;0;2;0;0;0
89;07.03.2018;2018;03;02;Keskiviikko;1;2;3;1;0;1
89;07.03.2018;2018;03;03;Keskiviikko;3;1;4;1;0;1
89;07.03.2018;2018;03;04;Keskiviikko;1;2;3;1;0;1
89;07.03.2018;2018;03;05;Keskiviikko;1;4;5;3;5;8
89;07.03.2018;2018;03;06;Keskiviikko;7;19;26;2;14;16
89;07.03.2018;2018;03;07;Keskiviikko;10;44;54;2;21;23
89;07.03.2018;2018;03;08;Keskiviikko;9;45;54;7;36;43
89;07.03.2018;2018;03;09;Keskiviikko;10;26;36;11;32;43
89;07.03.2018;2018;03;10;Keskiviikko;8;33;41;19;25;44
89;07.03.2018;2018;03;11;Keskiviikko;19;17;36;25;31;56
89;07.03.2018;2018;03;12;Keskiviikko;27;29;56;38;41;79
89;07.03.2018;2018;03;13;Keskiviikko;20;23;43;31;27;58
89;07.03.2018;2018;03;14;Keskiviikko;29;31;60;48;33;81
89;07.03.2018;2018;03;15;Keskiviikko;64;16;80;29;16;45
89;07.03.2018;2018;03;16;Keskiviikko;82;31;113;51;25;76
89;07.03.2018;2018;03;17;Keskiviikko;38;25;63;28;15;43
89;07.03.2018;2018;03;18;Keskiviikko;22;24;46;32;20;52
89;07.03.2018;2018;03;19;Keskiviikko;23;9;32;33;19;52
89;07.03.2018;2018;03;20;Keskiviikko;14;13;27;20;7;27
89;07.03.2018;2018;03;21;Keskiviikko;8;6;14;17;13;30
89;07.03.2018;2018;03;22;Keskiviikko;6;5;11;5;2;7
89;07.03.2018;2018;03;23;Keskiviikko;4;3;7;2;3;5
89;08.03.2018;2018;03;00;Torstai;2;2;4;5;2;7
89;08.03.2018;2018;03;01;Torstai;1;1;2;1;0;1
89;08.03.2018;2018;03;02;Torstai;1;3;4;4;1;5
89;08.03.2018;2018;03;03;Torstai;2;1;3;1;1;2
89;08.03.2018;2018;03;04;Torstai;2;2;4;2;2;4
89;08.03.2018;2018;03;05;Torstai;0;2;2;2;2;4
89;08.03.2018;2018;03;06;Torstai;5;22;27;4;9;13
89;08.03.2018;2018;03;07;Torstai;6;53;59;13;26;39
89;08.03.2018;2018;03;08;Torstai;11;41;52;10;28;38
89;08.03.2018;2018;03;09;Torstai;10;31;41;16;36;52
89;08.03.2018;2018;03;10;Torstai;10;31;41;15;36;51
89;08.03.2018;2018;03;11;Torstai;23;20;43;31;31;62
89;08.03.2018;2018;03;12;Torstai;20;28;48;32;30;62
89;08.03.2018;2018;03;13;Torstai;31;25;56;37;39;76
89;08.03.2018;2018;03;14;Torstai;37;25;62;34;24;58
89;08.03.2018;2018;03;15;Torstai;67;23;90;48;24;72
89;08.03.2018;2018;03;16;Torstai;61;37;98;48;27;75
89;08.03.2018;2018;03;17;Torstai;37;25;62;28;18;46
89;08.03.2018;2018;03;18;Torstai;43;21;64;36;17;53
89;08.03.2018;2018;03;19;Torstai;20;11;31;17;17;34
89;08.03.2018;2018;03;20;Torstai;19;10;29;25;14;39
89;08.03.2018;2018;03;21;Torstai;18;13;31;19;8;27
89;08.03.2018;2018;03;22;Torstai;7;3;10;13;1;14
89;08.03.2018;2018;03;23;Torstai;3;2;5;4;2;6
89;09.03.2018;2018;03;00;Perjantai;1;2;3;0;0;0
89;09.03.2018;2018;03;01;Perjantai;1;0;1;1;0;1
89;09.03.2018;2018;03;02;Perjantai;2;0;2;1;2;3
89;09.03.2018;2018;03;03;Perjantai;5;0;5;0;1;1
89;09.03.2018;2018;03;04;Perjantai;1;3;4;1;1;2
89;09.03.2018;2018;03;05;Perjantai;1;8;9;1;3;4
89;09.03.2018;2018;03;06;Perjantai;4;20;24;3;11;14
89;09.03.2018;2018;03;07;Perjantai;13;42;55;7;18;25
89;09.03.2018;2018;03;08;Perjantai;15;46;61;6;19;25
89;09.03.2018;2018;03;09;Perjantai;12;34;46;8;28;36
89;09.03.2018;2018;03;10;Perjantai;11;30;41;21;34;55
89;09.03.2018;2018;03;11;Perjantai;15;31;46;20;31;51
89;09.03.2018;2018;03;12;Perjantai;24;25;49;37;36;73
89;09.03.2018;2018;03;13;Perjantai;31;30;61;24;31;55
89;09.03.2018;2018;03;14;Perjantai;18;27;45;22;18;40
89;09.03.2018;2018;03;15;Perjantai;55;24;79;23;17;40
89;09.03.2018;2018;03;16;Perjantai;54;28;82;21;19;40
89;09.03.2018;2018;03;17;Perjantai;31;23;54;22;21;43
89;09.03.2018;2018;03;18;Perjantai;28;16;44;28;17;45
89;09.03.2018;2018;03;19;Perjantai;24;17;41;28;17;45
89;09.03.2018;2018;03;20;Perjantai;22;9;31;20;13;33
89;09.03.2018;2018;03;21;Perjantai;14;11;25;12;14;26
89;09.03.2018;2018;03;22;Perjantai;11;12;23;10;6;16
89;09.03.2018;2018;03;23;Perjantai;7;8;15;5;3;8
89;10.03.2018;2018;03;00;Lauantai;2;4;6;3;10;13
89;10.03.2018;2018;03;01;Lauantai;6;2;8;11;1;12
89;10.03.2018;2018;03;02;Lauantai;1;2;3;8;3;11
89;10.03.2018;2018;03;03;Lauantai;2;2;4;7;4;11
89;10.03.2018;2018;03;04;Lauantai;6;0;6;5;1;6
89;10.03.2018;2018;03;05;Lauantai;3;5;8;1;2;3
89;10.03.2018;2018;03;06;Lauantai;2;7;9;1;3;4
89;10.03.2018;2018;03;07;Lauantai;1;8;9;5;10;15
89;10.03.2018;2018;03;08;Lauantai;5;10;15;12;14;26
89;10.03.2018;2018;03;09;Lauantai;12;29;41;15;23;38
89;10.03.2018;2018;03;10;Lauantai;15;35;50;50;50;100
89;10.03.2018;2018;03;11;Lauantai;14;25;39;20;34;54
89;10.03.2018;2018;03;12;Lauantai;23;21;44;18;35;53
89;10.03.2018;2018;03;13;Lauantai;20;27;47;38;46;84
89;10.03.2018;2018;03;14;Lauantai;15;16;31;42;33;75
89;10.03.2018;2018;03;15;Lauantai;32;19;51;41;20;61
89;10.03.2018;2018;03;16;Lauantai;23;24;47;39;31;70
89;10.03.2018;2018;03;17;Lauantai;20;14;34;34;26;60
89;10.03.2018;2018;03;18;Lauantai;18;19;37;30;16;46
89;10.03.2018;2018;03;19;Lauantai;33;12;45;26;30;56
89;10.03.2018;2018;03;20;Lauantai;12;11;23;13;10;23
89;10.03.2018;2018;03;21;Lauantai;10;10;20;11;13;24
89;10.03.2018;2018;03;22;Lauantai;8;14;22;5;13;18
89;10.03.2018;2018;03;23;Lauantai;12;15;27;4;9;13
89;11.03.2018;2018;03;00;Sunnuntai;3;12;15;3;11;14
89;11.03.2018;2018;03;01;Sunnuntai;2;11;13;5;2;7
89;11.03.2018;2018;03;02;Sunnuntai;7;3;10;5;3;8
89;11.03.2018;2018;03;03;Sunnuntai;13;1;14;13;0;13
89;11.03.2018;2018;03;04;Sunnuntai;5;1;6;3;0;3
89;11.03.2018;2018;03;05;Sunnuntai;2;1;3;3;1;4
89;11.03.2018;2018;03;06;Sunnuntai;2;3;5;0;3;3
89;11.03.2018;2018;03;07;Sunnuntai;3;0;3;9;7;16
89;11.03.2018;2018;03;08;Sunnuntai;0;2;2;10;9;19
89;11.03.2018;2018;03;09;Sunnuntai;6;8;14;13;10;23
89;11.03.2018;2018;03;10;Sunnuntai;3;12;15;21;31;52
89;11.03.2018;2018;03;11;Sunnuntai;10;20;30;40;53;93
89;11.03.2018;2018;03;12;Sunnuntai;11;16;27;39;57;96
89;11.03.2018;2018;03;13;Sunnuntai;16;24;40;45;41;86
89;11.03.2018;2018;03;14;Sunnuntai;21;15;36;44;36;80
89;11.03.2018;2018;03;15;Sunnuntai;20;19;39;53;32;85
89;11.03.2018;2018;03;16;Sunnuntai;11;13;24;30;28;58
89;11.03.2018;2018;03;17;Sunnuntai;21;12;33;28;20;48
89;11.03.2018;2018;03;18;Sunnuntai;12;5;17;41;25;66
89;11.03.2018;2018;03;19;Sunnuntai;12;8;20;35;14;49
89;11.03.2018;2018;03;20;Sunnuntai;13;8;21;20;13;33
89;11.03.2018;2018;03;21;Sunnuntai;10;11;21;15;7;22
89;11.03.2018;2018;03;22;Sunnuntai;6;1;7;7;1;8
89;11.03.2018;2018;03;23;Sunnuntai;3;3;6;3;3;6
89;12.03.2018;2018;03;00;Maanantai;4;2;6;2;0;2
89;12.03.2018;2018;03;01;Maanantai;1;0;1;0;2;2
89;12.03.2018;2018;03;02;Maanantai;1;3;4;2;2;4
89;12.03.2018;2018;03;03;Maanantai;2;0;2;1;1;2
89;12.03.2018;2018;03;04;Maanantai;0;4;4;0;0;0
89;12.03.2018;2018;03;05;Maanantai;2;7;9;5;0;5
89;12.03.2018;2018;03;06;Maanantai;6;37;43;3;7;10
89;12.03.2018;2018;03;07;Maanantai;19;63;82;8;31;39
89;12.03.2018;2018;03;08;Maanantai;17;97;114;13;59;72
89;12.03.2018;2018;03;09;Maanantai;16;54;70;17;42;59
89;12.03.2018;2018;03;10;Maanantai;12;22;34;21;36;57
89;12.03.2018;2018;03;11;Maanantai;14;34;48;29;27;56
89;12.03.2018;2018;03;12;Maanantai;31;28;59;46;39;85
89;12.03.2018;2018;03;13;Maanantai;41;32;73;60;28;88
89;12.03.2018;2018;03;14;Maanantai;43;32;75;44;27;71
89;12.03.2018;2018;03;15;Maanantai;83;28;111;41;23;64
89;12.03.2018;2018;03;16;Maanantai;83;58;141;46;30;76
89;12.03.2018;2018;03;17;Maanantai;49;28;77;28;19;47
89;12.03.2018;2018;03;18;Maanantai;43;22;65;50;38;88
89;12.03.2018;2018;03;19;Maanantai;30;9;39;40;21;61
89;12.03.2018;2018;03;20;Maanantai;26;6;32;35;18;53
89;12.03.2018;2018;03;21;Maanantai;12;10;22;13;6;19
89;12.03.2018;2018;03;22;Maanantai;3;4;7;6;4;10
89;12.03.2018;2018;03;23;Maanantai;5;2;7;3;2;5
89;13.03.2018;2018;03;00;Tiistai;1;0;1;0;1;1
89;13.03.2018;2018;03;01;Tiistai;0;2;2;0;1;1
89;13.03.2018;2018;03;02;Tiistai;0;4;4;5;0;5
89;13.03.2018;2018;03;03;Tiistai;0;1;1;0;0;0
89;13.03.2018;2018;03;04;Tiistai;2;3;5;1;1;2
89;13.03.2018;2018;03;05;Tiistai;0;3;3;5;6;11
89;13.03.2018;2018;03;06;Tiistai;9;32;41;3;13;16
89;13.03.2018;2018;03;07;Tiistai;13;75;88;9;38;47
89;13.03.2018;2018;03;08;Tiistai;13;88;101;11;70;81
89;13.03.2018;2018;03;09;Tiistai;16;56;72;15;39;54
89;13.03.2018;2018;03;10;Tiistai;14;31;45;17;35;52
89;13.03.2018;2018;03;11;Tiistai;16;16;32;22;25;47
89;13.03.2018;2018;03;12;Tiistai;28;24;52;34;27;61
89;13.03.2018;2018;03;13;Tiistai;21;26;47;38;34;72
89;13.03.2018;2018;03;14;Tiistai;48;32;80;53;26;79
89;13.03.2018;2018;03;15;Tiistai;73;26;99;41;25;66
89;13.03.2018;2018;03;16;Tiistai;87;35;122;50;28;78
89;13.03.2018;2018;03;17;Tiistai;58;28;86;43;32;75
89;13.03.2018;2018;03;18;Tiistai;37;21;58;43;30;73
89;13.03.2018;2018;03;19;Tiistai;24;15;39;43;35;78
89;13.03.2018;2018;03;20;Tiistai;21;16;37;20;23;43
89;13.03.2018;2018;03;21;Tiistai;18;8;26;18;11;29
89;13.03.2018;2018;03;22;Tiistai;8;5;13;4;1;5
89;13.03.2018;2018;03;23;Tiistai;8;1;9;0;1;1
89;14.03.2018;2018;03;00;Keskiviikko;2;0;2;2;1;3
89;14.03.2018;2018;03;01;Keskiviikko;1;0;1;0;0;0
89;14.03.2018;2018;03;02;Keskiviikko;1;4;5;0;0;0
89;14.03.2018;2018;03;03;Keskiviikko;3;2;5;0;0;0
89;14.03.2018;2018;03;04;Keskiviikko;1;0;1;2;0;2
89;14.03.2018;2018;03;05;Keskiviikko;1;8;9;1;0;1
89;14.03.2018;2018;03;06;Keskiviikko;5;24;29;8;6;14
89;14.03.2018;2018;03;07;Keskiviikko;17;64;81;6;38;44
89;14.03.2018;2018;03;08;Keskiviikko;25;91;116;15;63;78
89;14.03.2018;2018;03;09;Keskiviikko;17;51;68;8;35;43
89;14.03.2018;2018;03;10;Keskiviikko;12;25;37;17;27;44
89;14.03.2018;2018;03;11;Keskiviikko;16;37;53;30;29;59
89;14.03.2018;2018;03;12;Keskiviikko;26;38;64;48;16;64
89;14.03.2018;2018;03;13;Keskiviikko;54;39;93;42;34;76
89;14.03.2018;2018;03;14;Keskiviikko;48;25;73;44;22;66
89;14.03.2018;2018;03;15;Keskiviikko;65;35;100;46;43;89
89;14.03.2018;2018;03;16;Keskiviikko;80;49;129;46;21;67
89;14.03.2018;2018;03;17;Keskiviikko;56;31;87;58;39;97
89;14.03.2018;2018;03;18;Keskiviikko;37;33;70;40;40;80
89;14.03.2018;2018;03;19;Keskiviikko;41;20;61;40;22;62
89;14.03.2018;2018;03;20;Keskiviikko;36;10;46;35;23;58
89;14.03.2018;2018;03;21;Keskiviikko;22;7;29;16;11;27
89;14.03.2018;2018;03;22;Keskiviikko;8;3;11;9;6;15
89;14.03.2018;2018;03;23;Keskiviikko;3;2;5;3;1;4
89;15.03.2018;2018;03;00;Torstai;1;1;2;2;6;8
89;15.03.2018;2018;03;01;Torstai;1;0;1;1;0;1
89;15.03.2018;2018;03;02;Torstai;3;4;7;0;0;0
89;15.03.2018;2018;03;03;Torstai;0;1;1;3;0;3
89;15.03.2018;2018;03;04;Torstai;0;2;2;3;0;3
89;15.03.2018;2018;03;05;Torstai;0;5;5;0;2;2
89;15.03.2018;2018;03;06;Torstai;8;21;29;2;14;16
89;15.03.2018;2018;03;07;Torstai;11;76;87;9;32;41
89;15.03.2018;2018;03;08;Torstai;18;83;101;14;59;73
89;15.03.2018;2018;03;09;Torstai;12;51;63;12;44;56
89;15.03.2018;2018;03;10;Torstai;21;24;45;31;53;84
89;15.03.2018;2018;03;11;Torstai;16;31;47;28;69;97
89;15.03.2018;2018;03;12;Torstai;31;33;64;30;41;71
89;15.03.2018;2018;03;13;Torstai;37;23;60;64;33;97
89;15.03.2018;2018;03;14;Torstai;50;33;83;66;30;96
89;15.03.2018;2018;03;15;Torstai;73;39;112;54;47;101
89;15.03.2018;2018;03;16;Torstai;81;48;129;55;37;92
89;15.03.2018;2018;03;17;Torstai;52;34;86;34;34;68
89;15.03.2018;2018;03;18;Torstai;45;27;72;45;21;66
89;15.03.2018;2018;03;19;Torstai;31;18;49;36;22;58
89;15.03.2018;2018;03;20;Torstai;26;9;35;22;8;30
89;15.03.2018;2018;03;21;Torstai;21;7;28;21;16;37
89;15.03.2018;2018;03;22;Torstai;13;4;17;7;3;10
89;15.03.2018;2018;03;23;Torstai;9;2;11;3;3;6
89;16.03.2018;2018;03;00;Perjantai;5;0;5;3;3;6
89;16.03.2018;2018;03;01;Perjantai;0;0;0;4;0;4
89;16.03.2018;2018;03;02;Perjantai;1;1;2;1;1;2
89;16.03.2018;2018;03;03;Perjantai;1;3;4;0;0;0
89;16.03.2018;2018;03;04;Perjantai;1;2;3;3;1;4
89;16.03.2018;2018;03;05;Perjantai;1;5;6;0;2;2
89;16.03.2018;2018;03;06;Perjantai;9;27;36;5;12;17
89;16.03.2018;2018;03;07;Perjantai;10;57;67;5;24;29
89;16.03.2018;2018;03;08;Perjantai;17;61;78;10;58;68
89;16.03.2018;2018;03;09;Perjantai;11;45;56;18;42;60
89;16.03.2018;2018;03;10;Perjantai;14;23;37;18;48;66
89;16.03.2018;2018;03;11;Perjantai;15;29;44;35;35;70
89;16.03.2018;2018;03;12;Perjantai;23;33;56;37;33;70
89;16.03.2018;2018;03;13;Perjantai;33;36;69;41;31;72
89;16.03.2018;2018;03;14;Perjantai;40;33;73;57;33;90
89;16.03.2018;2018;03;15;Perjantai;66;31;97;40;39;79
89;16.03.2018;2018;03;16;Perjantai;58;45;103;53;40;93
89;16.03.2018;2018;03;17;Perjantai;61;29;90;38;24;62
89;16.03.2018;2018;03;18;Perjantai;45;19;64;43;16;59
89;16.03.2018;2018;03;19;Perjantai;28;14;42;39;15;54
89;16.03.2018;2018;03;20;Perjantai;20;15;35;18;18;36
89;16.03.2018;2018;03;21;Perjantai;15;10;25;18;8;26
89;16.03.2018;2018;03;22;Perjantai;8;15;23;12;7;19
89;16.03.2018;2018;03;23;Perjantai;5;12;17;6;7;13
89;17.03.2018;2018;03;00;Lauantai;9;4;13;6;8;14
89;17.03.2018;2018;03;01;Lauantai;2;0;2;5;1;6
89;17.03.2018;2018;03;02;Lauantai;5;1;6;6;0;6
89;17.03.2018;2018;03;03;Lauantai;9;2;11;10;0;10
89;17.03.2018;2018;03;04;Lauantai;2;0;2;8;0;8
89;17.03.2018;2018;03;05;Lauantai;2;4;6;2;1;3
89;17.03.2018;2018;03;06;Lauantai;3;4;7;0;4;4
89;17.03.2018;2018;03;07;Lauantai;1;5;6;5;7;12
89;17.03.2018;2018;03;08;Lauantai;5;12;17;11;13;24
89;17.03.2018;2018;03;09;Lauantai;8;31;39;12;28;40
89;17.03.2018;2018;03;10;Lauantai;12;29;41;26;29;55
89;17.03.2018;2018;03;11;Lauantai;16;27;43;44;74;118
89;17.03.2018;2018;03;12;Lauantai;23;23;46;36;36;72
89;17.03.2018;2018;03;13;Lauantai;33;24;57;50;51;101
89;17.03.2018;2018;03;14;Lauantai;26;27;53;36;39;75
89;17.03.2018;2018;03;15;Lauantai;31;23;54;55;25;80
89;17.03.2018;2018;03;16;Lauantai;23;24;47;30;35;65
89;17.03.2018;2018;03;17;Lauantai;21;20;41;32;36;68
89;17.03.2018;2018;03;18;Lauantai;21;21;42;35;21;56
89;17.03.2018;2018;03;19;Lauantai;18;11;29;31;9;40
89;17.03.2018;2018;03;20;Lauantai;21;15;36;23;11;34
89;17.03.2018;2018;03;21;Lauantai;11;11;22;11;11;22
89;17.03.2018;2018;03;22;Lauantai;13;9;22;7;6;13
89;17.03.2018;2018;03;23;Lauantai;3;4;7;3;9;12
89;18.03.2018;2018;03;00;Sunnuntai;12;10;22;8;3;11
89;18.03.2018;2018;03;01;Sunnuntai;12;4;16;9;2;11
89;18.03.2018;2018;03;02;Sunnuntai;5;2;7;5;1;6
89;18.03.2018;2018;03;03;Sunnuntai;7;0;7;8;0;8
89;18.03.2018;2018;03;04;Sunnuntai;5;0;5;10;1;11
89;18.03.2018;2018;03;05;Sunnuntai;3;1;4;5;4;9
89;18.03.2018;2018;03;06;Sunnuntai;2;5;7;0;1;1
89;18.03.2018;2018;03;07;Sunnuntai;3;2;5;9;3;12
89;18.03.2018;2018;03;08;Sunnuntai;1;2;3;16;9;25
89;18.03.2018;2018;03;09;Sunnuntai;7;17;24;21;23;44
89;18.03.2018;2018;03;10;Sunnuntai;7;21;28;33;38;71
89;18.03.2018;2018;03;11;Sunnuntai;12;24;36;44;59;103
89;18.03.2018;2018;03;12;Sunnuntai;16;26;42;47;52;99
89;18.03.2018;2018;03;13;Sunnuntai;14;13;27;47;37;84
89;18.03.2018;2018;03;14;Sunnuntai;30;33;63;41;39;80
89;18.03.2018;2018;03;15;Sunnuntai;23;21;44;38;34;72
89;18.03.2018;2018;03;16;Sunnuntai;23;20;43;34;25;59
89;18.03.2018;2018;03;17;Sunnuntai;19;21;40;33;29;62
89;18.03.2018;2018;03;18;Sunnuntai;25;20;45;30;19;49
89;18.03.2018;2018;03;19;Sunnuntai;18;11;29;28;21;49
89;18.03.2018;2018;03;20;Sunnuntai;14;8;22;24;10;34
89;18.03.2018;2018;03;21;Sunnuntai;9;3;12;15;13;28
89;18.03.2018;2018;03;22;Sunnuntai;2;3;5;7;3;10
89;18.03.2018;2018;03;23;Sunnuntai;0;0;0;0;0;0
89;19.03.2018;2018;03;00;Maanantai;2;0;2;2;0;2
89;19.03.2018;2018;03;01;Maanantai;1;0;1;2;0;2
89;19.03.2018;2018;03;02;Maanantai;1;0;1;2;1;3
89;19.03.2018;2018;03;03;Maanantai;1;3;4;0;1;1
89;19.03.2018;2018;03;04;Maanantai;2;2;4;0;0;0
89;19.03.2018;2018;03;05;Maanantai;0;9;9;2;0;2
89;19.03.2018;2018;03;06;Maanantai;7;32;39;2;7;9
89;19.03.2018;2018;03;07;Maanantai;22;80;102;10;31;41
89;19.03.2018;2018;03;08;Maanantai;28;93;121;10;64;74
89;19.03.2018;2018;03;09;Maanantai;16;42;58;11;55;66
89;19.03.2018;2018;03;10;Maanantai;19;38;57;27;52;79
89;19.03.2018;2018;03;11;Maanantai;29;38;67;36;38;74
89;19.03.2018;2018;03;12;Maanantai;29;28;57;43;23;66
89;19.03.2018;2018;03;13;Maanantai;48;34;82;61;46;107
89;19.03.2018;2018;03;14;Maanantai;47;25;72;55;29;84
89;19.03.2018;2018;03;15;Maanantai;80;35;115;48;35;83
89;19.03.2018;2018;03;16;Maanantai;102;60;162;55;37;92
89;19.03.2018;2018;03;17;Maanantai;50;42;92;49;24;73
89;19.03.2018;2018;03;18;Maanantai;58;23;81;50;48;98
89;19.03.2018;2018;03;19;Maanantai;37;15;52;53;36;89
89;19.03.2018;2018;03;20;Maanantai;21;20;41;38;21;59
89;19.03.2018;2018;03;21;Maanantai;15;6;21;15;6;21
89;19.03.2018;2018;03;22;Maanantai;5;2;7;7;3;10
89;19.03.2018;2018;03;23;Maanantai;4;3;7;1;0;1
89;20.03.2018;2018;03;00;Tiistai;0;2;2;2;1;3
89;20.03.2018;2018;03;01;Tiistai;2;0;2;0;0;0
89;20.03.2018;2018;03;02;Tiistai;1;1;2;1;1;2
89;20.03.2018;2018;03;03;Tiistai;1;2;3;1;0;1
89;20.03.2018;2018;03;04;Tiistai;1;0;1;1;0;1
89;20.03.2018;2018;03;05;Tiistai;0;5;5;1;2;3
89;20.03.2018;2018;03;06;Tiistai;9;34;43;7;14;21
89;20.03.2018;2018;03;07;Tiistai;16;86;102;6;30;36
89;20.03.2018;2018;03;08;Tiistai;20;102;122;8;57;65
89;20.03.2018;2018;03;09;Tiistai;22;50;72;29;42;71
89;20.03.2018;2018;03;10;Tiistai;14;26;40;22;48;70
89;20.03.2018;2018;03;11;Tiistai;20;29;49;37;45;82
89;20.03.2018;2018;03;12;Tiistai;37;34;71;47;33;80
89;20.03.2018;2018;03;13;Tiistai;36;21;57;48;34;82
89;20.03.2018;2018;03;14;Tiistai;51;38;89;50;39;89
89;20.03.2018;2018;03;15;Tiistai;82;29;111;43;24;67
89;20.03.2018;2018;03;16;Tiistai;103;46;149;44;32;76
89;20.03.2018;2018;03;17;Tiistai;55;26;81;58;39;97
89;20.03.2018;2018;03;18;Tiistai;41;23;64;38;28;66
89;20.03.2018;2018;03;19;Tiistai;31;12;43;23;24;47
89;20.03.2018;2018;03;20;Tiistai;24;14;38;27;9;36
89;20.03.2018;2018;03;21;Tiistai;10;1;11;24;6;30
89;20.03.2018;2018;03;22;Tiistai;6;2;8;11;2;13
89;20.03.2018;2018;03;23;Tiistai;5;6;11;6;5;11
89;21.03.2018;2018;03;00;Keskiviikko;2;1;3;4;0;4
89;21.03.2018;2018;03;01;Keskiviikko;0;3;3;1;0;1
89;21.03.2018;2018;03;02;Keskiviikko;0;2;2;3;1;4
89;21.03.2018;2018;03;03;Keskiviikko;0;1;1;0;0;0
89;21.03.2018;2018;03;04;Keskiviikko;0;1;1;3;1;4
89;21.03.2018;2018;03;05;Keskiviikko;2;10;12;0;2;2
89;21.03.2018;2018;03;06;Keskiviikko;8;26;34;2;10;12
89;21.03.2018;2018;03;07;Keskiviikko;20;68;88;5;37;42
89;21.03.2018;2018;03;08;Keskiviikko;16;83;99;12;64;76
89;21.03.2018;2018;03;09;Keskiviikko;15;37;52;11;32;43
89;21.03.2018;2018;03;10;Keskiviikko;8;25;33;14;23;37
89;21.03.2018;2018;03;11;Keskiviikko;10;30;40;20;27;47
89;21.03.2018;2018;03;12;Keskiviikko;25;29;54;27;24;51
89;21.03.2018;2018;03;13;Keskiviikko;44;27;71;39;33;72
89;21.03.2018;2018;03;14;Keskiviikko;40;18;58;46;22;68
89;21.03.2018;2018;03;15;Keskiviikko;71;22;93;28;21;49
89;21.03.2018;2018;03;16;Keskiviikko;83;44;127;41;30;71
89;21.03.2018;2018;03;17;Keskiviikko;59;35;94;45;37;82
89;21.03.2018;2018;03;18;Keskiviikko;36;19;55;27;23;50
89;21.03.2018;2018;03;19;Keskiviikko;20;16;36;32;27;59
89;21.03.2018;2018;03;20;Keskiviikko;16;10;26;38;13;51
89;21.03.2018;2018;03;21;Keskiviikko;19;9;28;26;15;41
89;21.03.2018;2018;03;22;Keskiviikko;6;3;9;17;6;23
89;21.03.2018;2018;03;23;Keskiviikko;2;3;5;6;5;11
89;22.03.2018;2018;03;00;Torstai;0;2;2;4;1;5
89;22.03.2018;2018;03;01;Torstai;0;1;1;2;3;5
89;22.03.2018;2018;03;02;Torstai;1;2;3;3;1;4
89;22.03.2018;2018;03;03;Torstai;3;1;4;4;3;7
89;22.03.2018;2018;03;04;Torstai;3;1;4;1;1;2
89;22.03.2018;2018;03;05;Torstai;1;4;5;2;2;4
89;22.03.2018;2018;03;06;Torstai;6;30;36;2;17;19
89;22.03.2018;2018;03;07;Torstai;19;77;96;11;37;48
89;22.03.2018;2018;03;08;Torstai;19;75;94;14;77;91
89;22.03.2018;2018;03;09;Torstai;14;42;56;11;46;57
89;22.03.2018;2018;03;10;Torstai;25;35;60;20;44;64
89;22.03.2018;2018;03;11;Torstai;20;41;61;36;47;83
89;22.03.2018;2018;03;12;Torstai;24;36;60;47;33;80
89;22.03.2018;2018;03;13;Torstai;34;36;70;65;39;104
89;22.03.2018;2018;03;14;Torstai;56;39;95;60;20;80
89;22.03.2018;2018;03;15;Torstai;72;39;111;55;29;84
89;22.03.2018;2018;03;16;Torstai;98;42;140;73;24;97
89;22.03.2018;2018;03;17;Torstai;53;39;92;31;26;57
89;22.03.2018;2018;03;18;Torstai;42;22;64;30;29;59
89;22.03.2018;2018;03;19;Torstai;30;14;44;38;29;67
89;22.03.2018;2018;03;20;Torstai;30;15;45;23;15;38
89;22.03.2018;2018;03;21;Torstai;21;8;29;12;6;18
89;22.03.2018;2018;03;22;Torstai;12;6;18;8;8;16
89;22.03.2018;2018;03;23;Torstai;10;8;18;5;0;5
89;23.03.2018;2018;03;00;Perjantai;4;2;6;1;1;2
89;23.03.2018;2018;03;01;Perjantai;3;0;3;3;0;3
89;23.03.2018;2018;03;02;Perjantai;1;2;3;3;1;4
89;23.03.2018;2018;03;03;Perjantai;3;1;4;2;3;5
89;23.03.2018;2018;03;04;Perjantai;1;0;1;2;1;3
89;23.03.2018;2018;03;05;Perjantai;1;10;11;0;2;2
89;23.03.2018;2018;03;06;Perjantai;4;29;33;3;16;19
89;23.03.2018;2018;03;07;Perjantai;12;73;85;7;31;38
89;23.03.2018;2018;03;08;Perjantai;18;89;107;16;64;80
89;23.03.2018;2018;03;09;Perjantai;20;55;75;16;58;74
89;23.03.2018;2018;03;10;Perjantai;19;26;45;19;32;51
89;23.03.2018;2018;03;11;Perjantai;35;35;70;33;32;65
89;23.03.2018;2018;03;12;Perjantai;34;34;68;34;31;65
89;23.03.2018;2018;03;13;Perjantai;39;41;80;51;24;75
89;23.03.2018;2018;03;14;Perjantai;52;35;87;67;40;107
89;23.03.2018;2018;03;15;Perjantai;73;49;122;56;35;91
89;23.03.2018;2018;03;16;Perjantai;76;40;116;47;35;82
89;23.03.2018;2018;03;17;Perjantai;46;23;69;30;28;58
89;23.03.2018;2018;03;18;Perjantai;39;22;61;39;31;70
89;23.03.2018;2018;03;19;Perjantai;28;17;45;41;19;60
89;23.03.2018;2018;03;20;Perjantai;22;11;33;24;25;49
89;23.03.2018;2018;03;21;Perjantai;15;6;21;22;10;32
89;23.03.2018;2018;03;22;Perjantai;10;7;17;10;7;17
89;23.03.2018;2018;03;23;Perjantai;10;6;16;7;5;12
89;24.03.2018;2018;03;00;Lauantai;4;2;6;10;5;15
89;24.03.2018;2018;03;01;Lauantai;9;2;11;13;5;18
89;24.03.2018;2018;03;02;Lauantai;4;0;4;6;1;7
89;24.03.2018;2018;03;03;Lauantai;4;1;5;1;0;1
89;24.03.2018;2018;03;04;Lauantai;3;0;3;6;2;8
89;24.03.2018;2018;03;05;Lauantai;0;1;1;4;0;4
89;24.03.2018;2018;03;06;Lauantai;1;7;8;0;3;3
89;24.03.2018;2018;03;07;Lauantai;5;9;14;5;10;15
89;24.03.2018;2018;03;08;Lauantai;1;14;15;14;15;29
89;24.03.2018;2018;03;09;Lauantai;7;25;32;14;27;41
89;24.03.2018;2018;03;10;Lauantai;9;19;28;20;32;52
89;24.03.2018;2018;03;11;Lauantai;20;15;35;26;30;56
89;24.03.2018;2018;03;12;Lauantai;19;24;43;19;37;56
89;24.03.2018;2018;03;13;Lauantai;21;23;44;39;26;65
89;24.03.2018;2018;03;14;Lauantai;18;19;37;38;30;68
89;24.03.2018;2018;03;15;Lauantai;19;15;34;35;23;58
89;24.03.2018;2018;03;16;Lauantai;26;11;37;17;19;36
89;24.03.2018;2018;03;17;Lauantai;22;14;36;24;24;48
89;24.03.2018;2018;03;18;Lauantai;20;18;38;36;18;54
89;24.03.2018;2018;03;19;Lauantai;14;10;24;39;25;64
89;24.03.2018;2018;03;20;Lauantai;7;9;16;17;19;36
89;24.03.2018;2018;03;21;Lauantai;9;4;13;21;14;35
89;24.03.2018;2018;03;22;Lauantai;4;5;9;9;11;20
89;24.03.2018;2018;03;23;Lauantai;6;3;9;9;14;23
89;25.03.2018;2018;03;00;Sunnuntai;5;3;8;6;8;14
89;25.03.2018;2018;03;01;Sunnuntai;2;3;5;5;4;9
89;25.03.2018;2018;03;02;Sunnuntai;4;0;4;10;2;12
89;25.03.2018;2018;03;03;Sunnuntai;0;0;0;0;0;0
89;25.03.2018;2018;03;04;Sunnuntai;4;1;5;8;2;10
89;25.03.2018;2018;03;05;Sunnuntai;4;0;4;7;3;10
89;25.03.2018;2018;03;06;Sunnuntai;3;6;9;4;5;9
89;25.03.2018;2018;03;07;Sunnuntai;2;0;2;3;2;5
89;25.03.2018;2018;03;08;Sunnuntai;1;5;6;3;5;8
89;25.03.2018;2018;03;09;Sunnuntai;4;3;7;23;7;30
89;25.03.2018;2018;03;10;Sunnuntai;4;16;20;19;29;48
89;25.03.2018;2018;03;11;Sunnuntai;11;19;30;40;61;101
89;25.03.2018;2018;03;12;Sunnuntai;13;14;27;62;64;126
89;25.03.2018;2018;03;13;Sunnuntai;18;20;38;74;79;153
89;25.03.2018;2018;03;14;Sunnuntai;29;23;52;98;72;170
89;25.03.2018;2018;03;15;Sunnuntai;31;26;57;86;83;169
89;25.03.2018;2018;03;16;Sunnuntai;28;23;51;77;54;131
89;25.03.2018;2018;03;17;Sunnuntai;20;15;35;46;44;90
89;25.03.2018;2018;03;18;Sunnuntai;22;9;31;50;28;78
89;25.03.2018;2018;03;19;Sunnuntai;22;15;37;43;24;67
89;25.03.2018;2018;03;20;Sunnuntai;12;8;20;13;12;25
89;25.03.2018;2018;03;21;Sunnuntai;5;7;12;20;8;28
89;25.03.2018;2018;03;22;Sunnuntai;5;2;7;5;2;7
89;25.03.2018;2018;03;23;Sunnuntai;1;3;4;6;2;8
89;26.03.2018;2018;03;00;Maanantai;5;0;5;3;1;4
89;26.03.2018;2018;03;01;Maanantai;0;0;0;2;1;3
89;26.03.2018;2018;03;02;Maanantai;0;1;1;2;0;2
89;26.03.2018;2018;03;03;Maanantai;2;1;3;1;0;1
89;26.03.2018;2018;03;04;Maanantai;1;0;1;1;0;1
89;26.03.2018;2018;03;05;Maanantai;0;10;10;3;3;6
89;26.03.2018;2018;03;06;Maanantai;8;19;27;6;13;19
89;26.03.2018;2018;03;07;Maanantai;21;60;81;5;22;27
89;26.03.2018;2018;03;08;Maanantai;18;99;117;9;61;70
89;26.03.2018;2018;03;09;Maanantai;11;51;62;16;34;50
89;26.03.2018;2018;03;10;Maanantai;13;42;55;28;42;70
89;26.03.2018;2018;03;11;Maanantai;19;30;49;23;34;57
89;26.03.2018;2018;03;12;Maanantai;21;31;52;38;34;72
89;26.03.2018;2018;03;13;Maanantai;35;37;72;40;36;76
89;26.03.2018;2018;03;14;Maanantai;61;42;103;62;41;103
89;26.03.2018;2018;03;15;Maanantai;87;34;121;63;27;90
89;26.03.2018;2018;03;16;Maanantai;83;43;126;65;33;98
89;26.03.2018;2018;03;17;Maanantai;66;38;104;54;30;84
89;26.03.2018;2018;03;18;Maanantai;38;28;66;53;39;92
89;26.03.2018;2018;03;19;Maanantai;35;19;54;37;23;60
89;26.03.2018;2018;03;20;Maanantai;29;7;36;38;18;56
89;26.03.2018;2018;03;21;Maanantai;17;7;24;19;7;26
89;26.03.2018;2018;03;22;Maanantai;7;2;9;7;1;8
89;26.03.2018;2018;03;23;Maanantai;5;2;7;7;3;10
89;27.03.2018;2018;03;00;Tiistai;3;0;3;2;0;2
89;27.03.2018;2018;03;01;Tiistai;1;0;1;0;0;0
89;27.03.2018;2018;03;02;Tiistai;1;1;2;3;0;3
89;27.03.2018;2018;03;03;Tiistai;2;2;4;2;0;2
89;27.03.2018;2018;03;04;Tiistai;0;1;1;0;0;0
89;27.03.2018;2018;03;05;Tiistai;0;7;7;2;0;2
89;27.03.2018;2018;03;06;Tiistai;9;25;34;0;12;12
89;27.03.2018;2018;03;07;Tiistai;16;62;78;11;40;51
89;27.03.2018;2018;03;08;Tiistai;20;91;111;6;63;69
89;27.03.2018;2018;03;09;Tiistai;14;53;67;12;42;54
89;27.03.2018;2018;03;10;Tiistai;14;20;34;21;39;60
89;27.03.2018;2018;03;11;Tiistai;24;36;60;36;33;69
89;27.03.2018;2018;03;12;Tiistai;36;30;66;45;42;87
89;27.03.2018;2018;03;13;Tiistai;44;33;77;55;49;104
89;27.03.2018;2018;03;14;Tiistai;48;27;75;63;22;85
89;27.03.2018;2018;03;15;Tiistai;72;29;101;45;27;72
89;27.03.2018;2018;03;16;Tiistai;84;40;124;54;29;83
89;27.03.2018;2018;03;17;Tiistai;46;38;84;30;26;56
89;27.03.2018;2018;03;18;Tiistai;38;27;65;41;38;79
89;27.03.2018;2018;03;19;Tiistai;40;20;60;35;25;60
89;27.03.2018;2018;03;20;Tiistai;20;11;31;21;13;34
89;27.03.2018;2018;03;21;Tiistai;10;6;16;25;9;34
89;27.03.2018;2018;03;22;Tiistai;7;5;12;13;6;19
89;27.03.2018;2018;03;23;Tiistai;5;6;11;4;2;6
89;28.03.2018;2018;03;00;Keskiviikko;4;0;4;6;0;6
89;28.03.2018;2018;03;01;Keskiviikko;1;0;1;0;0;0
89;28.03.2018;2018;03;02;Keskiviikko;0;2;2;0;1;1
89;28.03.2018;2018;03;03;Keskiviikko;5;1;6;2;1;3
89;28.03.2018;2018;03;04;Keskiviikko;1;1;2;0;1;1
89;28.03.2018;2018;03;05;Keskiviikko;1;7;8;0;4;4
89;28.03.2018;2018;03;06;Keskiviikko;6;20;26;6;8;14
89;28.03.2018;2018;03;07;Keskiviikko;22;73;95;10;34;44
89;28.03.2018;2018;03;08;Keskiviikko;20;96;116;14;54;68
89;28.03.2018;2018;03;09;Keskiviikko;15;37;52;5;36;41
89;28.03.2018;2018;03;10;Keskiviikko;16;37;53;22;30;52
89;28.03.2018;2018;03;11;Keskiviikko;26;35;61;25;42;67
89;28.03.2018;2018;03;12;Keskiviikko;39;36;75;52;45;97
89;28.03.2018;2018;03;13;Keskiviikko;45;36;81;61;43;104
89;28.03.2018;2018;03;14;Keskiviikko;47;37;84;39;28;67
89;28.03.2018;2018;03;15;Keskiviikko;67;40;107;55;29;84
89;28.03.2018;2018;03;16;Keskiviikko;81;59;140;75;34;109
89;28.03.2018;2018;03;17;Keskiviikko;70;47;117;44;43;87
89;28.03.2018;2018;03;18;Keskiviikko;51;33;84;51;43;94
89;28.03.2018;2018;03;19;Keskiviikko;41;19;60;34;35;69
89;28.03.2018;2018;03;20;Keskiviikko;26;14;40;27;13;40
89;28.03.2018;2018;03;21;Keskiviikko;23;11;34;23;18;41
89;28.03.2018;2018;03;22;Keskiviikko;5;2;7;15;5;20
89;28.03.2018;2018;03;23;Keskiviikko;4;5;9;5;5;10
89;29.03.2018;2018;03;00;Torstai;4;0;4;7;1;8
89;29.03.2018;2018;03;01;Torstai;7;0;7;4;0;4
89;29.03.2018;2018;03;02;Torstai;6;1;7;1;0;1
89;29.03.2018;2018;03;03;Torstai;3;1;4;2;1;3
89;29.03.2018;2018;03;04;Torstai;0;0;0;3;4;7
89;29.03.2018;2018;03;05;Torstai;1;7;8;2;4;6
89;29.03.2018;2018;03;06;Torstai;12;24;36;3;7;10
89;29.03.2018;2018;03;07;Torstai;19;58;77;7;17;24
89;29.03.2018;2018;03;08;Torstai;10;96;106;10;48;58
89;29.03.2018;2018;03;09;Torstai;16;35;51;12;45;57
89;29.03.2018;2018;03;10;Torstai;16;29;45;37;41;78
89;29.03.2018;2018;03;11;Torstai;33;26;59;29;33;62
89;29.03.2018;2018;03;12;Torstai;37;28;65;46;27;73
89;29.03.2018;2018;03;13;Torstai;39;42;81;59;24;83
89;29.03.2018;2018;03;14;Torstai;57;26;83;41;29;70
89;29.03.2018;2018;03;15;Torstai;81;29;110;54;28;82
89;29.03.2018;2018;03;16;Torstai;50;41;91;30;20;50
89;29.03.2018;2018;03;17;Torstai;51;29;80;27;20;47
89;29.03.2018;2018;03;18;Torstai;25;23;48;28;19;47
89;29.03.2018;2018;03;19;Torstai;31;15;46;20;19;39
89;29.03.2018;2018;03;20;Torstai;21;21;42;31;22;53
89;29.03.2018;2018;03;21;Torstai;11;10;21;17;12;29
89;29.03.2018;2018;03;22;Torstai;10;8;18;14;6;20
89;29.03.2018;2018;03;23;Torstai;8;5;13;3;4;7
89;30.03.2018;2018;03;00;Perjantai;3;5;8;8;8;16
89;30.03.2018;2018;03;01;Perjantai;5;1;6;5;2;7
89;30.03.2018;2018;03;02;Perjantai;3;0;3;8;1;9
89;30.03.2018;2018;03;03;Perjantai;7;0;7;4;0;4
89;30.03.2018;2018;03;04;Perjantai;1;0;1;4;1;5
89;30.03.2018;2018;03;05;Perjantai;2;1;3;0;0;0
89;30.03.2018;2018;03;06;Perjantai;4;2;6;0;2;2
89;30.03.2018;2018;03;07;Perjantai;2;2;4;0;6;6
89;30.03.2018;2018;03;08;Perjantai;2;1;3;6;7;13
89;30.03.2018;2018;03;09;Perjantai;6;7;13;13;16;29
89;30.03.2018;2018;03;10;Perjantai;10;10;20;15;28;43
89;30.03.2018;2018;03;11;Perjantai;13;14;27;39;38;77
89;30.03.2018;2018;03;12;Perjantai;15;23;38;69;73;142
89;30.03.2018;2018;03;13;Perjantai;16;24;40;53;63;116
89;30.03.2018;2018;03;14;Perjantai;29;33;62;57;50;107
89;30.03.2018;2018;03;15;Perjantai;29;15;44;45;39;84
89;30.03.2018;2018;03;16;Perjantai;17;19;36;42;25;67
89;30.03.2018;2018;03;17;Perjantai;13;13;26;44;51;95
89;30.03.2018;2018;03;18;Perjantai;18;16;34;36;35;71
89;30.03.2018;2018;03;19;Perjantai;13;7;20;37;22;59
89;30.03.2018;2018;03;20;Perjantai;14;10;24;13;25;38
89;30.03.2018;2018;03;21;Perjantai;5;6;11;17;9;26
89;30.03.2018;2018;03;22;Perjantai;9;12;21;6;2;8
89;30.03.2018;2018;03;23;Perjantai;5;7;12;7;7;14
89;31.03.2018;2018;03;00;Lauantai;4;2;6;8;4;12
89;31.03.2018;2018;03;01;Lauantai;2;0;2;6;6;12
89;31.03.2018;2018;03;02;Lauantai;3;1;4;11;0;11
89;31.03.2018;2018;03;03;Lauantai;5;0;5;8;4;12
89;31.03.2018;2018;03;04;Lauantai;2;0;2;11;0;11
89;31.03.2018;2018;03;05;Lauantai;2;1;3;1;2;3
89;31.03.2018;2018;03;06;Lauantai;5;3;8;0;3;3
89;31.03.2018;2018;03;07;Lauantai;1;2;3;5;10;15
89;31.03.2018;2018;03;08;Lauantai;3;4;7;4;10;14
89;31.03.2018;2018;03;09;Lauantai;3;20;23;7;18;25
89;31.03.2018;2018;03;10;Lauantai;8;19;27;16;24;40
89;31.03.2018;2018;03;11;Lauantai;20;27;47;24;43;67
89;31.03.2018;2018;03;12;Lauantai;22;23;45;53;46;99
89;31.03.2018;2018;03;13;Lauantai;22;31;53;58;44;102
89;31.03.2018;2018;03;14;Lauantai;25;23;48;56;54;110
89;31.03.2018;2018;03;15;Lauantai;34;24;58;41;48;89
89;31.03.2018;2018;03;16;Lauantai;27;24;51;46;39;85
89;31.03.2018;2018;03;17;Lauantai;22;15;37;39;30;69
89;31.03.2018;2018;03;18;Lauantai;18;20;38;45;52;97
89;31.03.2018;2018;03;19;Lauantai;19;26;45;39;28;67
89;31.03.2018;2018;03;20;Lauantai;16;18;34;23;6;29
89;31.03.2018;2018;03;21;Lauantai;13;3;16;11;13;24
89;31.03.2018;2018;03;22;Lauantai;9;10;19;11;10;21
89;31.03.2018;2018;03;23;Lauantai;4;8;12;5;9;14
89;01.04.2018;2018;04;00;Sunnuntai;3;5;8;8;5;13
89;01.04.2018;2018;04;01;Sunnuntai;7;1;8;4;5;9
89;01.04.2018;2018;04;02;Sunnuntai;7;0;7;4;2;6
89;01.04.2018;2018;04;03;Sunnuntai;2;1;3;5;0;5
89;01.04.2018;2018;04;04;Sunnuntai;9;0;9;2;1;3
89;01.04.2018;2018;04;05;Sunnuntai;7;0;7;4;2;6
89;01.04.2018;2018;04;06;Sunnuntai;3;5;8;0;1;1
89;01.04.2018;2018;04;07;Sunnuntai;2;1;3;1;2;3
89;01.04.2018;2018;04;08;Sunnuntai;1;3;4;4;5;9
89;01.04.2018;2018;04;09;Sunnuntai;2;5;7;15;12;27
89;01.04.2018;2018;04;10;Sunnuntai;4;16;20;23;38;61
89;01.04.2018;2018;04;11;Sunnuntai;8;23;31;58;50;108
89;01.04.2018;2018;04;12;Sunnuntai;17;19;36;46;63;109
89;01.04.2018;2018;04;13;Sunnuntai;32;29;61;65;74;139
89;01.04.2018;2018;04;14;Sunnuntai;24;16;40;65;62;127
89;01.04.2018;2018;04;15;Sunnuntai;19;13;32;87;49;136
89;01.04.2018;2018;04;16;Sunnuntai;27;19;46;53;35;88
89;01.04.2018;2018;04;17;Sunnuntai;23;13;36;54;23;77
89;01.04.2018;2018;04;18;Sunnuntai;19;16;35;35;34;69
89;01.04.2018;2018;04;19;Sunnuntai;18;12;30;29;27;56
89;01.04.2018;2018;04;20;Sunnuntai;15;9;24;29;19;48
89;01.04.2018;2018;04;21;Sunnuntai;11;3;14;12;11;23
89;01.04.2018;2018;04;22;Sunnuntai;4;4;8;7;6;13
89;01.04.2018;2018;04;23;Sunnuntai;0;1;1;3;10;13
89;02.04.2018;2018;04;00;Maanantai;6;2;8;3;4;7
89;02.04.2018;2018;04;01;Maanantai;3;2;5;3;0;3
89;02.04.2018;2018;04;02;Maanantai;1;0;1;1;0;1
89;02.04.2018;2018;04;03;Maanantai;0;0;0;1;1;2
89;02.04.2018;2018;04;04;Maanantai;1;0;1;7;2;9
89;02.04.2018;2018;04;05;Maanantai;1;1;2;7;0;7
89;02.04.2018;2018;04;06;Maanantai;1;2;3;0;3;3
89;02.04.2018;2018;04;07;Maanantai;1;6;7;3;4;7
89;02.04.2018;2018;04;08;Maanantai;1;4;5;5;6;11
89;02.04.2018;2018;04;09;Maanantai;9;10;19;25;16;41
89;02.04.2018;2018;04;10;Maanantai;5;16;21;19;25;44
89;02.04.2018;2018;04;11;Maanantai;17;16;33;33;36;69
89;02.04.2018;2018;04;12;Maanantai;14;21;35;51;42;93
89;02.04.2018;2018;04;13;Maanantai;23;26;49;46;50;96
89;02.04.2018;2018;04;14;Maanantai;19;19;38;41;36;77
89;02.04.2018;2018;04;15;Maanantai;27;15;42;44;25;69
89;02.04.2018;2018;04;16;Maanantai;20;16;36;33;39;72
89;02.04.2018;2018;04;17;Maanantai;13;16;29;37;34;71
89;02.04.2018;2018;04;18;Maanantai;20;10;30;38;19;57
89;02.04.2018;2018;04;19;Maanantai;23;10;33;31;34;65
89;02.04.2018;2018;04;20;Maanantai;8;6;14;26;12;38
89;02.04.2018;2018;04;21;Maanantai;18;9;27;22;9;31
89;02.04.2018;2018;04;22;Maanantai;3;2;5;8;6;14
89;02.04.2018;2018;04;23;Maanantai;5;5;10;5;4;9
89;03.04.2018;2018;04;00;Tiistai;2;2;4;1;4;5
89;03.04.2018;2018;04;01;Tiistai;1;3;4;1;0;1
89;03.04.2018;2018;04;02;Tiistai;3;2;5;1;2;3
89;03.04.2018;2018;04;03;Tiistai;2;1;3;0;0;0
89;03.04.2018;2018;04;04;Tiistai;0;2;2;1;1;2
89;03.04.2018;2018;04;05;Tiistai;1;2;3;4;7;11
89;03.04.2018;2018;04;06;Tiistai;8;29;37;3;6;9
89;03.04.2018;2018;04;07;Tiistai;15;68;83;5;36;41
89;03.04.2018;2018;04;08;Tiistai;15;94;109;10;64;74
89;03.04.2018;2018;04;09;Tiistai;22;52;74;12;36;48
89;03.04.2018;2018;04;10;Tiistai;16;25;41;12;39;51
89;03.04.2018;2018;04;11;Tiistai;36;29;65;25;24;49
89;03.04.2018;2018;04;12;Tiistai;22;27;49;32;32;64
89;03.04.2018;2018;04;13;Tiistai;33;22;55;31;19;50
89;03.04.2018;2018;04;14;Tiistai;47;17;64;56;28;84
89;03.04.2018;2018;04;15;Tiistai;67;23;90;44;32;76
89;03.04.2018;2018;04;16;Tiistai;77;46;123;41;19;60
89;03.04.2018;2018;04;17;Tiistai;45;28;73;33;27;60
89;03.04.2018;2018;04;18;Tiistai;45;23;68;31;27;58
89;03.04.2018;2018;04;19;Tiistai;38;17;55;28;15;43
89;03.04.2018;2018;04;20;Tiistai;30;16;46;34;13;47
89;03.04.2018;2018;04;21;Tiistai;27;9;36;26;16;42
89;03.04.2018;2018;04;22;Tiistai;9;1;10;5;2;7
89;03.04.2018;2018;04;23;Tiistai;5;2;7;3;6;9
89;04.04.2018;2018;04;00;Keskiviikko;2;1;3;3;3;6
89;04.04.2018;2018;04;01;Keskiviikko;0;1;1;3;0;3
89;04.04.2018;2018;04;02;Keskiviikko;0;1;1;0;1;1
89;04.04.2018;2018;04;03;Keskiviikko;2;1;3;1;1;2
89;04.04.2018;2018;04;04;Keskiviikko;2;0;2;0;1;1
89;04.04.2018;2018;04;05;Keskiviikko;1;10;11;1;4;5
89;04.04.2018;2018;04;06;Keskiviikko;11;24;35;10;12;22
89;04.04.2018;2018;04;07;Keskiviikko;14;92;106;9;44;53
89;04.04.2018;2018;04;08;Keskiviikko;22;91;113;14;67;81
89;04.04.2018;2018;04;09;Keskiviikko;16;49;65;19;42;61
89;04.04.2018;2018;04;10;Keskiviikko;15;35;50;24;33;57
89;04.04.2018;2018;04;11;Keskiviikko;24;50;74;40;56;96
89;04.04.2018;2018;04;12;Keskiviikko;40;44;84;79;64;143
89;04.04.2018;2018;04;13;Keskiviikko;36;39;75;60;47;107
89;04.04.2018;2018;04;14;Keskiviikko;50;33;83;65;35;100
89;04.04.2018;2018;04;15;Keskiviikko;76;34;110;52;35;87
89;04.04.2018;2018;04;16;Keskiviikko;102;43;145;61;36;97
89;04.04.2018;2018;04;17;Keskiviikko;57;40;97;58;41;99
89;04.04.2018;2018;04;18;Keskiviikko;56;21;77;48;25;73
89;04.04.2018;2018;04;19;Keskiviikko;52;16;68;50;35;85
89;04.04.2018;2018;04;20;Keskiviikko;23;14;37;35;28;63
89;04.04.2018;2018;04;21;Keskiviikko;20;5;25;24;17;41
89;04.04.2018;2018;04;22;Keskiviikko;2;1;3;6;3;9
89;04.04.2018;2018;04;23;Keskiviikko;6;2;8;5;1;6
89;05.04.2018;2018;04;00;Torstai;1;0;1;3;2;5
89;05.04.2018;2018;04;01;Torstai;3;1;4;1;0;1
89;05.04.2018;2018;04;02;Torstai;0;0;0;0;0;0
89;05.04.2018;2018;04;03;Torstai;1;2;3;1;0;1
89;05.04.2018;2018;04;04;Torstai;2;2;4;0;0;0
89;05.04.2018;2018;04;05;Torstai;1;7;8;1;0;1
89;05.04.2018;2018;04;06;Torstai;9;39;48;7;14;21
89;05.04.2018;2018;04;07;Torstai;11;84;95;7;32;39
89;05.04.2018;2018;04;08;Torstai;18;97;115;7;58;65
89;05.04.2018;2018;04;09;Torstai;14;49;63;15;43;58
89;05.04.2018;2018;04;10;Torstai;24;36;60;25;30;55
89;05.04.2018;2018;04;11;Torstai;26;34;60;36;21;57
89;05.04.2018;2018;04;12;Torstai;29;44;73;31;28;59
89;05.04.2018;2018;04;13;Torstai;36;31;67;41;24;65
89;05.04.2018;2018;04;14;Torstai;56;24;80;40;28;68
89;05.04.2018;2018;04;15;Torstai;82;30;112;57;37;94
89;05.04.2018;2018;04;16;Torstai;75;48;123;51;29;80
89;05.04.2018;2018;04;17;Torstai;65;34;99;39;21;60
89;05.04.2018;2018;04;18;Torstai;44;32;76;37;28;65
89;05.04.2018;2018;04;19;Torstai;31;19;50;28;16;44
89;05.04.2018;2018;04;20;Torstai;15;15;30;38;15;53
89;05.04.2018;2018;04;21;Torstai;10;7;17;30;15;45
89;05.04.2018;2018;04;22;Torstai;6;0;6;12;7;19
89;05.04.2018;2018;04;23;Torstai;5;2;7;5;5;10
89;06.04.2018;2018;04;00;Perjantai;6;0;6;6;2;8
89;06.04.2018;2018;04;01;Perjantai;1;0;1;5;1;6
89;06.04.2018;2018;04;02;Perjantai;0;2;2;3;1;4
89;06.04.2018;2018;04;03;Perjantai;0;0;0;3;2;5
89;06.04.2018;2018;04;04;Perjantai;0;2;2;3;0;3
89;06.04.2018;2018;04;05;Perjantai;2;5;7;3;1;4
89;06.04.2018;2018;04;06;Perjantai;5;20;25;7;14;21
89;06.04.2018;2018;04;07;Perjantai;11;31;42;6;32;38
89;06.04.2018;2018;04;08;Perjantai;11;52;63;7;59;66
89;06.04.2018;2018;04;09;Perjantai;15;34;49;14;30;44
89;06.04.2018;2018;04;10;Perjantai;10;21;31;16;29;45
89;06.04.2018;2018;04;11;Perjantai;21;26;47;37;30;67
89;06.04.2018;2018;04;12;Perjantai;18;21;39;20;21;41
89;06.04.2018;2018;04;13;Perjantai;27;20;47;52;25;77
89;06.04.2018;2018;04;14;Perjantai;44;22;66;45;15;60
89;06.04.2018;2018;04;15;Perjantai;48;31;79;40;27;67
89;06.04.2018;2018;04;16;Perjantai;37;25;62;35;27;62
89;06.04.2018;2018;04;17;Perjantai;27;22;49;28;22;50
89;06.04.2018;2018;04;18;Perjantai;32;12;44;30;22;52
89;06.04.2018;2018;04;19;Perjantai;16;8;24;20;16;36
89;06.04.2018;2018;04;20;Perjantai;14;4;18;27;11;38
89;06.04.2018;2018;04;21;Perjantai;11;5;16;11;5;16
89;06.04.2018;2018;04;22;Perjantai;8;5;13;15;10;25
89;06.04.2018;2018;04;23;Perjantai;5;8;13;7;7;14
89;07.04.2018;2018;04;00;Lauantai;3;4;7;8;12;20
89;07.04.2018;2018;04;01;Lauantai;3;2;5;5;1;6
89;07.04.2018;2018;04;02;Lauantai;3;2;5;4;2;6
89;07.04.2018;2018;04;03;Lauantai;5;0;5;8;2;10
89;07.04.2018;2018;04;04;Lauantai;6;1;7;4;3;7
89;07.04.2018;2018;04;05;Lauantai;0;3;3;8;3;11
89;07.04.2018;2018;04;06;Lauantai;4;3;7;1;1;2
89;07.04.2018;2018;04;07;Lauantai;1;5;6;3;5;8
89;07.04.2018;2018;04;08;Lauantai;1;9;10;4;22;26
89;07.04.2018;2018;04;09;Lauantai;4;24;28;24;40;64
89;07.04.2018;2018;04;10;Lauantai;14;26;40;32;60;92
89;07.04.2018;2018;04;11;Lauantai;12;22;34;47;62;109
89;07.04.2018;2018;04;12;Lauantai;19;29;48;57;61;118
89;07.04.2018;2018;04;13;Lauantai;26;17;43;59;50;109
89;07.04.2018;2018;04;14;Lauantai;18;24;42;55;51;106
89;07.04.2018;2018;04;15;Lauantai;24;11;35;46;47;93
89;07.04.2018;2018;04;16;Lauantai;19;14;33;52;38;90
89;07.04.2018;2018;04;17;Lauantai;15;13;28;41;29;70
89;07.04.2018;2018;04;18;Lauantai;13;8;21;27;32;59
89;07.04.2018;2018;04;19;Lauantai;23;6;29;24;38;62
89;07.04.2018;2018;04;20;Lauantai;11;8;19;39;26;65
89;07.04.2018;2018;04;21;Lauantai;10;6;16;3;12;15
89;07.04.2018;2018;04;22;Lauantai;4;6;10;11;6;17
89;07.04.2018;2018;04;23;Lauantai;9;9;18;10;7;17
89;08.04.2018;2018;04;00;Sunnuntai;4;3;7;12;1;13
89;08.04.2018;2018;04;01;Sunnuntai;2;2;4;6;6;12
89;08.04.2018;2018;04;02;Sunnuntai;2;0;2;8;3;11
89;08.04.2018;2018;04;03;Sunnuntai;3;0;3;4;1;5
89;08.04.2018;2018;04;04;Sunnuntai;3;2;5;17;0;17
89;08.04.2018;2018;04;05;Sunnuntai;3;2;5;6;0;6
89;08.04.2018;2018;04;06;Sunnuntai;0;5;5;1;1;2
89;08.04.2018;2018;04;07;Sunnuntai;3;0;3;3;4;7
89;08.04.2018;2018;04;08;Sunnuntai;0;2;2;16;5;21
89;08.04.2018;2018;04;09;Sunnuntai;4;6;10;18;23;41
89;08.04.2018;2018;04;10;Sunnuntai;6;10;16;24;34;58
89;08.04.2018;2018;04;11;Sunnuntai;7;14;21;51;60;111
89;08.04.2018;2018;04;12;Sunnuntai;14;19;33;63;76;139
89;08.04.2018;2018;04;13;Sunnuntai;24;18;42;78;91;169
89;08.04.2018;2018;04;14;Sunnuntai;17;16;33;58;67;125
89;08.04.2018;2018;04;15;Sunnuntai;11;20;31;76;59;135
89;08.04.2018;2018;04;16;Sunnuntai;17;14;31;57;36;93
89;08.04.2018;2018;04;17;Sunnuntai;13;8;21;37;34;71
89;08.04.2018;2018;04;18;Sunnuntai;10;8;18;37;28;65
89;08.04.2018;2018;04;19;Sunnuntai;10;5;15;37;32;69
89;08.04.2018;2018;04;20;Sunnuntai;8;8;16;31;24;55
89;08.04.2018;2018;04;21;Sunnuntai;15;4;19;20;16;36
89;08.04.2018;2018;04;22;Sunnuntai;3;7;10;9;5;14
89;08.04.2018;2018;04;23;Sunnuntai;2;2;4;0;3;3
89;09.04.2018;2018;04;00;Maanantai;2;0;2;3;1;4
89;09.04.2018;2018;04;01;Maanantai;0;0;0;2;1;3
89;09.04.2018;2018;04;02;Maanantai;1;2;3;0;2;2
89;09.04.2018;2018;04;03;Maanantai;0;3;3;1;0;1
89;09.04.2018;2018;04;04;Maanantai;1;1;2;2;2;4
89;09.04.2018;2018;04;05;Maanantai;2;9;11;1;1;2
89;09.04.2018;2018;04;06;Maanantai;7;24;31;2;10;12
89;09.04.2018;2018;04;07;Maanantai;17;47;64;9;28;37
89;09.04.2018;2018;04;08;Maanantai;12;86;98;5;50;55
89;09.04.2018;2018;04;09;Maanantai;9;41;50;7;44;51
89;09.04.2018;2018;04;10;Maanantai;9;19;28;16;19;35
89;09.04.2018;2018;04;11;Maanantai;15;16;31;11;24;35
89;09.04.2018;2018;04;12;Maanantai;15;32;47;25;25;50
89;09.04.2018;2018;04;13;Maanantai;36;17;53;33;19;52
89;09.04.2018;2018;04;14;Maanantai;41;16;57;58;37;95
89;09.04.2018;2018;04;15;Maanantai;70;17;87;54;29;83
89;09.04.2018;2018;04;16;Maanantai;60;30;90;65;37;102
89;09.04.2018;2018;04;17;Maanantai;47;29;76;62;40;102
89;09.04.2018;2018;04;18;Maanantai;30;25;55;63;34;97
89;09.04.2018;2018;04;19;Maanantai;29;14;43;53;34;87
89;09.04.2018;2018;04;20;Maanantai;25;7;32;43;22;65
89;09.04.2018;2018;04;21;Maanantai;13;6;19;21;9;30
89;09.04.2018;2018;04;22;Maanantai;6;2;8;5;5;10
89;09.04.2018;2018;04;23;Maanantai;6;2;8;5;3;8
89;10.04.2018;2018;04;00;Tiistai;1;1;2;1;1;2
89;10.04.2018;2018;04;01;Tiistai;2;0;2;1;2;3
89;10.04.2018;2018;04;02;Tiistai;0;0;0;0;0;0
89;10.04.2018;2018;04;03;Tiistai;2;1;3;3;0;3
89;10.04.2018;2018;04;04;Tiistai;1;1;2;0;1;1
89;10.04.2018;2018;04;05;Tiistai;1;8;9;3;0;3
89;10.04.2018;2018;04;06;Tiistai;10;27;37;3;13;16
89;10.04.2018;2018;04;07;Tiistai;13;70;83;5;30;35
89;10.04.2018;2018;04;08;Tiistai;14;90;104;12;63;75
89;10.04.2018;2018;04;09;Tiistai;14;46;60;14;46;60
89;10.04.2018;2018;04;10;Tiistai;15;25;40;21;55;76
89;10.04.2018;2018;04;11;Tiistai;23;32;55;31;34;65
89;10.04.2018;2018;04;12;Tiistai;24;33;57;48;53;101
89;10.04.2018;2018;04;13;Tiistai;32;16;48;56;45;101
89;10.04.2018;2018;04;14;Tiistai;41;27;68;52;28;80
89;10.04.2018;2018;04;15;Tiistai;61;19;80;69;35;104
89;10.04.2018;2018;04;16;Tiistai;82;38;120;95;29;124
89;10.04.2018;2018;04;17;Tiistai;49;29;78;38;26;64
89;10.04.2018;2018;04;18;Tiistai;39;31;70;54;54;108
89;10.04.2018;2018;04;19;Tiistai;42;23;65;63;48;111
89;10.04.2018;2018;04;20;Tiistai;42;16;58;28;32;60
89;10.04.2018;2018;04;21;Tiistai;19;9;28;7;12;19
89;10.04.2018;2018;04;22;Tiistai;4;4;8;5;4;9
89;10.04.2018;2018;04;23;Tiistai;5;2;7;3;1;4
89;11.04.2018;2018;04;00;Keskiviikko;4;1;5;0;0;0
89;11.04.2018;2018;04;01;Keskiviikko;3;1;4;1;1;2
89;11.04.2018;2018;04;02;Keskiviikko;0;1;1;0;1;1
89;11.04.2018;2018;04;03;Keskiviikko;0;2;2;3;0;3
89;11.04.2018;2018;04;04;Keskiviikko;2;1;3;0;0;0
89;11.04.2018;2018;04;05;Keskiviikko;1;12;13;1;1;2
89;11.04.2018;2018;04;06;Keskiviikko;8;25;33;1;10;11
89;11.04.2018;2018;04;07;Keskiviikko;26;104;130;7;37;44
89;11.04.2018;2018;04;08;Keskiviikko;18;129;147;8;57;65
89;11.04.2018;2018;04;09;Keskiviikko;17;49;66;26;39;65
89;11.04.2018;2018;04;10;Keskiviikko;9;35;44;23;37;60
89;11.04.2018;2018;04;11;Keskiviikko;29;43;72;20;40;60
89;11.04.2018;2018;04;12;Keskiviikko;37;45;82;45;51;96
89;11.04.2018;2018;04;13;Keskiviikko;31;37;68;57;34;91
89;11.04.2018;2018;04;14;Keskiviikko;51;31;82;48;28;76
89;11.04.2018;2018;04;15;Keskiviikko;74;28;102;51;36;87
89;11.04.2018;2018;04;16;Keskiviikko;78;55;133;44;19;63
89;11.04.2018;2018;04;17;Keskiviikko;55;47;102;41;21;62
89;11.04.2018;2018;04;18;Keskiviikko;35;20;55;47;27;74
89;11.04.2018;2018;04;19;Keskiviikko;31;12;43;34;23;57
89;11.04.2018;2018;04;20;Keskiviikko;40;13;53;34;16;50
89;11.04.2018;2018;04;21;Keskiviikko;38;6;44;14;11;25
89;11.04.2018;2018;04;22;Keskiviikko;14;14;28;13;9;22
89;11.04.2018;2018;04;23;Keskiviikko;2;2;4;2;1;3
89;12.04.2018;2018;04;00;Torstai;3;3;6;1;5;6
89;12.04.2018;2018;04;01;Torstai;0;0;0;2;0;2
89;12.04.2018;2018;04;02;Torstai;2;3;5;3;0;3
89;12.04.2018;2018;04;03;Torstai;3;2;5;0;0;0
89;12.04.2018;2018;04;04;Torstai;1;1;2;2;0;2
89;12.04.2018;2018;04;05;Torstai;4;8;12;1;0;1
89;12.04.2018;2018;04;06;Torstai;9;17;26;2;10;12
89;12.04.2018;2018;04;07;Torstai;18;69;87;4;27;31
89;12.04.2018;2018;04;08;Torstai;13;96;109;7;57;64
89;12.04.2018;2018;04;09;Torstai;21;51;72;10;41;51
89;12.04.2018;2018;04;10;Torstai;10;30;40;12;19;31
89;12.04.2018;2018;04;11;Torstai;17;44;61;23;34;57
89;12.04.2018;2018;04;12;Torstai;30;37;67;37;31;68
89;12.04.2018;2018;04;13;Torstai;45;33;78;42;28;70
89;12.04.2018;2018;04;14;Torstai;53;35;88;48;22;70
89;12.04.2018;2018;04;15;Torstai;75;43;118;33;29;62
89;12.04.2018;2018;04;16;Torstai;75;54;129;50;29;79
89;12.04.2018;2018;04;17;Torstai;48;37;85;41;36;77
89;12.04.2018;2018;04;18;Torstai;54;25;79;35;26;61
89;12.04.2018;2018;04;19;Torstai;37;10;47;36;32;68
89;12.04.2018;2018;04;20;Torstai;29;9;38;32;18;50
89;12.04.2018;2018;04;21;Torstai;23;11;34;12;7;19
89;12.04.2018;2018;04;22;Torstai;14;6;20;4;7;11
89;12.04.2018;2018;04;23;Torstai;5;6;11;2;2;4
89;13.04.2018;2018;04;00;Perjantai;5;1;6;4;0;4
89;13.04.2018;2018;04;01;Perjantai;3;0;3;2;0;2
89;13.04.2018;2018;04;02;Perjantai;4;2;6;1;1;2
89;13.04.2018;2018;04;03;Perjantai;2;1;3;1;1;2
89;13.04.2018;2018;04;04;Perjantai;1;1;2;2;0;2
89;13.04.2018;2018;04;05;Perjantai;1;16;17;3;1;4
89;13.04.2018;2018;04;06;Perjantai;10;36;46;2;10;12
89;13.04.2018;2018;04;07;Perjantai;16;67;83;12;30;42
89;13.04.2018;2018;04;08;Perjantai;19;86;105;8;45;53
89;13.04.2018;2018;04;09;Perjantai;14;52;66;15;43;58
89;13.04.2018;2018;04;10;Perjantai;20;27;47;20;35;55
89;13.04.2018;2018;04;11;Perjantai;25;41;66;34;35;69
89;13.04.2018;2018;04;12;Perjantai;35;53;88;28;40;68
89;13.04.2018;2018;04;13;Perjantai;55;47;102;44;35;79
89;13.04.2018;2018;04;14;Perjantai;64;51;115;54;23;77
89;13.04.2018;2018;04;15;Perjantai;80;42;122;32;40;72
89;13.04.2018;2018;04;16;Perjantai;65;56;121;38;36;74
89;13.04.2018;2018;04;17;Perjantai;59;54;113;27;37;64
89;13.04.2018;2018;04;18;Perjantai;36;33;69;29;25;54
89;13.04.2018;2018;04;19;Perjantai;31;25;56;30;28;58
89;13.04.2018;2018;04;20;Perjantai;26;16;42;20;20;40
89;13.04.2018;2018;04;21;Perjantai;25;16;41;22;11;33
89;13.04.2018;2018;04;22;Perjantai;17;11;28;9;10;19
89;13.04.2018;2018;04;23;Perjantai;12;8;20;4;5;9
89;14.04.2018;2018;04;00;Lauantai;4;9;13;2;5;7
89;14.04.2018;2018;04;01;Lauantai;6;0;6;3;1;4
89;14.04.2018;2018;04;02;Lauantai;6;4;10;5;0;5
89;14.04.2018;2018;04;03;Lauantai;7;3;10;5;1;6
89;14.04.2018;2018;04;04;Lauantai;6;0;6;10;0;10
89;14.04.2018;2018;04;05;Lauantai;1;5;6;9;1;10
89;14.04.2018;2018;04;06;Lauantai;4;3;7;2;2;4
89;14.04.2018;2018;04;07;Lauantai;3;8;11;1;6;7
89;14.04.2018;2018;04;08;Lauantai;3;13;16;6;12;18
89;14.04.2018;2018;04;09;Lauantai;8;37;45;14;22;36
89;14.04.2018;2018;04;10;Lauantai;12;37;49;26;58;84
89;14.04.2018;2018;04;11;Lauantai;16;53;69;32;54;86
89;14.04.2018;2018;04;12;Lauantai;30;56;86;60;78;138
89;14.04.2018;2018;04;13;Lauantai;43;48;91;48;52;100
89;14.04.2018;2018;04;14;Lauantai;35;39;74;43;51;94
89;14.04.2018;2018;04;15;Lauantai;43;21;64;66;50;116
89;14.04.2018;2018;04;16;Lauantai;41;42;83;45;30;75
89;14.04.2018;2018;04;17;Lauantai;30;17;47;33;15;48
89;14.04.2018;2018;04;18;Lauantai;33;17;50;21;25;46
89;14.04.2018;2018;04;19;Lauantai;29;20;49;19;21;40
89;14.04.2018;2018;04;20;Lauantai;18;11;29;15;11;26
89;14.04.2018;2018;04;21;Lauantai;18;9;27;15;10;25
89;14.04.2018;2018;04;22;Lauantai;5;17;22;4;9;13
89;14.04.2018;2018;04;23;Lauantai;5;7;12;11;6;17
89;15.04.2018;2018;04;00;Sunnuntai;9;3;12;3;2;5
89;15.04.2018;2018;04;01;Sunnuntai;2;7;9;6;3;9
89;15.04.2018;2018;04;02;Sunnuntai;5;6;11;9;8;17
89;15.04.2018;2018;04;03;Sunnuntai;10;0;10;3;2;5
89;15.04.2018;2018;04;04;Sunnuntai;6;1;7;8;0;8
89;15.04.2018;2018;04;05;Sunnuntai;7;2;9;4;1;5
89;15.04.2018;2018;04;06;Sunnuntai;1;4;5;1;2;3
89;15.04.2018;2018;04;07;Sunnuntai;5;9;14;3;6;9
89;15.04.2018;2018;04;08;Sunnuntai;1;9;10;12;14;26
89;15.04.2018;2018;04;09;Sunnuntai;7;18;25;19;24;43
89;15.04.2018;2018;04;10;Sunnuntai;20;30;50;30;38;68
89;15.04.2018;2018;04;11;Sunnuntai;25;59;84;64;83;147
89;15.04.2018;2018;04;12;Sunnuntai;37;44;81;80;96;176
89;15.04.2018;2018;04;13;Sunnuntai;50;53;103;83;96;179
89;15.04.2018;2018;04;14;Sunnuntai;53;52;105;140;94;234
89;15.04.2018;2018;04;15;Sunnuntai;54;52;106;92;69;161
89;15.04.2018;2018;04;16;Sunnuntai;51;49;100;61;41;102
89;15.04.2018;2018;04;17;Sunnuntai;58;36;94;53;43;96
89;15.04.2018;2018;04;18;Sunnuntai;44;31;75;63;33;96
89;15.04.2018;2018;04;19;Sunnuntai;24;25;49;41;33;74
89;15.04.2018;2018;04;20;Sunnuntai;30;7;37;33;15;48
89;15.04.2018;2018;04;21;Sunnuntai;13;13;26;16;7;23
89;15.04.2018;2018;04;22;Sunnuntai;4;10;14;8;3;11
89;15.04.2018;2018;04;23;Sunnuntai;4;1;5;5;3;8
89;16.04.2018;2018;04;00;Maanantai;4;2;6;4;1;5
89;16.04.2018;2018;04;01;Maanantai;3;0;3;0;0;0
89;16.04.2018;2018;04;02;Maanantai;2;0;2;1;1;2
89;16.04.2018;2018;04;03;Maanantai;4;1;5;1;0;1
89;16.04.2018;2018;04;04;Maanantai;1;4;5;1;0;1
89;16.04.2018;2018;04;05;Maanantai;2;9;11;3;0;3
89;16.04.2018;2018;04;06;Maanantai;10;37;47;3;5;8
89;16.04.2018;2018;04;07;Maanantai;27;98;125;9;31;40
89;16.04.2018;2018;04;08;Maanantai;15;115;130;4;61;65
89;16.04.2018;2018;04;09;Maanantai;20;67;87;15;48;63
89;16.04.2018;2018;04;10;Maanantai;16;54;70;32;31;63
89;16.04.2018;2018;04;11;Maanantai;34;56;90;24;36;60
89;16.04.2018;2018;04;12;Maanantai;53;45;98;38;45;83
89;16.04.2018;2018;04;13;Maanantai;51;52;103;53;36;89
89;16.04.2018;2018;04;14;Maanantai;71;51;122;52;21;73
89;16.04.2018;2018;04;15;Maanantai;87;50;137;33;27;60
89;16.04.2018;2018;04;16;Maanantai;123;74;197;44;19;63
89;16.04.2018;2018;04;17;Maanantai;65;54;119;39;29;68
89;16.04.2018;2018;04;18;Maanantai;78;45;123;54;34;88
89;16.04.2018;2018;04;19;Maanantai;54;23;77;37;41;78
89;16.04.2018;2018;04;20;Maanantai;36;14;50;42;31;73
89;16.04.2018;2018;04;21;Maanantai;17;12;29;22;11;33
89;16.04.2018;2018;04;22;Maanantai;7;3;10;12;10;22
89;16.04.2018;2018;04;23;Maanantai;6;2;8;7;0;7
89;17.04.2018;2018;04;00;Tiistai;3;3;6;3;1;4
89;17.04.2018;2018;04;01;Tiistai;0;0;0;1;0;1
89;17.04.2018;2018;04;02;Tiistai;1;0;1;1;0;1
89;17.04.2018;2018;04;03;Tiistai;0;5;5;0;0;0
89;17.04.2018;2018;04;04;Tiistai;0;3;3;1;1;2
89;17.04.2018;2018;04;05;Tiistai;3;9;12;1;0;1
89;17.04.2018;2018;04;06;Tiistai;7;50;57;5;12;17
89;17.04.2018;2018;04;07;Tiistai;28;89;117;11;31;42
89;17.04.2018;2018;04;08;Tiistai;17;143;160;11;53;64
89;17.04.2018;2018;04;09;Tiistai;19;70;89;18;51;69
89;17.04.2018;2018;04;10;Tiistai;18;53;71;12;31;43
89;17.04.2018;2018;04;11;Tiistai;29;48;77;14;29;43
89;17.04.2018;2018;04;12;Tiistai;43;69;112;31;26;57
89;17.04.2018;2018;04;13;Tiistai;54;62;116;36;24;60
89;17.04.2018;2018;04;14;Tiistai;72;46;118;38;36;74
89;17.04.2018;2018;04;15;Tiistai;105;68;173;37;36;73
89;17.04.2018;2018;04;16;Tiistai;141;84;225;49;40;89
89;17.04.2018;2018;04;17;Tiistai;93;70;163;43;39;82
89;17.04.2018;2018;04;18;Tiistai;79;46;125;48;59;107
89;17.04.2018;2018;04;19;Tiistai;72;32;104;49;33;82
89;17.04.2018;2018;04;20;Tiistai;38;24;62;32;22;54
89;17.04.2018;2018;04;21;Tiistai;40;18;58;14;12;26
89;17.04.2018;2018;04;22;Tiistai;14;8;22;6;5;11
89;17.04.2018;2018;04;23;Tiistai;9;5;14;3;2;5
89;18.04.2018;2018;04;00;Keskiviikko;3;2;5;2;2;4
89;18.04.2018;2018;04;01;Keskiviikko;1;2;3;2;2;4
89;18.04.2018;2018;04;02;Keskiviikko;3;0;3;3;1;4
89;18.04.2018;2018;04;03;Keskiviikko;1;2;3;1;1;2
89;18.04.2018;2018;04;04;Keskiviikko;0;1;1;1;0;1
89;18.04.2018;2018;04;05;Keskiviikko;3;17;20;1;1;2
89;18.04.2018;2018;04;06;Keskiviikko;10;33;43;3;8;11
89;18.04.2018;2018;04;07;Keskiviikko;26;107;133;15;28;43
89;18.04.2018;2018;04;08;Keskiviikko;31;151;182;9;55;64
89;18.04.2018;2018;04;09;Keskiviikko;23;77;100;14;31;45
89;18.04.2018;2018;04;10;Keskiviikko;16;54;70;27;39;66
89;18.04.2018;2018;04;11;Keskiviikko;40;58;98;29;31;60
89;18.04.2018;2018;04;12;Keskiviikko;56;75;131;48;38;86
89;18.04.2018;2018;04;13;Keskiviikko;49;67;116;39;27;66
89;18.04.2018;2018;04;14;Keskiviikko;91;46;137;36;39;75
89;18.04.2018;2018;04;15;Keskiviikko;103;72;175;47;32;79
89;18.04.2018;2018;04;16;Keskiviikko;123;76;199;49;39;88
89;18.04.2018;2018;04;17;Keskiviikko;79;78;157;51;43;94
89;18.04.2018;2018;04;18;Keskiviikko;59;44;103;55;55;110
89;18.04.2018;2018;04;19;Keskiviikko;97;25;122;61;44;105
89;18.04.2018;2018;04;20;Keskiviikko;48;33;81;30;18;48
89;18.04.2018;2018;04;21;Keskiviikko;37;12;49;18;14;32
89;18.04.2018;2018;04;22;Keskiviikko;11;12;23;8;9;17
89;18.04.2018;2018;04;23;Keskiviikko;6;3;9;5;3;8
89;19.04.2018;2018;04;00;Torstai;3;0;3;1;1;2
89;19.04.2018;2018;04;01;Torstai;6;0;6;2;1;3
89;19.04.2018;2018;04;02;Torstai;2;1;3;0;0;0
89;19.04.2018;2018;04;03;Torstai;1;3;4;0;0;0
89;19.04.2018;2018;04;04;Torstai;3;5;8;0;0;0
89;19.04.2018;2018;04;05;Torstai;3;14;17;1;2;3
89;19.04.2018;2018;04;06;Torstai;11;41;52;3;9;12
89;19.04.2018;2018;04;07;Torstai;25;93;118;8;28;36
89;19.04.2018;2018;04;08;Torstai;34;145;179;9;55;64
89;19.04.2018;2018;04;09;Torstai;24;76;100;20;40;60
89;19.04.2018;2018;04;10;Torstai;22;56;78;10;34;44
89;19.04.2018;2018;04;11;Torstai;32;70;102;24;25;49
89;19.04.2018;2018;04;12;Torstai;45;58;103;30;47;77
89;19.04.2018;2018;04;13;Torstai;44;62;106;34;25;59
89;19.04.2018;2018;04;14;Torstai;88;42;130;45;26;71
89;19.04.2018;2018;04;15;Torstai;103;54;157;43;40;83
89;19.04.2018;2018;04;16;Torstai;144;77;221;41;31;72
89;19.04.2018;2018;04;17;Torstai;84;54;138;51;49;100
89;19.04.2018;2018;04;18;Torstai;62;69;131;49;44;93
89;19.04.2018;2018;04;19;Torstai;64;34;98;33;30;63
89;19.04.2018;2018;04;20;Torstai;52;29;81;27;12;39
89;19.04.2018;2018;04;21;Torstai;42;20;62;19;12;31
89;19.04.2018;2018;04;22;Torstai;21;9;30;9;9;18
89;19.04.2018;2018;04;23;Torstai;4;7;11;2;1;3
89;20.04.2018;2018;04;00;Perjantai;7;2;9;1;0;1
89;20.04.2018;2018;04;01;Perjantai;13;2;15;5;2;7
89;20.04.2018;2018;04;02;Perjantai;8;4;12;2;0;2
89;20.04.2018;2018;04;03;Perjantai;7;4;11;0;0;0
89;20.04.2018;2018;04;04;Perjantai;5;1;6;2;1;3
89;20.04.2018;2018;04;05;Perjantai;4;10;14;2;2;4
89;20.04.2018;2018;04;06;Perjantai;9;27;36;0;4;4
89;20.04.2018;2018;04;07;Perjantai;10;82;92;4;28;32
89;20.04.2018;2018;04;08;Perjantai;22;92;114;5;43;48
89;20.04.2018;2018;04;09;Perjantai;14;57;71;9;23;32
89;20.04.2018;2018;04;10;Perjantai;12;20;32;6;17;23
89;20.04.2018;2018;04;11;Perjantai;26;32;58;38;24;62
89;20.04.2018;2018;04;12;Perjantai;36;44;80;20;20;40
89;20.04.2018;2018;04;13;Perjantai;47;50;97;26;19;45
89;20.04.2018;2018;04;14;Perjantai;89;36;125;33;15;48
89;20.04.2018;2018;04;15;Perjantai;67;43;110;28;14;42
89;20.04.2018;2018;04;16;Perjantai;81;47;128;20;20;40
89;20.04.2018;2018;04;17;Perjantai;56;36;92;23;16;39
89;20.04.2018;2018;04;18;Perjantai;45;36;81;18;15;33
89;20.04.2018;2018;04;19;Perjantai;38;15;53;19;14;33
89;20.04.2018;2018;04;20;Perjantai;38;24;62;18;25;43
89;20.04.2018;2018;04;21;Perjantai;23;19;42;15;13;28
89;20.04.2018;2018;04;22;Perjantai;15;12;27;5;16;21
89;20.04.2018;2018;04;23;Perjantai;8;9;17;4;2;6
89;21.04.2018;2018;04;00;Lauantai;10;10;20;5;6;11
89;21.04.2018;2018;04;01;Lauantai;9;3;12;4;3;7
89;21.04.2018;2018;04;02;Lauantai;8;2;10;3;0;3
89;21.04.2018;2018;04;03;Lauantai;5;3;8;5;3;8
89;21.04.2018;2018;04;04;Lauantai;12;1;13;5;0;5
89;21.04.2018;2018;04;05;Lauantai;6;5;11;2;4;6
89;21.04.2018;2018;04;06;Lauantai;0;10;10;3;3;6
89;21.04.2018;2018;04;07;Lauantai;2;7;9;3;8;11
89;21.04.2018;2018;04;08;Lauantai;5;25;30;14;10;24
89;21.04.2018;2018;04;09;Lauantai;11;45;56;18;35;53
89;21.04.2018;2018;04;10;Lauantai;27;51;78;21;38;59
89;21.04.2018;2018;04;11;Lauantai;35;60;95;14;51;65
89;21.04.2018;2018;04;12;Lauantai;42;58;100;26;47;73
89;21.04.2018;2018;04;13;Lauantai;44;53;97;36;38;74
89;21.04.2018;2018;04;14;Lauantai;63;38;101;28;30;58
89;21.04.2018;2018;04;15;Lauantai;62;49;111;49;31;80
89;21.04.2018;2018;04;16;Lauantai;69;31;100;39;53;92
89;21.04.2018;2018;04;17;Lauantai;30;47;77;29;18;47
89;21.04.2018;2018;04;18;Lauantai;22;32;54;23;19;42
89;21.04.2018;2018;04;19;Lauantai;32;28;60;25;19;44
89;21.04.2018;2018;04;20;Lauantai;39;24;63;25;23;48
89;21.04.2018;2018;04;21;Lauantai;26;29;55;13;11;24
89;21.04.2018;2018;04;22;Lauantai;24;14;38;11;20;31
89;21.04.2018;2018;04;23;Lauantai;12;21;33;6;5;11
89;22.04.2018;2018;04;00;Sunnuntai;9;17;26;3;5;8
89;22.04.2018;2018;04;01;Sunnuntai;9;7;16;1;2;3
89;22.04.2018;2018;04;02;Sunnuntai;5;5;10;5;2;7
89;22.04.2018;2018;04;03;Sunnuntai;14;4;18;7;0;7
89;22.04.2018;2018;04;04;Sunnuntai;7;3;10;3;0;3
89;22.04.2018;2018;04;05;Sunnuntai;4;1;5;2;1;3
89;22.04.2018;2018;04;06;Sunnuntai;4;7;11;0;3;3
89;22.04.2018;2018;04;07;Sunnuntai;4;2;6;4;2;6
89;22.04.2018;2018;04;08;Sunnuntai;4;10;14;9;13;22
89;22.04.2018;2018;04;09;Sunnuntai;9;14;23;24;27;51
89;22.04.2018;2018;04;10;Sunnuntai;31;52;83;40;55;95
89;22.04.2018;2018;04;11;Sunnuntai;46;67;113;65;62;127
89;22.04.2018;2018;04;12;Sunnuntai;74;96;170;74;77;151
89;22.04.2018;2018;04;13;Sunnuntai;73;102;175;75;91;166
89;22.04.2018;2018;04;14;Sunnuntai;79;68;147;59;59;118
89;22.04.2018;2018;04;15;Sunnuntai;79;83;162;44;45;89
89;22.04.2018;2018;04;16;Sunnuntai;68;70;138;49;54;103
89;22.04.2018;2018;04;17;Sunnuntai;56;48;104;52;51;103
89;22.04.2018;2018;04;18;Sunnuntai;63;58;121;42;49;91
89;22.04.2018;2018;04;19;Sunnuntai;31;42;73;42;23;65
89;22.04.2018;2018;04;20;Sunnuntai;37;12;49;30;27;57
89;22.04.2018;2018;04;21;Sunnuntai;26;24;50;13;20;33
89;22.04.2018;2018;04;22;Sunnuntai;6;3;9;4;9;13
89;22.04.2018;2018;04;23;Sunnuntai;6;5;11;3;5;8
89;23.04.2018;2018;04;00;Maanantai;2;2;4;4;3;7
89;23.04.2018;2018;04;01;Maanantai;5;1;6;1;0;1
89;23.04.2018;2018;04;02;Maanantai;2;0;2;1;0;1
89;23.04.2018;2018;04;03;Maanantai;5;2;7;1;0;1
89;23.04.2018;2018;04;04;Maanantai;5;5;10;0;1;1
89;23.04.2018;2018;04;05;Maanantai;2;11;13;2;2;4
89;23.04.2018;2018;04;06;Maanantai;10;44;54;2;6;8
89;23.04.2018;2018;04;07;Maanantai;31;115;146;4;20;24
89;23.04.2018;2018;04;08;Maanantai;25;168;193;12;49;61
89;23.04.2018;2018;04;09;Maanantai;25;101;126;11;46;57
89;23.04.2018;2018;04;10;Maanantai;33;53;86;21;28;49
89;23.04.2018;2018;04;11;Maanantai;44;53;97;23;29;52
89;23.04.2018;2018;04;12;Maanantai;49;62;111;25;36;61
89;23.04.2018;2018;04;13;Maanantai;66;68;134;48;45;93
89;23.04.2018;2018;04;14;Maanantai;89;62;151;89;23;112
89;23.04.2018;2018;04;15;Maanantai;128;67;195;68;31;99
89;23.04.2018;2018;04;16;Maanantai;153;83;236;87;33;120
89;23.04.2018;2018;04;17;Maanantai;81;63;144;58;43;101
89;23.04.2018;2018;04;18;Maanantai;84;66;150;55;54;109
89;23.04.2018;2018;04;19;Maanantai;68;40;108;39;35;74
89;23.04.2018;2018;04;20;Maanantai;47;12;59;33;25;58
89;23.04.2018;2018;04;21;Maanantai;42;18;60;17;9;26
89;23.04.2018;2018;04;22;Maanantai;13;26;39;8;5;13
89;23.04.2018;2018;04;23;Maanantai;6;5;11;4;4;8
89;24.04.2018;2018;04;00;Tiistai;6;3;9;2;0;2
89;24.04.2018;2018;04;01;Tiistai;8;1;9;0;0;0
89;24.04.2018;2018;04;02;Tiistai;9;0;9;0;0;0
89;24.04.2018;2018;04;03;Tiistai;6;2;8;3;0;3
89;24.04.2018;2018;04;04;Tiistai;4;1;5;1;1;2
89;24.04.2018;2018;04;05;Tiistai;7;10;17;1;1;2
89;24.04.2018;2018;04;06;Tiistai;11;37;48;2;7;9
89;24.04.2018;2018;04;07;Tiistai;23;140;163;9;27;36
89;24.04.2018;2018;04;08;Tiistai;31;162;193;9;46;55
89;24.04.2018;2018;04;09;Tiistai;27;82;109;21;57;78
89;24.04.2018;2018;04;10;Tiistai;24;108;132;14;28;42
89;24.04.2018;2018;04;11;Tiistai;34;33;67;22;19;41
89;24.04.2018;2018;04;12;Tiistai;39;54;93;18;25;43
89;24.04.2018;2018;04;13;Tiistai;57;38;95;23;15;38
89;24.04.2018;2018;04;14;Tiistai;75;51;126;35;13;48
89;24.04.2018;2018;04;15;Tiistai;119;47;166;30;22;52
89;24.04.2018;2018;04;16;Tiistai;170;58;228;36;16;52
89;24.04.2018;2018;04;17;Tiistai;94;63;157;35;28;63
89;24.04.2018;2018;04;18;Tiistai;60;50;110;29;21;50
89;24.04.2018;2018;04;19;Tiistai;51;36;87;27;20;47
89;24.04.2018;2018;04;20;Tiistai;31;16;47;26;14;40
89;24.04.2018;2018;04;21;Tiistai;42;18;60;12;4;16
89;24.04.2018;2018;04;22;Tiistai;8;3;11;5;3;8
89;24.04.2018;2018;04;23;Tiistai;9;1;10;3;2;5
89;25.04.2018;2018;04;00;Keskiviikko;2;5;7;1;2;3
89;25.04.2018;2018;04;01;Keskiviikko;4;4;8;2;0;2
89;25.04.2018;2018;04;02;Keskiviikko;1;0;1;0;0;0
89;25.04.2018;2018;04;03;Keskiviikko;1;1;2;0;0;0
89;25.04.2018;2018;04;04;Keskiviikko;0;2;2;1;2;3
89;25.04.2018;2018;04;05;Keskiviikko;4;17;21;1;2;3
89;25.04.2018;2018;04;06;Keskiviikko;12;33;45;1;6;7
89;25.04.2018;2018;04;07;Keskiviikko;19;139;158;10;38;48
89;25.04.2018;2018;04;08;Keskiviikko;29;139;168;23;51;74
89;25.04.2018;2018;04;09;Keskiviikko;24;81;105;11;33;44
89;25.04.2018;2018;04;10;Keskiviikko;29;52;81;22;24;46
89;25.04.2018;2018;04;11;Keskiviikko;66;56;122;26;35;61
89;25.04.2018;2018;04;12;Keskiviikko;58;71;129;34;32;66
89;25.04.2018;2018;04;13;Keskiviikko;54;57;111;28;24;52
89;25.04.2018;2018;04;14;Keskiviikko;91;61;152;42;19;61
89;25.04.2018;2018;04;15;Keskiviikko;119;79;198;31;27;58
89;25.04.2018;2018;04;16;Keskiviikko;146;82;228;44;42;86
89;25.04.2018;2018;04;17;Keskiviikko;86;77;163;43;44;87
89;25.04.2018;2018;04;18;Keskiviikko;83;59;142;56;50;106
89;25.04.2018;2018;04;19;Keskiviikko;81;33;114;44;28;72
89;25.04.2018;2018;04;20;Keskiviikko;61;24;85;26;23;49
89;25.04.2018;2018;04;21;Keskiviikko;33;10;43;26;18;44
89;25.04.2018;2018;04;22;Keskiviikko;8;11;19;6;6;12
89;25.04.2018;2018;04;23;Keskiviikko;11;6;17;4;2;6
89;26.04.2018;2018;04;00;Torstai;8;5;13;2;2;4
89;26.04.2018;2018;04;01;Torstai;4;1;5;2;5;7
89;26.04.2018;2018;04;02;Torstai;3;1;4;4;0;4
89;26.04.2018;2018;04;03;Torstai;4;3;7;1;0;1
89;26.04.2018;2018;04;04;Torstai;2;3;5;1;3;4
89;26.04.2018;2018;04;05;Torstai;1;15;16;1;2;3
89;26.04.2018;2018;04;06;Torstai;12;29;41;3;8;11
89;26.04.2018;2018;04;07;Torstai;27;108;135;9;29;38
89;26.04.2018;2018;04;08;Torstai;19;137;156;10;33;43
89;26.04.2018;2018;04;09;Torstai;29;72;101;12;31;43
89;26.04.2018;2018;04;10;Torstai;29;52;81;25;29;54
89;26.04.2018;2018;04;11;Torstai;54;62;116;20;26;46
89;26.04.2018;2018;04;12;Torstai;43;62;105;27;34;61
89;26.04.2018;2018;04;13;Torstai;58;61;119;28;33;61
89;26.04.2018;2018;04;14;Torstai;95;62;157;34;29;63
89;26.04.2018;2018;04;15;Torstai;131;65;196;44;20;64
89;26.04.2018;2018;04;16;Torstai;153;92;245;37;28;65
89;26.04.2018;2018;04;17;Torstai;84;87;171;43;50;93
89;26.04.2018;2018;04;18;Torstai;87;71;158;48;34;82
89;26.04.2018;2018;04;19;Torstai;69;37;106;43;34;77
89;26.04.2018;2018;04;20;Torstai;61;36;97;30;33;63
89;26.04.2018;2018;04;21;Torstai;47;31;78;31;14;45
89;26.04.2018;2018;04;22;Torstai;20;34;54;9;11;20
89;26.04.2018;2018;04;23;Torstai;20;7;27;2;3;5
89;27.04.2018;2018;04;00;Perjantai;13;4;17;9;3;12
89;27.04.2018;2018;04;01;Perjantai;23;0;23;7;0;7
89;27.04.2018;2018;04;02;Perjantai;9;3;12;5;2;7
89;27.04.2018;2018;04;03;Perjantai;13;5;18;2;1;3
89;27.04.2018;2018;04;04;Perjantai;5;1;6;4;0;4
89;27.04.2018;2018;04;05;Perjantai;2;12;14;0;2;2
89;27.04.2018;2018;04;06;Perjantai;13;46;59;5;5;10
89;27.04.2018;2018;04;07;Perjantai;18;114;132;8;25;33
89;27.04.2018;2018;04;08;Perjantai;25;137;162;18;42;60
89;27.04.2018;2018;04;09;Perjantai;34;86;120;16;31;47
89;27.04.2018;2018;04;10;Perjantai;34;54;88;26;47;73
89;27.04.2018;2018;04;11;Perjantai;47;94;141;26;35;61
89;27.04.2018;2018;04;12;Perjantai;75;79;154;40;42;82
89;27.04.2018;2018;04;13;Perjantai;93;76;169;43;37;80
89;27.04.2018;2018;04;14;Perjantai;138;74;212;39;23;62
89;27.04.2018;2018;04;15;Perjantai;157;87;244;42;34;76
89;27.04.2018;2018;04;16;Perjantai;104;98;202;37;37;74
89;27.04.2018;2018;04;17;Perjantai;90;85;175;47;43;90
89;27.04.2018;2018;04;18;Perjantai;80;72;152;35;46;81
89;27.04.2018;2018;04;19;Perjantai;106;65;171;42;26;68
89;27.04.2018;2018;04;20;Perjantai;67;44;111;26;31;57
89;27.04.2018;2018;04;21;Perjantai;50;35;85;21;12;33
89;27.04.2018;2018;04;22;Perjantai;26;21;47;16;4;20
89;27.04.2018;2018;04;23;Perjantai;51;25;76;12;11;23
89;28.04.2018;2018;04;00;Lauantai;13;5;18;5;6;11
89;28.04.2018;2018;04;01;Lauantai;23;3;26;6;1;7
89;28.04.2018;2018;04;02;Lauantai;17;4;21;5;3;8
89;28.04.2018;2018;04;03;Lauantai;19;2;21;3;0;3
89;28.04.2018;2018;04;04;Lauantai;13;1;14;5;1;6
89;28.04.2018;2018;04;05;Lauantai;6;7;13;2;2;4
89;28.04.2018;2018;04;06;Lauantai;4;9;13;0;4;4
89;28.04.2018;2018;04;07;Lauantai;8;11;19;1;9;10
89;28.04.2018;2018;04;08;Lauantai;10;22;32;8;16;24
89;28.04.2018;2018;04;09;Lauantai;24;66;90;18;43;61
89;28.04.2018;2018;04;10;Lauantai;30;70;100;36;42;78
89;28.04.2018;2018;04;11;Lauantai;48;97;145;36;50;86
89;28.04.2018;2018;04;12;Lauantai;89;107;196;45;53;98
89;28.04.2018;2018;04;13;Lauantai;74;96;170;62;45;107
89;28.04.2018;2018;04;14;Lauantai;70;95;165;34;48;82
89;28.04.2018;2018;04;15;Lauantai;81;81;162;47;53;100
89;28.04.2018;2018;04;16;Lauantai;101;84;185;54;49;103
89;28.04.2018;2018;04;17;Lauantai;89;83;172;52;51;103
89;28.04.2018;2018;04;18;Lauantai;77;81;158;46;37;83
89;28.04.2018;2018;04;19;Lauantai;53;58;111;32;37;69
89;28.04.2018;2018;04;20;Lauantai;51;42;93;29;31;60
89;28.04.2018;2018;04;21;Lauantai;44;28;72;16;21;37
89;28.04.2018;2018;04;22;Lauantai;27;24;51;16;20;36
89;28.04.2018;2018;04;23;Lauantai;38;13;51;7;9;16
89;29.04.2018;2018;04;00;Sunnuntai;20;17;37;4;7;11
89;29.04.2018;2018;04;01;Sunnuntai;23;10;33;7;7;14
89;29.04.2018;2018;04;02;Sunnuntai;18;10;28;7;5;12
89;29.04.2018;2018;04;03;Sunnuntai;23;2;25;14;0;14
89;29.04.2018;2018;04;04;Sunnuntai;16;1;17;7;0;7
89;29.04.2018;2018;04;05;Sunnuntai;4;0;4;4;1;5
89;29.04.2018;2018;04;06;Sunnuntai;2;10;12;0;3;3
89;29.04.2018;2018;04;07;Sunnuntai;1;7;8;2;4;6
89;29.04.2018;2018;04;08;Sunnuntai;6;4;10;8;14;22
89;29.04.2018;2018;04;09;Sunnuntai;22;32;54;16;24;40
89;29.04.2018;2018;04;10;Sunnuntai;22;44;66;32;65;97
89;29.04.2018;2018;04;11;Sunnuntai;40;71;111;38;75;113
89;29.04.2018;2018;04;12;Sunnuntai;49;103;152;45;64;109
89;29.04.2018;2018;04;13;Sunnuntai;49;89;138;52;62;114
89;29.04.2018;2018;04;14;Sunnuntai;73;80;153;61;51;112
89;29.04.2018;2018;04;15;Sunnuntai;87;82;169;47;41;88
89;29.04.2018;2018;04;16;Sunnuntai;95;99;194;50;57;107
89;29.04.2018;2018;04;17;Sunnuntai;84;55;139;53;51;104
89;29.04.2018;2018;04;18;Sunnuntai;69;74;143;52;48;100
89;29.04.2018;2018;04;19;Sunnuntai;75;40;115;29;35;64
89;29.04.2018;2018;04;20;Sunnuntai;61;43;104;31;27;58
89;29.04.2018;2018;04;21;Sunnuntai;36;27;63;9;12;21
89;29.04.2018;2018;04;22;Sunnuntai;18;23;41;9;5;14
89;29.04.2018;2018;04;23;Sunnuntai;9;7;16;6;4;10
89;30.04.2018;2018;04;00;Maanantai;8;11;19;6;3;9
89;30.04.2018;2018;04;01;Maanantai;9;3;12;6;2;8
89;30.04.2018;2018;04;02;Maanantai;6;3;9;0;1;1
89;30.04.2018;2018;04;03;Maanantai;4;3;7;5;2;7
89;30.04.2018;2018;04;04;Maanantai;12;3;15;1;1;2
89;30.04.2018;2018;04;05;Maanantai;4;10;14;4;0;4
89;30.04.2018;2018;04;06;Maanantai;6;31;37;0;8;8
89;30.04.2018;2018;04;07;Maanantai;16;76;92;8;16;24
89;30.04.2018;2018;04;08;Maanantai;22;104;126;12;41;53
89;30.04.2018;2018;04;09;Maanantai;26;82;108;17;42;59
89;30.04.2018;2018;04;10;Maanantai;42;63;105;10;33;43
89;30.04.2018;2018;04;11;Maanantai;66;145;211;22;59;81
89;30.04.2018;2018;04;12;Maanantai;70;120;190;35;45;80
89;30.04.2018;2018;04;13;Maanantai;89;225;314;43;83;126
89;30.04.2018;2018;04;14;Maanantai;117;228;345;44;74;118
89;30.04.2018;2018;04;15;Maanantai;192;154;346;60;46;106
89;30.04.2018;2018;04;16;Maanantai;163;110;273;106;44;150
89;30.04.2018;2018;04;17;Maanantai;126;133;259;41;21;62
89;30.04.2018;2018;04;18;Maanantai;139;59;198;34;26;60
89;30.04.2018;2018;04;19;Maanantai;71;46;117;17;29;46
89;30.04.2018;2018;04;20;Maanantai;45;48;93;6;20;26
89;30.04.2018;2018;04;21;Maanantai;25;60;85;9;21;30
89;30.04.2018;2018;04;22;Maanantai;30;63;93;12;30;42
89;30.04.2018;2018;04;23;Maanantai;31;38;69;12;10;22
89;01.05.2018;2018;05;00;Tiistai;50;25;75;16;13;29
89;01.05.2018;2018;05;01;Tiistai;42;8;50;20;4;24
89;01.05.2018;2018;05;02;Tiistai;34;21;55;11;6;17
89;01.05.2018;2018;05;03;Tiistai;38;14;52;26;1;27
89;01.05.2018;2018;05;04;Tiistai;35;9;44;22;1;23
89;01.05.2018;2018;05;05;Tiistai;42;7;49;15;1;16
89;01.05.2018;2018;05;06;Tiistai;28;5;33;7;5;12
89;01.05.2018;2018;05;07;Tiistai;13;8;21;7;8;15
89;01.05.2018;2018;05;08;Tiistai;18;10;28;8;8;16
89;01.05.2018;2018;05;09;Tiistai;14;38;52;10;25;35
89;01.05.2018;2018;05;10;Tiistai;40;143;183;13;52;65
89;01.05.2018;2018;05;11;Tiistai;68;150;218;25;80;105
89;01.05.2018;2018;05;12;Tiistai;94;163;257;75;63;138
89;01.05.2018;2018;05;13;Tiistai;119;239;358;47;59;106
89;01.05.2018;2018;05;14;Tiistai;154;170;324;55;75;130
89;01.05.2018;2018;05;15;Tiistai;157;188;345;53;66;119
89;01.05.2018;2018;05;16;Tiistai;176;95;271;48;28;76
89;01.05.2018;2018;05;17;Tiistai;270;44;314;51;27;78
89;01.05.2018;2018;05;18;Tiistai;126;43;169;40;14;54
89;01.05.2018;2018;05;19;Tiistai;71;20;91;27;21;48
89;01.05.2018;2018;05;20;Tiistai;30;16;46;16;23;39
89;01.05.2018;2018;05;21;Tiistai;35;25;60;9;13;22
89;01.05.2018;2018;05;22;Tiistai;13;12;25;11;8;19
89;01.05.2018;2018;05;23;Tiistai;10;6;16;7;6;13
89;02.05.2018;2018;05;00;Keskiviikko;1;3;4;2;2;4
89;02.05.2018;2018;05;01;Keskiviikko;3;1;4;2;0;2
89;02.05.2018;2018;05;02;Keskiviikko;0;0;0;2;0;2
89;02.05.2018;2018;05;03;Keskiviikko;2;2;4;2;2;4
89;02.05.2018;2018;05;04;Keskiviikko;1;2;3;0;0;0
89;02.05.2018;2018;05;05;Keskiviikko;5;15;20;1;1;2
89;02.05.2018;2018;05;06;Keskiviikko;10;43;53;2;5;7
89;02.05.2018;2018;05;07;Keskiviikko;24;118;142;5;33;38
89;02.05.2018;2018;05;08;Keskiviikko;29;162;191;9;43;52
89;02.05.2018;2018;05;09;Keskiviikko;26;107;133;4;36;40
89;02.05.2018;2018;05;10;Keskiviikko;30;56;86;20;45;65
89;02.05.2018;2018;05;11;Keskiviikko;46;61;107;20;18;38
89;02.05.2018;2018;05;12;Keskiviikko;53;51;104;23;18;41
89;02.05.2018;2018;05;13;Keskiviikko;47;38;85;21;14;35
89;02.05.2018;2018;05;14;Keskiviikko;93;54;147;32;18;50
89;02.05.2018;2018;05;15;Keskiviikko;115;52;167;16;21;37
89;02.05.2018;2018;05;16;Keskiviikko;132;53;185;25;15;40
89;02.05.2018;2018;05;17;Keskiviikko;74;73;147;27;23;50
89;02.05.2018;2018;05;18;Keskiviikko;57;39;96;23;18;41
89;02.05.2018;2018;05;19;Keskiviikko;61;37;98;24;18;42
89;02.05.2018;2018;05;20;Keskiviikko;55;18;73;29;10;39
89;02.05.2018;2018;05;21;Keskiviikko;34;15;49;9;12;21
89;02.05.2018;2018;05;22;Keskiviikko;12;7;19;4;3;7
89;02.05.2018;2018;05;23;Keskiviikko;4;1;5;2;3;5
89;03.05.2018;2018;05;00;Torstai;3;1;4;3;2;5
89;03.05.2018;2018;05;01;Torstai;1;1;2;5;0;5
89;03.05.2018;2018;05;02;Torstai;0;1;1;2;0;2
89;03.05.2018;2018;05;03;Torstai;0;2;2;0;0;0
89;03.05.2018;2018;05;04;Torstai;3;2;5;0;1;1
89;03.05.2018;2018;05;05;Torstai;1;12;13;0;0;0
89;03.05.2018;2018;05;06;Torstai;9;59;68;0;9;9
89;03.05.2018;2018;05;07;Torstai;25;146;171;7;29;36
89;03.05.2018;2018;05;08;Torstai;33;193;226;12;45;57
89;03.05.2018;2018;05;09;Torstai;26;88;114;10;35;45
89;03.05.2018;2018;05;10;Torstai;23;61;84;10;25;35
89;03.05.2018;2018;05;11;Torstai;41;78;119;21;24;45
89;03.05.2018;2018;05;12;Torstai;70;63;133;18;25;43
89;03.05.2018;2018;05;13;Torstai;66;70;136;45;42;87
89;03.05.2018;2018;05;14;Torstai;110;49;159;41;21;62
89;03.05.2018;2018;05;15;Torstai;173;61;234;28;17;45
89;03.05.2018;2018;05;16;Torstai;138;79;217;30;18;48
89;03.05.2018;2018;05;17;Torstai;106;86;192;27;22;49
89;03.05.2018;2018;05;18;Torstai;85;50;135;31;35;66
89;03.05.2018;2018;05;19;Torstai;89;41;130;30;26;56
89;03.05.2018;2018;05;20;Torstai;44;26;70;20;20;40
89;03.05.2018;2018;05;21;Torstai;38;25;63;20;11;31
89;03.05.2018;2018;05;22;Torstai;23;9;32;6;3;9
89;03.05.2018;2018;05;23;Torstai;5;2;7;4;3;7
89;04.05.2018;2018;05;00;Perjantai;4;2;6;1;1;2
89;04.05.2018;2018;05;01;Perjantai;3;1;4;1;1;2
89;04.05.2018;2018;05;02;Perjantai;2;2;4;0;1;1
89;04.05.2018;2018;05;03;Perjantai;2;2;4;1;0;1
89;04.05.2018;2018;05;04;Perjantai;1;1;2;1;0;1
89;04.05.2018;2018;05;05;Perjantai;2;16;18;1;2;3
89;04.05.2018;2018;05;06;Perjantai;8;38;46;0;7;7
89;04.05.2018;2018;05;07;Perjantai;14;119;133;3;27;30
89;04.05.2018;2018;05;08;Perjantai;27;96;123;6;25;31
89;04.05.2018;2018;05;09;Perjantai;15;78;93;6;18;24
89;04.05.2018;2018;05;10;Perjantai;25;38;63;10;15;25
89;04.05.2018;2018;05;11;Perjantai;21;29;50;9;8;17
89;04.05.2018;2018;05;12;Perjantai;23;17;40;4;11;15
89;04.05.2018;2018;05;13;Perjantai;39;31;70;4;5;9
89;04.05.2018;2018;05;14;Perjantai;70;32;102;17;17;34
89;04.05.2018;2018;05;15;Perjantai;81;40;121;19;12;31
89;04.05.2018;2018;05;16;Perjantai;107;36;143;18;14;32
89;04.05.2018;2018;05;17;Perjantai;46;43;89;20;13;33
89;04.05.2018;2018;05;18;Perjantai;39;28;67;17;21;38
89;04.05.2018;2018;05;19;Perjantai;40;29;69;20;17;37
89;04.05.2018;2018;05;20;Perjantai;53;23;76;20;16;36
89;04.05.2018;2018;05;21;Perjantai;20;20;40;17;12;29
89;04.05.2018;2018;05;22;Perjantai;22;13;35;4;4;8
89;04.05.2018;2018;05;23;Perjantai;15;13;28;8;5;13
89;05.05.2018;2018;05;00;Lauantai;8;2;10;6;2;8
89;05.05.2018;2018;05;01;Lauantai;5;8;13;1;0;1
89;05.05.2018;2018;05;02;Lauantai;1;0;1;1;0;1
89;05.05.2018;2018;05;03;Lauantai;12;1;13;3;1;4
89;05.05.2018;2018;05;04;Lauantai;5;0;5;3;0;3
89;05.05.2018;2018;05;05;Lauantai;6;4;10;0;0;0
89;05.05.2018;2018;05;06;Lauantai;5;5;10;1;2;3
89;05.05.2018;2018;05;07;Lauantai;8;9;17;6;10;16
89;05.05.2018;2018;05;08;Lauantai;12;18;30;10;12;22
89;05.05.2018;2018;05;09;Lauantai;13;59;72;14;19;33
89;05.05.2018;2018;05;10;Lauantai;23;69;92;22;40;62
89;05.05.2018;2018;05;11;Lauantai;32;104;136;26;53;79
89;05.05.2018;2018;05;12;Lauantai;73;86;159;26;41;67
89;05.05.2018;2018;05;13;Lauantai;79;83;162;27;45;72
89;05.05.2018;2018;05;14;Lauantai;79;71;150;34;37;71
89;05.05.2018;2018;05;15;Lauantai;98;67;165;29;34;63
89;05.05.2018;2018;05;16;Lauantai;73;79;152;26;32;58
89;05.05.2018;2018;05;17;Lauantai;69;68;137;34;34;68
89;05.05.2018;2018;05;18;Lauantai;89;60;149;42;37;79
89;05.05.2018;2018;05;19;Lauantai;62;59;121;41;42;83
89;05.05.2018;2018;05;20;Lauantai;45;50;95;50;34;84
89;05.05.2018;2018;05;21;Lauantai;56;36;92;17;17;34
89;05.05.2018;2018;05;22;Lauantai;24;25;49;11;15;26
89;05.05.2018;2018;05;23;Lauantai;15;18;33;7;4;11
89;06.05.2018;2018;05;00;Sunnuntai;23;16;39;1;4;5
89;06.05.2018;2018;05;01;Sunnuntai;11;8;19;4;2;6
89;06.05.2018;2018;05;02;Sunnuntai;8;1;9;7;0;7
89;06.05.2018;2018;05;03;Sunnuntai;16;2;18;5;1;6
89;06.05.2018;2018;05;04;Sunnuntai;6;3;9;7;0;7
89;06.05.2018;2018;05;05;Sunnuntai;9;4;13;3;3;6
89;06.05.2018;2018;05;06;Sunnuntai;3;4;7;1;3;4
89;06.05.2018;2018;05;07;Sunnuntai;3;7;10;5;6;11
89;06.05.2018;2018;05;08;Sunnuntai;2;7;9;10;13;23
89;06.05.2018;2018;05;09;Sunnuntai;24;30;54;28;29;57
89;06.05.2018;2018;05;10;Sunnuntai;36;61;97;30;38;68
89;06.05.2018;2018;05;11;Sunnuntai;49;112;161;41;53;94
89;06.05.2018;2018;05;12;Sunnuntai;89;107;196;48;50;98
89;06.05.2018;2018;05;13;Sunnuntai;87;89;176;30;39;69
89;06.05.2018;2018;05;14;Sunnuntai;75;63;138;33;37;70
89;06.05.2018;2018;05;15;Sunnuntai;74;76;150;37;64;101
89;06.05.2018;2018;05;16;Sunnuntai;89;94;183;47;53;100
89;06.05.2018;2018;05;17;Sunnuntai;99;71;170;48;40;88
89;06.05.2018;2018;05;18;Sunnuntai;71;56;127;33;26;59
89;06.05.2018;2018;05;19;Sunnuntai;57;52;109;37;37;74
89;06.05.2018;2018;05;20;Sunnuntai;47;25;72;28;26;54
89;06.05.2018;2018;05;21;Sunnuntai;25;25;50;14;20;34
89;06.05.2018;2018;05;22;Sunnuntai;9;11;20;4;3;7
89;06.05.2018;2018;05;23;Sunnuntai;7;6;13;2;2;4
89;07.05.2018;2018;05;00;Maanantai;1;2;3;4;2;6
89;07.05.2018;2018;05;01;Maanantai;12;2;14;0;0;0
89;07.05.2018;2018;05;02;Maanantai;2;0;2;2;1;3
89;07.05.2018;2018;05;03;Maanantai;3;5;8;1;1;2
89;07.05.2018;2018;05;04;Maanantai;2;3;5;1;0;1
89;07.05.2018;2018;05;05;Maanantai;4;12;16;1;2;3
89;07.05.2018;2018;05;06;Maanantai;11;55;66;0;9;9
89;07.05.2018;2018;05;07;Maanantai;27;139;166;6;15;21
89;07.05.2018;2018;05;08;Maanantai;22;200;222;16;55;71
89;07.05.2018;2018;05;09;Maanantai;25;132;157;8;33;41
89;07.05.2018;2018;05;10;Maanantai;52;71;123;13;26;39
89;07.05.2018;2018;05;11;Maanantai;42;80;122;20;25;45
89;07.05.2018;2018;05;12;Maanantai;53;66;119;19;17;36
89;07.05.2018;2018;05;13;Maanantai;79;43;122;14;14;28
89;07.05.2018;2018;05;14;Maanantai;97;43;140;38;20;58
89;07.05.2018;2018;05;15;Maanantai;149;54;203;25;19;44
89;07.05.2018;2018;05;16;Maanantai;155;37;192;25;12;37
89;07.05.2018;2018;05;17;Maanantai;81;48;129;21;16;37
89;07.05.2018;2018;05;18;Maanantai;54;31;85;39;32;71
89;07.05.2018;2018;05;19;Maanantai;65;42;107;33;29;62
89;07.05.2018;2018;05;20;Maanantai;64;38;102;52;36;88
89;07.05.2018;2018;05;21;Maanantai;50;23;73;18;16;34
89;07.05.2018;2018;05;22;Maanantai;10;11;21;5;5;10
89;07.05.2018;2018;05;23;Maanantai;3;6;9;2;4;6
89;08.05.2018;2018;05;00;Tiistai;2;7;9;2;0;2
89;08.05.2018;2018;05;01;Tiistai;1;0;1;4;0;4
89;08.05.2018;2018;05;02;Tiistai;0;1;1;0;0;0
89;08.05.2018;2018;05;03;Tiistai;3;2;5;0;0;0
89;08.05.2018;2018;05;04;Tiistai;0;2;2;1;1;2
89;08.05.2018;2018;05;05;Tiistai;3;16;19;1;5;6
89;08.05.2018;2018;05;06;Tiistai;13;63;76;0;3;3
89;08.05.2018;2018;05;07;Tiistai;34;154;188;6;30;36
89;08.05.2018;2018;05;08;Tiistai;45;230;275;6;51;57
89;08.05.2018;2018;05;09;Tiistai;48;106;154;22;39;61
89;08.05.2018;2018;05;10;Tiistai;43;81;124;15;25;40
89;08.05.2018;2018;05;11;Tiistai;55;75;130;25;26;51
89;08.05.2018;2018;05;12;Tiistai;79;99;178;21;32;53
89;08.05.2018;2018;05;13;Tiistai;94;80;174;26;24;50
89;08.05.2018;2018;05;14;Tiistai;122;86;208;37;35;72
89;08.05.2018;2018;05;15;Tiistai;189;104;293;37;25;62
89;08.05.2018;2018;05;16;Tiistai;210;97;307;39;27;66
89;08.05.2018;2018;05;17;Tiistai;124;86;210;48;44;92
89;08.05.2018;2018;05;18;Tiistai;124;94;218;39;43;82
89;08.05.2018;2018;05;19;Tiistai;101;51;152;52;49;101
89;08.05.2018;2018;05;20;Tiistai;78;56;134;33;36;69
89;08.05.2018;2018;05;21;Tiistai;45;24;69;19;14;33
89;08.05.2018;2018;05;22;Tiistai;20;13;33;7;2;9
89;08.05.2018;2018;05;23;Tiistai;13;4;17;6;4;10
89;09.05.2018;2018;05;00;Keskiviikko;11;3;14;5;0;5
89;09.05.2018;2018;05;01;Keskiviikko;5;1;6;0;1;1
89;09.05.2018;2018;05;02;Keskiviikko;2;2;4;0;0;0
89;09.05.2018;2018;05;03;Keskiviikko;1;3;4;0;0;0
89;09.05.2018;2018;05;04;Keskiviikko;0;1;1;0;2;2
89;09.05.2018;2018;05;05;Keskiviikko;9;16;25;0;2;2
89;09.05.2018;2018;05;06;Keskiviikko;15;74;89;0;5;5
89;09.05.2018;2018;05;07;Keskiviikko;32;165;197;5;36;41
89;09.05.2018;2018;05;08;Keskiviikko;44;225;269;5;39;44
89;09.05.2018;2018;05;09;Keskiviikko;25;108;133;11;37;48
89;09.05.2018;2018;05;10;Keskiviikko;30;92;122;14;47;61
89;09.05.2018;2018;05;11;Keskiviikko;70;106;176;22;33;55
89;09.05.2018;2018;05;12;Keskiviikko;98;69;167;23;32;55
89;09.05.2018;2018;05;13;Keskiviikko;101;99;200;62;27;89
89;09.05.2018;2018;05;14;Keskiviikko;152;101;253;45;23;68
89;09.05.2018;2018;05;15;Keskiviikko;184;94;278;51;24;75
89;09.05.2018;2018;05;16;Keskiviikko;223;152;375;30;26;56
89;09.05.2018;2018;05;17;Keskiviikko;148;138;286;45;50;95
89;09.05.2018;2018;05;18;Keskiviikko;126;107;233;58;40;98
89;09.05.2018;2018;05;19;Keskiviikko;126;65;191;42;50;92
89;09.05.2018;2018;05;20;Keskiviikko;105;103;208;30;40;70
89;09.05.2018;2018;05;21;Keskiviikko;80;44;124;22;20;42
89;09.05.2018;2018;05;22;Keskiviikko;33;24;57;8;10;18
89;09.05.2018;2018;05;23;Keskiviikko;24;21;45;1;5;6
89;10.05.2018;2018;05;00;Torstai;22;7;29;2;5;7
89;10.05.2018;2018;05;01;Torstai;25;4;29;4;2;6
89;10.05.2018;2018;05;02;Torstai;9;6;15;8;0;8
89;10.05.2018;2018;05;03;Torstai;16;5;21;3;2;5
89;10.05.2018;2018;05;04;Torstai;6;13;19;2;1;3
89;10.05.2018;2018;05;05;Torstai;11;10;21;0;3;3
89;10.05.2018;2018;05;06;Torstai;2;20;22;1;3;4
89;10.05.2018;2018;05;07;Torstai;5;11;16;8;11;19
89;10.05.2018;2018;05;08;Torstai;24;31;55;9;6;15
89;10.05.2018;2018;05;09;Torstai;25;49;74;22;26;48
89;10.05.2018;2018;05;10;Torstai;30;95;125;20;33;53
89;10.05.2018;2018;05;11;Torstai;79;135;214;26;62;88
89;10.05.2018;2018;05;12;Torstai;105;178;283;38;57;95
89;10.05.2018;2018;05;13;Torstai;156;173;329;48;61;109
89;10.05.2018;2018;05;14;Torstai;165;232;397;80;59;139
89;10.05.2018;2018;05;15;Torstai;214;227;441;107;100;207
89;10.05.2018;2018;05;16;Torstai;208;200;408;65;81;146
89;10.05.2018;2018;05;17;Torstai;179;153;332;67;80;147
89;10.05.2018;2018;05;18;Torstai;198;123;321;61;57;118
89;10.05.2018;2018;05;19;Torstai;142;91;233;59;48;107
89;10.05.2018;2018;05;20;Torstai;90;50;140;38;33;71
89;10.05.2018;2018;05;21;Torstai;52;43;95;37;21;58
89;10.05.2018;2018;05;22;Torstai;27;18;45;6;11;17
89;10.05.2018;2018;05;23;Torstai;17;12;29;6;4;10
89;11.05.2018;2018;05;00;Perjantai;9;11;20;0;3;3
89;11.05.2018;2018;05;01;Perjantai;0;3;3;4;4;8
89;11.05.2018;2018;05;02;Perjantai;6;3;9;5;1;6
89;11.05.2018;2018;05;03;Perjantai;3;2;5;0;0;0
89;11.05.2018;2018;05;04;Perjantai;4;7;11;1;0;1
89;11.05.2018;2018;05;05;Perjantai;1;15;16;1;1;2
89;11.05.2018;2018;05;06;Perjantai;10;49;59;2;2;4
89;11.05.2018;2018;05;07;Perjantai;26;101;127;10;22;32
89;11.05.2018;2018;05;08;Perjantai;31;176;207;6;39;45
89;11.05.2018;2018;05;09;Perjantai;41;147;188;21;54;75
89;11.05.2018;2018;05;10;Perjantai;51;109;160;21;37;58
89;11.05.2018;2018;05;11;Perjantai;107;102;209;29;30;59
89;11.05.2018;2018;05;12;Perjantai;112;136;248;31;43;74
89;11.05.2018;2018;05;13;Perjantai;138;128;266;32;36;68
89;11.05.2018;2018;05;14;Perjantai;168;126;294;43;37;80
89;11.05.2018;2018;05;15;Perjantai;217;159;376;42;31;73
89;11.05.2018;2018;05;16;Perjantai;200;158;358;37;61;98
89;11.05.2018;2018;05;17;Perjantai;147;144;291;37;57;94
89;11.05.2018;2018;05;18;Perjantai;127;137;264;44;42;86
89;11.05.2018;2018;05;19;Perjantai;166;111;277;50;41;91
89;11.05.2018;2018;05;20;Perjantai;125;78;203;32;24;56
89;11.05.2018;2018;05;21;Perjantai;90;62;152;22;21;43
89;11.05.2018;2018;05;22;Perjantai;59;53;112;14;17;31
89;11.05.2018;2018;05;23;Perjantai;26;21;47;4;14;18
89;12.05.2018;2018;05;00;Lauantai;32;29;61;10;10;20
89;12.05.2018;2018;05;01;Lauantai;23;9;32;7;5;12
89;12.05.2018;2018;05;02;Lauantai;14;6;20;4;2;6
89;12.05.2018;2018;05;03;Lauantai;23;3;26;4;1;5
89;12.05.2018;2018;05;04;Lauantai;17;1;18;7;1;8
89;12.05.2018;2018;05;05;Lauantai;14;10;24;0;0;0
89;12.05.2018;2018;05;06;Lauantai;14;11;25;2;3;5
89;12.05.2018;2018;05;07;Lauantai;9;12;21;2;7;9
89;12.05.2018;2018;05;08;Lauantai;17;26;43;18;17;35
89;12.05.2018;2018;05;09;Lauantai;26;69;95;12;25;37
89;12.05.2018;2018;05;10;Lauantai;36;95;131;26;29;55
89;12.05.2018;2018;05;11;Lauantai;79;162;241;29;55;84
89;12.05.2018;2018;05;12;Lauantai;117;170;287;23;41;64
89;12.05.2018;2018;05;13;Lauantai;155;184;339;34;68;102
89;12.05.2018;2018;05;14;Lauantai;172;191;363;32;55;87
89;12.05.2018;2018;05;15;Lauantai;197;190;387;45;45;90
89;12.05.2018;2018;05;16;Lauantai;202;145;347;41;51;92
89;12.05.2018;2018;05;17;Lauantai;161;160;321;38;41;79
89;12.05.2018;2018;05;18;Lauantai;156;110;266;42;54;96
89;12.05.2018;2018;05;19;Lauantai;111;112;223;29;34;63
89;12.05.2018;2018;05;20;Lauantai;93;75;168;24;41;65
89;12.05.2018;2018;05;21;Lauantai;70;62;132;11;22;33
89;12.05.2018;2018;05;22;Lauantai;42;21;63;7;8;15
89;12.05.2018;2018;05;23;Lauantai;32;23;55;8;6;14
89;13.05.2018;2018;05;00;Sunnuntai;30;16;46;8;11;19
89;13.05.2018;2018;05;01;Sunnuntai;12;13;25;5;2;7
89;13.05.2018;2018;05;02;Sunnuntai;15;11;26;11;14;25
89;13.05.2018;2018;05;03;Sunnuntai;22;2;24;7;0;7
89;13.05.2018;2018;05;04;Sunnuntai;12;1;13;1;6;7
89;13.05.2018;2018;05;05;Sunnuntai;12;4;16;2;2;4
89;13.05.2018;2018;05;06;Sunnuntai;2;9;11;4;3;7
89;13.05.2018;2018;05;07;Sunnuntai;6;11;17;7;3;10
89;13.05.2018;2018;05;08;Sunnuntai;11;19;30;10;10;20
89;13.05.2018;2018;05;09;Sunnuntai;20;48;68;18;19;37
89;13.05.2018;2018;05;10;Sunnuntai;43;75;118;24;35;59
89;13.05.2018;2018;05;11;Sunnuntai;88;116;204;34;60;94
89;13.05.2018;2018;05;12;Sunnuntai;117;172;289;58;89;147
89;13.05.2018;2018;05;13;Sunnuntai;115;206;321;56;69;125
89;13.05.2018;2018;05;14;Sunnuntai;157;142;299;40;59;99
89;13.05.2018;2018;05;15;Sunnuntai;181;137;318;60;57;117
89;13.05.2018;2018;05;16;Sunnuntai;173;171;344;57;51;108
89;13.05.2018;2018;05;17;Sunnuntai;162;108;270;39;47;86
89;13.05.2018;2018;05;18;Sunnuntai;124;107;231;50;59;109
89;13.05.2018;2018;05;19;Sunnuntai;120;84;204;41;56;97
89;13.05.2018;2018;05;20;Sunnuntai;64;74;138;28;32;60
89;13.05.2018;2018;05;21;Sunnuntai;51;46;97;17;17;34
89;13.05.2018;2018;05;22;Sunnuntai;23;12;35;11;10;21
89;13.05.2018;2018;05;23;Sunnuntai;13;5;18;2;9;11
89;14.05.2018;2018;05;00;Maanantai;9;2;11;8;5;13
89;14.05.2018;2018;05;01;Maanantai;6;2;8;2;3;5
89;14.05.2018;2018;05;02;Maanantai;1;0;1;0;1;1
89;14.05.2018;2018;05;03;Maanantai;1;2;3;1;0;1
89;14.05.2018;2018;05;04;Maanantai;1;3;4;13;11;24
89;14.05.2018;2018;05;05;Maanantai;1;16;17;2;2;4
89;14.05.2018;2018;05;06;Maanantai;17;65;82;7;12;19
89;14.05.2018;2018;05;07;Maanantai;33;158;191;3;30;33
89;14.05.2018;2018;05;08;Maanantai;42;289;331;7;55;62
89;14.05.2018;2018;05;09;Maanantai;38;155;193;16;37;53
89;14.05.2018;2018;05;10;Maanantai;64;88;152;16;25;41
89;14.05.2018;2018;05;11;Maanantai;75;101;176;23;34;57
89;14.05.2018;2018;05;12;Maanantai;108;124;232;23;41;64
89;14.05.2018;2018;05;13;Maanantai;159;131;290;24;25;49
89;14.05.2018;2018;05;14;Maanantai;189;113;302;43;16;59
89;14.05.2018;2018;05;15;Maanantai;235;125;360;24;35;59
89;14.05.2018;2018;05;16;Maanantai;280;181;461;45;37;82
89;14.05.2018;2018;05;17;Maanantai;229;155;384;37;32;69
89;14.05.2018;2018;05;18;Maanantai;152;139;291;56;46;102
89;14.05.2018;2018;05;19;Maanantai;160;81;241;62;55;117
89;14.05.2018;2018;05;20;Maanantai;99;51;150;46;41;87
89;14.05.2018;2018;05;21;Maanantai;63;41;104;27;21;48
89;14.05.2018;2018;05;22;Maanantai;19;13;32;5;13;18
89;14.05.2018;2018;05;23;Maanantai;14;10;24;1;3;4
89;15.05.2018;2018;05;00;Tiistai;11;5;16;2;1;3
89;15.05.2018;2018;05;01;Tiistai;4;4;8;3;2;5
89;15.05.2018;2018;05;02;Tiistai;1;2;3;1;0;1
89;15.05.2018;2018;05;03;Tiistai;2;5;7;2;0;2
89;15.05.2018;2018;05;04;Tiistai;4;2;6;1;0;1
89;15.05.2018;2018;05;05;Tiistai;7;17;24;2;4;6
89;15.05.2018;2018;05;06;Tiistai;16;66;82;4;9;13
89;15.05.2018;2018;05;07;Tiistai;46;203;249;9;22;31
89;15.05.2018;2018;05;08;Tiistai;46;259;305;12;46;58
89;15.05.2018;2018;05;09;Tiistai;35;123;158;13;59;72
89;15.05.2018;2018;05;10;Tiistai;50;102;152;22;36;58
89;15.05.2018;2018;05;11;Tiistai;76;104;180;23;32;55
89;15.05.2018;2018;05;12;Tiistai;114;107;221;33;33;66
89;15.05.2018;2018;05;13;Tiistai;124;100;224;31;32;63
89;15.05.2018;2018;05;14;Tiistai;132;127;259;42;23;65
89;15.05.2018;2018;05;15;Tiistai;231;137;368;30;32;62
89;15.05.2018;2018;05;16;Tiistai;284;161;445;42;33;75
89;15.05.2018;2018;05;17;Tiistai;215;156;371;50;49;99
89;15.05.2018;2018;05;18;Tiistai;185;126;311;40;44;84
89;15.05.2018;2018;05;19;Tiistai;153;109;262;50;56;106
89;15.05.2018;2018;05;20;Tiistai;121;82;203;46;43;89
89;15.05.2018;2018;05;21;Tiistai;58;30;88;34;24;58
89;15.05.2018;2018;05;22;Tiistai;49;30;79;8;11;19
89;15.05.2018;2018;05;23;Tiistai;15;11;26;2;4;6
89;16.05.2018;2018;05;00;Keskiviikko;14;9;23;4;4;8
89;16.05.2018;2018;05;01;Keskiviikko;10;4;14;1;0;1
89;16.05.2018;2018;05;02;Keskiviikko;5;4;9;1;2;3
89;16.05.2018;2018;05;03;Keskiviikko;6;4;10;0;0;0
89;16.05.2018;2018;05;04;Keskiviikko;10;0;10;0;0;0
89;16.05.2018;2018;05;05;Keskiviikko;6;19;25;7;3;10
89;16.05.2018;2018;05;06;Keskiviikko;19;80;99;4;8;12
89;16.05.2018;2018;05;07;Keskiviikko;49;188;237;9;29;38
89;16.05.2018;2018;05;08;Keskiviikko;59;272;331;13;47;60
89;16.05.2018;2018;05;09;Keskiviikko;55;133;188;23;43;66
89;16.05.2018;2018;05;10;Keskiviikko;56;119;175;18;32;50
89;16.05.2018;2018;05;11;Keskiviikko;101;112;213;24;48;72
89;16.05.2018;2018;05;12;Keskiviikko;139;111;250;35;27;62
89;16.05.2018;2018;05;13;Keskiviikko;151;139;290;34;34;68
89;16.05.2018;2018;05;14;Keskiviikko;199;154;353;38;32;70
89;16.05.2018;2018;05;15;Keskiviikko;244;160;404;55;65;120
89;16.05.2018;2018;05;16;Keskiviikko;295;169;464;44;45;89
89;16.05.2018;2018;05;17;Keskiviikko;233;219;452;45;46;91
89;16.05.2018;2018;05;18;Keskiviikko;189;150;339;52;47;99
89;16.05.2018;2018;05;19;Keskiviikko;191;163;354;58;70;128
89;16.05.2018;2018;05;20;Keskiviikko;149;84;233;59;56;115
89;16.05.2018;2018;05;21;Keskiviikko;88;67;155;29;30;59
89;16.05.2018;2018;05;22;Keskiviikko;41;33;74;10;5;15
89;16.05.2018;2018;05;23;Keskiviikko;27;13;40;8;7;15
89;17.05.2018;2018;05;00;Torstai;8;8;16;4;1;5
89;17.05.2018;2018;05;01;Torstai;6;6;12;5;2;7
89;17.05.2018;2018;05;02;Torstai;8;6;14;1;1;2
89;17.05.2018;2018;05;03;Torstai;7;3;10;1;0;1
89;17.05.2018;2018;05;04;Torstai;5;0;5;1;1;2
89;17.05.2018;2018;05;05;Torstai;3;16;19;1;1;2
89;17.05.2018;2018;05;06;Torstai;11;69;80;2;11;13
89;17.05.2018;2018;05;07;Torstai;42;179;221;4;23;27
89;17.05.2018;2018;05;08;Torstai;62;261;323;8;59;67
89;17.05.2018;2018;05;09;Torstai;44;139;183;14;49;63
89;17.05.2018;2018;05;10;Torstai;47;111;158;22;36;58
89;17.05.2018;2018;05;11;Torstai;76;136;212;24;36;60
89;17.05.2018;2018;05;12;Torstai;108;105;213;32;28;60
89;17.05.2018;2018;05;13;Torstai;94;96;190;25;44;69
89;17.05.2018;2018;05;14;Torstai;165;111;276;38;36;74
89;17.05.2018;2018;05;15;Torstai;222;97;319;44;26;70
89;17.05.2018;2018;05;16;Torstai;287;128;415;40;29;69
89;17.05.2018;2018;05;17;Torstai;141;108;249;28;32;60
89;17.05.2018;2018;05;18;Torstai;132;119;251;36;43;79
89;17.05.2018;2018;05;19;Torstai;125;68;193;47;47;94
89;17.05.2018;2018;05;20;Torstai;80;44;124;34;25;59
89;17.05.2018;2018;05;21;Torstai;65;20;85;14;11;25
89;17.05.2018;2018;05;22;Torstai;31;9;40;5;4;9
89;17.05.2018;2018;05;23;Torstai;20;17;37;6;7;13
89;18.05.2018;2018;05;00;Perjantai;12;10;22;1;1;2
89;18.05.2018;2018;05;01;Perjantai;7;5;12;3;3;6
89;18.05.2018;2018;05;02;Perjantai;2;0;2;3;1;4
89;18.05.2018;2018;05;03;Perjantai;3;3;6;0;2;2
89;18.05.2018;2018;05;04;Perjantai;0;0;0;0;0;0
89;18.05.2018;2018;05;05;Perjantai;2;20;22;0;0;0
89;18.05.2018;2018;05;06;Perjantai;19;61;80;0;6;6
89;18.05.2018;2018;05;07;Perjantai;35;171;206;3;31;34
89;18.05.2018;2018;05;08;Perjantai;47;219;266;9;35;44
89;18.05.2018;2018;05;09;Perjantai;34;133;167;8;35;43
89;18.05.2018;2018;05;10;Perjantai;42;81;123;25;27;52
89;18.05.2018;2018;05;11;Perjantai;61;110;171;20;24;44
89;18.05.2018;2018;05;12;Perjantai;92;74;166;24;24;48
89;18.05.2018;2018;05;13;Perjantai;111;77;188;24;25;49
89;18.05.2018;2018;05;14;Perjantai;187;90;277;32;22;54
89;18.05.2018;2018;05;15;Perjantai;191;103;294;25;21;46
89;18.05.2018;2018;05;16;Perjantai;187;103;290;32;27;59
89;18.05.2018;2018;05;17;Perjantai;125;92;217;28;28;56
89;18.05.2018;2018;05;18;Perjantai;103;86;189;30;24;54
89;18.05.2018;2018;05;19;Perjantai;82;65;147;13;19;32
89;18.05.2018;2018;05;20;Perjantai;101;61;162;27;25;52
89;18.05.2018;2018;05;21;Perjantai;49;30;79;11;19;30
89;18.05.2018;2018;05;22;Perjantai;49;26;75;7;8;15
89;18.05.2018;2018;05;23;Perjantai;24;28;52;9;10;19
89;19.05.2018;2018;05;00;Lauantai;29;15;44;3;9;12
89;19.05.2018;2018;05;01;Lauantai;16;10;26;6;5;11
89;19.05.2018;2018;05;02;Lauantai;16;5;21;5;1;6
89;19.05.2018;2018;05;03;Lauantai;17;4;21;9;2;11
89;19.05.2018;2018;05;04;Lauantai;12;4;16;4;2;6
89;19.05.2018;2018;05;05;Lauantai;15;4;19;4;4;8
89;19.05.2018;2018;05;06;Lauantai;12;12;24;7;2;9
89;19.05.2018;2018;05;07;Lauantai;5;15;20;2;5;7
89;19.05.2018;2018;05;08;Lauantai;14;28;42;8;23;31
89;19.05.2018;2018;05;09;Lauantai;29;57;86;19;27;46
89;19.05.2018;2018;05;10;Lauantai;38;76;114;22;32;54
89;19.05.2018;2018;05;11;Lauantai;44;122;166;25;47;72
89;19.05.2018;2018;05;12;Lauantai;83;115;198;47;100;147
89;19.05.2018;2018;05;13;Lauantai;79;107;186;53;66;119
89;19.05.2018;2018;05;14;Lauantai;143;95;238;60;66;126
89;19.05.2018;2018;05;15;Lauantai;134;114;248;44;50;94
89;19.05.2018;2018;05;16;Lauantai;118;86;204;56;55;111
89;19.05.2018;2018;05;17;Lauantai;98;112;210;35;44;79
89;19.05.2018;2018;05;18;Lauantai;108;88;196;31;27;58
89;19.05.2018;2018;05;19;Lauantai;86;73;159;34;25;59
89;19.05.2018;2018;05;20;Lauantai;72;81;153;30;20;50
89;19.05.2018;2018;05;21;Lauantai;62;44;106;19;25;44
89;19.05.2018;2018;05;22;Lauantai;37;49;86;11;13;24
89;19.05.2018;2018;05;23;Lauantai;33;29;62;8;18;26
89;20.05.2018;2018;05;00;Sunnuntai;23;24;47;5;7;12
89;20.05.2018;2018;05;01;Sunnuntai;26;17;43;7;3;10
89;20.05.2018;2018;05;02;Sunnuntai;27;9;36;5;0;5
89;20.05.2018;2018;05;03;Sunnuntai;15;3;18;3;3;6
89;20.05.2018;2018;05;04;Sunnuntai;19;3;22;4;2;6
89;20.05.2018;2018;05;05;Sunnuntai;14;5;19;3;3;6
89;20.05.2018;2018;05;06;Sunnuntai;5;13;18;1;4;5
89;20.05.2018;2018;05;07;Sunnuntai;8;9;17;2;7;9
89;20.05.2018;2018;05;08;Sunnuntai;7;13;20;11;10;21
89;20.05.2018;2018;05;09;Sunnuntai;24;28;52;14;23;37
89;20.05.2018;2018;05;10;Sunnuntai;36;66;102;26;46;72
89;20.05.2018;2018;05;11;Sunnuntai;46;109;155;45;44;89
89;20.05.2018;2018;05;12;Sunnuntai;81;111;192;41;56;97
89;20.05.2018;2018;05;13;Sunnuntai;88;104;192;42;44;86
89;20.05.2018;2018;05;14;Sunnuntai;127;102;229;44;51;95
89;20.05.2018;2018;05;15;Sunnuntai;112;98;210;50;44;94
89;20.05.2018;2018;05;16;Sunnuntai;111;88;199;39;42;81
89;20.05.2018;2018;05;17;Sunnuntai;84;80;164;34;34;68
89;20.05.2018;2018;05;18;Sunnuntai;111;63;174;37;36;73
89;20.05.2018;2018;05;19;Sunnuntai;85;65;150;31;41;72
89;20.05.2018;2018;05;20;Sunnuntai;59;46;105;30;29;59
89;20.05.2018;2018;05;21;Sunnuntai;46;23;69;19;21;40
89;20.05.2018;2018;05;22;Sunnuntai;24;19;43;6;4;10
89;20.05.2018;2018;05;23;Sunnuntai;8;2;10;0;3;3
89;21.05.2018;2018;05;00;Maanantai;9;6;15;0;2;2
89;21.05.2018;2018;05;01;Maanantai;1;4;5;2;3;5
89;21.05.2018;2018;05;02;Maanantai;2;4;6;3;3;6
89;21.05.2018;2018;05;03;Maanantai;4;6;10;1;0;1
89;21.05.2018;2018;05;04;Maanantai;1;3;4;2;0;2
89;21.05.2018;2018;05;05;Maanantai;3;19;22;1;1;2
89;21.05.2018;2018;05;06;Maanantai;21;63;84;5;11;16
89;21.05.2018;2018;05;07;Maanantai;33;160;193;7;19;26
89;21.05.2018;2018;05;08;Maanantai;35;243;278;9;42;51
89;21.05.2018;2018;05;09;Maanantai;36;141;177;13;58;71
89;21.05.2018;2018;05;10;Maanantai;52;69;121;16;43;59
89;21.05.2018;2018;05;11;Maanantai;67;92;159;25;26;51
89;21.05.2018;2018;05;12;Maanantai;100;123;223;24;34;58
89;21.05.2018;2018;05;13;Maanantai;121;96;217;36;35;71
89;21.05.2018;2018;05;14;Maanantai;165;105;270;46;24;70
89;21.05.2018;2018;05;15;Maanantai;205;117;322;31;34;65
89;21.05.2018;2018;05;16;Maanantai;262;144;406;35;36;71
89;21.05.2018;2018;05;17;Maanantai;160;124;284;43;27;70
89;21.05.2018;2018;05;18;Maanantai;154;119;273;45;53;98
89;21.05.2018;2018;05;19;Maanantai;133;83;216;50;42;92
89;21.05.2018;2018;05;20;Maanantai;121;66;187;40;35;75
89;21.05.2018;2018;05;21;Maanantai;56;32;88;16;18;34
89;21.05.2018;2018;05;22;Maanantai;24;20;44;16;5;21
89;21.05.2018;2018;05;23;Maanantai;22;12;34;3;6;9
89;22.05.2018;2018;05;00;Tiistai;13;6;19;8;3;11
89;22.05.2018;2018;05;01;Tiistai;7;11;18;18;18;36
89;22.05.2018;2018;05;02;Tiistai;5;3;8;0;0;0
89;22.05.2018;2018;05;03;Tiistai;5;4;9;1;0;1
89;22.05.2018;2018;05;04;Tiistai;4;2;6;1;0;1
89;22.05.2018;2018;05;05;Tiistai;2;11;13;4;2;6
89;22.05.2018;2018;05;06;Tiistai;19;75;94;2;6;8
89;22.05.2018;2018;05;07;Tiistai;46;190;236;5;20;25
89;22.05.2018;2018;05;08;Tiistai;52;270;322;7;42;49
89;22.05.2018;2018;05;09;Tiistai;44;149;193;16;37;53
89;22.05.2018;2018;05;10;Tiistai;66;99;165;17;25;42
89;22.05.2018;2018;05;11;Tiistai;105;113;218;25;36;61
89;22.05.2018;2018;05;12;Tiistai;114;102;216;17;38;55
89;22.05.2018;2018;05;13;Tiistai;141;143;284;41;40;81
89;22.05.2018;2018;05;14;Tiistai;181;125;306;54;45;99
89;22.05.2018;2018;05;15;Tiistai;271;139;410;47;34;81
89;22.05.2018;2018;05;16;Tiistai;287;167;454;41;39;80
89;22.05.2018;2018;05;17;Tiistai;204;166;370;46;49;95
89;22.05.2018;2018;05;18;Tiistai;149;147;296;47;53;100
89;22.05.2018;2018;05;19;Tiistai;152;84;236;54;41;95
89;22.05.2018;2018;05;20;Tiistai;114;85;199;40;46;86
89;22.05.2018;2018;05;21;Tiistai;65;32;97;19;26;45
89;22.05.2018;2018;05;22;Tiistai;37;30;67;17;10;27
89;22.05.2018;2018;05;23;Tiistai;27;6;33;11;4;15
89;23.05.2018;2018;05;00;Keskiviikko;8;7;15;2;2;4
89;23.05.2018;2018;05;01;Keskiviikko;3;2;5;0;0;0
89;23.05.2018;2018;05;02;Keskiviikko;0;3;3;1;1;2
89;23.05.2018;2018;05;03;Keskiviikko;4;3;7;2;0;2
89;23.05.2018;2018;05;04;Keskiviikko;3;1;4;1;1;2
89;23.05.2018;2018;05;05;Keskiviikko;1;15;16;1;4;5
89;23.05.2018;2018;05;06;Keskiviikko;21;55;76;3;11;14
89;23.05.2018;2018;05;07;Keskiviikko;38;193;231;3;27;30
89;23.05.2018;2018;05;08;Keskiviikko;36;261;297;9;43;52
89;23.05.2018;2018;05;09;Keskiviikko;34;128;162;8;32;40
89;23.05.2018;2018;05;10;Keskiviikko;51;88;139;34;25;59
89;23.05.2018;2018;05;11;Keskiviikko;99;98;197;15;27;42
89;23.05.2018;2018;05;12;Keskiviikko;105;96;201;14;44;58
89;23.05.2018;2018;05;13;Keskiviikko;101;95;196;33;14;47
89;23.05.2018;2018;05;14;Keskiviikko;104;94;198;16;18;34
89;23.05.2018;2018;05;15;Keskiviikko;174;85;259;23;30;53
89;23.05.2018;2018;05;16;Keskiviikko;245;112;357;33;25;58
89;23.05.2018;2018;05;17;Keskiviikko;136;120;256;27;20;47
89;23.05.2018;2018;05;18;Keskiviikko;132;72;204;39;38;77
89;23.05.2018;2018;05;19;Keskiviikko;120;57;177;33;29;62
89;23.05.2018;2018;05;20;Keskiviikko;94;53;147;28;31;59
89;23.05.2018;2018;05;21;Keskiviikko;74;33;107;20;25;45
89;23.05.2018;2018;05;22;Keskiviikko;37;25;62;15;7;22
89;23.05.2018;2018;05;23;Keskiviikko;20;7;27;6;7;13
89;24.05.2018;2018;05;00;Torstai;19;9;28;9;7;16
89;24.05.2018;2018;05;01;Torstai;7;6;13;5;3;8
89;24.05.2018;2018;05;02;Torstai;4;5;9;0;1;1
89;24.05.2018;2018;05;03;Torstai;9;3;12;0;2;2
89;24.05.2018;2018;05;04;Torstai;2;2;4;1;1;2
89;24.05.2018;2018;05;05;Torstai;2;15;17;3;2;5
89;24.05.2018;2018;05;06;Torstai;25;64;89;3;8;11
89;24.05.2018;2018;05;07;Torstai;40;146;186;3;12;15
89;24.05.2018;2018;05;08;Torstai;35;244;279;4;33;37
89;24.05.2018;2018;05;09;Torstai;40;136;176;19;44;63
89;24.05.2018;2018;05;10;Torstai;53;87;140;16;31;47
89;24.05.2018;2018;05;11;Torstai;55;94;149;46;48;94
89;24.05.2018;2018;05;12;Torstai;91;117;208;23;44;67
89;24.05.2018;2018;05;13;Torstai;144;88;232;33;28;61
89;24.05.2018;2018;05;14;Torstai;170;83;253;31;24;55
89;24.05.2018;2018;05;15;Torstai;199;99;298;19;20;39
89;24.05.2018;2018;05;16;Torstai;212;88;300;33;18;51
89;24.05.2018;2018;05;17;Torstai;131;95;226;39;30;69
89;24.05.2018;2018;05;18;Torstai;104;81;185;26;31;57
89;24.05.2018;2018;05;19;Torstai;103;80;183;34;40;74
89;24.05.2018;2018;05;20;Torstai;79;48;127;24;17;41
89;24.05.2018;2018;05;21;Torstai;40;31;71;19;21;40
89;24.05.2018;2018;05;22;Torstai;27;18;45;8;6;14
89;24.05.2018;2018;05;23;Torstai;29;13;42;16;4;20
89;25.05.2018;2018;05;00;Perjantai;8;5;13;6;4;10
89;25.05.2018;2018;05;01;Perjantai;6;5;11;2;1;3
89;25.05.2018;2018;05;02;Perjantai;1;1;2;1;1;2
89;25.05.2018;2018;05;03;Perjantai;2;4;6;0;1;1
89;25.05.2018;2018;05;04;Perjantai;4;1;5;0;1;1
89;25.05.2018;2018;05;05;Perjantai;4;19;23;0;2;2
89;25.05.2018;2018;05;06;Perjantai;15;75;90;1;6;7
89;25.05.2018;2018;05;07;Perjantai;48;160;208;4;24;28
89;25.05.2018;2018;05;08;Perjantai;40;233;273;11;45;56
89;25.05.2018;2018;05;09;Perjantai;42;133;175;16;39;55
89;25.05.2018;2018;05;10;Perjantai;73;176;249;17;37;54
89;25.05.2018;2018;05;11;Perjantai;87;95;182;23;39;62
89;25.05.2018;2018;05;12;Perjantai;115;113;228;26;26;52
89;25.05.2018;2018;05;13;Perjantai;178;124;302;25;29;54
89;25.05.2018;2018;05;14;Perjantai;166;131;297;39;31;70
89;25.05.2018;2018;05;15;Perjantai;213;123;336;37;27;64
89;25.05.2018;2018;05;16;Perjantai;218;165;383;28;38;66
89;25.05.2018;2018;05;17;Perjantai;173;143;316;36;39;75
89;25.05.2018;2018;05;18;Perjantai;145;111;256;43;44;87
89;25.05.2018;2018;05;19;Perjantai;124;143;267;42;40;82
89;25.05.2018;2018;05;20;Perjantai;159;97;256;55;47;102
89;25.05.2018;2018;05;21;Perjantai;95;57;152;27;48;75
89;25.05.2018;2018;05;22;Perjantai;79;41;120;19;27;46
89;25.05.2018;2018;05;23;Perjantai;38;37;75;16;22;38
89;26.05.2018;2018;05;00;Lauantai;31;59;90;8;24;32
89;26.05.2018;2018;05;01;Lauantai;22;23;45;8;13;21
89;26.05.2018;2018;05;02;Lauantai;21;11;32;6;4;10
89;26.05.2018;2018;05;03;Lauantai;19;5;24;5;4;9
89;26.05.2018;2018;05;04;Lauantai;18;2;20;2;5;7
89;26.05.2018;2018;05;05;Lauantai;9;8;17;1;2;3
89;26.05.2018;2018;05;06;Lauantai;10;10;20;3;1;4
89;26.05.2018;2018;05;07;Lauantai;7;31;38;4;6;10
89;26.05.2018;2018;05;08;Lauantai;13;55;68;8;22;30
89;26.05.2018;2018;05;09;Lauantai;26;126;152;11;31;42
89;26.05.2018;2018;05;10;Lauantai;48;170;218;13;48;61
89;26.05.2018;2018;05;11;Lauantai;73;134;207;28;110;138
89;26.05.2018;2018;05;12;Lauantai;62;155;217;78;634;712
89;26.05.2018;2018;05;13;Lauantai;117;181;298;65;131;196
89;26.05.2018;2018;05;14;Lauantai;164;138;302;55;141;196
89;26.05.2018;2018;05;15;Lauantai;93;182;275;113;639;752
89;26.05.2018;2018;05;16;Lauantai;107;107;214;51;322;373
89;26.05.2018;2018;05;17;Lauantai;139;98;237;40;45;85
89;26.05.2018;2018;05;18;Lauantai;92;67;159;28;29;57
89;26.05.2018;2018;05;19;Lauantai;59;69;128;24;16;40
89;26.05.2018;2018;05;20;Lauantai;53;52;105;34;20;54
89;26.05.2018;2018;05;21;Lauantai;38;55;93;23;19;42
89;26.05.2018;2018;05;22;Lauantai;27;28;55;15;10;25
89;26.05.2018;2018;05;23;Lauantai;34;22;56;9;11;20
89;27.05.2018;2018;05;00;Sunnuntai;31;31;62;12;11;23
89;27.05.2018;2018;05;01;Sunnuntai;25;19;44;6;9;15
89;27.05.2018;2018;05;02;Sunnuntai;29;3;32;9;1;10
89;27.05.2018;2018;05;03;Sunnuntai;23;0;23;4;1;5
89;27.05.2018;2018;05;04;Sunnuntai;23;10;33;10;4;14
89;27.05.2018;2018;05;05;Sunnuntai;10;9;19;3;3;6
89;27.05.2018;2018;05;06;Sunnuntai;5;7;12;1;5;6
89;27.05.2018;2018;05;07;Sunnuntai;4;9;13;3;3;6
89;27.05.2018;2018;05;08;Sunnuntai;13;24;37;9;13;22
89;27.05.2018;2018;05;09;Sunnuntai;27;38;65;11;19;30
89;27.05.2018;2018;05;10;Sunnuntai;26;94;120;27;38;65
89;27.05.2018;2018;05;11;Sunnuntai;53;118;171;29;36;65
89;27.05.2018;2018;05;12;Sunnuntai;83;122;205;24;48;72
89;27.05.2018;2018;05;13;Sunnuntai;144;116;260;44;54;98
89;27.05.2018;2018;05;14;Sunnuntai;136;105;241;39;42;81
89;27.05.2018;2018;05;15;Sunnuntai;76;75;151;20;51;71
89;27.05.2018;2018;05;16;Sunnuntai;95;87;182;47;27;74
89;27.05.2018;2018;05;17;Sunnuntai;115;79;194;37;26;63
89;27.05.2018;2018;05;18;Sunnuntai;122;60;182;30;29;59
89;27.05.2018;2018;05;19;Sunnuntai;71;49;120;38;39;77
89;27.05.2018;2018;05;20;Sunnuntai;64;49;113;30;39;69
89;27.05.2018;2018;05;21;Sunnuntai;38;41;79;16;10;26
89;27.05.2018;2018;05;22;Sunnuntai;18;18;36;9;18;27
89;27.05.2018;2018;05;23;Sunnuntai;10;3;13;3;3;6
89;28.05.2018;2018;05;00;Maanantai;4;7;11;4;3;7
89;28.05.2018;2018;05;01;Maanantai;7;2;9;0;0;0
89;28.05.2018;2018;05;02;Maanantai;4;7;11;0;1;1
89;28.05.2018;2018;05;03;Maanantai;4;4;8;0;0;0
89;28.05.2018;2018;05;04;Maanantai;5;2;7;1;0;1
89;28.05.2018;2018;05;05;Maanantai;4;13;17;0;1;1
89;28.05.2018;2018;05;06;Maanantai;16;67;83;6;2;8
89;28.05.2018;2018;05;07;Maanantai;43;168;211;4;20;24
89;28.05.2018;2018;05;08;Maanantai;50;244;294;3;32;35
89;28.05.2018;2018;05;09;Maanantai;41;117;158;9;47;56
89;28.05.2018;2018;05;10;Maanantai;45;114;159;13;37;50
89;28.05.2018;2018;05;11;Maanantai;86;102;188;46;28;74
89;28.05.2018;2018;05;12;Maanantai;87;124;211;25;47;72
89;28.05.2018;2018;05;13;Maanantai;129;102;231;30;31;61
89;28.05.2018;2018;05;14;Maanantai;142;114;256;42;35;77
89;28.05.2018;2018;05;15;Maanantai;247;101;348;27;27;54
89;28.05.2018;2018;05;16;Maanantai;267;136;403;36;31;67
89;28.05.2018;2018;05;17;Maanantai;198;124;322;32;33;65
89;28.05.2018;2018;05;18;Maanantai;119;91;210;37;45;82
89;28.05.2018;2018;05;19;Maanantai;140;83;223;52;34;86
89;28.05.2018;2018;05;20;Maanantai;101;61;162;52;27;79
89;28.05.2018;2018;05;21;Maanantai;36;44;80;18;20;38
89;28.05.2018;2018;05;22;Maanantai;53;19;72;11;9;20
89;28.05.2018;2018;05;23;Maanantai;13;7;20;4;7;11
89;29.05.2018;2018;05;00;Tiistai;11;7;18;3;3;6
89;29.05.2018;2018;05;01;Tiistai;3;6;9;1;1;2
89;29.05.2018;2018;05;02;Tiistai;5;4;9;1;0;1
89;29.05.2018;2018;05;03;Tiistai;1;8;9;0;0;0
89;29.05.2018;2018;05;04;Tiistai;1;3;4;0;5;5
89;29.05.2018;2018;05;05;Tiistai;5;15;20;3;2;5
89;29.05.2018;2018;05;06;Tiistai;22;68;90;2;10;12
89;29.05.2018;2018;05;07;Tiistai;43;171;214;7;19;26
89;29.05.2018;2018;05;08;Tiistai;50;255;305;19;44;63
89;29.05.2018;2018;05;09;Tiistai;47;197;244;13;43;56
89;29.05.2018;2018;05;10;Tiistai;54;169;223;27;29;56
89;29.05.2018;2018;05;11;Tiistai;74;143;217;28;40;68
89;29.05.2018;2018;05;12;Tiistai;111;113;224;33;15;48
89;29.05.2018;2018;05;13;Tiistai;196;112;308;32;32;64
89;29.05.2018;2018;05;14;Tiistai;194;119;313;33;30;63
89;29.05.2018;2018;05;15;Tiistai;238;95;333;45;31;76
89;29.05.2018;2018;05;16;Tiistai;267;132;399;40;35;75
89;29.05.2018;2018;05;17;Tiistai;168;123;291;34;29;63
89;29.05.2018;2018;05;18;Tiistai;147;119;266;40;48;88
89;29.05.2018;2018;05;19;Tiistai;137;96;233;62;53;115
89;29.05.2018;2018;05;20;Tiistai;106;70;176;36;37;73
89;29.05.2018;2018;05;21;Tiistai;72;46;118;24;27;51
89;29.05.2018;2018;05;22;Tiistai;40;15;55;18;5;23
89;29.05.2018;2018;05;23;Tiistai;22;7;29;6;5;11
89;30.05.2018;2018;05;00;Keskiviikko;11;8;19;3;2;5
89;30.05.2018;2018;05;01;Keskiviikko;4;6;10;3;2;5
89;30.05.2018;2018;05;02;Keskiviikko;7;6;13;0;5;5
89;30.05.2018;2018;05;03;Keskiviikko;3;5;8;1;1;2
89;30.05.2018;2018;05;04;Keskiviikko;2;4;6;2;1;3
89;30.05.2018;2018;05;05;Keskiviikko;4;20;24;2;1;3
89;30.05.2018;2018;05;06;Keskiviikko;18;69;87;2;8;10
89;30.05.2018;2018;05;07;Keskiviikko;43;167;210;12;38;50
89;30.05.2018;2018;05;08;Keskiviikko;54;236;290;38;54;92
89;30.05.2018;2018;05;09;Keskiviikko;38;168;206;37;40;77
89;30.05.2018;2018;05;10;Keskiviikko;55;93;148;31;70;101
89;30.05.2018;2018;05;11;Keskiviikko;132;130;262;41;33;74
89;30.05.2018;2018;05;12;Keskiviikko;99;87;186;36;38;74
89;30.05.2018;2018;05;13;Keskiviikko;136;86;222;31;28;59
89;30.05.2018;2018;05;14;Keskiviikko;150;87;237;49;37;86
89;30.05.2018;2018;05;15;Keskiviikko;174;96;270;42;38;80
89;30.05.2018;2018;05;16;Keskiviikko;286;112;398;34;24;58
89;30.05.2018;2018;05;17;Keskiviikko;156;140;296;38;28;66
89;30.05.2018;2018;05;18;Keskiviikko;128;94;222;32;34;66
89;30.05.2018;2018;05;19;Keskiviikko;99;51;150;43;39;82
89;30.05.2018;2018;05;20;Keskiviikko;112;52;164;50;23;73
89;30.05.2018;2018;05;21;Keskiviikko;53;34;87;20;20;40
89;30.05.2018;2018;05;22;Keskiviikko;40;36;76;6;11;17
89;30.05.2018;2018;05;23;Keskiviikko;16;5;21;2;6;8
89;31.05.2018;2018;05;00;Torstai;12;5;17;2;4;6
89;31.05.2018;2018;05;01;Torstai;4;2;6;2;2;4
89;31.05.2018;2018;05;02;Torstai;4;8;12;0;1;1
89;31.05.2018;2018;05;03;Torstai;7;3;10;0;0;0
89;31.05.2018;2018;05;04;Torstai;1;4;5;2;1;3
89;31.05.2018;2018;05;05;Torstai;3;16;19;0;3;3
89;31.05.2018;2018;05;06;Torstai;15;64;79;5;1;6
89;31.05.2018;2018;05;07;Torstai;40;185;225;4;16;20
89;31.05.2018;2018;05;08;Torstai;46;269;315;4;34;38
89;31.05.2018;2018;05;09;Torstai;42;151;193;7;32;39
89;31.05.2018;2018;05;10;Torstai;44;94;138;6;31;37
89;31.05.2018;2018;05;11;Torstai;117;94;211;20;28;48
89;31.05.2018;2018;05;12;Torstai;101;90;191;27;35;62
89;31.05.2018;2018;05;13;Torstai;120;106;226;22;31;53
89;31.05.2018;2018;05;14;Torstai;137;77;214;16;25;41
89;31.05.2018;2018;05;15;Torstai;200;91;291;36;35;71
89;31.05.2018;2018;05;16;Torstai;252;134;386;38;31;69
89;31.05.2018;2018;05;17;Torstai;188;140;328;35;46;81
89;31.05.2018;2018;05;18;Torstai;137;88;225;40;44;84
89;31.05.2018;2018;05;19;Torstai;129;84;213;24;28;52
89;31.05.2018;2018;05;20;Torstai;109;46;155;23;22;45
89;31.05.2018;2018;05;21;Torstai;61;45;106;23;18;41
89;31.05.2018;2018;05;22;Torstai;46;23;69;8;9;17
89;31.05.2018;2018;05;23;Torstai;19;7;26;8;5;13
89;01.06.2018;2018;06;00;Perjantai;13;0;13;10;0;10
89;01.06.2018;2018;06;01;Perjantai;11;0;11;3;0;3
89;01.06.2018;2018;06;02;Perjantai;2;0;2;2;0;2
89;01.06.2018;2018;06;03;Perjantai;6;0;6;1;0;1
89;01.06.2018;2018;06;04;Perjantai;5;0;5;1;0;1
89;01.06.2018;2018;06;05;Perjantai;23;0;23;2;0;2
89;01.06.2018;2018;06;06;Perjantai;90;0;90;7;0;7
89;01.06.2018;2018;06;07;Perjantai;208;0;208;28;0;28
89;01.06.2018;2018;06;08;Perjantai;273;0;273;56;0;56
89;01.06.2018;2018;06;09;Perjantai;175;0;175;55;0;55
89;01.06.2018;2018;06;10;Perjantai;249;0;249;54;0;54
89;01.06.2018;2018;06;11;Perjantai;182;0;182;62;0;62
89;01.06.2018;2018;06;12;Perjantai;228;0;228;52;0;52
89;01.06.2018;2018;06;13;Perjantai;302;0;302;54;0;54
89;01.06.2018;2018;06;14;Perjantai;297;0;297;70;0;70
89;01.06.2018;2018;06;15;Perjantai;336;0;336;64;0;64
89;01.06.2018;2018;06;16;Perjantai;383;0;383;66;0;66
89;01.06.2018;2018;06;17;Perjantai;316;0;316;75;0;75
89;01.06.2018;2018;06;18;Perjantai;256;0;256;87;0;87
89;01.06.2018;2018;06;19;Perjantai;267;0;267;82;0;82
89;01.06.2018;2018;06;20;Perjantai;256;0;256;102;0;102
89;01.06.2018;2018;06;21;Perjantai;152;0;152;75;0;75
89;01.06.2018;2018;06;22;Perjantai;120;0;120;46;0;46
89;01.06.2018;2018;06;23;Perjantai;75;0;75;38;0;38
89;02.06.2018;2018;06;00;Lauantai;28;32;60;9;6;15
89;02.06.2018;2018;06;01;Lauantai;29;9;38;5;4;9
89;02.06.2018;2018;06;02;Lauantai;23;8;31;1;2;3
89;02.06.2018;2018;06;03;Lauantai;21;4;25;7;0;7
89;02.06.2018;2018;06;04;Lauantai;16;3;19;8;4;12
89;02.06.2018;2018;06;05;Lauantai;12;9;21;7;3;10
89;02.06.2018;2018;06;06;Lauantai;5;8;13;2;2;4
89;02.06.2018;2018;06;07;Lauantai;6;15;21;2;5;7
89;02.06.2018;2018;06;08;Lauantai;17;50;67;12;20;32
89;02.06.2018;2018;06;09;Lauantai;29;75;104;23;30;53
89;02.06.2018;2018;06;10;Lauantai;53;111;164;27;58;85
89;02.06.2018;2018;06;11;Lauantai;88;120;208;27;46;73
89;02.06.2018;2018;06;12;Lauantai;118;123;241;39;56;95
89;02.06.2018;2018;06;13;Lauantai;116;128;244;35;58;93
89;02.06.2018;2018;06;14;Lauantai;145;126;271;51;51;102
89;02.06.2018;2018;06;15;Lauantai;135;108;243;53;53;106
89;02.06.2018;2018;06;16;Lauantai;148;122;270;39;38;77
89;02.06.2018;2018;06;17;Lauantai;139;132;271;35;49;84
89;02.06.2018;2018;06;18;Lauantai;106;113;219;41;36;77
89;02.06.2018;2018;06;19;Lauantai;118;141;259;24;44;68
89;02.06.2018;2018;06;20;Lauantai;79;119;198;15;41;56
89;02.06.2018;2018;06;21;Lauantai;70;102;172;21;39;60
89;02.06.2018;2018;06;22;Lauantai;45;77;122;18;20;38
89;02.06.2018;2018;06;23;Lauantai;37;54;91;19;16;35
89;03.06.2018;2018;06;00;Sunnuntai;55;33;88;11;12;23
89;03.06.2018;2018;06;01;Sunnuntai;47;13;60;9;1;10
89;03.06.2018;2018;06;02;Sunnuntai;45;9;54;14;0;14
89;03.06.2018;2018;06;03;Sunnuntai;49;10;59;7;1;8
89;03.06.2018;2018;06;04;Sunnuntai;32;7;39;11;2;13
89;03.06.2018;2018;06;05;Sunnuntai;17;5;22;14;1;15
89;03.06.2018;2018;06;06;Sunnuntai;14;7;21;4;1;5
89;03.06.2018;2018;06;07;Sunnuntai;7;8;15;2;4;6
89;03.06.2018;2018;06;08;Sunnuntai;10;22;32;8;16;24
89;03.06.2018;2018;06;09;Sunnuntai;27;45;72;15;17;32
89;03.06.2018;2018;06;10;Sunnuntai;32;65;97;17;31;48
89;03.06.2018;2018;06;11;Sunnuntai;59;81;140;34;47;81
89;03.06.2018;2018;06;12;Sunnuntai;67;97;164;32;56;88
89;03.06.2018;2018;06;13;Sunnuntai;101;106;207;43;51;94
89;03.06.2018;2018;06;14;Sunnuntai;89;77;166;35;54;89
89;03.06.2018;2018;06;15;Sunnuntai;114;110;224;45;31;76
89;03.06.2018;2018;06;16;Sunnuntai;87;47;134;35;26;61
89;03.06.2018;2018;06;17;Sunnuntai;75;58;133;24;18;42
89;03.06.2018;2018;06;18;Sunnuntai;74;45;119;19;23;42
89;03.06.2018;2018;06;19;Sunnuntai;52;45;97;22;21;43
89;03.06.2018;2018;06;20;Sunnuntai;47;20;67;9;14;23
89;03.06.2018;2018;06;21;Sunnuntai;39;21;60;10;9;19
89;03.06.2018;2018;06;22;Sunnuntai;18;14;32;5;10;15
89;03.06.2018;2018;06;23;Sunnuntai;9;6;15;4;8;12
89;04.06.2018;2018;06;00;Maanantai;7;1;8;3;2;5
89;04.06.2018;2018;06;01;Maanantai;3;0;3;0;2;2
89;04.06.2018;2018;06;02;Maanantai;5;4;9;0;1;1
89;04.06.2018;2018;06;03;Maanantai;3;5;8;1;1;2
89;04.06.2018;2018;06;04;Maanantai;1;4;5;3;1;4
89;04.06.2018;2018;06;05;Maanantai;2;17;19;2;1;3
89;04.06.2018;2018;06;06;Maanantai;15;66;81;3;5;8
89;04.06.2018;2018;06;07;Maanantai;24;126;150;8;16;24
89;04.06.2018;2018;06;08;Maanantai;19;172;191;7;24;31
89;04.06.2018;2018;06;09;Maanantai;26;83;109;10;21;31
89;04.06.2018;2018;06;10;Maanantai;21;50;71;4;23;27
89;04.06.2018;2018;06;11;Maanantai;35;65;100;30;13;43
89;04.06.2018;2018;06;12;Maanantai;42;51;93;30;23;53
89;04.06.2018;2018;06;13;Maanantai;47;50;97;24;26;50
89;04.06.2018;2018;06;14;Maanantai;67;50;117;15;12;27
89;04.06.2018;2018;06;15;Maanantai;118;70;188;21;23;44
89;04.06.2018;2018;06;16;Maanantai;190;79;269;20;17;37
89;04.06.2018;2018;06;17;Maanantai;90;42;132;18;15;33
89;04.06.2018;2018;06;18;Maanantai;80;24;104;16;15;31
89;04.06.2018;2018;06;19;Maanantai;59;18;77;19;9;28
89;04.06.2018;2018;06;20;Maanantai;41;25;66;20;10;30
89;04.06.2018;2018;06;21;Maanantai;20;12;32;12;3;15
89;04.06.2018;2018;06;22;Maanantai;12;7;19;8;8;16
89;04.06.2018;2018;06;23;Maanantai;11;8;19;8;0;8
89;05.06.2018;2018;06;00;Tiistai;5;3;8;0;3;3
89;05.06.2018;2018;06;01;Tiistai;7;0;7;3;1;4
89;05.06.2018;2018;06;02;Tiistai;3;3;6;0;2;2
89;05.06.2018;2018;06;03;Tiistai;4;2;6;2;2;4
89;05.06.2018;2018;06;04;Tiistai;0;2;2;3;1;4
89;05.06.2018;2018;06;05;Tiistai;2;14;16;2;2;4
89;05.06.2018;2018;06;06;Tiistai;17;65;82;0;7;7
89;05.06.2018;2018;06;07;Tiistai;24;131;155;3;8;11
89;05.06.2018;2018;06;08;Tiistai;38;177;215;11;18;29
89;05.06.2018;2018;06;09;Tiistai;36;110;146;10;23;33
89;05.06.2018;2018;06;10;Tiistai;48;55;103;14;20;34
89;05.06.2018;2018;06;11;Tiistai;50;71;121;16;17;33
89;05.06.2018;2018;06;12;Tiistai;56;87;143;11;28;39
89;05.06.2018;2018;06;13;Tiistai;60;79;139;23;20;43
89;05.06.2018;2018;06;14;Tiistai;84;69;153;20;30;50
89;05.06.2018;2018;06;15;Tiistai;125;95;220;23;24;47
89;05.06.2018;2018;06;16;Tiistai;190;80;270;26;18;44
89;05.06.2018;2018;06;17;Tiistai;115;69;184;26;14;40
89;05.06.2018;2018;06;18;Tiistai;99;75;174;40;34;74
89;05.06.2018;2018;06;19;Tiistai;86;47;133;34;36;70
89;05.06.2018;2018;06;20;Tiistai;74;43;117;31;24;55
89;05.06.2018;2018;06;21;Tiistai;49;35;84;22;17;39
89;05.06.2018;2018;06;22;Tiistai;24;12;36;9;3;12
89;05.06.2018;2018;06;23;Tiistai;18;12;30;6;13;19
89;06.06.2018;2018;06;00;Keskiviikko;5;5;10;6;4;10
89;06.06.2018;2018;06;01;Keskiviikko;5;8;13;1;3;4
89;06.06.2018;2018;06;02;Keskiviikko;5;5;10;4;2;6
89;06.06.2018;2018;06;03;Keskiviikko;4;2;6;1;1;2
89;06.06.2018;2018;06;04;Keskiviikko;1;2;3;0;1;1
89;06.06.2018;2018;06;05;Keskiviikko;3;24;27;0;2;2
89;06.06.2018;2018;06;06;Keskiviikko;17;69;86;4;8;12
89;06.06.2018;2018;06;07;Keskiviikko;32;137;169;8;17;25
89;06.06.2018;2018;06;08;Keskiviikko;30;180;210;15;21;36
89;06.06.2018;2018;06;09;Keskiviikko;31;87;118;18;17;35
89;06.06.2018;2018;06;10;Keskiviikko;23;77;100;20;32;52
89;06.06.2018;2018;06;11;Keskiviikko;59;68;127;22;36;58
89;06.06.2018;2018;06;12;Keskiviikko;66;78;144;17;20;37
89;06.06.2018;2018;06;13;Keskiviikko;84;68;152;20;19;39
89;06.06.2018;2018;06;14;Keskiviikko;87;67;154;40;25;65
89;06.06.2018;2018;06;15;Keskiviikko;160;73;233;19;22;41
89;06.06.2018;2018;06;16;Keskiviikko;199;95;294;24;23;47
89;06.06.2018;2018;06;17;Keskiviikko;128;90;218;31;30;61
89;06.06.2018;2018;06;18;Keskiviikko;96;74;170;24;27;51
89;06.06.2018;2018;06;19;Keskiviikko;94;54;148;25;32;57
89;06.06.2018;2018;06;20;Keskiviikko;77;51;128;21;22;43
89;06.06.2018;2018;06;21;Keskiviikko;49;30;79;10;8;18
89;06.06.2018;2018;06;22;Keskiviikko;19;19;38;4;2;6
89;06.06.2018;2018;06;23;Keskiviikko;26;6;32;1;5;6
89;07.06.2018;2018;06;00;Torstai;8;8;16;3;4;7
89;07.06.2018;2018;06;01;Torstai;5;1;6;3;3;6
89;07.06.2018;2018;06;02;Torstai;9;2;11;1;0;1
89;07.06.2018;2018;06;03;Torstai;5;4;9;0;1;1
89;07.06.2018;2018;06;04;Torstai;5;5;10;2;2;4
89;07.06.2018;2018;06;05;Torstai;1;15;16;1;2;3
89;07.06.2018;2018;06;06;Torstai;12;53;65;7;7;14
89;07.06.2018;2018;06;07;Torstai;34;93;127;3;9;12
89;07.06.2018;2018;06;08;Torstai;14;116;130;1;19;20
89;07.06.2018;2018;06;09;Torstai;22;53;75;7;12;19
89;07.06.2018;2018;06;10;Torstai;10;35;45;2;9;11
89;07.06.2018;2018;06;11;Torstai;20;30;50;1;12;13
89;07.06.2018;2018;06;12;Torstai;26;45;71;6;10;16
89;07.06.2018;2018;06;13;Torstai;41;35;76;17;20;37
89;07.06.2018;2018;06;14;Torstai;70;48;118;29;19;48
89;07.06.2018;2018;06;15;Torstai;121;60;181;27;13;40
89;07.06.2018;2018;06;16;Torstai;116;58;174;31;16;47
89;07.06.2018;2018;06;17;Torstai;92;60;152;25;20;45
89;07.06.2018;2018;06;18;Torstai;67;68;135;28;32;60
89;07.06.2018;2018;06;19;Torstai;63;56;119;21;35;56
89;07.06.2018;2018;06;20;Torstai;63;36;99;28;23;51
89;07.06.2018;2018;06;21;Torstai;56;34;90;15;10;25
89;07.06.2018;2018;06;22;Torstai;28;19;47;9;8;17
89;07.06.2018;2018;06;23;Torstai;15;5;20;9;3;12
89;08.06.2018;2018;06;00;Perjantai;19;5;24;2;1;3
89;08.06.2018;2018;06;01;Perjantai;9;6;15;0;1;1
89;08.06.2018;2018;06;02;Perjantai;2;6;8;2;1;3
89;08.06.2018;2018;06;03;Perjantai;2;6;8;1;1;2
89;08.06.2018;2018;06;04;Perjantai;2;3;5;1;0;1
89;08.06.2018;2018;06;05;Perjantai;2;20;22;0;4;4
89;08.06.2018;2018;06;06;Perjantai;16;56;72;2;8;10
89;08.06.2018;2018;06;07;Perjantai;27;126;153;6;16;22
89;08.06.2018;2018;06;08;Perjantai;37;166;203;6;20;26
89;08.06.2018;2018;06;09;Perjantai;41;108;149;15;16;31
89;08.06.2018;2018;06;10;Perjantai;56;97;153;7;37;44
89;08.06.2018;2018;06;11;Perjantai;50;79;129;10;29;39
89;08.06.2018;2018;06;12;Perjantai;60;82;142;19;38;57
89;08.06.2018;2018;06;13;Perjantai;93;89;182;25;28;53
89;08.06.2018;2018;06;14;Perjantai;107;91;198;40;33;73
89;08.06.2018;2018;06;15;Perjantai;168;97;265;33;21;54
89;08.06.2018;2018;06;16;Perjantai;200;110;310;36;44;80
89;08.06.2018;2018;06;17;Perjantai;132;78;210;29;31;60
89;08.06.2018;2018;06;18;Perjantai;97;65;162;18;29;47
89;08.06.2018;2018;06;19;Perjantai;75;79;154;29;24;53
89;08.06.2018;2018;06;20;Perjantai;86;60;146;25;19;44
89;08.06.2018;2018;06;21;Perjantai;64;49;113;18;20;38
89;08.06.2018;2018;06;22;Perjantai;36;33;69;12;19;31
89;08.06.2018;2018;06;23;Perjantai;44;35;79;14;5;19
89;09.06.2018;2018;06;00;Lauantai;35;18;53;7;11;18
89;09.06.2018;2018;06;01;Lauantai;24;7;31;6;4;10
89;09.06.2018;2018;06;02;Lauantai;17;4;21;6;1;7
89;09.06.2018;2018;06;03;Lauantai;19;7;26;8;1;9
89;09.06.2018;2018;06;04;Lauantai;17;5;22;2;0;2
89;09.06.2018;2018;06;05;Lauantai;8;8;16;2;2;4
89;09.06.2018;2018;06;06;Lauantai;3;13;16;3;3;6
89;09.06.2018;2018;06;07;Lauantai;6;18;24;0;4;4
89;09.06.2018;2018;06;08;Lauantai;12;22;34;6;8;14
89;09.06.2018;2018;06;09;Lauantai;28;78;106;9;22;31
89;09.06.2018;2018;06;10;Lauantai;33;61;94;15;22;37
89;09.06.2018;2018;06;11;Lauantai;58;88;146;20;39;59
89;09.06.2018;2018;06;12;Lauantai;91;110;201;36;38;74
89;09.06.2018;2018;06;13;Lauantai;74;104;178;27;35;62
89;09.06.2018;2018;06;14;Lauantai;82;75;157;49;45;94
89;09.06.2018;2018;06;15;Lauantai;83;72;155;26;27;53
89;09.06.2018;2018;06;16;Lauantai;103;64;167;33;34;67
89;09.06.2018;2018;06;17;Lauantai;71;54;125;29;18;47
89;09.06.2018;2018;06;18;Lauantai;67;52;119;24;23;47
89;09.06.2018;2018;06;19;Lauantai;71;54;125;31;10;41
89;09.06.2018;2018;06;20;Lauantai;53;51;104;23;31;54
89;09.06.2018;2018;06;21;Lauantai;36;39;75;12;16;28
89;09.06.2018;2018;06;22;Lauantai;43;45;88;8;14;22
89;09.06.2018;2018;06;23;Lauantai;25;22;47;10;4;14
89;10.06.2018;2018;06;00;Sunnuntai;36;20;56;5;12;17
89;10.06.2018;2018;06;01;Sunnuntai;22;14;36;3;6;9
89;10.06.2018;2018;06;02;Sunnuntai;25;13;38;12;2;14
89;10.06.2018;2018;06;03;Sunnuntai;18;5;23;4;1;5
89;10.06.2018;2018;06;04;Sunnuntai;25;3;28;8;0;8
89;10.06.2018;2018;06;05;Sunnuntai;12;7;19;7;2;9
89;10.06.2018;2018;06;06;Sunnuntai;4;12;16;1;0;1
89;10.06.2018;2018;06;07;Sunnuntai;4;12;16;7;2;9
89;10.06.2018;2018;06;08;Sunnuntai;6;10;16;5;8;13
89;10.06.2018;2018;06;09;Sunnuntai;18;30;48;11;12;23
89;10.06.2018;2018;06;10;Sunnuntai;23;60;83;19;25;44
89;10.06.2018;2018;06;11;Sunnuntai;34;67;101;27;44;71
89;10.06.2018;2018;06;12;Sunnuntai;64;81;145;30;33;63
89;10.06.2018;2018;06;13;Sunnuntai;69;105;174;32;36;68
89;10.06.2018;2018;06;14;Sunnuntai;106;98;204;44;49;93
89;10.06.2018;2018;06;15;Sunnuntai;102;90;192;30;49;79
89;10.06.2018;2018;06;16;Sunnuntai;95;66;161;39;32;71
89;10.06.2018;2018;06;17;Sunnuntai;101;55;156;35;36;71
89;10.06.2018;2018;06;18;Sunnuntai;91;51;142;32;36;68
89;10.06.2018;2018;06;19;Sunnuntai;88;57;145;25;30;55
89;10.06.2018;2018;06;20;Sunnuntai;68;32;100;30;21;51
89;10.06.2018;2018;06;21;Sunnuntai;43;47;90;16;29;45
89;10.06.2018;2018;06;22;Sunnuntai;22;21;43;3;10;13
89;10.06.2018;2018;06;23;Sunnuntai;14;16;30;8;5;13
89;11.06.2018;2018;06;00;Maanantai;15;2;17;7;8;15
89;11.06.2018;2018;06;01;Maanantai;4;5;9;1;1;2
89;11.06.2018;2018;06;02;Maanantai;5;5;10;4;2;6
89;11.06.2018;2018;06;03;Maanantai;4;2;6;2;1;3
89;11.06.2018;2018;06;04;Maanantai;7;4;11;4;1;5
89;11.06.2018;2018;06;05;Maanantai;3;14;17;1;3;4
89;11.06.2018;2018;06;06;Maanantai;13;79;92;6;10;16
89;11.06.2018;2018;06;07;Maanantai;45;160;205;7;19;26
89;11.06.2018;2018;06;08;Maanantai;37;170;207;6;20;26
89;11.06.2018;2018;06;09;Maanantai;45;127;172;14;26;40
89;11.06.2018;2018;06;10;Maanantai;44;89;133;11;36;47
89;11.06.2018;2018;06;11;Maanantai;68;81;149;22;24;46
89;11.06.2018;2018;06;12;Maanantai;67;85;152;18;30;48
89;11.06.2018;2018;06;13;Maanantai;77;98;175;18;27;45
89;11.06.2018;2018;06;14;Maanantai;109;100;209;32;22;54
89;11.06.2018;2018;06;15;Maanantai;203;101;304;28;24;52
89;11.06.2018;2018;06;16;Maanantai;229;112;341;31;32;63
89;11.06.2018;2018;06;17;Maanantai;163;104;267;28;40;68
89;11.06.2018;2018;06;18;Maanantai;114;94;208;36;30;66
89;11.06.2018;2018;06;19;Maanantai;149;70;219;34;34;68
89;11.06.2018;2018;06;20;Maanantai;99;70;169;38;20;58
89;11.06.2018;2018;06;21;Maanantai;50;36;86;22;20;42
89;11.06.2018;2018;06;22;Maanantai;29;34;63;21;12;33
89;11.06.2018;2018;06;23;Maanantai;16;10;26;5;6;11
89;12.06.2018;2018;06;00;Tiistai;10;5;15;6;8;14
89;12.06.2018;2018;06;01;Tiistai;4;3;7;4;5;9
89;12.06.2018;2018;06;02;Tiistai;3;10;13;3;1;4
89;12.06.2018;2018;06;03;Tiistai;3;3;6;1;1;2
89;12.06.2018;2018;06;04;Tiistai;6;2;8;2;5;7
89;12.06.2018;2018;06;05;Tiistai;3;14;17;0;3;3
89;12.06.2018;2018;06;06;Tiistai;21;78;99;3;6;9
89;12.06.2018;2018;06;07;Tiistai;50;170;220;4;13;17
89;12.06.2018;2018;06;08;Tiistai;39;202;241;1;24;25
89;12.06.2018;2018;06;09;Tiistai;34;113;147;8;29;37
89;12.06.2018;2018;06;10;Tiistai;35;85;120;16;29;45
89;12.06.2018;2018;06;11;Tiistai;66;93;159;12;42;54
89;12.06.2018;2018;06;12;Tiistai;64;95;159;19;24;43
89;12.06.2018;2018;06;13;Tiistai;100;110;210;17;23;40
89;12.06.2018;2018;06;14;Tiistai;104;92;196;29;23;52
89;12.06.2018;2018;06;15;Tiistai;186;92;278;24;16;40
89;12.06.2018;2018;06;16;Tiistai;227;105;332;35;29;64
89;12.06.2018;2018;06;17;Tiistai;151;119;270;43;31;74
89;12.06.2018;2018;06;18;Tiistai;153;90;243;33;38;71
89;12.06.2018;2018;06;19;Tiistai;130;68;198;32;34;66
89;12.06.2018;2018;06;20;Tiistai;110;38;148;33;31;64
89;12.06.2018;2018;06;21;Tiistai;80;38;118;23;19;42
89;12.06.2018;2018;06;22;Tiistai;36;14;50;9;8;17
89;12.06.2018;2018;06;23;Tiistai;17;9;26;5;9;14
89;13.06.2018;2018;06;00;Keskiviikko;5;4;9;1;5;6
89;13.06.2018;2018;06;01;Keskiviikko;11;6;17;1;1;2
89;13.06.2018;2018;06;02;Keskiviikko;2;2;4;0;2;2
89;13.06.2018;2018;06;03;Keskiviikko;1;3;4;0;0;0
89;13.06.2018;2018;06;04;Keskiviikko;5;2;7;1;0;1
89;13.06.2018;2018;06;05;Keskiviikko;0;21;21;0;0;0
89;13.06.2018;2018;06;06;Keskiviikko;16;51;67;2;9;11
89;13.06.2018;2018;06;07;Keskiviikko;37;162;199;10;18;28
89;13.06.2018;2018;06;08;Keskiviikko;34;172;206;4;16;20
89;13.06.2018;2018;06;09;Keskiviikko;48;90;138;21;21;42
89;13.06.2018;2018;06;10;Keskiviikko;32;79;111;16;26;42
89;13.06.2018;2018;06;11;Keskiviikko;35;101;136;15;22;37
89;13.06.2018;2018;06;12;Keskiviikko;68;102;170;18;40;58
89;13.06.2018;2018;06;13;Keskiviikko;88;99;187;24;35;59
89;13.06.2018;2018;06;14;Keskiviikko;99;83;182;26;40;66
89;13.06.2018;2018;06;15;Keskiviikko;155;101;256;39;42;81
89;13.06.2018;2018;06;16;Keskiviikko;214;137;351;33;20;53
89;13.06.2018;2018;06;17;Keskiviikko;136;109;245;31;23;54
89;13.06.2018;2018;06;18;Keskiviikko;126;83;209;34;41;75
89;13.06.2018;2018;06;19;Keskiviikko;127;71;198;38;39;77
89;13.06.2018;2018;06;20;Keskiviikko;113;58;171;36;31;67
89;13.06.2018;2018;06;21;Keskiviikko;48;46;94;17;20;37
89;13.06.2018;2018;06;22;Keskiviikko;39;21;60;12;12;24
89;13.06.2018;2018;06;23;Keskiviikko;19;16;35;7;5;12
89;14.06.2018;2018;06;00;Torstai;10;9;19;3;2;5
89;14.06.2018;2018;06;01;Torstai;12;11;23;2;0;2
89;14.06.2018;2018;06;02;Torstai;1;6;7;5;1;6
89;14.06.2018;2018;06;03;Torstai;3;1;4;1;2;3
89;14.06.2018;2018;06;04;Torstai;6;6;12;0;0;0
89;14.06.2018;2018;06;05;Torstai;4;13;17;1;1;2
89;14.06.2018;2018;06;06;Torstai;15;77;92;2;9;11
89;14.06.2018;2018;06;07;Torstai;39;174;213;3;9;12
89;14.06.2018;2018;06;08;Torstai;36;190;226;5;19;24
89;14.06.2018;2018;06;09;Torstai;37;107;144;8;26;34
89;14.06.2018;2018;06;10;Torstai;38;102;140;8;30;38
89;14.06.2018;2018;06;11;Torstai;62;127;189;13;36;49
89;14.06.2018;2018;06;12;Torstai;73;129;202;23;26;49
89;14.06.2018;2018;06;13;Torstai;93;143;236;16;37;53
89;14.06.2018;2018;06;14;Torstai;139;111;250;33;31;64
89;14.06.2018;2018;06;15;Torstai;203;113;316;48;31;79
89;14.06.2018;2018;06;16;Torstai;230;127;357;37;19;56
89;14.06.2018;2018;06;17;Torstai;158;145;303;32;46;78
89;14.06.2018;2018;06;18;Torstai;143;124;267;37;19;56
89;14.06.2018;2018;06;19;Torstai;125;76;201;29;40;69
89;14.06.2018;2018;06;20;Torstai;122;66;188;22;25;47
89;14.06.2018;2018;06;21;Torstai;88;71;159;15;16;31
89;14.06.2018;2018;06;22;Torstai;51;20;71;11;7;18
89;14.06.2018;2018;06;23;Torstai;45;14;59;7;7;14
89;15.06.2018;2018;06;00;Perjantai;19;12;31;5;2;7
89;15.06.2018;2018;06;01;Perjantai;15;5;20;8;3;11
89;15.06.2018;2018;06;02;Perjantai;14;5;19;1;1;2
89;15.06.2018;2018;06;03;Perjantai;6;0;6;1;0;1
89;15.06.2018;2018;06;04;Perjantai;4;2;6;1;1;2
89;15.06.2018;2018;06;05;Perjantai;6;23;29;2;2;4
89;15.06.2018;2018;06;06;Perjantai;20;70;90;2;5;7
89;15.06.2018;2018;06;07;Perjantai;39;126;165;1;17;18
89;15.06.2018;2018;06;08;Perjantai;49;174;223;12;25;37
89;15.06.2018;2018;06;09;Perjantai;33;80;113;3;24;27
89;15.06.2018;2018;06;10;Perjantai;43;115;158;9;21;30
89;15.06.2018;2018;06;11;Perjantai;51;108;159;16;19;35
89;15.06.2018;2018;06;12;Perjantai;91;104;195;15;30;45
89;15.06.2018;2018;06;13;Perjantai;96;113;209;49;62;111
89;15.06.2018;2018;06;14;Perjantai;123;86;209;25;20;45
89;15.06.2018;2018;06;15;Perjantai;169;86;255;32;27;59
89;15.06.2018;2018;06;16;Perjantai;147;104;251;29;31;60
89;15.06.2018;2018;06;17;Perjantai;135;120;255;31;40;71
89;15.06.2018;2018;06;18;Perjantai;87;102;189;29;31;60
89;15.06.2018;2018;06;19;Perjantai;110;96;206;28;31;59
89;15.06.2018;2018;06;20;Perjantai;110;80;190;21;30;51
89;15.06.2018;2018;06;21;Perjantai;66;51;117;17;17;34
89;15.06.2018;2018;06;22;Perjantai;59;37;96;8;15;23
89;15.06.2018;2018;06;23;Perjantai;63;56;119;10;9;19
89;16.06.2018;2018;06;00;Lauantai;30;19;49;3;11;14
89;16.06.2018;2018;06;01;Lauantai;32;12;44;8;1;9
89;16.06.2018;2018;06;02;Lauantai;29;6;35;8;1;9
89;16.06.2018;2018;06;03;Lauantai;14;1;15;7;3;10
89;16.06.2018;2018;06;04;Lauantai;28;7;35;4;4;8
89;16.06.2018;2018;06;05;Lauantai;8;9;17;9;2;11
89;16.06.2018;2018;06;06;Lauantai;6;8;14;3;2;5
89;16.06.2018;2018;06;07;Lauantai;8;16;24;8;8;16
89;16.06.2018;2018;06;08;Lauantai;9;39;48;9;17;26
89;16.06.2018;2018;06;09;Lauantai;36;93;129;17;33;50
89;16.06.2018;2018;06;10;Lauantai;58;89;147;11;31;42
89;16.06.2018;2018;06;11;Lauantai;68;143;211;27;52;79
89;16.06.2018;2018;06;12;Lauantai;117;173;290;43;62;105
89;16.06.2018;2018;06;13;Lauantai;129;196;325;62;63;125
89;16.06.2018;2018;06;14;Lauantai;165;195;360;53;80;133
89;16.06.2018;2018;06;15;Lauantai;176;174;350;67;60;127
89;16.06.2018;2018;06;16;Lauantai;185;121;306;41;46;87
89;16.06.2018;2018;06;17;Lauantai;169;115;284;28;40;68
89;16.06.2018;2018;06;18;Lauantai;115;107;222;22;30;52
89;16.06.2018;2018;06;19;Lauantai;93;66;159;26;38;64
89;16.06.2018;2018;06;20;Lauantai;72;75;147;20;24;44
89;16.06.2018;2018;06;21;Lauantai;64;73;137;25;31;56
89;16.06.2018;2018;06;22;Lauantai;57;38;95;21;25;46
89;16.06.2018;2018;06;23;Lauantai;45;40;85;23;10;33
89;17.06.2018;2018;06;00;Sunnuntai;43;77;120;10;14;24
89;17.06.2018;2018;06;01;Sunnuntai;37;46;83;7;9;16
89;17.06.2018;2018;06;02;Sunnuntai;32;18;50;4;3;7
89;17.06.2018;2018;06;03;Sunnuntai;25;5;30;20;9;29
89;17.06.2018;2018;06;04;Sunnuntai;21;5;26;5;2;7
89;17.06.2018;2018;06;05;Sunnuntai;9;8;17;4;4;8
89;17.06.2018;2018;06;06;Sunnuntai;6;12;18;2;2;4
89;17.06.2018;2018;06;07;Sunnuntai;10;12;22;1;8;9
89;17.06.2018;2018;06;08;Sunnuntai;15;11;26;9;8;17
89;17.06.2018;2018;06;09;Sunnuntai;27;39;66;16;18;34
89;17.06.2018;2018;06;10;Sunnuntai;32;78;110;18;30;48
89;17.06.2018;2018;06;11;Sunnuntai;80;115;195;35;51;86
89;17.06.2018;2018;06;12;Sunnuntai;138;200;338;28;49;77
89;17.06.2018;2018;06;13;Sunnuntai;171;188;359;47;55;102
89;17.06.2018;2018;06;14;Sunnuntai;183;219;402;42;55;97
89;17.06.2018;2018;06;15;Sunnuntai;188;162;350;55;58;113
89;17.06.2018;2018;06;16;Sunnuntai;150;165;315;47;61;108
89;17.06.2018;2018;06;17;Sunnuntai;166;126;292;53;46;99
89;17.06.2018;2018;06;18;Sunnuntai;140;133;273;42;45;87
89;17.06.2018;2018;06;19;Sunnuntai;124;97;221;42;39;81
89;17.06.2018;2018;06;20;Sunnuntai;94;59;153;19;24;43
89;17.06.2018;2018;06;21;Sunnuntai;55;53;108;19;14;33
89;17.06.2018;2018;06;22;Sunnuntai;27;16;43;11;4;15
89;17.06.2018;2018;06;23;Sunnuntai;19;9;28;5;4;9
89;18.06.2018;2018;06;00;Maanantai;7;27;34;4;1;5
89;18.06.2018;2018;06;01;Maanantai;7;3;10;3;0;3
89;18.06.2018;2018;06;02;Maanantai;7;5;12;1;2;3
89;18.06.2018;2018;06;03;Maanantai;10;5;15;1;0;1
89;18.06.2018;2018;06;04;Maanantai;2;7;9;0;3;3
89;18.06.2018;2018;06;05;Maanantai;7;19;26;0;4;4
89;18.06.2018;2018;06;06;Maanantai;15;68;83;4;7;11
89;18.06.2018;2018;06;07;Maanantai;29;147;176;5;14;19
89;18.06.2018;2018;06;08;Maanantai;41;176;217;5;26;31
89;18.06.2018;2018;06;09;Maanantai;35;71;106;7;14;21
89;18.06.2018;2018;06;10;Maanantai;42;63;105;5;21;26
89;18.06.2018;2018;06;11;Maanantai;29;68;97;12;8;20
89;18.06.2018;2018;06;12;Maanantai;48;78;126;8;13;21
89;18.06.2018;2018;06;13;Maanantai;53;58;111;10;18;28
89;18.06.2018;2018;06;14;Maanantai;102;100;202;28;18;46
89;18.06.2018;2018;06;15;Maanantai;159;76;235;30;22;52
89;18.06.2018;2018;06;16;Maanantai;199;106;305;22;15;37
89;18.06.2018;2018;06;17;Maanantai;129;85;214;33;24;57
89;18.06.2018;2018;06;18;Maanantai;93;59;152;29;28;57
89;18.06.2018;2018;06;19;Maanantai;81;39;120;15;30;45
89;18.06.2018;2018;06;20;Maanantai;75;50;125;22;14;36
89;18.06.2018;2018;06;21;Maanantai;58;18;76;11;19;30
89;18.06.2018;2018;06;22;Maanantai;13;16;29;5;5;10
89;18.06.2018;2018;06;23;Maanantai;25;11;36;2;3;5
89;19.06.2018;2018;06;00;Tiistai;6;11;17;3;1;4
89;19.06.2018;2018;06;01;Tiistai;5;6;11;3;5;8
89;19.06.2018;2018;06;02;Tiistai;7;3;10;2;1;3
89;19.06.2018;2018;06;03;Tiistai;2;3;5;2;0;2
89;19.06.2018;2018;06;04;Tiistai;3;6;9;2;0;2
89;19.06.2018;2018;06;05;Tiistai;3;18;21;1;4;5
89;19.06.2018;2018;06;06;Tiistai;20;66;86;2;5;7
89;19.06.2018;2018;06;07;Tiistai;34;130;164;10;18;28
89;19.06.2018;2018;06;08;Tiistai;34;173;207;12;30;42
89;19.06.2018;2018;06;09;Tiistai;35;106;141;22;30;52
89;19.06.2018;2018;06;10;Tiistai;52;90;142;16;11;27
89;19.06.2018;2018;06;11;Tiistai;68;57;125;24;12;36
89;19.06.2018;2018;06;12;Tiistai;46;41;87;11;9;20
89;19.06.2018;2018;06;13;Tiistai;39;39;78;6;9;15
89;19.06.2018;2018;06;14;Tiistai;61;54;115;14;8;22
89;19.06.2018;2018;06;15;Tiistai;112;41;153;13;8;21
89;19.06.2018;2018;06;16;Tiistai;143;37;180;21;10;31
89;19.06.2018;2018;06;17;Tiistai;79;46;125;14;14;28
89;19.06.2018;2018;06;18;Tiistai;47;46;93;14;7;21
89;19.06.2018;2018;06;19;Tiistai;68;30;98;23;26;49
89;19.06.2018;2018;06;20;Tiistai;57;32;89;27;14;41
89;19.06.2018;2018;06;21;Tiistai;31;11;42;5;3;8
89;19.06.2018;2018;06;22;Tiistai;27;13;40;4;3;7
89;19.06.2018;2018;06;23;Tiistai;16;14;30;3;4;7
89;20.06.2018;2018;06;00;Keskiviikko;6;6;12;0;0;0
89;20.06.2018;2018;06;01;Keskiviikko;2;1;3;0;1;1
89;20.06.2018;2018;06;02;Keskiviikko;8;3;11;1;0;1
89;20.06.2018;2018;06;03;Keskiviikko;1;1;2;0;1;1
89;20.06.2018;2018;06;04;Keskiviikko;2;5;7;3;0;3
89;20.06.2018;2018;06;05;Keskiviikko;2;18;20;0;1;1
89;20.06.2018;2018;06;06;Keskiviikko;16;62;78;2;8;10
89;20.06.2018;2018;06;07;Keskiviikko;38;146;184;7;16;23
89;20.06.2018;2018;06;08;Keskiviikko;24;179;203;10;16;26
89;20.06.2018;2018;06;09;Keskiviikko;35;101;136;16;18;34
89;20.06.2018;2018;06;10;Keskiviikko;52;99;151;7;33;40
89;20.06.2018;2018;06;11;Keskiviikko;56;99;155;22;25;47
89;20.06.2018;2018;06;12;Keskiviikko;68;93;161;24;35;59
89;20.06.2018;2018;06;13;Keskiviikko;87;90;177;27;40;67
89;20.06.2018;2018;06;14;Keskiviikko;111;98;209;32;19;51
89;20.06.2018;2018;06;15;Keskiviikko;183;120;303;28;24;52
89;20.06.2018;2018;06;16;Keskiviikko;207;95;302;48;30;78
89;20.06.2018;2018;06;17;Keskiviikko;176;123;299;24;35;59
89;20.06.2018;2018;06;18;Keskiviikko;97;82;179;32;48;80
89;20.06.2018;2018;06;19;Keskiviikko;132;73;205;34;42;76
89;20.06.2018;2018;06;20;Keskiviikko;119;58;177;33;24;57
89;20.06.2018;2018;06;21;Keskiviikko;48;24;72;20;14;34
89;20.06.2018;2018;06;22;Keskiviikko;40;36;76;8;15;23
89;20.06.2018;2018;06;23;Keskiviikko;29;14;43;14;11;25
89;21.06.2018;2018;06;00;Torstai;17;10;27;4;5;9
89;21.06.2018;2018;06;01;Torstai;11;12;23;3;1;4
89;21.06.2018;2018;06;02;Torstai;11;9;20;4;1;5
89;21.06.2018;2018;06;03;Torstai;3;0;3;0;0;0
89;21.06.2018;2018;06;04;Torstai;2;6;8;1;2;3
89;21.06.2018;2018;06;05;Torstai;2;15;17;3;4;7
89;21.06.2018;2018;06;06;Torstai;14;64;78;2;6;8
89;21.06.2018;2018;06;07;Torstai;32;126;158;1;14;15
89;21.06.2018;2018;06;08;Torstai;45;145;190;3;17;20
89;21.06.2018;2018;06;09;Torstai;34;90;124;18;23;41
89;21.06.2018;2018;06;10;Torstai;40;79;119;11;20;31
89;21.06.2018;2018;06;11;Torstai;63;83;146;11;24;35
89;21.06.2018;2018;06;12;Torstai;80;114;194;14;25;39
89;21.06.2018;2018;06;13;Torstai;126;130;256;35;29;64
89;21.06.2018;2018;06;14;Torstai;161;103;264;23;28;51
89;21.06.2018;2018;06;15;Torstai;178;102;280;39;33;72
89;21.06.2018;2018;06;16;Torstai;156;92;248;25;29;54
89;21.06.2018;2018;06;17;Torstai;92;95;187;23;26;49
89;21.06.2018;2018;06;18;Torstai;107;77;184;26;19;45
89;21.06.2018;2018;06;19;Torstai;85;91;176;25;24;49
89;21.06.2018;2018;06;20;Torstai;74;69;143;27;20;47
89;21.06.2018;2018;06;21;Torstai;40;55;95;7;11;18
89;21.06.2018;2018;06;22;Torstai;30;22;52;5;13;18
89;21.06.2018;2018;06;23;Torstai;23;17;40;11;9;20
89;22.06.2018;2018;06;00;Perjantai;23;18;41;7;2;9
89;22.06.2018;2018;06;01;Perjantai;17;6;23;4;3;7
89;22.06.2018;2018;06;02;Perjantai;23;6;29;3;1;4
89;22.06.2018;2018;06;03;Perjantai;10;3;13;3;5;8
89;22.06.2018;2018;06;04;Perjantai;13;5;18;4;0;4
89;22.06.2018;2018;06;05;Perjantai;4;11;15;2;6;8
89;22.06.2018;2018;06;06;Perjantai;8;7;15;2;4;6
89;22.06.2018;2018;06;07;Perjantai;9;10;19;1;2;3
89;22.06.2018;2018;06;08;Perjantai;15;13;28;5;1;6
89;22.06.2018;2018;06;09;Perjantai;4;6;10;2;4;6
89;22.06.2018;2018;06;10;Perjantai;6;13;19;2;0;2
89;22.06.2018;2018;06;11;Perjantai;8;5;13;4;7;11
89;22.06.2018;2018;06;12;Perjantai;10;13;23;2;3;5
89;22.06.2018;2018;06;13;Perjantai;12;14;26;4;7;11
89;22.06.2018;2018;06;14;Perjantai;23;27;50;11;14;25
89;22.06.2018;2018;06;15;Perjantai;18;9;27;16;5;21
89;22.06.2018;2018;06;16;Perjantai;18;19;37;10;9;19
89;22.06.2018;2018;06;17;Perjantai;16;13;29;10;12;22
89;22.06.2018;2018;06;18;Perjantai;13;13;26;3;5;8
89;22.06.2018;2018;06;19;Perjantai;16;13;29;6;11;17
89;22.06.2018;2018;06;20;Perjantai;10;15;25;7;6;13
89;22.06.2018;2018;06;21;Perjantai;20;21;41;2;4;6
89;22.06.2018;2018;06;22;Perjantai;13;17;30;3;10;13
89;22.06.2018;2018;06;23;Perjantai;7;26;33;6;8;14
89;23.06.2018;2018;06;00;Lauantai;15;13;28;5;9;14
89;23.06.2018;2018;06;01;Lauantai;7;13;20;2;4;6
89;23.06.2018;2018;06;02;Lauantai;16;3;19;3;7;10
89;23.06.2018;2018;06;03;Lauantai;4;7;11;4;0;4
89;23.06.2018;2018;06;04;Lauantai;21;1;22;3;1;4
89;23.06.2018;2018;06;05;Lauantai;3;5;8;3;1;4
89;23.06.2018;2018;06;06;Lauantai;4;5;9;1;1;2
89;23.06.2018;2018;06;07;Lauantai;2;5;7;1;0;1
89;23.06.2018;2018;06;08;Lauantai;3;4;7;4;7;11
89;23.06.2018;2018;06;09;Lauantai;6;10;16;4;8;12
89;23.06.2018;2018;06;10;Lauantai;8;6;14;5;5;10
89;23.06.2018;2018;06;11;Lauantai;9;9;18;7;9;16
89;23.06.2018;2018;06;12;Lauantai;27;31;58;9;18;27
89;23.06.2018;2018;06;13;Lauantai;19;22;41;12;10;22
89;23.06.2018;2018;06;14;Lauantai;38;23;61;15;22;37
89;23.06.2018;2018;06;15;Lauantai;29;25;54;18;20;38
89;23.06.2018;2018;06;16;Lauantai;15;31;46;12;15;27
89;23.06.2018;2018;06;17;Lauantai;23;30;53;19;18;37
89;23.06.2018;2018;06;18;Lauantai;29;36;65;8;19;27
89;23.06.2018;2018;06;19;Lauantai;34;28;62;12;17;29
89;23.06.2018;2018;06;20;Lauantai;33;23;56;11;17;28
89;23.06.2018;2018;06;21;Lauantai;15;27;42;10;5;15
89;23.06.2018;2018;06;22;Lauantai;11;13;24;4;5;9
89;23.06.2018;2018;06;23;Lauantai;11;22;33;4;6;10
89;24.06.2018;2018;06;00;Sunnuntai;15;23;38;2;4;6
89;24.06.2018;2018;06;01;Sunnuntai;8;10;18;2;4;6
89;24.06.2018;2018;06;02;Sunnuntai;5;4;9;4;2;6
89;24.06.2018;2018;06;03;Sunnuntai;8;6;14;2;0;2
89;24.06.2018;2018;06;04;Sunnuntai;5;0;5;4;0;4
89;24.06.2018;2018;06;05;Sunnuntai;3;4;7;1;0;1
89;24.06.2018;2018;06;06;Sunnuntai;12;8;20;3;4;7
89;24.06.2018;2018;06;07;Sunnuntai;5;7;12;3;2;5
89;24.06.2018;2018;06;08;Sunnuntai;9;7;16;1;6;7
89;24.06.2018;2018;06;09;Sunnuntai;20;32;52;13;22;35
89;24.06.2018;2018;06;10;Sunnuntai;30;68;98;19;28;47
89;24.06.2018;2018;06;11;Sunnuntai;48;84;132;24;38;62
89;24.06.2018;2018;06;12;Sunnuntai;94;126;220;29;35;64
89;24.06.2018;2018;06;13;Sunnuntai;94;122;216;54;40;94
89;24.06.2018;2018;06;14;Sunnuntai;116;134;250;74;64;138
89;24.06.2018;2018;06;15;Sunnuntai;111;95;206;55;38;93
89;24.06.2018;2018;06;16;Sunnuntai;97;102;199;52;40;92
89;24.06.2018;2018;06;17;Sunnuntai;108;96;204;45;32;77
89;24.06.2018;2018;06;18;Sunnuntai;105;95;200;48;59;107
89;24.06.2018;2018;06;19;Sunnuntai;76;51;127;42;37;79
89;24.06.2018;2018;06;20;Sunnuntai;67;53;120;30;38;68
89;24.06.2018;2018;06;21;Sunnuntai;39;34;73;20;17;37
89;24.06.2018;2018;06;22;Sunnuntai;27;23;50;9;10;19
89;24.06.2018;2018;06;23;Sunnuntai;21;17;38;4;6;10
89;25.06.2018;2018;06;00;Maanantai;12;7;19;2;3;5
89;25.06.2018;2018;06;01;Maanantai;4;2;6;3;5;8
89;25.06.2018;2018;06;02;Maanantai;8;4;12;0;2;2
89;25.06.2018;2018;06;03;Maanantai;6;1;7;0;0;0
89;25.06.2018;2018;06;04;Maanantai;5;4;9;1;1;2
89;25.06.2018;2018;06;05;Maanantai;6;17;23;1;1;2
89;25.06.2018;2018;06;06;Maanantai;16;60;76;1;6;7
89;25.06.2018;2018;06;07;Maanantai;38;133;171;3;12;15
89;25.06.2018;2018;06;08;Maanantai;29;152;181;2;21;23
89;25.06.2018;2018;06;09;Maanantai;37;112;149;9;22;31
89;25.06.2018;2018;06;10;Maanantai;41;118;159;11;23;34
89;25.06.2018;2018;06;11;Maanantai;74;139;213;18;48;66
89;25.06.2018;2018;06;12;Maanantai;95;116;211;38;34;72
89;25.06.2018;2018;06;13;Maanantai;135;138;273;54;38;92
89;25.06.2018;2018;06;14;Maanantai;176;140;316;29;40;69
89;25.06.2018;2018;06;15;Maanantai;205;133;338;41;34;75
89;25.06.2018;2018;06;16;Maanantai;244;143;387;46;39;85
89;25.06.2018;2018;06;17;Maanantai;198;143;341;35;37;72
89;25.06.2018;2018;06;18;Maanantai;152;140;292;43;54;97
89;25.06.2018;2018;06;19;Maanantai;151;112;263;29;62;91
89;25.06.2018;2018;06;20;Maanantai;129;95;224;47;24;71
89;25.06.2018;2018;06;21;Maanantai;72;45;117;23;23;46
89;25.06.2018;2018;06;22;Maanantai;49;24;73;13;8;21
89;25.06.2018;2018;06;23;Maanantai;19;27;46;12;5;17
89;26.06.2018;2018;06;00;Tiistai;10;13;23;4;7;11
89;26.06.2018;2018;06;01;Tiistai;3;2;5;1;3;4
89;26.06.2018;2018;06;02;Tiistai;13;6;19;1;2;3
89;26.06.2018;2018;06;03;Tiistai;6;1;7;2;0;2
89;26.06.2018;2018;06;04;Tiistai;6;2;8;2;3;5
89;26.06.2018;2018;06;05;Tiistai;3;18;21;0;3;3
89;26.06.2018;2018;06;06;Tiistai;15;70;85;5;4;9
89;26.06.2018;2018;06;07;Tiistai;34;153;187;5;9;14
89;26.06.2018;2018;06;08;Tiistai;31;172;203;8;16;24
89;26.06.2018;2018;06;09;Tiistai;41;104;145;8;29;37
89;26.06.2018;2018;06;10;Tiistai;37;93;130;12;41;53
89;26.06.2018;2018;06;11;Tiistai;72;107;179;24;30;54
89;26.06.2018;2018;06;12;Tiistai;85;133;218;18;34;52
89;26.06.2018;2018;06;13;Tiistai;103;114;217;23;28;51
89;26.06.2018;2018;06;14;Tiistai;133;110;243;37;23;60
89;26.06.2018;2018;06;15;Tiistai;183;118;301;31;18;49
89;26.06.2018;2018;06;16;Tiistai;241;112;353;31;20;51
89;26.06.2018;2018;06;17;Tiistai;158;132;290;23;42;65
89;26.06.2018;2018;06;18;Tiistai;129;107;236;35;29;64
89;26.06.2018;2018;06;19;Tiistai;143;82;225;37;33;70
89;26.06.2018;2018;06;20;Tiistai;141;66;207;56;35;91
89;26.06.2018;2018;06;21;Tiistai;78;46;124;21;18;39
89;26.06.2018;2018;06;22;Tiistai;31;14;45;9;17;26
89;26.06.2018;2018;06;23;Tiistai;24;9;33;8;6;14
89;27.06.2018;2018;06;00;Keskiviikko;10;3;13;5;3;8
89;27.06.2018;2018;06;01;Keskiviikko;2;3;5;2;1;3
89;27.06.2018;2018;06;02;Keskiviikko;5;5;10;1;0;1
89;27.06.2018;2018;06;03;Keskiviikko;2;3;5;1;2;3
89;27.06.2018;2018;06;04;Keskiviikko;2;4;6;1;0;1
89;27.06.2018;2018;06;05;Keskiviikko;6;13;19;1;2;3
89;27.06.2018;2018;06;06;Keskiviikko;14;63;77;2;9;11
89;27.06.2018;2018;06;07;Keskiviikko;34;130;164;6;8;14
89;27.06.2018;2018;06;08;Keskiviikko;32;172;204;1;17;18
89;27.06.2018;2018;06;09;Keskiviikko;38;112;150;6;24;30
89;27.06.2018;2018;06;10;Keskiviikko;41;94;135;7;27;34
89;27.06.2018;2018;06;11;Keskiviikko;60;129;189;24;33;57
89;27.06.2018;2018;06;12;Keskiviikko;84;134;218;18;28;46
89;27.06.2018;2018;06;13;Keskiviikko;112;131;243;30;32;62
89;27.06.2018;2018;06;14;Keskiviikko;127;107;234;49;32;81
89;27.06.2018;2018;06;15;Keskiviikko;187;107;294;53;36;89
89;27.06.2018;2018;06;16;Keskiviikko;219;133;352;54;35;89
89;27.06.2018;2018;06;17;Keskiviikko;183;149;332;34;31;65
89;27.06.2018;2018;06;18;Keskiviikko;168;110;278;37;66;103
89;27.06.2018;2018;06;19;Keskiviikko;145;72;217;56;31;87
89;27.06.2018;2018;06;20;Keskiviikko;105;74;179;29;25;54
89;27.06.2018;2018;06;21;Keskiviikko;55;42;97;22;15;37
89;27.06.2018;2018;06;22;Keskiviikko;54;23;77;15;13;28
89;27.06.2018;2018;06;23;Keskiviikko;28;16;44;7;7;14
89;28.06.2018;2018;06;00;Torstai;13;6;19;0;3;3
89;28.06.2018;2018;06;01;Torstai;11;6;17;2;2;4
89;28.06.2018;2018;06;02;Torstai;8;3;11;0;3;3
89;28.06.2018;2018;06;03;Torstai;7;4;11;0;1;1
89;28.06.2018;2018;06;04;Torstai;6;3;9;1;0;1
89;28.06.2018;2018;06;05;Torstai;3;8;11;1;2;3
89;28.06.2018;2018;06;06;Torstai;13;63;76;1;7;8
89;28.06.2018;2018;06;07;Torstai;22;104;126;2;15;17
89;28.06.2018;2018;06;08;Torstai;23;116;139;3;18;21
89;28.06.2018;2018;06;09;Torstai;21;56;77;8;10;18
89;28.06.2018;2018;06;10;Torstai;11;41;52;3;6;9
89;28.06.2018;2018;06;11;Torstai;30;27;57;3;12;15
89;28.06.2018;2018;06;12;Torstai;31;29;60;2;10;12
89;28.06.2018;2018;06;13;Torstai;30;42;72;15;7;22
89;28.06.2018;2018;06;14;Torstai;31;40;71;17;16;33
89;28.06.2018;2018;06;15;Torstai;75;34;109;11;13;24
89;28.06.2018;2018;06;16;Torstai;106;41;147;11;8;19
89;28.06.2018;2018;06;17;Torstai;61;33;94;17;9;26
89;28.06.2018;2018;06;18;Torstai;44;22;66;14;16;30
89;28.06.2018;2018;06;19;Torstai;36;34;70;19;10;29
89;28.06.2018;2018;06;20;Torstai;50;23;73;10;14;24
89;28.06.2018;2018;06;21;Torstai;28;16;44;3;10;13
89;28.06.2018;2018;06;22;Torstai;15;15;30;5;3;8
89;28.06.2018;2018;06;23;Torstai;11;6;17;2;5;7
89;29.06.2018;2018;06;00;Perjantai;6;8;14;2;4;6
89;29.06.2018;2018;06;01;Perjantai;3;4;7;3;1;4
89;29.06.2018;2018;06;02;Perjantai;3;3;6;0;1;1
89;29.06.2018;2018;06;03;Perjantai;3;1;4;2;1;3
89;29.06.2018;2018;06;04;Perjantai;4;5;9;1;0;1
89;29.06.2018;2018;06;05;Perjantai;3;13;16;0;2;2
89;29.06.2018;2018;06;06;Perjantai;13;56;69;4;11;15
89;29.06.2018;2018;06;07;Perjantai;27;99;126;3;9;12
89;29.06.2018;2018;06;08;Perjantai;27;138;165;8;21;29
89;29.06.2018;2018;06;09;Perjantai;26;61;87;11;21;32
89;29.06.2018;2018;06;10;Perjantai;30;91;121;14;23;37
89;29.06.2018;2018;06;11;Perjantai;65;74;139;25;36;61
89;29.06.2018;2018;06;12;Perjantai;68;74;142;22;35;57
89;29.06.2018;2018;06;13;Perjantai;70;80;150;32;31;63
89;29.06.2018;2018;06;14;Perjantai;108;84;192;28;26;54
89;29.06.2018;2018;06;15;Perjantai;128;87;215;17;13;30
89;29.06.2018;2018;06;16;Perjantai;135;86;221;25;17;42
89;29.06.2018;2018;06;17;Perjantai;110;83;193;21;24;45
89;29.06.2018;2018;06;18;Perjantai;97;48;145;20;19;39
89;29.06.2018;2018;06;19;Perjantai;64;50;114;17;24;41
89;29.06.2018;2018;06;20;Perjantai;85;61;146;26;14;40
89;29.06.2018;2018;06;21;Perjantai;38;67;105;11;14;25
89;29.06.2018;2018;06;22;Perjantai;46;26;72;11;20;31
89;29.06.2018;2018;06;23;Perjantai;40;35;75;1;16;17
89;30.06.2018;2018;06;00;Lauantai;31;18;49;5;4;9
89;30.06.2018;2018;06;01;Lauantai;18;29;47;5;3;8
89;30.06.2018;2018;06;02;Lauantai;24;8;32;1;1;2
89;30.06.2018;2018;06;03;Lauantai;22;4;26;3;2;5
89;30.06.2018;2018;06;04;Lauantai;17;9;26;11;1;12
89;30.06.2018;2018;06;05;Lauantai;13;13;26;5;2;7
89;30.06.2018;2018;06;06;Lauantai;9;7;16;1;2;3
89;30.06.2018;2018;06;07;Lauantai;4;16;20;2;4;6
89;30.06.2018;2018;06;08;Lauantai;15;38;53;11;8;19
89;30.06.2018;2018;06;09;Lauantai;22;62;84;7;22;29
89;30.06.2018;2018;06;10;Lauantai;25;98;123;15;24;39
89;30.06.2018;2018;06;11;Lauantai;59;89;148;23;22;45
89;30.06.2018;2018;06;12;Lauantai;72;144;216;19;34;53
89;30.06.2018;2018;06;13;Lauantai;91;118;209;24;49;73
89;30.06.2018;2018;06;14;Lauantai;93;109;202;22;44;66
89;30.06.2018;2018;06;15;Lauantai;125;80;205;49;24;73
89;30.06.2018;2018;06;16;Lauantai;102;70;172;27;24;51
89;30.06.2018;2018;06;17;Lauantai;96;51;147;23;18;41
89;30.06.2018;2018;06;18;Lauantai;72;61;133;12;22;34
89;30.06.2018;2018;06;19;Lauantai;92;90;182;16;16;32
89;30.06.2018;2018;06;20;Lauantai;44;64;108;18;29;47
89;30.06.2018;2018;06;21;Lauantai;41;46;87;7;14;21
89;30.06.2018;2018;06;22;Lauantai;40;35;75;11;16;27
89;30.06.2018;2018;06;23;Lauantai;37;32;69;10;5;15
89;01.07.2018;2018;07;00;Sunnuntai;27;21;48;0;8;8
89;01.07.2018;2018;07;01;Sunnuntai;22;25;47;11;7;18
89;01.07.2018;2018;07;02;Sunnuntai;26;7;33;10;0;10
89;01.07.2018;2018;07;03;Sunnuntai;26;7;33;9;3;12
89;01.07.2018;2018;07;04;Sunnuntai;17;5;22;5;2;7
89;01.07.2018;2018;07;05;Sunnuntai;11;8;19;1;2;3
89;01.07.2018;2018;07;06;Sunnuntai;7;12;19;3;3;6
89;01.07.2018;2018;07;07;Sunnuntai;5;6;11;5;8;13
89;01.07.2018;2018;07;08;Sunnuntai;20;10;30;4;11;15
89;01.07.2018;2018;07;09;Sunnuntai;20;35;55;15;18;33
89;01.07.2018;2018;07;10;Sunnuntai;35;71;106;18;30;48
89;01.07.2018;2018;07;11;Sunnuntai;50;108;158;22;33;55
89;01.07.2018;2018;07;12;Sunnuntai;111;132;243;43;55;98
89;01.07.2018;2018;07;13;Sunnuntai;130;179;309;42;52;94
89;01.07.2018;2018;07;14;Sunnuntai;145;150;295;52;59;111
89;01.07.2018;2018;07;15;Sunnuntai;154;128;282;52;56;108
89;01.07.2018;2018;07;16;Sunnuntai;126;108;234;61;41;102
89;01.07.2018;2018;07;17;Sunnuntai;118;92;210;36;31;67
89;01.07.2018;2018;07;18;Sunnuntai;128;100;228;45;47;92
89;01.07.2018;2018;07;19;Sunnuntai;82;97;179;22;42;64
89;01.07.2018;2018;07;20;Sunnuntai;91;78;169;27;23;50
89;01.07.2018;2018;07;21;Sunnuntai;51;41;92;18;17;35
89;01.07.2018;2018;07;22;Sunnuntai;15;24;39;22;16;38
89;01.07.2018;2018;07;23;Sunnuntai;22;22;44;12;8;20
89;02.07.2018;2018;07;00;Maanantai;10;12;22;3;4;7
89;02.07.2018;2018;07;01;Maanantai;10;6;16;4;3;7
89;02.07.2018;2018;07;02;Maanantai;3;4;7;1;2;3
89;02.07.2018;2018;07;03;Maanantai;2;3;5;0;0;0
89;02.07.2018;2018;07;04;Maanantai;6;6;12;3;1;4
89;02.07.2018;2018;07;05;Maanantai;2;10;12;1;6;7
89;02.07.2018;2018;07;06;Maanantai;21;73;94;5;6;11
89;02.07.2018;2018;07;07;Maanantai;35;113;148;1;9;10
89;02.07.2018;2018;07;08;Maanantai;25;140;165;1;21;22
89;02.07.2018;2018;07;09;Maanantai;33;108;141;4;24;28
89;02.07.2018;2018;07;10;Maanantai;47;96;143;14;43;57
89;02.07.2018;2018;07;11;Maanantai;82;125;207;31;38;69
89;02.07.2018;2018;07;12;Maanantai;87;163;250;23;40;63
89;02.07.2018;2018;07;13;Maanantai;136;153;289;50;46;96
89;02.07.2018;2018;07;14;Maanantai;165;161;326;87;41;128
89;02.07.2018;2018;07;15;Maanantai;252;196;448;161;41;202
89;02.07.2018;2018;07;16;Maanantai;277;146;423;94;48;142
89;02.07.2018;2018;07;17;Maanantai;217;166;383;48;42;90
89;02.07.2018;2018;07;18;Maanantai;171;130;301;45;44;89
89;02.07.2018;2018;07;19;Maanantai;177;147;324;65;59;124
89;02.07.2018;2018;07;20;Maanantai;154;99;253;47;32;79
89;02.07.2018;2018;07;21;Maanantai;89;55;144;36;21;57
89;02.07.2018;2018;07;22;Maanantai;51;28;79;17;26;43
89;02.07.2018;2018;07;23;Maanantai;31;27;58;8;10;18
89;03.07.2018;2018;07;00;Tiistai;22;7;29;6;5;11
89;03.07.2018;2018;07;01;Tiistai;5;7;12;4;2;6
89;03.07.2018;2018;07;02;Tiistai;16;9;25;5;0;5
89;03.07.2018;2018;07;03;Tiistai;4;7;11;0;0;0
89;03.07.2018;2018;07;04;Tiistai;5;7;12;1;1;2
89;03.07.2018;2018;07;05;Tiistai;3;15;18;4;4;8
89;03.07.2018;2018;07;06;Tiistai;21;70;91;1;6;7
89;03.07.2018;2018;07;07;Tiistai;32;118;150;1;7;8
89;03.07.2018;2018;07;08;Tiistai;37;163;200;11;18;29
89;03.07.2018;2018;07;09;Tiistai;32;115;147;8;28;36
89;03.07.2018;2018;07;10;Tiistai;42;107;149;10;24;34
89;03.07.2018;2018;07;11;Tiistai;67;114;181;30;21;51
89;03.07.2018;2018;07;12;Tiistai;95;112;207;26;49;75
89;03.07.2018;2018;07;13;Tiistai;103;121;224;31;37;68
89;03.07.2018;2018;07;14;Tiistai;128;94;222;32;34;66
89;03.07.2018;2018;07;15;Tiistai;148;129;277;32;35;67
89;03.07.2018;2018;07;16;Tiistai;198;121;319;40;40;80
89;03.07.2018;2018;07;17;Tiistai;152;106;258;25;27;52
89;03.07.2018;2018;07;18;Tiistai;135;82;217;34;24;58
89;03.07.2018;2018;07;19;Tiistai;115;81;196;30;33;63
89;03.07.2018;2018;07;20;Tiistai;128;50;178;36;24;60
89;03.07.2018;2018;07;21;Tiistai;59;38;97;16;16;32
89;03.07.2018;2018;07;22;Tiistai;21;15;36;2;3;5
89;03.07.2018;2018;07;23;Tiistai;5;5;10;1;2;3
89;04.07.2018;2018;07;00;Keskiviikko;13;9;22;3;2;5
89;04.07.2018;2018;07;01;Keskiviikko;5;2;7;2;3;5
89;04.07.2018;2018;07;02;Keskiviikko;9;0;9;1;1;2
89;04.07.2018;2018;07;03;Keskiviikko;6;4;10;0;0;0
89;04.07.2018;2018;07;04;Keskiviikko;0;5;5;0;1;1
89;04.07.2018;2018;07;05;Keskiviikko;4;12;16;0;0;0
89;04.07.2018;2018;07;06;Keskiviikko;9;53;62;1;4;5
89;04.07.2018;2018;07;07;Keskiviikko;15;68;83;1;7;8
89;04.07.2018;2018;07;08;Keskiviikko;9;89;98;1;12;13
89;04.07.2018;2018;07;09;Keskiviikko;14;59;73;3;19;22
89;04.07.2018;2018;07;10;Keskiviikko;21;35;56;2;15;17
89;04.07.2018;2018;07;11;Keskiviikko;21;41;62;9;8;17
89;04.07.2018;2018;07;12;Keskiviikko;26;30;56;5;12;17
89;04.07.2018;2018;07;13;Keskiviikko;41;32;73;8;12;20
89;04.07.2018;2018;07;14;Keskiviikko;51;35;86;16;8;24
89;04.07.2018;2018;07;15;Keskiviikko;77;52;129;16;15;31
89;04.07.2018;2018;07;16;Keskiviikko;84;76;160;19;20;39
89;04.07.2018;2018;07;17;Keskiviikko;104;88;192;28;37;65
89;04.07.2018;2018;07;18;Keskiviikko;104;110;214;45;33;78
89;04.07.2018;2018;07;19;Keskiviikko;129;98;227;44;44;88
89;04.07.2018;2018;07;20;Keskiviikko;105;52;157;38;28;66
89;04.07.2018;2018;07;21;Keskiviikko;73;53;126;20;23;43
89;04.07.2018;2018;07;22;Keskiviikko;48;29;77;21;10;31
89;04.07.2018;2018;07;23;Keskiviikko;14;11;25;6;4;10
89;05.07.2018;2018;07;00;Torstai;18;12;30;6;12;18
89;05.07.2018;2018;07;01;Torstai;13;5;18;1;3;4
89;05.07.2018;2018;07;02;Torstai;11;7;18;1;5;6
89;05.07.2018;2018;07;03;Torstai;6;8;14;1;2;3
89;05.07.2018;2018;07;04;Torstai;1;2;3;2;1;3
89;05.07.2018;2018;07;05;Torstai;10;10;20;4;2;6
89;05.07.2018;2018;07;06;Torstai;15;62;77;2;12;14
89;05.07.2018;2018;07;07;Torstai;24;111;135;3;9;12
89;05.07.2018;2018;07;08;Torstai;32;133;165;6;20;26
89;05.07.2018;2018;07;09;Torstai;30;89;119;15;22;37
89;05.07.2018;2018;07;10;Torstai;47;116;163;14;29;43
89;05.07.2018;2018;07;11;Torstai;80;151;231;21;36;57
89;05.07.2018;2018;07;12;Torstai;93;165;258;27;43;70
89;05.07.2018;2018;07;13;Torstai;104;155;259;18;46;64
89;05.07.2018;2018;07;14;Torstai;145;106;251;44;16;60
89;05.07.2018;2018;07;15;Torstai;188;121;309;39;56;95
89;05.07.2018;2018;07;16;Torstai;180;83;263;29;14;43
89;05.07.2018;2018;07;17;Torstai;129;86;215;20;19;39
89;05.07.2018;2018;07;18;Torstai;90;71;161;31;24;55
89;05.07.2018;2018;07;19;Torstai;94;64;158;28;18;46
89;05.07.2018;2018;07;20;Torstai;60;26;86;22;16;38
89;05.07.2018;2018;07;21;Torstai;66;40;106;20;20;40
89;05.07.2018;2018;07;22;Torstai;30;11;41;10;10;20
89;05.07.2018;2018;07;23;Torstai;27;9;36;6;9;15
89;06.07.2018;2018;07;00;Perjantai;12;9;21;8;1;9
89;06.07.2018;2018;07;01;Perjantai;8;4;12;2;1;3
89;06.07.2018;2018;07;02;Perjantai;7;10;17;4;3;7
89;06.07.2018;2018;07;03;Perjantai;1;7;8;1;1;2
89;06.07.2018;2018;07;04;Perjantai;5;4;9;0;1;1
89;06.07.2018;2018;07;05;Perjantai;7;12;19;2;2;4
89;06.07.2018;2018;07;06;Perjantai;11;58;69;2;8;10
89;06.07.2018;2018;07;07;Perjantai;30;77;107;6;9;15
89;06.07.2018;2018;07;08;Perjantai;16;133;149;5;20;25
89;06.07.2018;2018;07;09;Perjantai;24;79;103;10;31;41
89;06.07.2018;2018;07;10;Perjantai;44;101;145;9;37;46
89;06.07.2018;2018;07;11;Perjantai;69;112;181;18;31;49
89;06.07.2018;2018;07;12;Perjantai;99;156;255;24;53;77
89;06.07.2018;2018;07;13;Perjantai;127;137;264;35;43;78
89;06.07.2018;2018;07;14;Perjantai;174;161;335;60;31;91
89;06.07.2018;2018;07;15;Perjantai;229;169;398;42;36;78
89;06.07.2018;2018;07;16;Perjantai;249;152;401;64;25;89
89;06.07.2018;2018;07;17;Perjantai;168;175;343;25;27;52
89;06.07.2018;2018;07;18;Perjantai;194;150;344;48;32;80
89;06.07.2018;2018;07;19;Perjantai;183;151;334;43;38;81
89;06.07.2018;2018;07;20;Perjantai;156;147;303;27;43;70
89;06.07.2018;2018;07;21;Perjantai;95;82;177;27;28;55
89;06.07.2018;2018;07;22;Perjantai;58;41;99;15;25;40
89;06.07.2018;2018;07;23;Perjantai;88;63;151;13;17;30
89;07.07.2018;2018;07;00;Lauantai;51;44;95;11;28;39
89;07.07.2018;2018;07;01;Lauantai;53;50;103;12;21;33
89;07.07.2018;2018;07;02;Lauantai;38;22;60;2;1;3
89;07.07.2018;2018;07;03;Lauantai;19;11;30;7;2;9
89;07.07.2018;2018;07;04;Lauantai;31;10;41;11;3;14
89;07.07.2018;2018;07;05;Lauantai;18;17;35;4;3;7
89;07.07.2018;2018;07;06;Lauantai;6;8;14;4;4;8
89;07.07.2018;2018;07;07;Lauantai;9;25;34;2;4;6
89;07.07.2018;2018;07;08;Lauantai;21;26;47;6;9;15
89;07.07.2018;2018;07;09;Lauantai;21;76;97;14;23;37
89;07.07.2018;2018;07;10;Lauantai;52;104;156;23;44;67
89;07.07.2018;2018;07;11;Lauantai;91;185;276;31;48;79
89;07.07.2018;2018;07;12;Lauantai;144;225;369;21;50;71
89;07.07.2018;2018;07;13;Lauantai;166;224;390;36;42;78
89;07.07.2018;2018;07;14;Lauantai;201;182;383;30;58;88
89;07.07.2018;2018;07;15;Lauantai;167;149;316;36;55;91
89;07.07.2018;2018;07;16;Lauantai;201;143;344;43;51;94
89;07.07.2018;2018;07;17;Lauantai;161;109;270;38;31;69
89;07.07.2018;2018;07;18;Lauantai;124;94;218;24;14;38
89;07.07.2018;2018;07;19;Lauantai;113;109;222;18;27;45
89;07.07.2018;2018;07;20;Lauantai;108;112;220;24;21;45
89;07.07.2018;2018;07;21;Lauantai;85;88;173;20;13;33
89;07.07.2018;2018;07;22;Lauantai;41;80;121;7;23;30
89;07.07.2018;2018;07;23;Lauantai;45;32;77;4;14;18
89;08.07.2018;2018;07;00;Sunnuntai;50;58;108;5;14;19
89;08.07.2018;2018;07;01;Sunnuntai;23;42;65;4;20;24
89;08.07.2018;2018;07;02;Sunnuntai;27;16;43;19;5;24
89;08.07.2018;2018;07;03;Sunnuntai;30;13;43;9;3;12
89;08.07.2018;2018;07;04;Sunnuntai;39;3;42;11;1;12
89;08.07.2018;2018;07;05;Sunnuntai;14;10;24;3;4;7
89;08.07.2018;2018;07;06;Sunnuntai;7;10;17;5;4;9
89;08.07.2018;2018;07;07;Sunnuntai;4;11;15;4;2;6
89;08.07.2018;2018;07;08;Sunnuntai;10;14;24;6;6;12
89;08.07.2018;2018;07;09;Sunnuntai;27;32;59;11;10;21
89;08.07.2018;2018;07;10;Sunnuntai;26;72;98;17;30;47
89;08.07.2018;2018;07;11;Sunnuntai;59;122;181;20;38;58
89;08.07.2018;2018;07;12;Sunnuntai;97;169;266;53;94;147
89;08.07.2018;2018;07;13;Sunnuntai;138;151;289;63;78;141
89;08.07.2018;2018;07;14;Sunnuntai;150;176;326;61;51;112
89;08.07.2018;2018;07;15;Sunnuntai;178;105;283;55;43;98
89;08.07.2018;2018;07;16;Sunnuntai;119;108;227;51;57;108
89;08.07.2018;2018;07;17;Sunnuntai;170;153;323;33;39;72
89;08.07.2018;2018;07;18;Sunnuntai;172;107;279;50;54;104
89;08.07.2018;2018;07;19;Sunnuntai;121;112;233;42;48;90
89;08.07.2018;2018;07;20;Sunnuntai;111;98;209;34;26;60
89;08.07.2018;2018;07;21;Sunnuntai;60;74;134;12;26;38
89;08.07.2018;2018;07;22;Sunnuntai;53;34;87;13;12;25
89;08.07.2018;2018;07;23;Sunnuntai;26;16;42;9;9;18
89;09.07.2018;2018;07;00;Maanantai;19;10;29;5;2;7
89;09.07.2018;2018;07;01;Maanantai;4;3;7;1;3;4
89;09.07.2018;2018;07;02;Maanantai;9;13;22;11;2;13
89;09.07.2018;2018;07;03;Maanantai;1;2;3;4;1;5
89;09.07.2018;2018;07;04;Maanantai;8;3;11;2;1;3
89;09.07.2018;2018;07;05;Maanantai;7;19;26;1;1;2
89;09.07.2018;2018;07;06;Maanantai;16;74;90;2;5;7
89;09.07.2018;2018;07;07;Maanantai;26;114;140;3;10;13
89;09.07.2018;2018;07;08;Maanantai;22;125;147;5;12;17
89;09.07.2018;2018;07;09;Maanantai;44;97;141;7;36;43
89;09.07.2018;2018;07;10;Maanantai;50;133;183;13;32;45
89;09.07.2018;2018;07;11;Maanantai;94;145;239;22;43;65
89;09.07.2018;2018;07;12;Maanantai;136;170;306;29;44;73
89;09.07.2018;2018;07;13;Maanantai;147;169;316;35;36;71
89;09.07.2018;2018;07;14;Maanantai;169;140;309;38;40;78
89;09.07.2018;2018;07;15;Maanantai;212;138;350;42;35;77
89;09.07.2018;2018;07;16;Maanantai;230;177;407;39;56;95
89;09.07.2018;2018;07;17;Maanantai;188;192;380;31;54;85
89;09.07.2018;2018;07;18;Maanantai;201;152;353;50;48;98
89;09.07.2018;2018;07;19;Maanantai;201;144;345;38;41;79
89;09.07.2018;2018;07;20;Maanantai;129;109;238;36;53;89
89;09.07.2018;2018;07;21;Maanantai;97;80;177;17;29;46
89;09.07.2018;2018;07;22;Maanantai;60;53;113;21;15;36
89;09.07.2018;2018;07;23;Maanantai;30;15;45;9;12;21
89;10.07.2018;2018;07;00;Tiistai;16;17;33;5;3;8
89;10.07.2018;2018;07;01;Tiistai;6;8;14;3;4;7
89;10.07.2018;2018;07;02;Tiistai;3;3;6;4;3;7
89;10.07.2018;2018;07;03;Tiistai;6;6;12;1;0;1
89;10.07.2018;2018;07;04;Tiistai;6;4;10;0;1;1
89;10.07.2018;2018;07;05;Tiistai;8;18;26;3;1;4
89;10.07.2018;2018;07;06;Tiistai;17;74;91;2;5;7
89;10.07.2018;2018;07;07;Tiistai;33;109;142;0;8;8
89;10.07.2018;2018;07;08;Tiistai;29;139;168;7;14;21
89;10.07.2018;2018;07;09;Tiistai;40;111;151;19;29;48
89;10.07.2018;2018;07;10;Tiistai;65;146;211;24;42;66
89;10.07.2018;2018;07;11;Tiistai;131;137;268;31;42;73
89;10.07.2018;2018;07;12;Tiistai;132;197;329;39;41;80
89;10.07.2018;2018;07;13;Tiistai;180;189;369;44;52;96
89;10.07.2018;2018;07;14;Tiistai;170;179;349;77;56;133
89;10.07.2018;2018;07;15;Tiistai;239;194;433;43;48;91
89;10.07.2018;2018;07;16;Tiistai;233;169;402;46;42;88
89;10.07.2018;2018;07;17;Tiistai;226;183;409;39;51;90
89;10.07.2018;2018;07;18;Tiistai;245;184;429;38;42;80
89;10.07.2018;2018;07;19;Tiistai;198;164;362;78;86;164
89;10.07.2018;2018;07;20;Tiistai;175;107;282;42;30;72
89;10.07.2018;2018;07;21;Tiistai;99;51;150;23;15;38
89;10.07.2018;2018;07;22;Tiistai;52;43;95;14;9;23
89;10.07.2018;2018;07;23;Tiistai;63;33;96;12;7;19
89;11.07.2018;2018;07;00;Keskiviikko;23;16;39;3;4;7
89;11.07.2018;2018;07;01;Keskiviikko;11;15;26;3;4;7
89;11.07.2018;2018;07;02;Keskiviikko;17;5;22;1;5;6
89;11.07.2018;2018;07;03;Keskiviikko;7;9;16;2;0;2
89;11.07.2018;2018;07;04;Keskiviikko;3;6;9;0;0;0
89;11.07.2018;2018;07;05;Keskiviikko;7;21;28;1;3;4
89;11.07.2018;2018;07;06;Keskiviikko;16;64;80;1;9;10
89;11.07.2018;2018;07;07;Keskiviikko;31;98;129;0;11;11
89;11.07.2018;2018;07;08;Keskiviikko;20;121;141;5;16;21
89;11.07.2018;2018;07;09;Keskiviikko;29;123;152;7;28;35
89;11.07.2018;2018;07;10;Keskiviikko;37;117;154;14;24;38
89;11.07.2018;2018;07;11;Keskiviikko;92;153;245;25;23;48
89;11.07.2018;2018;07;12;Keskiviikko;109;139;248;35;39;74
89;11.07.2018;2018;07;13;Keskiviikko;155;191;346;54;56;110
89;11.07.2018;2018;07;14;Keskiviikko;209;153;362;105;35;140
89;11.07.2018;2018;07;15;Keskiviikko;239;161;400;160;35;195
89;11.07.2018;2018;07;16;Keskiviikko;257;188;445;60;48;108
89;11.07.2018;2018;07;17;Keskiviikko;219;209;428;39;40;79
89;11.07.2018;2018;07;18;Keskiviikko;214;185;399;47;56;103
89;11.07.2018;2018;07;19;Keskiviikko;193;177;370;46;57;103
89;11.07.2018;2018;07;20;Keskiviikko;149;127;276;34;52;86
89;11.07.2018;2018;07;21;Keskiviikko;122;74;196;24;22;46
89;11.07.2018;2018;07;22;Keskiviikko;65;61;126;10;19;29
89;11.07.2018;2018;07;23;Keskiviikko;41;29;70;14;18;32
89;12.07.2018;2018;07;00;Torstai;33;15;48;7;4;11
89;12.07.2018;2018;07;01;Torstai;21;9;30;1;4;5
89;12.07.2018;2018;07;02;Torstai;14;7;21;2;2;4
89;12.07.2018;2018;07;03;Torstai;7;3;10;1;0;1
89;12.07.2018;2018;07;04;Torstai;10;2;12;2;0;2
89;12.07.2018;2018;07;05;Torstai;8;11;19;2;3;5
89;12.07.2018;2018;07;06;Torstai;14;63;77;2;2;4
89;12.07.2018;2018;07;07;Torstai;33;102;135;5;14;19
89;12.07.2018;2018;07;08;Torstai;22;147;169;4;14;18
89;12.07.2018;2018;07;09;Torstai;41;103;144;10;23;33
89;12.07.2018;2018;07;10;Torstai;51;116;167;19;20;39
89;12.07.2018;2018;07;11;Torstai;113;147;260;35;26;61
89;12.07.2018;2018;07;12;Torstai;149;156;305;20;42;62
89;12.07.2018;2018;07;13;Torstai;137;156;293;34;32;66
89;12.07.2018;2018;07;14;Torstai;161;163;324;40;30;70
89;12.07.2018;2018;07;15;Torstai;221;212;433;39;49;88
89;12.07.2018;2018;07;16;Torstai;230;179;409;47;23;70
89;12.07.2018;2018;07;17;Torstai;162;211;373;39;45;84
89;12.07.2018;2018;07;18;Torstai;188;198;386;36;39;75
89;12.07.2018;2018;07;19;Torstai;175;162;337;42;45;87
89;12.07.2018;2018;07;20;Torstai;169;152;321;22;31;53
89;12.07.2018;2018;07;21;Torstai;108;98;206;16;23;39
89;12.07.2018;2018;07;22;Torstai;83;57;140;16;17;33
89;12.07.2018;2018;07;23;Torstai;67;28;95;5;14;19
89;13.07.2018;2018;07;00;Perjantai;42;19;61;11;1;12
89;13.07.2018;2018;07;01;Perjantai;13;5;18;5;6;11
89;13.07.2018;2018;07;02;Perjantai;16;5;21;1;0;1
89;13.07.2018;2018;07;03;Perjantai;9;4;13;2;0;2
89;13.07.2018;2018;07;04;Perjantai;16;10;26;5;1;6
89;13.07.2018;2018;07;05;Perjantai;8;18;26;2;4;6
89;13.07.2018;2018;07;06;Perjantai;14;58;72;1;5;6
89;13.07.2018;2018;07;07;Perjantai;21;106;127;4;11;15
89;13.07.2018;2018;07;08;Perjantai;19;139;158;7;9;16
89;13.07.2018;2018;07;09;Perjantai;51;92;143;7;23;30
89;13.07.2018;2018;07;10;Perjantai;56;121;177;10;23;33
89;13.07.2018;2018;07;11;Perjantai;87;138;225;19;35;54
89;13.07.2018;2018;07;12;Perjantai;118;167;285;21;39;60
89;13.07.2018;2018;07;13;Perjantai;138;229;367;35;52;87
89;13.07.2018;2018;07;14;Perjantai;228;182;410;48;29;77
89;13.07.2018;2018;07;15;Perjantai;217;166;383;39;30;69
89;13.07.2018;2018;07;16;Perjantai;204;203;407;35;45;80
89;13.07.2018;2018;07;17;Perjantai;180;151;331;29;36;65
89;13.07.2018;2018;07;18;Perjantai;155;167;322;41;46;87
89;13.07.2018;2018;07;19;Perjantai;171;165;336;36;34;70
89;13.07.2018;2018;07;20;Perjantai;137;145;282;21;25;46
89;13.07.2018;2018;07;21;Perjantai;115;137;252;17;23;40
89;13.07.2018;2018;07;22;Perjantai;128;69;197;25;17;42
89;13.07.2018;2018;07;23;Perjantai;80;44;124;15;28;43
89;14.07.2018;2018;07;00;Lauantai;109;80;189;15;18;33
89;14.07.2018;2018;07;01;Lauantai;80;38;118;16;10;26
89;14.07.2018;2018;07;02;Lauantai;55;23;78;9;10;19
89;14.07.2018;2018;07;03;Lauantai;27;7;34;8;2;10
89;14.07.2018;2018;07;04;Lauantai;30;10;40;8;3;11
89;14.07.2018;2018;07;05;Lauantai;24;13;37;16;7;23
89;14.07.2018;2018;07;06;Lauantai;7;9;16;3;3;6
89;14.07.2018;2018;07;07;Lauantai;8;15;23;1;6;7
89;14.07.2018;2018;07;08;Lauantai;18;26;44;5;11;16
89;14.07.2018;2018;07;09;Lauantai;29;68;97;15;19;34
89;14.07.2018;2018;07;10;Lauantai;58;111;169;14;31;45
89;14.07.2018;2018;07;11;Lauantai;73;87;160;24;23;47
89;14.07.2018;2018;07;12;Lauantai;79;112;191;29;34;63
89;14.07.2018;2018;07;13;Lauantai;84;163;247;26;36;62
89;14.07.2018;2018;07;14;Lauantai;141;140;281;22;40;62
89;14.07.2018;2018;07;15;Lauantai;162;141;303;42;34;76
89;14.07.2018;2018;07;16;Lauantai;159;181;340;33;56;89
89;14.07.2018;2018;07;17;Lauantai;145;153;298;55;35;90
89;14.07.2018;2018;07;18;Lauantai;136;145;281;37;31;68
89;14.07.2018;2018;07;19;Lauantai;95;128;223;23;21;44
89;14.07.2018;2018;07;20;Lauantai;134;114;248;36;32;68
89;14.07.2018;2018;07;21;Lauantai;101;125;226;17;33;50
89;14.07.2018;2018;07;22;Lauantai;81;94;175;12;20;32
89;14.07.2018;2018;07;23;Lauantai;97;66;163;19;17;36
89;15.07.2018;2018;07;00;Sunnuntai;76;95;171;15;25;40
89;15.07.2018;2018;07;01;Sunnuntai;53;44;97;13;17;30
89;15.07.2018;2018;07;02;Sunnuntai;30;29;59;6;8;14
89;15.07.2018;2018;07;03;Sunnuntai;43;13;56;17;5;22
89;15.07.2018;2018;07;04;Sunnuntai;39;5;44;18;2;20
89;15.07.2018;2018;07;05;Sunnuntai;22;14;36;5;3;8
89;15.07.2018;2018;07;06;Sunnuntai;7;15;22;2;6;8
89;15.07.2018;2018;07;07;Sunnuntai;8;11;19;4;4;8
89;15.07.2018;2018;07;08;Sunnuntai;21;16;37;8;7;15
89;15.07.2018;2018;07;09;Sunnuntai;19;42;61;18;24;42
89;15.07.2018;2018;07;10;Sunnuntai;52;88;140;17;30;47
89;15.07.2018;2018;07;11;Sunnuntai;97;126;223;16;41;57
89;15.07.2018;2018;07;12;Sunnuntai;130;142;272;51;36;87
89;15.07.2018;2018;07;13;Sunnuntai;154;151;305;21;49;70
89;15.07.2018;2018;07;14;Sunnuntai;177;172;349;55;43;98
89;15.07.2018;2018;07;15;Sunnuntai;172;167;339;45;51;96
89;15.07.2018;2018;07;16;Sunnuntai;197;141;338;43;52;95
89;15.07.2018;2018;07;17;Sunnuntai;155;161;316;34;34;68
89;15.07.2018;2018;07;18;Sunnuntai;129;70;199;20;27;47
89;15.07.2018;2018;07;19;Sunnuntai;110;64;174;19;20;39
89;15.07.2018;2018;07;20;Sunnuntai;114;109;223;27;29;56
89;15.07.2018;2018;07;21;Sunnuntai;87;79;166;15;33;48
89;15.07.2018;2018;07;22;Sunnuntai;58;46;104;12;11;23
89;15.07.2018;2018;07;23;Sunnuntai;24;23;47;12;11;23
89;16.07.2018;2018;07;00;Maanantai;13;16;29;7;6;13
89;16.07.2018;2018;07;01;Maanantai;11;3;14;3;2;5
89;16.07.2018;2018;07;02;Maanantai;6;9;15;1;2;3
89;16.07.2018;2018;07;03;Maanantai;8;8;16;25;28;53
89;16.07.2018;2018;07;04;Maanantai;11;5;16;2;0;2
89;16.07.2018;2018;07;05;Maanantai;8;10;18;4;3;7
89;16.07.2018;2018;07;06;Maanantai;10;63;73;3;7;10
89;16.07.2018;2018;07;07;Maanantai;42;110;152;2;12;14
89;16.07.2018;2018;07;08;Maanantai;30;126;156;9;14;23
89;16.07.2018;2018;07;09;Maanantai;39;122;161;5;21;26
89;16.07.2018;2018;07;10;Maanantai;60;127;187;16;26;42
89;16.07.2018;2018;07;11;Maanantai;85;139;224;27;27;54
89;16.07.2018;2018;07;12;Maanantai;141;145;286;24;32;56
89;16.07.2018;2018;07;13;Maanantai;154;155;309;20;37;57
89;16.07.2018;2018;07;14;Maanantai;183;154;337;37;34;71
89;16.07.2018;2018;07;15;Maanantai;211;113;324;29;28;57
89;16.07.2018;2018;07;16;Maanantai;234;139;373;30;32;62
89;16.07.2018;2018;07;17;Maanantai;181;141;322;30;39;69
89;16.07.2018;2018;07;18;Maanantai;138;140;278;43;29;72
89;16.07.2018;2018;07;19;Maanantai;178;157;335;36;50;86
89;16.07.2018;2018;07;20;Maanantai;175;99;274;45;44;89
89;16.07.2018;2018;07;21;Maanantai;127;68;195;23;30;53
89;16.07.2018;2018;07;22;Maanantai;58;46;104;14;19;33
89;16.07.2018;2018;07;23;Maanantai;26;19;45;4;11;15
89;17.07.2018;2018;07;00;Tiistai;7;15;22;6;7;13
89;17.07.2018;2018;07;01;Tiistai;15;12;27;0;1;1
89;17.07.2018;2018;07;02;Tiistai;7;4;11;2;4;6
89;17.07.2018;2018;07;03;Tiistai;4;7;11;5;0;5
89;17.07.2018;2018;07;04;Tiistai;7;7;14;5;5;10
89;17.07.2018;2018;07;05;Tiistai;7;11;18;2;2;4
89;17.07.2018;2018;07;06;Tiistai;18;69;87;1;8;9
89;17.07.2018;2018;07;07;Tiistai;28;104;132;2;8;10
89;17.07.2018;2018;07;08;Tiistai;16;121;137;8;22;30
89;17.07.2018;2018;07;09;Tiistai;69;101;170;6;29;35
89;17.07.2018;2018;07;10;Tiistai;55;101;156;10;23;33
89;17.07.2018;2018;07;11;Tiistai;115;135;250;13;24;37
89;17.07.2018;2018;07;12;Tiistai;120;165;285;24;25;49
89;17.07.2018;2018;07;13;Tiistai;163;127;290;28;29;57
89;17.07.2018;2018;07;14;Tiistai;177;140;317;20;29;49
89;17.07.2018;2018;07;15;Tiistai;233;136;369;45;29;74
89;17.07.2018;2018;07;16;Tiistai;253;173;426;52;26;78
89;17.07.2018;2018;07;17;Tiistai;215;151;366;37;46;83
89;17.07.2018;2018;07;18;Tiistai;208;169;377;36;47;83
89;17.07.2018;2018;07;19;Tiistai;181;183;364;30;47;77
89;17.07.2018;2018;07;20;Tiistai;184;152;336;20;43;63
89;17.07.2018;2018;07;21;Tiistai;132;108;240;14;39;53
89;17.07.2018;2018;07;22;Tiistai;72;79;151;26;39;65
89;17.07.2018;2018;07;23;Tiistai;61;43;104;18;17;35
89;18.07.2018;2018;07;00;Keskiviikko;32;20;52;9;9;18
89;18.07.2018;2018;07;01;Keskiviikko;21;20;41;8;0;8
89;18.07.2018;2018;07;02;Keskiviikko;24;8;32;2;4;6
89;18.07.2018;2018;07;03;Keskiviikko;8;4;12;1;1;2
89;18.07.2018;2018;07;04;Keskiviikko;15;8;23;3;3;6
89;18.07.2018;2018;07;05;Keskiviikko;6;12;18;0;3;3
89;18.07.2018;2018;07;06;Keskiviikko;13;67;80;1;4;5
89;18.07.2018;2018;07;07;Keskiviikko;33;90;123;4;8;12
89;18.07.2018;2018;07;08;Keskiviikko;20;134;154;3;18;21
89;18.07.2018;2018;07;09;Keskiviikko;48;112;160;12;13;25
89;18.07.2018;2018;07;10;Keskiviikko;52;105;157;16;16;32
89;18.07.2018;2018;07;11;Keskiviikko;101;125;226;28;37;65
89;18.07.2018;2018;07;12;Keskiviikko;118;138;256;25;27;52
89;18.07.2018;2018;07;13;Keskiviikko;170;151;321;24;31;55
89;18.07.2018;2018;07;14;Keskiviikko;164;149;313;40;36;76
89;18.07.2018;2018;07;15;Keskiviikko;235;166;401;49;38;87
89;18.07.2018;2018;07;16;Keskiviikko;242;147;389;54;35;89
89;18.07.2018;2018;07;17;Keskiviikko;202;165;367;49;60;109
89;18.07.2018;2018;07;18;Keskiviikko;202;151;353;28;51;79
89;18.07.2018;2018;07;19;Keskiviikko;194;131;325;27;34;61
89;18.07.2018;2018;07;20;Keskiviikko;189;143;332;24;44;68
89;18.07.2018;2018;07;21;Keskiviikko;145;143;288;25;23;48
89;18.07.2018;2018;07;22;Keskiviikko;88;84;172;20;26;46
89;18.07.2018;2018;07;23;Keskiviikko;61;58;119;4;5;9
89;19.07.2018;2018;07;00;Torstai;42;20;62;7;15;22
89;19.07.2018;2018;07;01;Torstai;35;13;48;6;5;11
89;19.07.2018;2018;07;02;Torstai;16;9;25;4;4;8
89;19.07.2018;2018;07;03;Torstai;11;6;17;2;0;2
89;19.07.2018;2018;07;04;Torstai;21;8;29;0;2;2
89;19.07.2018;2018;07;05;Torstai;7;13;20;3;5;8
89;19.07.2018;2018;07;06;Torstai;11;69;80;3;5;8
89;19.07.2018;2018;07;07;Torstai;33;108;141;7;6;13
89;19.07.2018;2018;07;08;Torstai;21;123;144;5;22;27
89;19.07.2018;2018;07;09;Torstai;39;109;148;4;14;18
89;19.07.2018;2018;07;10;Torstai;63;119;182;14;31;45
89;19.07.2018;2018;07;11;Torstai;104;152;256;15;27;42
89;19.07.2018;2018;07;12;Torstai;109;141;250;21;33;54
89;19.07.2018;2018;07;13;Torstai;134;148;282;22;29;51
89;19.07.2018;2018;07;14;Torstai;182;136;318;32;50;82
89;19.07.2018;2018;07;15;Torstai;196;143;339;74;22;96
89;19.07.2018;2018;07;16;Torstai;236;150;386;54;37;91
89;19.07.2018;2018;07;17;Torstai;174;149;323;39;48;87
89;19.07.2018;2018;07;18;Torstai;195;104;299;38;40;78
89;19.07.2018;2018;07;19;Torstai;152;128;280;30;35;65
89;19.07.2018;2018;07;20;Torstai;154;149;303;25;34;59
89;19.07.2018;2018;07;21;Torstai;134;87;221;15;22;37
89;19.07.2018;2018;07;22;Torstai;96;78;174;15;17;32
89;19.07.2018;2018;07;23;Torstai;59;41;100;9;16;25
89;20.07.2018;2018;07;00;Perjantai;28;20;48;12;10;22
89;20.07.2018;2018;07;01;Perjantai;15;13;28;2;6;8
89;20.07.2018;2018;07;02;Perjantai;22;3;25;4;4;8
89;20.07.2018;2018;07;03;Perjantai;15;6;21;8;1;9
89;20.07.2018;2018;07;04;Perjantai;14;6;20;4;1;5
89;20.07.2018;2018;07;05;Perjantai;5;15;20;1;3;4
89;20.07.2018;2018;07;06;Perjantai;11;57;68;1;3;4
89;20.07.2018;2018;07;07;Perjantai;23;82;105;4;9;13
89;20.07.2018;2018;07;08;Perjantai;20;116;136;7;14;21
89;20.07.2018;2018;07;09;Perjantai;40;98;138;14;23;37
89;20.07.2018;2018;07;10;Perjantai;69;104;173;21;30;51
89;20.07.2018;2018;07;11;Perjantai;97;114;211;16;33;49
89;20.07.2018;2018;07;12;Perjantai;110;140;250;15;35;50
89;20.07.2018;2018;07;13;Perjantai;128;137;265;19;33;52
89;20.07.2018;2018;07;14;Perjantai;182;139;321;45;23;68
89;20.07.2018;2018;07;15;Perjantai;226;151;377;52;32;84
89;20.07.2018;2018;07;16;Perjantai;214;152;366;35;27;62
89;20.07.2018;2018;07;17;Perjantai;201;135;336;29;35;64
89;20.07.2018;2018;07;18;Perjantai;185;115;300;27;34;61
89;20.07.2018;2018;07;19;Perjantai;146;148;294;41;60;101
89;20.07.2018;2018;07;20;Perjantai;119;166;285;20;30;50
89;20.07.2018;2018;07;21;Perjantai;142;136;278;23;46;69
89;20.07.2018;2018;07;22;Perjantai;87;84;171;24;39;63
89;20.07.2018;2018;07;23;Perjantai;77;64;141;18;15;33
89;21.07.2018;2018;07;00;Lauantai;59;24;83;18;17;35
89;21.07.2018;2018;07;01;Lauantai;62;24;86;12;8;20
89;21.07.2018;2018;07;02;Lauantai;34;10;44;7;5;12
89;21.07.2018;2018;07;03;Lauantai;20;9;29;12;1;13
89;21.07.2018;2018;07;04;Lauantai;32;7;39;9;1;10
89;21.07.2018;2018;07;05;Lauantai;29;14;43;6;4;10
89;21.07.2018;2018;07;06;Lauantai;14;10;24;1;4;5
89;21.07.2018;2018;07;07;Lauantai;10;23;33;5;7;12
89;21.07.2018;2018;07;08;Lauantai;15;42;57;5;12;17
89;21.07.2018;2018;07;09;Lauantai;22;60;82;6;26;32
89;21.07.2018;2018;07;10;Lauantai;56;81;137;16;11;27
89;21.07.2018;2018;07;11;Lauantai;60;108;168;9;31;40
89;21.07.2018;2018;07;12;Lauantai;73;148;221;29;46;75
89;21.07.2018;2018;07;13;Lauantai;75;89;164;26;28;54
89;21.07.2018;2018;07;14;Lauantai;99;78;177;27;33;60
89;21.07.2018;2018;07;15;Lauantai;121;56;177;27;20;47
89;21.07.2018;2018;07;16;Lauantai;103;108;211;24;27;51
89;21.07.2018;2018;07;17;Lauantai;119;100;219;20;37;57
89;21.07.2018;2018;07;18;Lauantai;116;118;234;24;30;54
89;21.07.2018;2018;07;19;Lauantai;94;88;182;22;36;58
89;21.07.2018;2018;07;20;Lauantai;97;90;187;33;45;78
89;21.07.2018;2018;07;21;Lauantai;76;87;163;30;43;73
89;21.07.2018;2018;07;22;Lauantai;37;59;96;11;21;32
89;21.07.2018;2018;07;23;Lauantai;51;42;93;12;12;24
89;22.07.2018;2018;07;00;Sunnuntai;41;39;80;5;7;12
89;22.07.2018;2018;07;01;Sunnuntai;39;21;60;14;14;28
89;22.07.2018;2018;07;02;Sunnuntai;38;7;45;10;3;13
89;22.07.2018;2018;07;03;Sunnuntai;27;15;42;8;3;11
89;22.07.2018;2018;07;04;Sunnuntai;35;7;42;6;3;9
89;22.07.2018;2018;07;05;Sunnuntai;9;3;12;5;2;7
89;22.07.2018;2018;07;06;Sunnuntai;8;9;17;0;2;2
89;22.07.2018;2018;07;07;Sunnuntai;1;5;6;3;8;11
89;22.07.2018;2018;07;08;Sunnuntai;8;10;18;4;8;12
89;22.07.2018;2018;07;09;Sunnuntai;16;17;33;5;14;19
89;22.07.2018;2018;07;10;Sunnuntai;17;39;56;14;21;35
89;22.07.2018;2018;07;11;Sunnuntai;39;72;111;19;31;50
89;22.07.2018;2018;07;12;Sunnuntai;49;94;143;29;33;62
89;22.07.2018;2018;07;13;Sunnuntai;62;66;128;21;24;45
89;22.07.2018;2018;07;14;Sunnuntai;79;72;151;29;22;51
89;22.07.2018;2018;07;15;Sunnuntai;101;80;181;30;22;52
89;22.07.2018;2018;07;16;Sunnuntai;69;59;128;19;17;36
89;22.07.2018;2018;07;17;Sunnuntai;63;72;135;26;28;54
89;22.07.2018;2018;07;18;Sunnuntai;88;73;161;15;27;42
89;22.07.2018;2018;07;19;Sunnuntai;86;47;133;34;27;61
89;22.07.2018;2018;07;20;Sunnuntai;62;38;100;21;14;35
89;22.07.2018;2018;07;21;Sunnuntai;55;36;91;26;25;51
89;22.07.2018;2018;07;22;Sunnuntai;36;44;80;12;16;28
89;22.07.2018;2018;07;23;Sunnuntai;19;24;43;5;5;10
89;23.07.2018;2018;07;00;Maanantai;14;9;23;7;3;10
89;23.07.2018;2018;07;01;Maanantai;4;4;8;2;2;4
89;23.07.2018;2018;07;02;Maanantai;9;5;14;2;1;3
89;23.07.2018;2018;07;03;Maanantai;7;3;10;1;0;1
89;23.07.2018;2018;07;04;Maanantai;8;3;11;1;2;3
89;23.07.2018;2018;07;05;Maanantai;3;8;11;2;2;4
89;23.07.2018;2018;07;06;Maanantai;14;64;78;0;5;5
89;23.07.2018;2018;07;07;Maanantai;25;85;110;5;10;15
89;23.07.2018;2018;07;08;Maanantai;30;129;159;5;14;19
89;23.07.2018;2018;07;09;Maanantai;37;93;130;15;18;33
89;23.07.2018;2018;07;10;Maanantai;38;104;142;21;22;43
89;23.07.2018;2018;07;11;Maanantai;86;109;195;17;30;47
89;23.07.2018;2018;07;12;Maanantai;88;139;227;20;36;56
89;23.07.2018;2018;07;13;Maanantai;123;131;254;17;37;54
89;23.07.2018;2018;07;14;Maanantai;161;150;311;23;30;53
89;23.07.2018;2018;07;15;Maanantai;213;181;394;28;40;68
89;23.07.2018;2018;07;16;Maanantai;223;157;380;39;27;66
89;23.07.2018;2018;07;17;Maanantai;212;144;356;37;33;70
89;23.07.2018;2018;07;18;Maanantai;183;178;361;44;43;87
89;23.07.2018;2018;07;19;Maanantai;195;158;353;42;38;80
89;23.07.2018;2018;07;20;Maanantai;179;132;311;46;47;93
89;23.07.2018;2018;07;21;Maanantai;112;104;216;26;30;56
89;23.07.2018;2018;07;22;Maanantai;59;73;132;12;18;30
89;23.07.2018;2018;07;23;Maanantai;27;22;49;13;14;27
89;24.07.2018;2018;07;00;Tiistai;4;11;15;7;5;12
89;24.07.2018;2018;07;01;Tiistai;24;8;32;5;0;5
89;24.07.2018;2018;07;02;Tiistai;9;12;21;2;0;2
89;24.07.2018;2018;07;03;Tiistai;10;5;15;2;3;5
89;24.07.2018;2018;07;04;Tiistai;5;4;9;1;0;1
89;24.07.2018;2018;07;05;Tiistai;5;8;13;2;1;3
89;24.07.2018;2018;07;06;Tiistai;13;73;86;2;4;6
89;24.07.2018;2018;07;07;Tiistai;38;98;136;4;12;16
89;24.07.2018;2018;07;08;Tiistai;25;153;178;3;23;26
89;24.07.2018;2018;07;09;Tiistai;52;157;209;12;24;36
89;24.07.2018;2018;07;10;Tiistai;60;130;190;15;38;53
89;24.07.2018;2018;07;11;Tiistai;122;165;287;26;40;66
89;24.07.2018;2018;07;12;Tiistai;142;198;340;25;38;63
89;24.07.2018;2018;07;13;Tiistai;155;183;338;30;27;57
89;24.07.2018;2018;07;14;Tiistai;183;156;339;22;34;56
89;24.07.2018;2018;07;15;Tiistai;231;173;404;31;29;60
89;24.07.2018;2018;07;16;Tiistai;269;170;439;43;34;77
89;24.07.2018;2018;07;17;Tiistai;180;216;396;36;54;90
89;24.07.2018;2018;07;18;Tiistai;184;160;344;37;50;87
89;24.07.2018;2018;07;19;Tiistai;195;153;348;30;52;82
89;24.07.2018;2018;07;20;Tiistai;183;152;335;21;38;59
89;24.07.2018;2018;07;21;Tiistai;126;100;226;23;20;43
89;24.07.2018;2018;07;22;Tiistai;85;57;142;21;17;38
89;24.07.2018;2018;07;23;Tiistai;50;33;83;15;15;30
89;25.07.2018;2018;07;00;Keskiviikko;26;26;52;8;9;17
89;25.07.2018;2018;07;01;Keskiviikko;18;10;28;8;3;11
89;25.07.2018;2018;07;02;Keskiviikko;13;6;19;1;1;2
89;25.07.2018;2018;07;03;Keskiviikko;5;3;8;1;0;1
89;25.07.2018;2018;07;04;Keskiviikko;5;8;13;0;1;1
89;25.07.2018;2018;07;05;Keskiviikko;4;9;13;3;2;5
89;25.07.2018;2018;07;06;Keskiviikko;21;56;77;1;6;7
89;25.07.2018;2018;07;07;Keskiviikko;27;111;138;4;9;13
89;25.07.2018;2018;07;08;Keskiviikko;30;153;183;3;12;15
89;25.07.2018;2018;07;09;Keskiviikko;53;106;159;14;17;31
89;25.07.2018;2018;07;10;Keskiviikko;79;155;234;17;28;45
89;25.07.2018;2018;07;11;Keskiviikko;116;142;258;14;24;38
89;25.07.2018;2018;07;12;Keskiviikko;155;171;326;22;44;66
89;25.07.2018;2018;07;13;Keskiviikko;171;183;354;15;29;44
89;25.07.2018;2018;07;14;Keskiviikko;187;140;327;35;30;65
89;25.07.2018;2018;07;15;Keskiviikko;281;158;439;34;28;62
89;25.07.2018;2018;07;16;Keskiviikko;258;215;473;27;22;49
89;25.07.2018;2018;07;17;Keskiviikko;219;209;428;34;47;81
89;25.07.2018;2018;07;18;Keskiviikko;193;182;375;36;31;67
89;25.07.2018;2018;07;19;Keskiviikko;166;164;330;29;47;76
89;25.07.2018;2018;07;20;Keskiviikko;194;157;351;29;39;68
89;25.07.2018;2018;07;21;Keskiviikko;184;109;293;17;27;44
89;25.07.2018;2018;07;22;Keskiviikko;88;67;155;15;24;39
89;25.07.2018;2018;07;23;Keskiviikko;60;60;120;9;12;21
89;26.07.2018;2018;07;00;Torstai;27;18;45;4;8;12
89;26.07.2018;2018;07;01;Torstai;36;16;52;9;5;14
89;26.07.2018;2018;07;02;Torstai;22;5;27;3;3;6
89;26.07.2018;2018;07;03;Torstai;19;3;22;3;1;4
89;26.07.2018;2018;07;04;Torstai;12;3;15;3;1;4
89;26.07.2018;2018;07;05;Torstai;4;11;15;2;2;4
89;26.07.2018;2018;07;06;Torstai;20;75;95;1;7;8
89;26.07.2018;2018;07;07;Torstai;37;99;136;1;5;6
89;26.07.2018;2018;07;08;Torstai;22;114;136;5;10;15
89;26.07.2018;2018;07;09;Torstai;39;134;173;8;22;30
89;26.07.2018;2018;07;10;Torstai;60;118;178;15;33;48
89;26.07.2018;2018;07;11;Torstai;118;155;273;26;44;70
89;26.07.2018;2018;07;12;Torstai;133;170;303;15;31;46
89;26.07.2018;2018;07;13;Torstai;181;137;318;21;27;48
89;26.07.2018;2018;07;14;Torstai;145;141;286;18;26;44
89;26.07.2018;2018;07;15;Torstai;203;146;349;27;20;47
89;26.07.2018;2018;07;16;Torstai;245;165;410;27;36;63
89;26.07.2018;2018;07;17;Torstai;183;183;366;27;30;57
89;26.07.2018;2018;07;18;Torstai;184;171;355;35;34;69
89;26.07.2018;2018;07;19;Torstai;169;142;311;39;47;86
89;26.07.2018;2018;07;20;Torstai;176;138;314;35;31;66
89;26.07.2018;2018;07;21;Torstai;124;98;222;32;29;61
89;26.07.2018;2018;07;22;Torstai;81;66;147;20;22;42
89;26.07.2018;2018;07;23;Torstai;39;31;70;2;8;10
89;27.07.2018;2018;07;00;Perjantai;33;16;49;9;7;16
89;27.07.2018;2018;07;01;Perjantai;25;13;38;1;1;2
89;27.07.2018;2018;07;02;Perjantai;5;11;16;6;0;6
89;27.07.2018;2018;07;03;Perjantai;9;7;16;0;1;1
89;27.07.2018;2018;07;04;Perjantai;15;1;16;1;1;2
89;27.07.2018;2018;07;05;Perjantai;5;9;14;0;0;0
89;27.07.2018;2018;07;06;Perjantai;11;56;67;0;6;6
89;27.07.2018;2018;07;07;Perjantai;26;108;134;2;10;12
89;27.07.2018;2018;07;08;Perjantai;22;128;150;9;19;28
89;27.07.2018;2018;07;09;Perjantai;45;119;164;17;29;46
89;27.07.2018;2018;07;10;Perjantai;61;144;205;14;36;50
89;27.07.2018;2018;07;11;Perjantai;104;148;252;14;34;48
89;27.07.2018;2018;07;12;Perjantai;136;179;315;21;28;49
89;27.07.2018;2018;07;13;Perjantai;186;199;385;33;48;81
89;27.07.2018;2018;07;14;Perjantai;203;195;398;36;27;63
89;27.07.2018;2018;07;15;Perjantai;227;248;475;68;60;128
89;27.07.2018;2018;07;16;Perjantai;195;304;499;49;44;93
89;27.07.2018;2018;07;17;Perjantai;165;257;422;36;47;83
89;27.07.2018;2018;07;18;Perjantai;170;197;367;28;54;82
89;27.07.2018;2018;07;19;Perjantai;167;169;336;34;57;91
89;27.07.2018;2018;07;20;Perjantai;178;181;359;24;43;67
89;27.07.2018;2018;07;21;Perjantai;154;124;278;34;25;59
89;27.07.2018;2018;07;22;Perjantai;151;109;260;21;48;69
89;27.07.2018;2018;07;23;Perjantai;176;86;262;28;21;49
89;28.07.2018;2018;07;00;Lauantai;201;36;237;41;11;52
89;28.07.2018;2018;07;01;Lauantai;189;50;239;33;6;39
89;28.07.2018;2018;07;02;Lauantai;89;17;106;18;2;20
89;28.07.2018;2018;07;03;Lauantai;55;13;68;28;2;30
89;28.07.2018;2018;07;04;Lauantai;48;7;55;24;5;29
89;28.07.2018;2018;07;05;Lauantai;13;14;27;9;2;11
89;28.07.2018;2018;07;06;Lauantai;5;12;17;5;3;8
89;28.07.2018;2018;07;07;Lauantai;10;25;35;1;10;11
89;28.07.2018;2018;07;08;Lauantai;17;30;47;10;4;14
89;28.07.2018;2018;07;09;Lauantai;27;93;120;8;28;36
89;28.07.2018;2018;07;10;Lauantai;50;89;139;15;31;46
89;28.07.2018;2018;07;11;Lauantai;72;160;232;18;40;58
89;28.07.2018;2018;07;12;Lauantai;138;233;371;39;54;93
89;28.07.2018;2018;07;13;Lauantai;165;261;426;44;59;103
89;28.07.2018;2018;07;14;Lauantai;165;215;380;64;50;114
89;28.07.2018;2018;07;15;Lauantai;186;230;416;89;43;132
89;28.07.2018;2018;07;16;Lauantai;184;196;380;67;70;137
89;28.07.2018;2018;07;17;Lauantai;163;247;410;56;46;102
89;28.07.2018;2018;07;18;Lauantai;187;180;367;29;63;92
89;28.07.2018;2018;07;19;Lauantai;157;181;338;24;62;86
89;28.07.2018;2018;07;20;Lauantai;135;136;271;26;35;61
89;28.07.2018;2018;07;21;Lauantai;117;118;235;14;38;52
89;28.07.2018;2018;07;22;Lauantai;114;97;211;20;25;45
89;28.07.2018;2018;07;23;Lauantai;117;67;184;11;21;32
89;29.07.2018;2018;07;00;Sunnuntai;168;53;221;26;30;56
89;29.07.2018;2018;07;01;Sunnuntai;171;21;192;25;11;36
89;29.07.2018;2018;07;02;Sunnuntai;96;6;102;41;6;47
89;29.07.2018;2018;07;03;Sunnuntai;93;11;104;38;12;50
89;29.07.2018;2018;07;04;Sunnuntai;60;3;63;43;4;47
89;29.07.2018;2018;07;05;Sunnuntai;40;16;56;12;2;14
89;29.07.2018;2018;07;06;Sunnuntai;16;10;26;2;0;2
89;29.07.2018;2018;07;07;Sunnuntai;7;9;16;5;5;10
89;29.07.2018;2018;07;08;Sunnuntai;14;21;35;7;11;18
89;29.07.2018;2018;07;09;Sunnuntai;32;45;77;10;15;25
89;29.07.2018;2018;07;10;Sunnuntai;44;81;125;18;18;36
89;29.07.2018;2018;07;11;Sunnuntai;77;118;195;23;34;57
89;29.07.2018;2018;07;12;Sunnuntai;114;116;230;23;37;60
89;29.07.2018;2018;07;13;Sunnuntai;129;162;291;23;47;70
89;29.07.2018;2018;07;14;Sunnuntai;144;149;293;45;54;99
89;29.07.2018;2018;07;15;Sunnuntai;164;166;330;53;47;100
89;29.07.2018;2018;07;16;Sunnuntai;147;142;289;41;45;86
89;29.07.2018;2018;07;17;Sunnuntai;154;151;305;36;60;96
89;29.07.2018;2018;07;18;Sunnuntai;180;156;336;30;44;74
89;29.07.2018;2018;07;19;Sunnuntai;116;111;227;25;31;56
89;29.07.2018;2018;07;20;Sunnuntai;128;111;239;29;35;64
89;29.07.2018;2018;07;21;Sunnuntai;92;72;164;20;32;52
89;29.07.2018;2018;07;22;Sunnuntai;49;36;85;16;22;38
89;29.07.2018;2018;07;23;Sunnuntai;39;37;76;9;5;14
89;30.07.2018;2018;07;00;Maanantai;18;11;29;7;2;9
89;30.07.2018;2018;07;01;Maanantai;18;9;27;2;1;3
89;30.07.2018;2018;07;02;Maanantai;7;2;9;2;1;3
89;30.07.2018;2018;07;03;Maanantai;11;6;17;0;0;0
89;30.07.2018;2018;07;04;Maanantai;2;6;8;4;0;4
89;30.07.2018;2018;07;05;Maanantai;7;18;25;2;3;5
89;30.07.2018;2018;07;06;Maanantai;21;78;99;3;6;9
89;30.07.2018;2018;07;07;Maanantai;48;144;192;2;10;12
89;30.07.2018;2018;07;08;Maanantai;28;145;173;12;17;29
89;30.07.2018;2018;07;09;Maanantai;45;128;173;11;32;43
89;30.07.2018;2018;07;10;Maanantai;74;95;169;11;30;41
89;30.07.2018;2018;07;11;Maanantai;98;126;224;13;28;41
89;30.07.2018;2018;07;12;Maanantai;120;161;281;21;30;51
89;30.07.2018;2018;07;13;Maanantai;158;139;297;23;21;44
89;30.07.2018;2018;07;14;Maanantai;189;134;323;39;27;66
89;30.07.2018;2018;07;15;Maanantai;262;149;411;51;29;80
89;30.07.2018;2018;07;16;Maanantai;243;169;412;50;33;83
89;30.07.2018;2018;07;17;Maanantai;205;131;336;34;31;65
89;30.07.2018;2018;07;18;Maanantai;200;115;315;18;33;51
89;30.07.2018;2018;07;19;Maanantai;179;163;342;23;29;52
89;30.07.2018;2018;07;20;Maanantai;128;122;250;24;33;57
89;30.07.2018;2018;07;21;Maanantai;129;78;207;23;36;59
89;30.07.2018;2018;07;22;Maanantai;69;60;129;18;19;37
89;30.07.2018;2018;07;23;Maanantai;38;37;75;12;11;23
89;31.07.2018;2018;07;00;Tiistai;15;17;32;7;8;15
89;31.07.2018;2018;07;01;Tiistai;8;11;19;5;3;8
89;31.07.2018;2018;07;02;Tiistai;7;12;19;5;4;9
89;31.07.2018;2018;07;03;Tiistai;2;8;10;2;0;2
89;31.07.2018;2018;07;04;Tiistai;4;3;7;2;0;2
89;31.07.2018;2018;07;05;Tiistai;7;12;19;0;1;1
89;31.07.2018;2018;07;06;Tiistai;22;78;100;2;7;9
89;31.07.2018;2018;07;07;Tiistai;40;121;161;1;12;13
89;31.07.2018;2018;07;08;Tiistai;31;160;191;9;13;22
89;31.07.2018;2018;07;09;Tiistai;33;117;150;10;18;28
89;31.07.2018;2018;07;10;Tiistai;68;109;177;11;29;40
89;31.07.2018;2018;07;11;Tiistai;99;128;227;14;21;35
89;31.07.2018;2018;07;12;Tiistai;114;149;263;17;19;36
89;31.07.2018;2018;07;13;Tiistai;139;134;273;26;17;43
89;31.07.2018;2018;07;14;Tiistai;140;145;285;33;40;73
89;31.07.2018;2018;07;15;Tiistai;263;134;397;33;30;63
89;31.07.2018;2018;07;16;Tiistai;283;205;488;21;30;51
89;31.07.2018;2018;07;17;Tiistai;190;143;333;28;45;73
89;31.07.2018;2018;07;18;Tiistai;204;158;362;19;46;65
89;31.07.2018;2018;07;19;Tiistai;200;126;326;28;37;65
89;31.07.2018;2018;07;20;Tiistai;181;150;331;26;33;59
89;31.07.2018;2018;07;21;Tiistai;131;98;229;28;29;57
89;31.07.2018;2018;07;22;Tiistai;52;81;133;16;25;41
89;31.07.2018;2018;07;23;Tiistai;42;43;85;5;8;13
89;01.08.2018;2018;08;00;Keskiviikko;38;29;67;6;7;13
89;01.08.2018;2018;08;01;Keskiviikko;12;9;21;3;1;4
89;01.08.2018;2018;08;02;Keskiviikko;15;5;20;8;5;13
89;01.08.2018;2018;08;03;Keskiviikko;14;9;23;6;3;9
89;01.08.2018;2018;08;04;Keskiviikko;6;3;9;3;0;3
89;01.08.2018;2018;08;05;Keskiviikko;6;13;19;0;1;1
89;01.08.2018;2018;08;06;Keskiviikko;22;65;87;3;6;9
89;01.08.2018;2018;08;07;Keskiviikko;40;123;163;2;12;14
89;01.08.2018;2018;08;08;Keskiviikko;38;168;206;6;11;17
89;01.08.2018;2018;08;09;Keskiviikko;34;120;154;3;27;30
89;01.08.2018;2018;08;10;Keskiviikko;66;114;180;9;21;30
89;01.08.2018;2018;08;11;Keskiviikko;100;122;222;17;25;42
89;01.08.2018;2018;08;12;Keskiviikko;108;134;242;17;29;46
89;01.08.2018;2018;08;13;Keskiviikko;114;133;247;22;35;57
89;01.08.2018;2018;08;14;Keskiviikko;133;127;260;20;31;51
89;01.08.2018;2018;08;15;Keskiviikko;248;155;403;24;32;56
89;01.08.2018;2018;08;16;Keskiviikko;266;145;411;31;21;52
89;01.08.2018;2018;08;17;Keskiviikko;166;137;303;24;22;46
89;01.08.2018;2018;08;18;Keskiviikko;213;98;311;27;26;53
89;01.08.2018;2018;08;19;Keskiviikko;151;139;290;27;48;75
89;01.08.2018;2018;08;20;Keskiviikko;157;104;261;20;26;46
89;01.08.2018;2018;08;21;Keskiviikko;91;100;191;21;32;53
89;01.08.2018;2018;08;22;Keskiviikko;71;51;122;19;10;29
89;01.08.2018;2018;08;23;Keskiviikko;51;37;88;16;7;23
89;02.08.2018;2018;08;00;Torstai;26;16;42;11;11;22
89;02.08.2018;2018;08;01;Torstai;9;17;26;3;3;6
89;02.08.2018;2018;08;02;Torstai;18;5;23;3;2;5
89;02.08.2018;2018;08;03;Torstai;8;5;13;4;2;6
89;02.08.2018;2018;08;04;Torstai;10;5;15;2;0;2
89;02.08.2018;2018;08;05;Torstai;9;8;17;0;4;4
89;02.08.2018;2018;08;06;Torstai;27;86;113;4;6;10
89;02.08.2018;2018;08;07;Torstai;37;138;175;9;18;27
89;02.08.2018;2018;08;08;Torstai;40;155;195;5;21;26
89;02.08.2018;2018;08;09;Torstai;42;145;187;9;23;32
89;02.08.2018;2018;08;10;Torstai;57;113;170;19;17;36
89;02.08.2018;2018;08;11;Torstai;79;120;199;18;29;47
89;02.08.2018;2018;08;12;Torstai;124;135;259;15;36;51
89;02.08.2018;2018;08;13;Torstai;133;137;270;21;25;46
89;02.08.2018;2018;08;14;Torstai;115;125;240;19;30;49
89;02.08.2018;2018;08;15;Torstai;215;128;343;17;25;42
89;02.08.2018;2018;08;16;Torstai;261;117;378;29;18;47
89;02.08.2018;2018;08;17;Torstai;211;131;342;36;27;63
89;02.08.2018;2018;08;18;Torstai;160;131;291;24;40;64
89;02.08.2018;2018;08;19;Torstai;171;106;277;29;29;58
89;02.08.2018;2018;08;20;Torstai;127;148;275;27;35;62
89;02.08.2018;2018;08;21;Torstai;104;80;184;28;20;48
89;02.08.2018;2018;08;22;Torstai;68;45;113;19;16;35
89;02.08.2018;2018;08;23;Torstai;48;38;86;8;10;18
89;03.08.2018;2018;08;00;Perjantai;28;21;49;2;7;9
89;03.08.2018;2018;08;01;Perjantai;12;6;18;5;0;5
89;03.08.2018;2018;08;02;Perjantai;11;3;14;1;0;1
89;03.08.2018;2018;08;03;Perjantai;16;16;32;1;1;2
89;03.08.2018;2018;08;04;Perjantai;9;3;12;3;0;3
89;03.08.2018;2018;08;05;Perjantai;9;13;22;1;0;1
89;03.08.2018;2018;08;06;Perjantai;18;51;69;1;4;5
89;03.08.2018;2018;08;07;Perjantai;22;79;101;4;9;13
89;03.08.2018;2018;08;08;Perjantai;18;114;132;1;16;17
89;03.08.2018;2018;08;09;Perjantai;23;62;85;6;9;15
89;03.08.2018;2018;08;10;Perjantai;21;24;45;4;11;15
89;03.08.2018;2018;08;11;Perjantai;18;14;32;9;9;18
89;03.08.2018;2018;08;12;Perjantai;28;34;62;6;10;16
89;03.08.2018;2018;08;13;Perjantai;33;76;109;15;17;32
89;03.08.2018;2018;08;14;Perjantai;75;102;177;21;20;41
89;03.08.2018;2018;08;15;Perjantai;137;95;232;26;28;54
89;03.08.2018;2018;08;16;Perjantai;171;103;274;17;24;41
89;03.08.2018;2018;08;17;Perjantai;92;122;214;32;36;68
89;03.08.2018;2018;08;18;Perjantai;105;110;215;31;39;70
89;03.08.2018;2018;08;19;Perjantai;109;82;191;30;28;58
89;03.08.2018;2018;08;20;Perjantai;92;96;188;30;31;61
89;03.08.2018;2018;08;21;Perjantai;81;74;155;22;21;43
89;03.08.2018;2018;08;22;Perjantai;55;76;131;22;17;39
89;03.08.2018;2018;08;23;Perjantai;47;46;93;13;13;26
89;04.08.2018;2018;08;00;Lauantai;43;22;65;5;8;13
89;04.08.2018;2018;08;01;Lauantai;41;26;67;10;7;17
89;04.08.2018;2018;08;02;Lauantai;38;11;49;10;2;12
89;04.08.2018;2018;08;03;Lauantai;27;8;35;2;1;3
89;04.08.2018;2018;08;04;Lauantai;23;0;23;5;0;5
89;04.08.2018;2018;08;05;Lauantai;17;8;25;4;3;7
89;04.08.2018;2018;08;06;Lauantai;4;9;13;3;4;7
89;04.08.2018;2018;08;07;Lauantai;10;15;25;5;4;9
89;04.08.2018;2018;08;08;Lauantai;15;35;50;7;11;18
89;04.08.2018;2018;08;09;Lauantai;20;46;66;12;13;25
89;04.08.2018;2018;08;10;Lauantai;34;82;116;13;14;27
89;04.08.2018;2018;08;11;Lauantai;62;105;167;23;30;53
89;04.08.2018;2018;08;12;Lauantai;75;105;180;21;19;40
89;04.08.2018;2018;08;13;Lauantai;105;160;265;15;41;56
89;04.08.2018;2018;08;14;Lauantai;108;143;251;24;40;64
89;04.08.2018;2018;08;15;Lauantai;134;134;268;37;55;92
89;04.08.2018;2018;08;16;Lauantai;166;129;295;45;43;88
89;04.08.2018;2018;08;17;Lauantai;140;127;267;36;38;74
89;04.08.2018;2018;08;18;Lauantai;144;123;267;40;34;74
89;04.08.2018;2018;08;19;Lauantai;133;146;279;40;46;86
89;04.08.2018;2018;08;20;Lauantai;108;136;244;30;43;73
89;04.08.2018;2018;08;21;Lauantai;75;104;179;20;35;55
89;04.08.2018;2018;08;22;Lauantai;59;59;118;29;36;65
89;04.08.2018;2018;08;23;Lauantai;78;48;126;9;15;24
89;05.08.2018;2018;08;00;Sunnuntai;55;31;86;6;8;14
89;05.08.2018;2018;08;01;Sunnuntai;29;23;52;7;8;15
89;05.08.2018;2018;08;02;Sunnuntai;41;15;56;6;4;10
89;05.08.2018;2018;08;03;Sunnuntai;32;3;35;7;1;8
89;05.08.2018;2018;08;04;Sunnuntai;31;7;38;8;1;9
89;05.08.2018;2018;08;05;Sunnuntai;22;6;28;3;1;4
89;05.08.2018;2018;08;06;Sunnuntai;7;11;18;1;4;5
89;05.08.2018;2018;08;07;Sunnuntai;7;10;17;4;3;7
89;05.08.2018;2018;08;08;Sunnuntai;9;10;19;11;5;16
89;05.08.2018;2018;08;09;Sunnuntai;30;41;71;8;20;28
89;05.08.2018;2018;08;10;Sunnuntai;38;69;107;20;31;51
89;05.08.2018;2018;08;11;Sunnuntai;64;120;184;38;35;73
89;05.08.2018;2018;08;12;Sunnuntai;73;130;203;27;45;72
89;05.08.2018;2018;08;13;Sunnuntai;63;51;114;21;28;49
89;05.08.2018;2018;08;14;Sunnuntai;68;63;131;11;26;37
89;05.08.2018;2018;08;15;Sunnuntai;94;101;195;32;47;79
89;05.08.2018;2018;08;16;Sunnuntai;123;110;233;52;33;85
89;05.08.2018;2018;08;17;Sunnuntai;121;91;212;43;43;86
89;05.08.2018;2018;08;18;Sunnuntai;140;86;226;34;36;70
89;05.08.2018;2018;08;19;Sunnuntai;120;80;200;46;43;89
89;05.08.2018;2018;08;20;Sunnuntai;99;84;183;34;24;58
89;05.08.2018;2018;08;21;Sunnuntai;63;69;132;22;35;57
89;05.08.2018;2018;08;22;Sunnuntai;41;34;75;16;16;32
89;05.08.2018;2018;08;23;Sunnuntai;15;16;31;9;7;16
89;06.08.2018;2018;08;00;Maanantai;8;7;15;6;5;11
89;06.08.2018;2018;08;01;Maanantai;11;6;17;4;5;9
89;06.08.2018;2018;08;02;Maanantai;10;0;10;3;2;5
89;06.08.2018;2018;08;03;Maanantai;5;2;7;4;1;5
89;06.08.2018;2018;08;04;Maanantai;8;3;11;2;0;2
89;06.08.2018;2018;08;05;Maanantai;7;13;20;5;4;9
89;06.08.2018;2018;08;06;Maanantai;21;76;97;2;4;6
89;06.08.2018;2018;08;07;Maanantai;31;126;157;4;10;14
89;06.08.2018;2018;08;08;Maanantai;22;143;165;3;20;23
89;06.08.2018;2018;08;09;Maanantai;30;84;114;9;22;31
89;06.08.2018;2018;08;10;Maanantai;37;66;103;9;21;30
89;06.08.2018;2018;08;11;Maanantai;27;61;88;6;15;21
89;06.08.2018;2018;08;12;Maanantai;34;20;54;9;5;14
89;06.08.2018;2018;08;13;Maanantai;55;32;87;8;10;18
89;06.08.2018;2018;08;14;Maanantai;58;52;110;10;14;24
89;06.08.2018;2018;08;15;Maanantai;106;58;164;18;9;27
89;06.08.2018;2018;08;16;Maanantai;147;77;224;20;17;37
89;06.08.2018;2018;08;17;Maanantai;107;75;182;26;17;43
89;06.08.2018;2018;08;18;Maanantai;109;79;188;31;26;57
89;06.08.2018;2018;08;19;Maanantai;92;66;158;22;31;53
89;06.08.2018;2018;08;20;Maanantai;78;67;145;31;30;61
89;06.08.2018;2018;08;21;Maanantai;52;36;88;24;19;43
89;06.08.2018;2018;08;22;Maanantai;26;18;44;9;8;17
89;06.08.2018;2018;08;23;Maanantai;28;14;42;8;3;11
89;07.08.2018;2018;08;00;Tiistai;32;0;32;15;0;15
89;07.08.2018;2018;08;01;Tiistai;19;0;19;8;0;8
89;07.08.2018;2018;08;02;Tiistai;19;0;19;9;0;9
89;07.08.2018;2018;08;03;Tiistai;10;0;10;2;0;2
89;07.08.2018;2018;08;04;Tiistai;7;0;7;2;0;2
89;07.08.2018;2018;08;05;Tiistai;19;0;19;1;0;1
89;07.08.2018;2018;08;06;Tiistai;100;0;100;9;0;9
89;07.08.2018;2018;08;07;Tiistai;161;0;161;13;0;13
89;07.08.2018;2018;08;08;Tiistai;191;0;191;22;0;22
89;07.08.2018;2018;08;09;Tiistai;150;0;150;28;0;28
89;07.08.2018;2018;08;10;Tiistai;177;0;177;40;0;40
89;07.08.2018;2018;08;11;Tiistai;227;0;227;35;0;35
89;07.08.2018;2018;08;12;Tiistai;263;0;263;36;0;36
89;07.08.2018;2018;08;13;Tiistai;273;0;273;43;0;43
89;07.08.2018;2018;08;14;Tiistai;285;0;285;73;0;73
89;07.08.2018;2018;08;15;Tiistai;397;0;397;63;0;63
89;07.08.2018;2018;08;16;Tiistai;488;0;488;51;0;51
89;07.08.2018;2018;08;17;Tiistai;333;0;333;73;0;73
89;07.08.2018;2018;08;18;Tiistai;362;0;362;65;0;65
89;07.08.2018;2018;08;19;Tiistai;326;0;326;65;0;65
89;07.08.2018;2018;08;20;Tiistai;331;0;331;59;0;59
89;07.08.2018;2018;08;21;Tiistai;229;0;229;57;0;57
89;07.08.2018;2018;08;22;Tiistai;133;0;133;41;0;41
89;07.08.2018;2018;08;23;Tiistai;85;0;85;13;0;13
89;08.08.2018;2018;08;00;Keskiviikko;14;13;27;11;5;16
89;08.08.2018;2018;08;01;Keskiviikko;6;8;14;1;2;3
89;08.08.2018;2018;08;02;Keskiviikko;7;3;10;2;1;3
89;08.08.2018;2018;08;03;Keskiviikko;5;3;8;1;0;1
89;08.08.2018;2018;08;04;Keskiviikko;2;0;2;0;0;0
89;08.08.2018;2018;08;05;Keskiviikko;5;14;19;2;0;2
89;08.08.2018;2018;08;06;Keskiviikko;21;86;107;1;9;10
89;08.08.2018;2018;08;07;Keskiviikko;49;153;202;0;13;13
89;08.08.2018;2018;08;08;Keskiviikko;45;195;240;4;24;28
89;08.08.2018;2018;08;09;Keskiviikko;38;117;155;16;18;34
89;08.08.2018;2018;08;10;Keskiviikko;68;100;168;18;37;55
89;08.08.2018;2018;08;11;Keskiviikko;80;110;190;16;40;56
89;08.08.2018;2018;08;12;Keskiviikko;96;136;232;28;26;54
89;08.08.2018;2018;08;13;Keskiviikko;115;121;236;35;35;70
89;08.08.2018;2018;08;14;Keskiviikko;142;127;269;50;35;85
89;08.08.2018;2018;08;15;Keskiviikko;219;143;362;42;48;90
89;08.08.2018;2018;08;16;Keskiviikko;296;164;460;47;36;83
89;08.08.2018;2018;08;17;Keskiviikko;203;162;365;39;49;88
89;08.08.2018;2018;08;18;Keskiviikko;163;132;295;40;47;87
89;08.08.2018;2018;08;19;Keskiviikko;192;117;309;58;31;89
89;08.08.2018;2018;08;20;Keskiviikko;138;83;221;38;35;73
89;08.08.2018;2018;08;21;Keskiviikko;78;57;135;23;22;45
89;08.08.2018;2018;08;22;Keskiviikko;52;30;82;13;14;27
89;08.08.2018;2018;08;23;Keskiviikko;26;15;41;7;5;12
89;09.08.2018;2018;08;00;Torstai;14;18;32;7;2;9
89;09.08.2018;2018;08;01;Torstai;8;10;18;0;1;1
89;09.08.2018;2018;08;02;Torstai;5;10;15;1;6;7
89;09.08.2018;2018;08;03;Torstai;9;5;14;0;0;0
89;09.08.2018;2018;08;04;Torstai;10;0;10;4;1;5
89;09.08.2018;2018;08;05;Torstai;6;9;15;2;2;4
89;09.08.2018;2018;08;06;Torstai;18;70;88;1;3;4
89;09.08.2018;2018;08;07;Torstai;42;143;185;1;15;16
89;09.08.2018;2018;08;08;Torstai;41;190;231;8;22;30
89;09.08.2018;2018;08;09;Torstai;26;113;139;5;20;25
89;09.08.2018;2018;08;10;Torstai;34;83;117;7;27;34
89;09.08.2018;2018;08;11;Torstai;61;73;134;12;19;31
89;09.08.2018;2018;08;12;Torstai;89;99;188;14;14;28
89;09.08.2018;2018;08;13;Torstai;102;108;210;29;17;46
89;09.08.2018;2018;08;14;Torstai;137;105;242;19;20;39
89;09.08.2018;2018;08;15;Torstai;199;100;299;30;20;50
89;09.08.2018;2018;08;16;Torstai;204;94;298;31;19;50
89;09.08.2018;2018;08;17;Torstai;141;133;274;27;38;65
89;09.08.2018;2018;08;18;Torstai;144;135;279;27;44;71
89;09.08.2018;2018;08;19;Torstai;126;70;196;31;43;74
89;09.08.2018;2018;08;20;Torstai;128;52;180;26;24;50
89;09.08.2018;2018;08;21;Torstai;77;45;122;20;16;36
89;09.08.2018;2018;08;22;Torstai;37;40;77;7;8;15
89;09.08.2018;2018;08;23;Torstai;34;27;61;6;6;12
89;10.08.2018;2018;08;00;Perjantai;11;4;15;2;0;2
89;10.08.2018;2018;08;01;Perjantai;6;5;11;1;1;2
89;10.08.2018;2018;08;02;Perjantai;5;7;12;1;2;3
89;10.08.2018;2018;08;03;Perjantai;7;6;13;0;1;1
89;10.08.2018;2018;08;04;Perjantai;2;1;3;2;0;2
89;10.08.2018;2018;08;05;Perjantai;2;16;18;3;2;5
89;10.08.2018;2018;08;06;Perjantai;15;81;96;4;4;8
89;10.08.2018;2018;08;07;Perjantai;38;146;184;4;20;24
89;10.08.2018;2018;08;08;Perjantai;57;248;305;21;49;70
89;10.08.2018;2018;08;09;Perjantai;39;122;161;10;31;41
89;10.08.2018;2018;08;10;Perjantai;52;94;146;35;17;52
89;10.08.2018;2018;08;11;Perjantai;80;110;190;25;42;67
89;10.08.2018;2018;08;12;Perjantai;139;128;267;22;16;38
89;10.08.2018;2018;08;13;Perjantai;146;124;270;26;25;51
89;10.08.2018;2018;08;14;Perjantai;211;150;361;25;22;47
89;10.08.2018;2018;08;15;Perjantai;201;133;334;22;31;53
89;10.08.2018;2018;08;16;Perjantai;221;134;355;32;32;64
89;10.08.2018;2018;08;17;Perjantai;135;144;279;20;35;55
89;10.08.2018;2018;08;18;Perjantai;134;94;228;20;30;50
89;10.08.2018;2018;08;19;Perjantai;109;71;180;17;11;28
89;10.08.2018;2018;08;20;Perjantai;64;64;128;10;30;40
89;10.08.2018;2018;08;21;Perjantai;20;18;38;9;9;18
89;10.08.2018;2018;08;22;Perjantai;28;24;52;6;10;16
89;10.08.2018;2018;08;23;Perjantai;23;18;41;6;10;16
89;11.08.2018;2018;08;00;Lauantai;20;15;35;5;7;12
89;11.08.2018;2018;08;01;Lauantai;14;6;20;7;2;9
89;11.08.2018;2018;08;02;Lauantai;17;6;23;4;1;5
89;11.08.2018;2018;08;03;Lauantai;10;2;12;11;1;12
89;11.08.2018;2018;08;04;Lauantai;18;6;24;6;1;7
89;11.08.2018;2018;08;05;Lauantai;8;5;13;3;7;10
89;11.08.2018;2018;08;06;Lauantai;15;11;26;7;3;10
89;11.08.2018;2018;08;07;Lauantai;17;11;28;2;4;6
89;11.08.2018;2018;08;08;Lauantai;16;37;53;8;8;16
89;11.08.2018;2018;08;09;Lauantai;14;41;55;9;25;34
89;11.08.2018;2018;08;10;Lauantai;26;106;132;14;25;39
89;11.08.2018;2018;08;11;Lauantai;55;81;136;18;25;43
89;11.08.2018;2018;08;12;Lauantai;76;102;178;40;92;132
89;11.08.2018;2018;08;13;Lauantai;69;85;154;49;65;114
89;11.08.2018;2018;08;14;Lauantai;100;84;184;57;74;131
89;11.08.2018;2018;08;15;Lauantai;100;77;177;43;42;85
89;11.08.2018;2018;08;16;Lauantai;83;67;150;19;20;39
89;11.08.2018;2018;08;17;Lauantai;89;59;148;33;16;49
89;11.08.2018;2018;08;18;Lauantai;84;71;155;26;34;60
89;11.08.2018;2018;08;19;Lauantai;62;65;127;23;38;61
89;11.08.2018;2018;08;20;Lauantai;69;63;132;25;24;49
89;11.08.2018;2018;08;21;Lauantai;46;52;98;15;12;27
89;11.08.2018;2018;08;22;Lauantai;35;49;84;6;23;29
89;11.08.2018;2018;08;23;Lauantai;38;30;68;13;6;19
89;12.08.2018;2018;08;00;Sunnuntai;23;17;40;8;6;14
89;12.08.2018;2018;08;01;Sunnuntai;21;22;43;4;11;15
89;12.08.2018;2018;08;02;Sunnuntai;29;9;38;2;4;6
89;12.08.2018;2018;08;03;Sunnuntai;24;9;33;7;1;8
89;12.08.2018;2018;08;04;Sunnuntai;21;4;25;5;1;6
89;12.08.2018;2018;08;05;Sunnuntai;14;6;20;4;1;5
89;12.08.2018;2018;08;06;Sunnuntai;5;3;8;6;3;9
89;12.08.2018;2018;08;07;Sunnuntai;6;6;12;4;5;9
89;12.08.2018;2018;08;08;Sunnuntai;7;14;21;4;9;13
89;12.08.2018;2018;08;09;Sunnuntai;19;30;49;12;20;32
89;12.08.2018;2018;08;10;Sunnuntai;35;65;100;23;20;43
89;12.08.2018;2018;08;11;Sunnuntai;54;99;153;26;49;75
89;12.08.2018;2018;08;12;Sunnuntai;81;146;227;47;95;142
89;12.08.2018;2018;08;13;Sunnuntai;116;160;276;76;83;159
89;12.08.2018;2018;08;14;Sunnuntai;130;117;247;100;57;157
89;12.08.2018;2018;08;15;Sunnuntai;126;89;215;76;56;132
89;12.08.2018;2018;08;16;Sunnuntai;120;122;242;54;46;100
89;12.08.2018;2018;08;17;Sunnuntai;118;74;192;42;28;70
89;12.08.2018;2018;08;18;Sunnuntai;117;69;186;43;35;78
89;12.08.2018;2018;08;19;Sunnuntai;87;76;163;23;28;51
89;12.08.2018;2018;08;20;Sunnuntai;59;49;108;29;24;53
89;12.08.2018;2018;08;21;Sunnuntai;38;56;94;11;16;27
89;12.08.2018;2018;08;22;Sunnuntai;19;23;42;10;2;12
89;12.08.2018;2018;08;23;Sunnuntai;11;11;22;5;6;11
89;13.08.2018;2018;08;00;Maanantai;15;7;22;3;5;8
89;13.08.2018;2018;08;01;Maanantai;3;3;6;0;1;1
89;13.08.2018;2018;08;02;Maanantai;3;1;4;1;0;1
89;13.08.2018;2018;08;03;Maanantai;3;5;8;0;0;0
89;13.08.2018;2018;08;04;Maanantai;5;3;8;0;1;1
89;13.08.2018;2018;08;05;Maanantai;5;18;23;2;2;4
89;13.08.2018;2018;08;06;Maanantai;21;62;83;0;5;5
89;13.08.2018;2018;08;07;Maanantai;38;155;193;7;15;22
89;13.08.2018;2018;08;08;Maanantai;46;281;327;1;21;22
89;13.08.2018;2018;08;09;Maanantai;39;147;186;5;32;37
89;13.08.2018;2018;08;10;Maanantai;25;86;111;8;33;41
89;13.08.2018;2018;08;11;Maanantai;42;70;112;15;21;36
89;13.08.2018;2018;08;12;Maanantai;74;75;149;16;14;30
89;13.08.2018;2018;08;13;Maanantai;81;78;159;18;11;29
89;13.08.2018;2018;08;14;Maanantai;140;75;215;16;10;26
89;13.08.2018;2018;08;15;Maanantai;160;93;253;30;12;42
89;13.08.2018;2018;08;16;Maanantai;212;90;302;17;31;48
89;13.08.2018;2018;08;17;Maanantai;134;74;208;21;19;40
89;13.08.2018;2018;08;18;Maanantai;94;80;174;16;23;39
89;13.08.2018;2018;08;19;Maanantai;83;48;131;23;19;42
89;13.08.2018;2018;08;20;Maanantai;88;29;117;23;28;51
89;13.08.2018;2018;08;21;Maanantai;49;26;75;19;24;43
89;13.08.2018;2018;08;22;Maanantai;16;20;36;9;7;16
89;13.08.2018;2018;08;23;Maanantai;11;4;15;4;2;6
89;14.08.2018;2018;08;00;Tiistai;3;6;9;1;0;1
89;14.08.2018;2018;08;01;Tiistai;3;4;7;1;1;2
89;14.08.2018;2018;08;02;Tiistai;0;2;2;0;0;0
89;14.08.2018;2018;08;03;Tiistai;2;5;7;0;0;0
89;14.08.2018;2018;08;04;Tiistai;3;6;9;0;1;1
89;14.08.2018;2018;08;05;Tiistai;4;17;21;0;1;1
89;14.08.2018;2018;08;06;Tiistai;25;82;107;0;5;5
89;14.08.2018;2018;08;07;Tiistai;51;197;248;8;20;28
89;14.08.2018;2018;08;08;Tiistai;62;300;362;8;34;42
89;14.08.2018;2018;08;09;Tiistai;48;158;206;16;39;55
89;14.08.2018;2018;08;10;Tiistai;47;89;136;15;26;41
89;14.08.2018;2018;08;11;Tiistai;92;94;186;23;20;43
89;14.08.2018;2018;08;12;Tiistai;79;122;201;17;22;39
89;14.08.2018;2018;08;13;Tiistai;118;108;226;17;14;31
89;14.08.2018;2018;08;14;Tiistai;190;91;281;24;31;55
89;14.08.2018;2018;08;15;Tiistai;212;92;304;30;20;50
89;14.08.2018;2018;08;16;Tiistai;276;115;391;29;26;55
89;14.08.2018;2018;08;17;Tiistai;161;127;288;31;33;64
89;14.08.2018;2018;08;18;Tiistai;136;108;244;40;35;75
89;14.08.2018;2018;08;19;Tiistai;136;82;218;36;34;70
89;14.08.2018;2018;08;20;Tiistai;107;64;171;26;29;55
89;14.08.2018;2018;08;21;Tiistai;78;35;113;15;15;30
89;14.08.2018;2018;08;22;Tiistai;23;24;47;7;10;17
89;14.08.2018;2018;08;23;Tiistai;17;5;22;6;6;12
89;15.08.2018;2018;08;00;Keskiviikko;8;8;16;0;1;1
89;15.08.2018;2018;08;01;Keskiviikko;6;2;8;1;1;2
89;15.08.2018;2018;08;02;Keskiviikko;3;0;3;1;0;1
89;15.08.2018;2018;08;03;Keskiviikko;5;4;9;0;0;0
89;15.08.2018;2018;08;04;Keskiviikko;1;2;3;1;0;1
89;15.08.2018;2018;08;05;Keskiviikko;7;20;27;1;2;3
89;15.08.2018;2018;08;06;Keskiviikko;21;75;96;3;6;9
89;15.08.2018;2018;08;07;Keskiviikko;54;186;240;4;20;24
89;15.08.2018;2018;08;08;Keskiviikko;48;294;342;5;22;27
89;15.08.2018;2018;08;09;Keskiviikko;39;138;177;14;37;51
89;15.08.2018;2018;08;10;Keskiviikko;61;104;165;11;32;43
89;15.08.2018;2018;08;11;Keskiviikko;92;98;190;12;30;42
89;15.08.2018;2018;08;12;Keskiviikko;94;110;204;26;48;74
89;15.08.2018;2018;08;13;Keskiviikko;116;157;273;53;34;87
89;15.08.2018;2018;08;14;Keskiviikko;161;130;291;60;22;82
89;15.08.2018;2018;08;15;Keskiviikko;205;91;296;89;29;118
89;15.08.2018;2018;08;16;Keskiviikko;290;141;431;77;32;109
89;15.08.2018;2018;08;17;Keskiviikko;160;122;282;36;29;65
89;15.08.2018;2018;08;18;Keskiviikko;169;128;297;25;28;53
89;15.08.2018;2018;08;19;Keskiviikko;152;82;234;52;34;86
89;15.08.2018;2018;08;20;Keskiviikko;104;73;177;39;25;64
89;15.08.2018;2018;08;21;Keskiviikko;59;41;100;21;15;36
89;15.08.2018;2018;08;22;Keskiviikko;37;17;54;4;8;12
89;15.08.2018;2018;08;23;Keskiviikko;21;8;29;14;5;19
89;16.08.2018;2018;08;00;Torstai;13;7;20;2;2;4
89;16.08.2018;2018;08;01;Torstai;3;1;4;0;0;0
89;16.08.2018;2018;08;02;Torstai;2;4;6;0;0;0
89;16.08.2018;2018;08;03;Torstai;7;3;10;0;0;0
89;16.08.2018;2018;08;04;Torstai;5;3;8;1;0;1
89;16.08.2018;2018;08;05;Torstai;4;16;20;0;0;0
89;16.08.2018;2018;08;06;Torstai;17;62;79;0;7;7
89;16.08.2018;2018;08;07;Torstai;44;185;229;4;18;22
89;16.08.2018;2018;08;08;Torstai;40;277;317;5;31;36
89;16.08.2018;2018;08;09;Torstai;41;143;184;7;30;37
89;16.08.2018;2018;08;10;Torstai;40;112;152;10;28;38
89;16.08.2018;2018;08;11;Torstai;82;92;174;28;32;60
89;16.08.2018;2018;08;12;Torstai;96;114;210;17;36;53
89;16.08.2018;2018;08;13;Torstai;130;115;245;30;29;59
89;16.08.2018;2018;08;14;Torstai;168;120;288;32;26;58
89;16.08.2018;2018;08;15;Torstai;236;148;384;20;23;43
89;16.08.2018;2018;08;16;Torstai;254;201;455;16;29;45
89;16.08.2018;2018;08;17;Torstai;168;244;412;23;52;75
89;16.08.2018;2018;08;18;Torstai;149;229;378;26;52;78
89;16.08.2018;2018;08;19;Torstai;167;189;356;38;49;87
89;16.08.2018;2018;08;20;Torstai;196;119;315;32;40;72
89;16.08.2018;2018;08;21;Torstai;163;90;253;18;12;30
89;16.08.2018;2018;08;22;Torstai;163;34;197;26;10;36
89;16.08.2018;2018;08;23;Torstai;89;22;111;14;19;33
89;17.08.2018;2018;08;00;Perjantai;59;13;72;12;6;18
89;17.08.2018;2018;08;01;Perjantai;25;9;34;13;8;21
89;17.08.2018;2018;08;02;Perjantai;19;6;25;4;0;4
89;17.08.2018;2018;08;03;Perjantai;24;2;26;5;0;5
89;17.08.2018;2018;08;04;Perjantai;9;3;12;5;1;6
89;17.08.2018;2018;08;05;Perjantai;11;15;26;1;0;1
89;17.08.2018;2018;08;06;Perjantai;25;67;92;1;5;6
89;17.08.2018;2018;08;07;Perjantai;34;141;175;3;23;26
89;17.08.2018;2018;08;08;Perjantai;41;226;267;4;35;39
89;17.08.2018;2018;08;09;Perjantai;41;135;176;9;18;27
89;17.08.2018;2018;08;10;Perjantai;40;83;123;22;31;53
89;17.08.2018;2018;08;11;Perjantai;52;86;138;18;26;44
89;17.08.2018;2018;08;12;Perjantai;86;89;175;23;17;40
89;17.08.2018;2018;08;13;Perjantai;121;95;216;17;18;35
89;17.08.2018;2018;08;14;Perjantai;179;103;282;29;20;49
89;17.08.2018;2018;08;15;Perjantai;183;93;276;21;16;37
89;17.08.2018;2018;08;16;Perjantai;166;116;282;18;21;39
89;17.08.2018;2018;08;17;Perjantai;134;156;290;12;23;35
89;17.08.2018;2018;08;18;Perjantai;98;118;216;22;33;55
89;17.08.2018;2018;08;19;Perjantai;115;84;199;15;22;37
89;17.08.2018;2018;08;20;Perjantai;119;37;156;10;12;22
89;17.08.2018;2018;08;21;Perjantai;72;35;107;17;8;25
89;17.08.2018;2018;08;22;Perjantai;37;25;62;7;1;8
89;17.08.2018;2018;08;23;Perjantai;20;8;28;1;5;6
89;18.08.2018;2018;08;00;Lauantai;21;12;33;1;5;6
89;18.08.2018;2018;08;01;Lauantai;9;13;22;4;3;7
89;18.08.2018;2018;08;02;Lauantai;7;2;9;4;0;4
89;18.08.2018;2018;08;03;Lauantai;7;2;9;4;0;4
89;18.08.2018;2018;08;04;Lauantai;9;2;11;6;0;6
89;18.08.2018;2018;08;05;Lauantai;2;6;8;0;1;1
89;18.08.2018;2018;08;06;Lauantai;7;8;15;5;1;6
89;18.08.2018;2018;08;07;Lauantai;4;10;14;1;4;5
89;18.08.2018;2018;08;08;Lauantai;23;39;62;5;12;17
89;18.08.2018;2018;08;09;Lauantai;19;75;94;9;9;18
89;18.08.2018;2018;08;10;Lauantai;35;71;106;21;26;47
89;18.08.2018;2018;08;11;Lauantai;34;103;137;19;37;56
89;18.08.2018;2018;08;12;Lauantai;56;119;175;20;47;67
89;18.08.2018;2018;08;13;Lauantai;102;122;224;27;32;59
89;18.08.2018;2018;08;14;Lauantai;125;125;250;41;49;90
89;18.08.2018;2018;08;15;Lauantai;102;122;224;38;40;78
89;18.08.2018;2018;08;16;Lauantai;131;89;220;39;36;75
89;18.08.2018;2018;08;17;Lauantai;111;94;205;31;43;74
89;18.08.2018;2018;08;18;Lauantai;115;88;203;28;28;56
89;18.08.2018;2018;08;19;Lauantai;102;120;222;25;45;70
89;18.08.2018;2018;08;20;Lauantai;73;72;145;18;31;49
89;18.08.2018;2018;08;21;Lauantai;75;61;136;21;20;41
89;18.08.2018;2018;08;22;Lauantai;40;48;88;12;18;30
89;18.08.2018;2018;08;23;Lauantai;48;44;92;11;10;21
89;19.08.2018;2018;08;00;Sunnuntai;50;29;79;6;4;10
89;19.08.2018;2018;08;01;Sunnuntai;20;15;35;7;1;8
89;19.08.2018;2018;08;02;Sunnuntai;14;3;17;4;1;5
89;19.08.2018;2018;08;03;Sunnuntai;20;4;24;10;0;10
89;19.08.2018;2018;08;04;Sunnuntai;15;0;15;9;0;9
89;19.08.2018;2018;08;05;Sunnuntai;7;7;14;4;1;5
89;19.08.2018;2018;08;06;Sunnuntai;6;9;15;1;4;5
89;19.08.2018;2018;08;07;Sunnuntai;5;8;13;1;2;3
89;19.08.2018;2018;08;08;Sunnuntai;4;11;15;5;13;18
89;19.08.2018;2018;08;09;Sunnuntai;24;29;53;16;23;39
89;19.08.2018;2018;08;10;Sunnuntai;23;56;79;24;32;56
89;19.08.2018;2018;08;11;Sunnuntai;24;87;111;19;35;54
89;19.08.2018;2018;08;12;Sunnuntai;73;90;163;37;40;77
89;19.08.2018;2018;08;13;Sunnuntai;87;101;188;34;43;77
89;19.08.2018;2018;08;14;Sunnuntai;87;88;175;37;25;62
89;19.08.2018;2018;08;15;Sunnuntai;107;80;187;56;42;98
89;19.08.2018;2018;08;16;Sunnuntai;97;62;159;45;41;86
89;19.08.2018;2018;08;17;Sunnuntai;92;63;155;43;42;85
89;19.08.2018;2018;08;18;Sunnuntai;85;53;138;27;23;50
89;19.08.2018;2018;08;19;Sunnuntai;78;64;142;26;32;58
89;19.08.2018;2018;08;20;Sunnuntai;65;44;109;18;36;54
89;19.08.2018;2018;08;21;Sunnuntai;34;21;55;8;14;22
89;19.08.2018;2018;08;22;Sunnuntai;18;17;35;3;5;8
89;19.08.2018;2018;08;23;Sunnuntai;16;11;27;2;2;4
89;20.08.2018;2018;08;00;Maanantai;13;7;20;2;0;2
89;20.08.2018;2018;08;01;Maanantai;1;3;4;3;1;4
89;20.08.2018;2018;08;02;Maanantai;1;2;3;1;0;1
89;20.08.2018;2018;08;03;Maanantai;2;4;6;0;0;0
89;20.08.2018;2018;08;04;Maanantai;4;3;7;0;0;0
89;20.08.2018;2018;08;05;Maanantai;7;13;20;2;0;2
89;20.08.2018;2018;08;06;Maanantai;17;82;99;1;4;5
89;20.08.2018;2018;08;07;Maanantai;44;190;234;4;12;16
89;20.08.2018;2018;08;08;Maanantai;61;300;361;5;38;43
89;20.08.2018;2018;08;09;Maanantai;51;157;208;9;35;44
89;20.08.2018;2018;08;10;Maanantai;45;71;116;9;19;28
89;20.08.2018;2018;08;11;Maanantai;56;82;138;17;16;33
89;20.08.2018;2018;08;12;Maanantai;66;84;150;17;19;36
89;20.08.2018;2018;08;13;Maanantai;103;70;173;24;26;50
89;20.08.2018;2018;08;14;Maanantai;175;95;270;31;23;54
89;20.08.2018;2018;08;15;Maanantai;233;94;327;33;33;66
89;20.08.2018;2018;08;16;Maanantai;261;121;382;41;21;62
89;20.08.2018;2018;08;17;Maanantai;176;97;273;34;38;72
89;20.08.2018;2018;08;18;Maanantai;121;74;195;37;32;69
89;20.08.2018;2018;08;19;Maanantai;118;64;182;35;31;66
89;20.08.2018;2018;08;20;Maanantai;95;45;140;33;21;54
89;20.08.2018;2018;08;21;Maanantai;60;33;93;20;16;36
89;20.08.2018;2018;08;22;Maanantai;38;10;48;4;11;15
89;20.08.2018;2018;08;23;Maanantai;8;11;19;2;6;8
89;21.08.2018;2018;08;00;Tiistai;8;1;9;9;5;14
89;21.08.2018;2018;08;01;Tiistai;2;1;3;5;0;5
89;21.08.2018;2018;08;02;Tiistai;1;1;2;1;0;1
89;21.08.2018;2018;08;03;Tiistai;1;8;9;1;1;2
89;21.08.2018;2018;08;04;Tiistai;7;4;11;13;14;27
89;21.08.2018;2018;08;05;Tiistai;4;14;18;1;2;3
89;21.08.2018;2018;08;06;Tiistai;19;85;104;3;2;5
89;21.08.2018;2018;08;07;Tiistai;48;189;237;4;13;17
89;21.08.2018;2018;08;08;Tiistai;53;277;330;13;34;47
89;21.08.2018;2018;08;09;Tiistai;33;151;184;12;34;46
89;21.08.2018;2018;08;10;Tiistai;50;102;152;9;17;26
89;21.08.2018;2018;08;11;Tiistai;55;108;163;19;19;38
89;21.08.2018;2018;08;12;Tiistai;70;94;164;66;46;112
89;21.08.2018;2018;08;13;Tiistai;111;74;185;28;12;40
89;21.08.2018;2018;08;14;Tiistai;136;109;245;32;20;52
89;21.08.2018;2018;08;15;Tiistai;205;112;317;27;16;43
89;21.08.2018;2018;08;16;Tiistai;275;105;380;24;22;46
89;21.08.2018;2018;08;17;Tiistai;175;78;253;25;33;58
89;21.08.2018;2018;08;18;Tiistai;138;73;211;34;39;73
89;21.08.2018;2018;08;19;Tiistai;128;65;193;41;35;76
89;21.08.2018;2018;08;20;Tiistai;94;65;159;43;41;84
89;21.08.2018;2018;08;21;Tiistai;51;42;93;16;22;38
89;21.08.2018;2018;08;22;Tiistai;24;14;38;9;10;19
89;21.08.2018;2018;08;23;Tiistai;24;10;34;1;6;7
89;22.08.2018;2018;08;00;Keskiviikko;8;1;9;4;3;7
89;22.08.2018;2018;08;01;Keskiviikko;2;6;8;0;0;0
89;22.08.2018;2018;08;02;Keskiviikko;2;4;6;2;0;2
89;22.08.2018;2018;08;03;Keskiviikko;4;2;6;1;0;1
89;22.08.2018;2018;08;04;Keskiviikko;0;2;2;2;0;2
89;22.08.2018;2018;08;05;Keskiviikko;6;13;19;0;1;1
89;22.08.2018;2018;08;06;Keskiviikko;17;94;111;1;4;5
89;22.08.2018;2018;08;07;Keskiviikko;41;200;241;7;21;28
89;22.08.2018;2018;08;08;Keskiviikko;62;275;337;5;31;36
89;22.08.2018;2018;08;09;Keskiviikko;39;134;173;13;33;46
89;22.08.2018;2018;08;10;Keskiviikko;45;86;131;14;17;31
89;22.08.2018;2018;08;11;Keskiviikko;54;96;150;20;31;51
89;22.08.2018;2018;08;12;Keskiviikko;92;78;170;27;27;54
89;22.08.2018;2018;08;13;Keskiviikko;114;88;202;37;35;72
89;22.08.2018;2018;08;14;Keskiviikko;175;98;273;30;18;48
89;22.08.2018;2018;08;15;Keskiviikko;232;67;299;18;21;39
89;22.08.2018;2018;08;16;Keskiviikko;263;118;381;22;16;38
89;22.08.2018;2018;08;17;Keskiviikko;149;88;237;18;18;36
89;22.08.2018;2018;08;18;Keskiviikko;97;73;170;29;26;55
89;22.08.2018;2018;08;19;Keskiviikko;99;45;144;34;25;59
89;22.08.2018;2018;08;20;Keskiviikko;68;39;107;16;16;32
89;22.08.2018;2018;08;21;Keskiviikko;38;14;52;8;16;24
89;22.08.2018;2018;08;22;Keskiviikko;13;13;26;4;7;11
89;22.08.2018;2018;08;23;Keskiviikko;13;3;16;6;4;10
89;23.08.2018;2018;08;00;Torstai;3;6;9;3;2;5
89;23.08.2018;2018;08;01;Torstai;2;3;5;0;0;0
89;23.08.2018;2018;08;02;Torstai;5;2;7;0;0;0
89;23.08.2018;2018;08;03;Torstai;1;2;3;0;0;0
89;23.08.2018;2018;08;04;Torstai;2;1;3;0;1;1
89;23.08.2018;2018;08;05;Torstai;8;12;20;2;2;4
89;23.08.2018;2018;08;06;Torstai;17;62;79;1;1;2
89;23.08.2018;2018;08;07;Torstai;33;133;166;3;17;20
89;23.08.2018;2018;08;08;Torstai;38;187;225;1;34;35
89;23.08.2018;2018;08;09;Torstai;27;80;107;4;17;21
89;23.08.2018;2018;08;10;Torstai;8;27;35;3;16;19
89;23.08.2018;2018;08;11;Torstai;18;33;51;12;9;21
89;23.08.2018;2018;08;12;Torstai;35;39;74;7;6;13
89;23.08.2018;2018;08;13;Torstai;75;73;148;21;15;36
89;23.08.2018;2018;08;14;Torstai;132;105;237;29;20;49
89;23.08.2018;2018;08;15;Torstai;192;79;271;31;22;53
89;23.08.2018;2018;08;16;Torstai;211;104;315;36;21;57
89;23.08.2018;2018;08;17;Torstai;115;120;235;28;28;56
89;23.08.2018;2018;08;18;Torstai;146;76;222;39;29;68
89;23.08.2018;2018;08;19;Torstai;129;53;182;43;40;83
89;23.08.2018;2018;08;20;Torstai;115;41;156;31;16;47
89;23.08.2018;2018;08;21;Torstai;51;37;88;16;14;30
89;23.08.2018;2018;08;22;Torstai;27;10;37;14;10;24
89;23.08.2018;2018;08;23;Torstai;15;8;23;2;1;3
89;24.08.2018;2018;08;00;Perjantai;8;2;10;5;0;5
89;24.08.2018;2018;08;01;Perjantai;6;8;14;0;1;1
89;24.08.2018;2018;08;02;Perjantai;7;3;10;1;0;1
89;24.08.2018;2018;08;03;Perjantai;2;4;6;1;0;1
89;24.08.2018;2018;08;04;Perjantai;2;2;4;1;1;2
89;24.08.2018;2018;08;05;Perjantai;8;13;21;0;1;1
89;24.08.2018;2018;08;06;Perjantai;19;58;77;2;8;10
89;24.08.2018;2018;08;07;Perjantai;36;112;148;5;26;31
89;24.08.2018;2018;08;08;Perjantai;32;197;229;10;33;43
89;24.08.2018;2018;08;09;Perjantai;27;67;94;8;26;34
89;24.08.2018;2018;08;10;Perjantai;15;48;63;4;15;19
89;24.08.2018;2018;08;11;Perjantai;21;23;44;10;14;24
89;24.08.2018;2018;08;12;Perjantai;42;36;78;17;15;32
89;24.08.2018;2018;08;13;Perjantai;80;31;111;15;5;20
89;24.08.2018;2018;08;14;Perjantai;117;43;160;17;14;31
89;24.08.2018;2018;08;15;Perjantai;123;60;183;10;16;26
89;24.08.2018;2018;08;16;Perjantai;124;93;217;27;20;47
89;24.08.2018;2018;08;17;Perjantai;83;92;175;28;17;45
89;24.08.2018;2018;08;18;Perjantai;78;62;140;20;32;52
89;24.08.2018;2018;08;19;Perjantai;90;61;151;22;29;51
89;24.08.2018;2018;08;20;Perjantai;70;57;127;25;18;43
89;24.08.2018;2018;08;21;Perjantai;33;32;65;16;6;22
89;24.08.2018;2018;08;22;Perjantai;42;16;58;7;6;13
89;24.08.2018;2018;08;23;Perjantai;10;25;35;1;6;7
89;25.08.2018;2018;08;00;Lauantai;13;18;31;5;5;10
89;25.08.2018;2018;08;01;Lauantai;13;10;23;7;0;7
89;25.08.2018;2018;08;02;Lauantai;21;4;25;3;2;5
89;25.08.2018;2018;08;03;Lauantai;21;1;22;6;0;6
89;25.08.2018;2018;08;04;Lauantai;15;1;16;10;0;10
89;25.08.2018;2018;08;05;Lauantai;5;10;15;10;0;10
89;25.08.2018;2018;08;06;Lauantai;6;7;13;1;1;2
89;25.08.2018;2018;08;07;Lauantai;3;15;18;3;1;4
89;25.08.2018;2018;08;08;Lauantai;3;23;26;3;9;12
89;25.08.2018;2018;08;09;Lauantai;15;35;50;12;14;26
89;25.08.2018;2018;08;10;Lauantai;18;48;66;7;27;34
89;25.08.2018;2018;08;11;Lauantai;24;96;120;11;34;45
89;25.08.2018;2018;08;12;Lauantai;47;167;214;30;106;136
89;25.08.2018;2018;08;13;Lauantai;110;154;264;59;61;120
89;25.08.2018;2018;08;14;Lauantai;151;138;289;64;64;128
89;25.08.2018;2018;08;15;Lauantai;173;142;315;43;49;92
89;25.08.2018;2018;08;16;Lauantai;146;87;233;42;34;76
89;25.08.2018;2018;08;17;Lauantai;113;75;188;44;20;64
89;25.08.2018;2018;08;18;Lauantai;106;66;172;46;33;79
89;25.08.2018;2018;08;19;Lauantai;76;63;139;35;37;72
89;25.08.2018;2018;08;20;Lauantai;48;41;89;16;21;37
89;25.08.2018;2018;08;21;Lauantai;40;44;84;13;24;37
89;25.08.2018;2018;08;22;Lauantai;17;43;60;9;22;31
89;25.08.2018;2018;08;23;Lauantai;20;35;55;3;14;17
89;26.08.2018;2018;08;00;Sunnuntai;25;29;54;12;8;20
89;26.08.2018;2018;08;01;Sunnuntai;21;15;36;4;2;6
89;26.08.2018;2018;08;02;Sunnuntai;14;9;23;9;1;10
89;26.08.2018;2018;08;03;Sunnuntai;17;3;20;7;1;8
89;26.08.2018;2018;08;04;Sunnuntai;15;1;16;8;0;8
89;26.08.2018;2018;08;05;Sunnuntai;12;9;21;6;1;7
89;26.08.2018;2018;08;06;Sunnuntai;6;7;13;1;1;2
89;26.08.2018;2018;08;07;Sunnuntai;6;6;12;8;6;14
89;26.08.2018;2018;08;08;Sunnuntai;4;11;15;2;14;16
89;26.08.2018;2018;08;09;Sunnuntai;25;30;55;22;14;36
89;26.08.2018;2018;08;10;Sunnuntai;37;80;117;26;45;71
89;26.08.2018;2018;08;11;Sunnuntai;42;117;159;36;54;90
89;26.08.2018;2018;08;12;Sunnuntai;97;125;222;50;47;97
89;26.08.2018;2018;08;13;Sunnuntai;110;144;254;39;53;92
89;26.08.2018;2018;08;14;Sunnuntai;147;120;267;38;45;83
89;26.08.2018;2018;08;15;Sunnuntai;101;42;143;23;12;35
89;26.08.2018;2018;08;16;Sunnuntai;50;30;80;11;13;24
89;26.08.2018;2018;08;17;Sunnuntai;48;19;67;20;7;27
89;26.08.2018;2018;08;18;Sunnuntai;45;27;72;17;17;34
89;26.08.2018;2018;08;19;Sunnuntai;34;32;66;35;20;55
89;26.08.2018;2018;08;20;Sunnuntai;23;23;46;6;24;30
89;26.08.2018;2018;08;21;Sunnuntai;25;10;35;14;11;25
89;26.08.2018;2018;08;22;Sunnuntai;9;6;15;1;2;3
89;26.08.2018;2018;08;23;Sunnuntai;3;6;9;4;3;7
89;27.08.2018;2018;08;00;Maanantai;5;4;9;3;1;4
89;27.08.2018;2018;08;01;Maanantai;2;4;6;0;0;0
89;27.08.2018;2018;08;02;Maanantai;1;11;12;1;1;2
89;27.08.2018;2018;08;03;Maanantai;5;9;14;1;0;1
89;27.08.2018;2018;08;04;Maanantai;2;1;3;0;0;0
89;27.08.2018;2018;08;05;Maanantai;3;16;19;1;1;2
89;27.08.2018;2018;08;06;Maanantai;13;67;80;4;4;8
89;27.08.2018;2018;08;07;Maanantai;40;154;194;8;23;31
89;27.08.2018;2018;08;08;Maanantai;50;229;279;15;60;75
89;27.08.2018;2018;08;09;Maanantai;29;111;140;13;37;50
89;27.08.2018;2018;08;10;Maanantai;29;59;88;12;23;35
89;27.08.2018;2018;08;11;Maanantai;54;80;134;15;22;37
89;27.08.2018;2018;08;12;Maanantai;56;69;125;12;17;29
89;27.08.2018;2018;08;13;Maanantai;65;57;122;12;7;19
89;27.08.2018;2018;08;14;Maanantai;130;80;210;18;25;43
89;27.08.2018;2018;08;15;Maanantai;190;60;250;40;17;57
89;27.08.2018;2018;08;16;Maanantai;231;98;329;37;12;49
89;27.08.2018;2018;08;17;Maanantai;132;90;222;30;25;55
89;27.08.2018;2018;08;18;Maanantai;105;86;191;36;31;67
89;27.08.2018;2018;08;19;Maanantai;99;47;146;42;43;85
89;27.08.2018;2018;08;20;Maanantai;82;40;122;43;25;68
89;27.08.2018;2018;08;21;Maanantai;66;28;94;14;23;37
89;27.08.2018;2018;08;22;Maanantai;20;18;38;4;5;9
89;27.08.2018;2018;08;23;Maanantai;7;3;10;0;2;2
89;28.08.2018;2018;08;00;Tiistai;4;4;8;0;6;6
89;28.08.2018;2018;08;01;Tiistai;1;3;4;2;0;2
89;28.08.2018;2018;08;02;Tiistai;1;3;4;4;2;6
89;28.08.2018;2018;08;03;Tiistai;1;2;3;0;1;1
89;28.08.2018;2018;08;04;Tiistai;2;2;4;3;1;4
89;28.08.2018;2018;08;05;Tiistai;2;16;18;2;1;3
89;28.08.2018;2018;08;06;Tiistai;16;75;91;1;9;10
89;28.08.2018;2018;08;07;Tiistai;51;177;228;9;29;38
89;28.08.2018;2018;08;08;Tiistai;42;256;298;7;39;46
89;28.08.2018;2018;08;09;Tiistai;42;140;182;14;32;46
89;28.08.2018;2018;08;10;Tiistai;38;88;126;16;33;49
89;28.08.2018;2018;08;11;Tiistai;48;92;140;20;30;50
89;28.08.2018;2018;08;12;Tiistai;79;78;157;24;52;76
89;28.08.2018;2018;08;13;Tiistai;97;81;178;39;16;55
89;28.08.2018;2018;08;14;Tiistai;149;79;228;47;48;95
89;28.08.2018;2018;08;15;Tiistai;193;89;282;30;23;53
89;28.08.2018;2018;08;16;Tiistai;272;110;382;36;17;53
89;28.08.2018;2018;08;17;Tiistai;166;78;244;30;26;56
89;28.08.2018;2018;08;18;Tiistai;106;71;177;25;36;61
89;28.08.2018;2018;08;19;Tiistai;105;60;165;48;34;82
89;28.08.2018;2018;08;20;Tiistai;100;41;141;30;24;54
89;28.08.2018;2018;08;21;Tiistai;57;39;96;16;10;26
89;28.08.2018;2018;08;22;Tiistai;17;8;25;3;7;10
89;28.08.2018;2018;08;23;Tiistai;9;5;14;6;6;12
89;29.08.2018;2018;08;00;Keskiviikko;8;10;18;1;1;2
89;29.08.2018;2018;08;01;Keskiviikko;6;5;11;0;0;0
89;29.08.2018;2018;08;02;Keskiviikko;4;2;6;0;2;2
89;29.08.2018;2018;08;03;Keskiviikko;2;3;5;2;0;2
89;29.08.2018;2018;08;04;Keskiviikko;0;2;2;0;2;2
89;29.08.2018;2018;08;05;Keskiviikko;6;20;26;2;1;3
89;29.08.2018;2018;08;06;Keskiviikko;17;74;91;1;3;4
89;29.08.2018;2018;08;07;Keskiviikko;48;182;230;3;30;33
89;29.08.2018;2018;08;08;Keskiviikko;45;262;307;10;56;66
89;29.08.2018;2018;08;09;Keskiviikko;36;117;153;3;41;44
89;29.08.2018;2018;08;10;Keskiviikko;39;96;135;26;39;65
89;29.08.2018;2018;08;11;Keskiviikko;58;101;159;18;27;45
89;29.08.2018;2018;08;12;Keskiviikko;98;87;185;22;20;42
89;29.08.2018;2018;08;13;Keskiviikko;138;99;237;21;24;45
89;29.08.2018;2018;08;14;Keskiviikko;153;100;253;40;23;63
89;29.08.2018;2018;08;15;Keskiviikko;196;123;319;37;19;56
89;29.08.2018;2018;08;16;Keskiviikko;246;122;368;42;26;68
89;29.08.2018;2018;08;17;Keskiviikko;176;142;318;48;36;84
89;29.08.2018;2018;08;18;Keskiviikko;139;107;246;29;42;71
89;29.08.2018;2018;08;19;Keskiviikko;174;90;264;52;32;84
89;29.08.2018;2018;08;20;Keskiviikko;121;77;198;39;26;65
89;29.08.2018;2018;08;21;Keskiviikko;71;30;101;16;16;32
89;29.08.2018;2018;08;22;Keskiviikko;32;28;60;3;9;12
89;29.08.2018;2018;08;23;Keskiviikko;20;16;36;4;1;5
89;30.08.2018;2018;08;00;Torstai;15;5;20;3;1;4
89;30.08.2018;2018;08;01;Torstai;10;0;10;5;0;5
89;30.08.2018;2018;08;02;Torstai;5;5;10;2;1;3
89;30.08.2018;2018;08;03;Torstai;2;4;6;2;0;2
89;30.08.2018;2018;08;04;Torstai;3;3;6;0;1;1
89;30.08.2018;2018;08;05;Torstai;3;12;15;0;0;0
89;30.08.2018;2018;08;06;Torstai;17;70;87;1;7;8
89;30.08.2018;2018;08;07;Torstai;30;186;216;1;26;27
89;30.08.2018;2018;08;08;Torstai;39;244;283;6;48;54
89;30.08.2018;2018;08;09;Torstai;42;154;196;17;32;49
89;30.08.2018;2018;08;10;Torstai;40;87;127;15;33;48
89;30.08.2018;2018;08;11;Torstai;65;104;169;19;27;46
89;30.08.2018;2018;08;12;Torstai;101;77;178;18;23;41
89;30.08.2018;2018;08;13;Torstai;111;93;204;26;26;52
89;30.08.2018;2018;08;14;Torstai;163;78;241;20;34;54
89;30.08.2018;2018;08;15;Torstai;206;73;279;26;14;40
89;30.08.2018;2018;08;16;Torstai;194;122;316;27;22;49
89;30.08.2018;2018;08;17;Torstai;148;115;263;31;25;56
89;30.08.2018;2018;08;18;Torstai;108;68;176;31;20;51
89;30.08.2018;2018;08;19;Torstai;118;59;177;33;25;58
89;30.08.2018;2018;08;20;Torstai;73;50;123;33;22;55
89;30.08.2018;2018;08;21;Torstai;50;22;72;11;13;24
89;30.08.2018;2018;08;22;Torstai;29;20;49;6;5;11
89;30.08.2018;2018;08;23;Torstai;11;9;20;3;6;9
89;31.08.2018;2018;08;00;Perjantai;6;10;16;2;1;3
89;31.08.2018;2018;08;01;Perjantai;3;2;5;1;0;1
89;31.08.2018;2018;08;02;Perjantai;4;2;6;2;0;2
89;31.08.2018;2018;08;03;Perjantai;3;5;8;0;0;0
89;31.08.2018;2018;08;04;Perjantai;11;1;12;3;1;4
89;31.08.2018;2018;08;05;Perjantai;8;15;23;0;0;0
89;31.08.2018;2018;08;06;Perjantai;7;70;77;0;4;4
89;31.08.2018;2018;08;07;Perjantai;36;151;187;5;18;23
89;31.08.2018;2018;08;08;Perjantai;32;227;259;4;32;36
89;31.08.2018;2018;08;09;Perjantai;39;139;178;6;26;32
89;31.08.2018;2018;08;10;Perjantai;36;89;125;29;24;53
89;31.08.2018;2018;08;11;Perjantai;68;91;159;16;35;51
89;31.08.2018;2018;08;12;Perjantai;80;119;199;16;24;40
89;31.08.2018;2018;08;13;Perjantai;132;108;240;22;24;46
89;31.08.2018;2018;08;14;Perjantai;174;124;298;30;27;57
89;31.08.2018;2018;08;15;Perjantai;207;91;298;22;19;41
89;31.08.2018;2018;08;16;Perjantai;205;120;325;25;21;46
89;31.08.2018;2018;08;17;Perjantai;121;126;247;25;31;56
89;31.08.2018;2018;08;18;Perjantai;110;91;201;34;26;60
89;31.08.2018;2018;08;19;Perjantai;123;77;200;35;20;55
89;31.08.2018;2018;08;20;Perjantai;91;63;154;22;27;49
89;31.08.2018;2018;08;21;Perjantai;63;62;125;14;14;28
89;31.08.2018;2018;08;22;Perjantai;45;29;74;6;5;11
89;31.08.2018;2018;08;23;Perjantai;30;21;51;7;13;20
89;01.09.2018;2018;09;00;Lauantai;26;24;50;3;4;7
89;01.09.2018;2018;09;01;Lauantai;28;5;33;11;0;11
89;01.09.2018;2018;09;02;Lauantai;18;9;27;2;4;6
89;01.09.2018;2018;09;03;Lauantai;18;4;22;5;0;5
89;01.09.2018;2018;09;04;Lauantai;23;4;27;5;1;6
89;01.09.2018;2018;09;05;Lauantai;10;6;16;5;3;8
89;01.09.2018;2018;09;06;Lauantai;2;16;18;2;3;5
89;01.09.2018;2018;09;07;Lauantai;2;18;20;5;4;9
89;01.09.2018;2018;09;08;Lauantai;24;42;66;7;13;20
89;01.09.2018;2018;09;09;Lauantai;26;63;89;5;16;21
89;01.09.2018;2018;09;10;Lauantai;42;104;146;16;42;58
89;01.09.2018;2018;09;11;Lauantai;63;128;191;32;49;81
89;01.09.2018;2018;09;12;Lauantai;108;120;228;39;38;77
89;01.09.2018;2018;09;13;Lauantai;100;139;239;32;43;75
89;01.09.2018;2018;09;14;Lauantai;134;102;236;40;40;80
89;01.09.2018;2018;09;15;Lauantai;127;115;242;44;33;77
89;01.09.2018;2018;09;16;Lauantai;109;124;233;40;34;74
89;01.09.2018;2018;09;17;Lauantai;97;101;198;32;30;62
89;01.09.2018;2018;09;18;Lauantai;88;82;170;35;30;65
89;01.09.2018;2018;09;19;Lauantai;110;90;200;30;27;57
89;01.09.2018;2018;09;20;Lauantai;74;33;107;31;43;74
89;01.09.2018;2018;09;21;Lauantai;38;38;76;10;14;24
89;01.09.2018;2018;09;22;Lauantai;61;31;92;12;17;29
89;01.09.2018;2018;09;23;Lauantai;26;35;61;9;14;23
89;02.09.2018;2018;09;00;Sunnuntai;28;21;49;11;8;19
89;02.09.2018;2018;09;01;Sunnuntai;21;18;39;7;8;15
89;02.09.2018;2018;09;02;Sunnuntai;24;12;36;8;4;12
89;02.09.2018;2018;09;03;Sunnuntai;29;7;36;2;1;3
89;02.09.2018;2018;09;04;Sunnuntai;26;4;30;9;0;9
89;02.09.2018;2018;09;05;Sunnuntai;13;3;16;5;4;9
89;02.09.2018;2018;09;06;Sunnuntai;2;10;12;1;3;4
89;02.09.2018;2018;09;07;Sunnuntai;6;4;10;3;3;6
89;02.09.2018;2018;09;08;Sunnuntai;6;15;21;6;10;16
89;02.09.2018;2018;09;09;Sunnuntai;24;33;57;7;23;30
89;02.09.2018;2018;09;10;Sunnuntai;19;56;75;14;21;35
89;02.09.2018;2018;09;11;Sunnuntai;40;112;152;30;63;93
89;02.09.2018;2018;09;12;Sunnuntai;70;115;185;59;63;122
89;02.09.2018;2018;09;13;Sunnuntai;96;111;207;44;61;105
89;02.09.2018;2018;09;14;Sunnuntai;132;129;261;43;46;89
89;02.09.2018;2018;09;15;Sunnuntai;136;143;279;69;56;125
89;02.09.2018;2018;09;16;Sunnuntai;107;93;200;54;36;90
89;02.09.2018;2018;09;17;Sunnuntai;93;86;179;26;36;62
89;02.09.2018;2018;09;18;Sunnuntai;108;87;195;38;36;74
89;02.09.2018;2018;09;19;Sunnuntai;83;54;137;23;33;56
89;02.09.2018;2018;09;20;Sunnuntai;72;45;117;21;17;38
89;02.09.2018;2018;09;21;Sunnuntai;55;25;80;10;8;18
89;02.09.2018;2018;09;22;Sunnuntai;20;20;40;4;2;6
89;02.09.2018;2018;09;23;Sunnuntai;8;6;14;2;2;4
89;03.09.2018;2018;09;00;Maanantai;4;3;7;1;1;2
89;03.09.2018;2018;09;01;Maanantai;2;4;6;0;0;0
89;03.09.2018;2018;09;02;Maanantai;3;3;6;1;0;1
89;03.09.2018;2018;09;03;Maanantai;2;2;4;0;3;3
89;03.09.2018;2018;09;04;Maanantai;4;4;8;0;4;4
89;03.09.2018;2018;09;05;Maanantai;4;5;9;0;0;0
89;03.09.2018;2018;09;06;Maanantai;12;68;80;0;4;4
89;03.09.2018;2018;09;07;Maanantai;44;182;226;4;18;22
89;03.09.2018;2018;09;08;Maanantai;66;257;323;11;38;49
89;03.09.2018;2018;09;09;Maanantai;43;144;187;11;43;54
89;03.09.2018;2018;09;10;Maanantai;40;104;144;8;20;28
89;03.09.2018;2018;09;11;Maanantai;72;82;154;25;30;55
89;03.09.2018;2018;09;12;Maanantai;91;100;191;21;33;54
89;03.09.2018;2018;09;13;Maanantai;115;78;193;27;27;54
89;03.09.2018;2018;09;14;Maanantai;162;115;277;37;21;58
89;03.09.2018;2018;09;15;Maanantai;198;107;305;51;19;70
89;03.09.2018;2018;09;16;Maanantai;224;137;361;44;23;67
89;03.09.2018;2018;09;17;Maanantai;160;148;308;37;29;66
89;03.09.2018;2018;09;18;Maanantai;140;98;238;35;41;76
89;03.09.2018;2018;09;19;Maanantai;137;87;224;35;36;71
89;03.09.2018;2018;09;20;Maanantai;112;60;172;42;26;68
89;03.09.2018;2018;09;21;Maanantai;52;33;85;17;10;27
89;03.09.2018;2018;09;22;Maanantai;32;19;51;8;4;12
89;03.09.2018;2018;09;23;Maanantai;15;8;23;2;2;4
89;04.09.2018;2018;09;00;Tiistai;12;15;27;3;1;4
89;04.09.2018;2018;09;01;Tiistai;12;6;18;2;1;3
89;04.09.2018;2018;09;02;Tiistai;5;2;7;0;0;0
89;04.09.2018;2018;09;03;Tiistai;2;3;5;0;0;0
89;04.09.2018;2018;09;04;Tiistai;0;1;1;0;0;0
89;04.09.2018;2018;09;05;Tiistai;3;13;16;1;0;1
89;04.09.2018;2018;09;06;Tiistai;13;73;86;3;5;8
89;04.09.2018;2018;09;07;Tiistai;47;197;244;3;21;24
89;04.09.2018;2018;09;08;Tiistai;52;278;330;4;39;43
89;04.09.2018;2018;09;09;Tiistai;41;140;181;7;32;39
89;04.09.2018;2018;09;10;Tiistai;46;109;155;14;32;46
89;04.09.2018;2018;09;11;Tiistai;97;87;184;15;26;41
89;04.09.2018;2018;09;12;Tiistai;86;105;191;16;20;36
89;04.09.2018;2018;09;13;Tiistai;114;97;211;34;23;57
89;04.09.2018;2018;09;14;Tiistai;207;96;303;38;31;69
89;04.09.2018;2018;09;15;Tiistai;244;119;363;21;18;39
89;04.09.2018;2018;09;16;Tiistai;280;113;393;35;28;63
89;04.09.2018;2018;09;17;Tiistai;202;120;322;30;37;67
89;04.09.2018;2018;09;18;Tiistai;151;106;257;34;45;79
89;04.09.2018;2018;09;19;Tiistai;141;88;229;35;34;69
89;04.09.2018;2018;09;20;Tiistai;93;73;166;35;37;72
89;04.09.2018;2018;09;21;Tiistai;72;35;107;18;14;32
89;04.09.2018;2018;09;22;Tiistai;24;20;44;9;2;11
89;04.09.2018;2018;09;23;Tiistai;16;8;24;2;3;5
89;05.09.2018;2018;09;00;Keskiviikko;2;9;11;1;0;1
89;05.09.2018;2018;09;01;Keskiviikko;8;5;13;0;0;0
89;05.09.2018;2018;09;02;Keskiviikko;3;0;3;0;2;2
89;05.09.2018;2018;09;03;Keskiviikko;2;2;4;0;1;1
89;05.09.2018;2018;09;04;Keskiviikko;1;2;3;0;1;1
89;05.09.2018;2018;09;05;Keskiviikko;1;10;11;0;2;2
89;05.09.2018;2018;09;06;Keskiviikko;11;60;71;4;3;7
89;05.09.2018;2018;09;07;Keskiviikko;42;185;227;3;26;29
89;05.09.2018;2018;09;08;Keskiviikko;37;262;299;5;27;32
89;05.09.2018;2018;09;09;Keskiviikko;66;145;211;9;23;32
89;05.09.2018;2018;09;10;Keskiviikko;38;78;116;14;15;29
89;05.09.2018;2018;09;11;Keskiviikko;62;63;125;20;22;42
89;05.09.2018;2018;09;12;Keskiviikko;91;89;180;24;11;35
89;05.09.2018;2018;09;13;Keskiviikko;114;81;195;14;17;31
89;05.09.2018;2018;09;14;Keskiviikko;168;100;268;15;19;34
89;05.09.2018;2018;09;15;Keskiviikko;215;95;310;18;17;35
89;05.09.2018;2018;09;16;Keskiviikko;222;133;355;41;27;68
89;05.09.2018;2018;09;17;Keskiviikko;122;115;237;20;23;43
89;05.09.2018;2018;09;18;Keskiviikko;123;86;209;38;34;72
89;05.09.2018;2018;09;19;Keskiviikko;114;39;153;49;32;81
89;05.09.2018;2018;09;20;Keskiviikko;115;46;161;23;20;43
89;05.09.2018;2018;09;21;Keskiviikko;59;32;91;9;18;27
89;05.09.2018;2018;09;22;Keskiviikko;21;20;41;4;6;10
89;05.09.2018;2018;09;23;Keskiviikko;15;5;20;3;4;7
89;06.09.2018;2018;09;00;Torstai;15;6;21;5;1;6
89;06.09.2018;2018;09;01;Torstai;4;3;7;0;0;0
89;06.09.2018;2018;09;02;Torstai;10;2;12;3;2;5
89;06.09.2018;2018;09;03;Torstai;4;2;6;0;0;0
89;06.09.2018;2018;09;04;Torstai;2;0;2;3;1;4
89;06.09.2018;2018;09;05;Torstai;1;18;19;1;0;1
89;06.09.2018;2018;09;06;Torstai;9;60;69;4;6;10
89;06.09.2018;2018;09;07;Torstai;49;163;212;8;26;34
89;06.09.2018;2018;09;08;Torstai;38;250;288;13;32;45
89;06.09.2018;2018;09;09;Torstai;39;128;167;10;31;41
89;06.09.2018;2018;09;10;Torstai;47;112;159;42;54;96
89;06.09.2018;2018;09;11;Torstai;64;71;135;44;25;69
89;06.09.2018;2018;09;12;Torstai;73;78;151;19;27;46
89;06.09.2018;2018;09;13;Torstai;120;77;197;19;26;45
89;06.09.2018;2018;09;14;Torstai;131;91;222;27;20;47
89;06.09.2018;2018;09;15;Torstai;196;83;279;18;22;40
89;06.09.2018;2018;09;16;Torstai;263;118;381;33;12;45
89;06.09.2018;2018;09;17;Torstai;139;131;270;24;43;67
89;06.09.2018;2018;09;18;Torstai;108;100;208;27;30;57
89;06.09.2018;2018;09;19;Torstai;103;66;169;44;36;80
89;06.09.2018;2018;09;20;Torstai;85;38;123;33;24;57
89;06.09.2018;2018;09;21;Torstai;40;37;77;13;12;25
89;06.09.2018;2018;09;22;Torstai;13;31;44;8;9;17
89;06.09.2018;2018;09;23;Torstai;11;11;22;1;2;3
89;07.09.2018;2018;09;00;Perjantai;13;9;22;2;0;2
89;07.09.2018;2018;09;01;Perjantai;21;4;25;1;1;2
89;07.09.2018;2018;09;02;Perjantai;10;1;11;7;1;8
89;07.09.2018;2018;09;03;Perjantai;6;4;10;0;0;0
89;07.09.2018;2018;09;04;Perjantai;10;0;10;1;2;3
89;07.09.2018;2018;09;05;Perjantai;6;16;22;0;1;1
89;07.09.2018;2018;09;06;Perjantai;10;57;67;1;4;5
89;07.09.2018;2018;09;07;Perjantai;38;156;194;4;18;22
89;07.09.2018;2018;09;08;Perjantai;54;219;273;5;24;29
89;07.09.2018;2018;09;09;Perjantai;58;131;189;11;32;43
89;07.09.2018;2018;09;10;Perjantai;58;72;130;33;29;62
89;07.09.2018;2018;09;11;Perjantai;65;91;156;20;19;39
89;07.09.2018;2018;09;12;Perjantai;101;97;198;24;17;41
89;07.09.2018;2018;09;13;Perjantai;133;102;235;35;30;65
89;07.09.2018;2018;09;14;Perjantai;144;89;233;38;26;64
89;07.09.2018;2018;09;15;Perjantai;198;92;290;30;23;53
89;07.09.2018;2018;09;16;Perjantai;177;99;276;26;23;49
89;07.09.2018;2018;09;17;Perjantai;117;102;219;31;27;58
89;07.09.2018;2018;09;18;Perjantai;98;94;192;20;37;57
89;07.09.2018;2018;09;19;Perjantai;107;80;187;20;47;67
89;07.09.2018;2018;09;20;Perjantai;63;68;131;15;30;45
89;07.09.2018;2018;09;21;Perjantai;57;38;95;29;16;45
89;07.09.2018;2018;09;22;Perjantai;26;33;59;11;22;33
89;07.09.2018;2018;09;23;Perjantai;27;21;48;5;4;9
89;08.09.2018;2018;09;00;Lauantai;30;14;44;7;3;10
89;08.09.2018;2018;09;01;Lauantai;13;6;19;2;4;6
89;08.09.2018;2018;09;02;Lauantai;16;4;20;4;3;7
89;08.09.2018;2018;09;03;Lauantai;19;4;23;1;4;5
89;08.09.2018;2018;09;04;Lauantai;12;1;13;1;0;1
89;08.09.2018;2018;09;05;Lauantai;8;7;15;4;5;9
89;08.09.2018;2018;09;06;Lauantai;5;14;19;3;3;6
89;08.09.2018;2018;09;07;Lauantai;3;5;8;3;4;7
89;08.09.2018;2018;09;08;Lauantai;7;29;36;6;11;17
89;08.09.2018;2018;09;09;Lauantai;22;74;96;19;25;44
89;08.09.2018;2018;09;10;Lauantai;36;77;113;20;31;51
89;08.09.2018;2018;09;11;Lauantai;65;124;189;22;53;75
89;08.09.2018;2018;09;12;Lauantai;81;138;219;62;63;125
89;08.09.2018;2018;09;13;Lauantai;105;123;228;32;64;96
89;08.09.2018;2018;09;14;Lauantai;124;128;252;75;58;133
89;08.09.2018;2018;09;15;Lauantai;129;118;247;81;58;139
89;08.09.2018;2018;09;16;Lauantai;129;60;189;83;40;123
89;08.09.2018;2018;09;17;Lauantai;107;77;184;39;42;81
89;08.09.2018;2018;09;18;Lauantai;81;90;171;33;39;72
89;08.09.2018;2018;09;19;Lauantai;74;72;146;37;43;80
89;08.09.2018;2018;09;20;Lauantai;68;76;144;25;28;53
89;08.09.2018;2018;09;21;Lauantai;46;46;92;15;8;23
89;08.09.2018;2018;09;22;Lauantai;45;33;78;11;16;27
89;08.09.2018;2018;09;23;Lauantai;34;26;60;6;13;19
89;09.09.2018;2018;09;00;Sunnuntai;17;29;46;6;10;16
89;09.09.2018;2018;09;01;Sunnuntai;15;9;24;1;2;3
89;09.09.2018;2018;09;02;Sunnuntai;22;5;27;6;3;9
89;09.09.2018;2018;09;03;Sunnuntai;12;6;18;4;1;5
89;09.09.2018;2018;09;04;Sunnuntai;11;5;16;8;0;8
89;09.09.2018;2018;09;05;Sunnuntai;11;4;15;3;1;4
89;09.09.2018;2018;09;06;Sunnuntai;6;6;12;2;3;5
89;09.09.2018;2018;09;07;Sunnuntai;4;6;10;2;12;14
89;09.09.2018;2018;09;08;Sunnuntai;2;12;14;17;11;28
89;09.09.2018;2018;09;09;Sunnuntai;26;22;48;12;18;30
89;09.09.2018;2018;09;10;Sunnuntai;19;59;78;30;38;68
89;09.09.2018;2018;09;11;Sunnuntai;33;80;113;37;55;92
89;09.09.2018;2018;09;12;Sunnuntai;67;96;163;49;46;95
89;09.09.2018;2018;09;13;Sunnuntai;126;88;214;40;55;95
89;09.09.2018;2018;09;14;Sunnuntai;90;99;189;50;60;110
89;09.09.2018;2018;09;15;Sunnuntai;113;99;212;51;56;107
89;09.09.2018;2018;09;16;Sunnuntai;106;81;187;42;28;70
89;09.09.2018;2018;09;17;Sunnuntai;92;83;175;37;25;62
89;09.09.2018;2018;09;18;Sunnuntai;76;84;160;39;33;72
89;09.09.2018;2018;09;19;Sunnuntai;72;48;120;44;31;75
89;09.09.2018;2018;09;20;Sunnuntai;53;33;86;26;22;48
89;09.09.2018;2018;09;21;Sunnuntai;31;14;45;8;11;19
89;09.09.2018;2018;09;22;Sunnuntai;11;13;24;6;2;8
89;09.09.2018;2018;09;23;Sunnuntai;5;11;16;3;3;6
89;10.09.2018;2018;09;00;Maanantai;8;5;13;3;1;4
89;10.09.2018;2018;09;01;Maanantai;1;2;3;0;0;0
89;10.09.2018;2018;09;02;Maanantai;2;2;4;2;0;2
89;10.09.2018;2018;09;03;Maanantai;3;2;5;0;0;0
89;10.09.2018;2018;09;04;Maanantai;2;2;4;0;3;3
89;10.09.2018;2018;09;05;Maanantai;4;9;13;3;1;4
89;10.09.2018;2018;09;06;Maanantai;13;56;69;5;6;11
89;10.09.2018;2018;09;07;Maanantai;42;179;221;5;11;16
89;10.09.2018;2018;09;08;Maanantai;37;268;305;5;29;34
89;10.09.2018;2018;09;09;Maanantai;44;144;188;7;37;44
89;10.09.2018;2018;09;10;Maanantai;44;101;145;10;15;25
89;10.09.2018;2018;09;11;Maanantai;84;117;201;14;18;32
89;10.09.2018;2018;09;12;Maanantai;95;97;192;16;19;35
89;10.09.2018;2018;09;13;Maanantai;116;81;197;19;26;45
89;10.09.2018;2018;09;14;Maanantai;179;94;273;22;12;34
89;10.09.2018;2018;09;15;Maanantai;204;70;274;36;15;51
89;10.09.2018;2018;09;16;Maanantai;271;121;392;20;19;39
89;10.09.2018;2018;09;17;Maanantai;180;129;309;40;30;70
89;10.09.2018;2018;09;18;Maanantai;135;108;243;35;52;87
89;10.09.2018;2018;09;19;Maanantai;134;80;214;41;38;79
89;10.09.2018;2018;09;20;Maanantai;90;48;138;36;20;56
89;10.09.2018;2018;09;21;Maanantai;51;23;74;12;11;23
89;10.09.2018;2018;09;22;Maanantai;21;15;36;3;8;11
89;10.09.2018;2018;09;23;Maanantai;8;6;14;2;5;7
89;11.09.2018;2018;09;00;Tiistai;5;7;12;7;3;10
89;11.09.2018;2018;09;01;Tiistai;2;1;3;0;1;1
89;11.09.2018;2018;09;02;Tiistai;2;3;5;0;0;0
89;11.09.2018;2018;09;03;Tiistai;1;2;3;1;0;1
89;11.09.2018;2018;09;04;Tiistai;0;0;0;1;0;1
89;11.09.2018;2018;09;05;Tiistai;6;16;22;0;4;4
89;11.09.2018;2018;09;06;Tiistai;16;62;78;4;4;8
89;11.09.2018;2018;09;07;Tiistai;35;153;188;3;18;21
89;11.09.2018;2018;09;08;Tiistai;47;260;307;10;29;39
89;11.09.2018;2018;09;09;Tiistai;33;120;153;10;29;39
89;11.09.2018;2018;09;10;Tiistai;43;83;126;25;20;45
89;11.09.2018;2018;09;11;Tiistai;58;90;148;17;26;43
89;11.09.2018;2018;09;12;Tiistai;72;86;158;19;19;38
89;11.09.2018;2018;09;13;Tiistai;89;59;148;14;21;35
89;11.09.2018;2018;09;14;Tiistai;146;84;230;19;14;33
89;11.09.2018;2018;09;15;Tiistai;185;74;259;22;14;36
89;11.09.2018;2018;09;16;Tiistai;237;97;334;23;26;49
89;11.09.2018;2018;09;17;Tiistai;96;34;130;7;7;14
89;11.09.2018;2018;09;18;Tiistai;71;34;105;11;6;17
89;11.09.2018;2018;09;19;Tiistai;69;35;104;30;16;46
89;11.09.2018;2018;09;20;Tiistai;41;11;52;16;22;38
89;11.09.2018;2018;09;21;Tiistai;19;16;35;8;12;20
89;11.09.2018;2018;09;22;Tiistai;20;12;32;2;3;5
89;11.09.2018;2018;09;23;Tiistai;5;4;9;4;3;7
89;12.09.2018;2018;09;00;Keskiviikko;4;1;5;2;0;2
89;12.09.2018;2018;09;01;Keskiviikko;5;2;7;0;0;0
89;12.09.2018;2018;09;02;Keskiviikko;0;0;0;2;0;2
89;12.09.2018;2018;09;03;Keskiviikko;2;3;5;0;0;0
89;12.09.2018;2018;09;04;Keskiviikko;1;2;3;0;0;0
89;12.09.2018;2018;09;05;Keskiviikko;2;14;16;1;1;2
89;12.09.2018;2018;09;06;Keskiviikko;5;47;52;3;6;9
89;12.09.2018;2018;09;07;Keskiviikko;37;148;185;2;16;18
89;12.09.2018;2018;09;08;Keskiviikko;35;223;258;1;28;29
89;12.09.2018;2018;09;09;Keskiviikko;34;85;119;4;24;28
89;12.09.2018;2018;09;10;Keskiviikko;33;62;95;12;27;39
89;12.09.2018;2018;09;11;Keskiviikko;46;51;97;16;30;46
89;12.09.2018;2018;09;12;Keskiviikko;53;64;117;24;15;39
89;12.09.2018;2018;09;13;Keskiviikko;94;45;139;23;10;33
89;12.09.2018;2018;09;14;Keskiviikko;118;46;164;7;9;16
89;12.09.2018;2018;09;15;Keskiviikko;111;53;164;16;12;28
89;12.09.2018;2018;09;16;Keskiviikko;142;67;209;11;7;18
89;12.09.2018;2018;09;17;Keskiviikko;73;57;130;19;11;30
89;12.09.2018;2018;09;18;Keskiviikko;52;50;102;26;24;50
89;12.09.2018;2018;09;19;Keskiviikko;73;52;125;31;30;61
89;12.09.2018;2018;09;20;Keskiviikko;57;62;119;33;36;69
89;12.09.2018;2018;09;21;Keskiviikko;33;30;63;12;19;31
89;12.09.2018;2018;09;22;Keskiviikko;18;23;41;10;22;32
89;12.09.2018;2018;09;23;Keskiviikko;10;8;18;1;3;4
89;13.09.2018;2018;09;00;Torstai;10;0;10;3;0;3
89;13.09.2018;2018;09;01;Torstai;13;3;16;2;3;5
89;13.09.2018;2018;09;02;Torstai;14;0;14;1;0;1
89;13.09.2018;2018;09;03;Torstai;4;1;5;0;1;1
89;13.09.2018;2018;09;04;Torstai;6;2;8;2;0;2
89;13.09.2018;2018;09;05;Torstai;4;15;19;2;5;7
89;13.09.2018;2018;09;06;Torstai;15;66;81;2;2;4
89;13.09.2018;2018;09;07;Torstai;42;143;185;5;20;25
89;13.09.2018;2018;09;08;Torstai;43;253;296;5;40;45
89;13.09.2018;2018;09;09;Torstai;50;135;185;9;25;34
89;13.09.2018;2018;09;10;Torstai;29;72;101;14;25;39
89;13.09.2018;2018;09;11;Torstai;63;87;150;18;24;42
89;13.09.2018;2018;09;12;Torstai;70;68;138;18;26;44
89;13.09.2018;2018;09;13;Torstai;122;86;208;21;20;41
89;13.09.2018;2018;09;14;Torstai;123;81;204;16;22;38
89;13.09.2018;2018;09;15;Torstai;178;85;263;23;34;57
89;13.09.2018;2018;09;16;Torstai;216;103;319;39;41;80
89;13.09.2018;2018;09;17;Torstai;132;154;286;30;45;75
89;13.09.2018;2018;09;18;Torstai;122;105;227;32;45;77
89;13.09.2018;2018;09;19;Torstai;137;57;194;51;50;101
89;13.09.2018;2018;09;20;Torstai;82;64;146;30;31;61
89;13.09.2018;2018;09;21;Torstai;41;18;59;13;16;29
89;13.09.2018;2018;09;22;Torstai;30;19;49;8;10;18
89;13.09.2018;2018;09;23;Torstai;14;10;24;3;2;5
89;14.09.2018;2018;09;00;Perjantai;11;7;18;3;1;4
89;14.09.2018;2018;09;01;Perjantai;11;9;20;2;7;9
89;14.09.2018;2018;09;02;Perjantai;7;3;10;2;1;3
89;14.09.2018;2018;09;03;Perjantai;5;4;9;0;0;0
89;14.09.2018;2018;09;04;Perjantai;7;2;9;0;2;2
89;14.09.2018;2018;09;05;Perjantai;4;13;17;7;0;7
89;14.09.2018;2018;09;06;Perjantai;13;59;72;0;6;6
89;14.09.2018;2018;09;07;Perjantai;48;139;187;3;20;23
89;14.09.2018;2018;09;08;Perjantai;39;223;262;9;29;38
89;14.09.2018;2018;09;09;Perjantai;58;139;197;6;39;45
89;14.09.2018;2018;09;10;Perjantai;38;92;130;14;27;41
89;14.09.2018;2018;09;11;Perjantai;63;100;163;22;30;52
89;14.09.2018;2018;09;12;Perjantai;100;97;197;15;22;37
89;14.09.2018;2018;09;13;Perjantai;125;79;204;32;24;56
89;14.09.2018;2018;09;14;Perjantai;149;93;242;24;18;42
89;14.09.2018;2018;09;15;Perjantai;163;106;269;18;17;35
89;14.09.2018;2018;09;16;Perjantai;175;98;273;28;26;54
89;14.09.2018;2018;09;17;Perjantai;84;64;148;18;19;37
89;14.09.2018;2018;09;18;Perjantai;91;55;146;32;21;53
89;14.09.2018;2018;09;19;Perjantai;69;54;123;14;16;30
89;14.09.2018;2018;09;20;Perjantai;57;42;99;27;27;54
89;14.09.2018;2018;09;21;Perjantai;62;30;92;7;9;16
89;14.09.2018;2018;09;22;Perjantai;19;23;42;8;13;21
89;14.09.2018;2018;09;23;Perjantai;15;19;34;12;5;17
89;15.09.2018;2018;09;00;Lauantai;14;13;27;3;8;11
89;15.09.2018;2018;09;01;Lauantai;19;8;27;7;1;8
89;15.09.2018;2018;09;02;Lauantai;7;14;21;5;4;9
89;15.09.2018;2018;09;03;Lauantai;11;6;17;4;0;4
89;15.09.2018;2018;09;04;Lauantai;16;3;19;0;0;0
89;15.09.2018;2018;09;05;Lauantai;10;4;14;5;2;7
89;15.09.2018;2018;09;06;Lauantai;6;11;17;2;2;4
89;15.09.2018;2018;09;07;Lauantai;6;13;19;6;10;16
89;15.09.2018;2018;09;08;Lauantai;20;31;51;13;12;25
89;15.09.2018;2018;09;09;Lauantai;13;64;77;14;27;41
89;15.09.2018;2018;09;10;Lauantai;35;79;114;9;32;41
89;15.09.2018;2018;09;11;Lauantai;50;63;113;28;37;65
89;15.09.2018;2018;09;12;Lauantai;63;59;122;19;18;37
89;15.09.2018;2018;09;13;Lauantai;51;24;75;23;7;30
89;15.09.2018;2018;09;14;Lauantai;27;21;48;13;9;22
89;15.09.2018;2018;09;15;Lauantai;34;50;84;11;21;32
89;15.09.2018;2018;09;16;Lauantai;62;35;97;18;15;33
89;15.09.2018;2018;09;17;Lauantai;48;42;90;21;20;41
89;15.09.2018;2018;09;18;Lauantai;40;50;90;31;23;54
89;15.09.2018;2018;09;19;Lauantai;43;32;75;29;23;52
89;15.09.2018;2018;09;20;Lauantai;40;32;72;26;20;46
89;15.09.2018;2018;09;21;Lauantai;24;27;51;10;16;26
89;15.09.2018;2018;09;22;Lauantai;18;25;43;4;7;11
89;15.09.2018;2018;09;23;Lauantai;17;23;40;8;6;14
89;16.09.2018;2018;09;00;Sunnuntai;20;12;32;7;8;15
89;16.09.2018;2018;09;01;Sunnuntai;13;6;19;1;0;1
89;16.09.2018;2018;09;02;Sunnuntai;11;1;12;2;3;5
89;16.09.2018;2018;09;03;Sunnuntai;20;2;22;1;1;2
89;16.09.2018;2018;09;04;Sunnuntai;20;2;22;6;2;8
89;16.09.2018;2018;09;05;Sunnuntai;7;2;9;4;2;6
89;16.09.2018;2018;09;06;Sunnuntai;2;9;11;2;4;6
89;16.09.2018;2018;09;07;Sunnuntai;2;7;9;9;6;15
89;16.09.2018;2018;09;08;Sunnuntai;16;13;29;4;15;19
89;16.09.2018;2018;09;09;Sunnuntai;19;31;50;13;26;39
89;16.09.2018;2018;09;10;Sunnuntai;28;78;106;27;40;67
89;16.09.2018;2018;09;11;Sunnuntai;42;76;118;37;56;93
89;16.09.2018;2018;09;12;Sunnuntai;61;115;176;31;38;69
89;16.09.2018;2018;09;13;Sunnuntai;72;82;154;39;174;213
89;16.09.2018;2018;09;14;Sunnuntai;51;108;159;62;564;626
89;16.09.2018;2018;09;15;Sunnuntai;72;65;137;57;407;464
89;16.09.2018;2018;09;16;Sunnuntai;67;62;129;35;32;67
89;16.09.2018;2018;09;17;Sunnuntai;76;52;128;24;26;50
89;16.09.2018;2018;09;18;Sunnuntai;81;37;118;30;28;58
89;16.09.2018;2018;09;19;Sunnuntai;46;40;86;28;28;56
89;16.09.2018;2018;09;20;Sunnuntai;26;15;41;18;15;33
89;16.09.2018;2018;09;21;Sunnuntai;23;19;42;11;7;18
89;16.09.2018;2018;09;22;Sunnuntai;6;4;10;3;3;6
89;16.09.2018;2018;09;23;Sunnuntai;3;5;8;3;1;4
89;17.09.2018;2018;09;00;Maanantai;1;3;4;6;2;8
89;17.09.2018;2018;09;01;Maanantai;4;0;4;1;0;1
89;17.09.2018;2018;09;02;Maanantai;2;3;5;1;1;2
89;17.09.2018;2018;09;03;Maanantai;3;3;6;0;1;1
89;17.09.2018;2018;09;04;Maanantai;3;3;6;1;1;2
89;17.09.2018;2018;09;05;Maanantai;4;15;19;0;0;0
89;17.09.2018;2018;09;06;Maanantai;8;55;63;6;2;8
89;17.09.2018;2018;09;07;Maanantai;39;161;200;3;12;15
89;17.09.2018;2018;09;08;Maanantai;57;259;316;5;28;33
89;17.09.2018;2018;09;09;Maanantai;45;136;181;14;36;50
89;17.09.2018;2018;09;10;Maanantai;36;124;160;20;29;49
89;17.09.2018;2018;09;11;Maanantai;69;87;156;25;30;55
89;17.09.2018;2018;09;12;Maanantai;104;99;203;15;22;37
89;17.09.2018;2018;09;13;Maanantai;107;72;179;16;26;42
89;17.09.2018;2018;09;14;Maanantai;148;83;231;17;18;35
89;17.09.2018;2018;09;15;Maanantai;198;77;275;28;18;46
89;17.09.2018;2018;09;16;Maanantai;213;117;330;29;26;55
89;17.09.2018;2018;09;17;Maanantai;122;80;202;33;32;65
89;17.09.2018;2018;09;18;Maanantai;90;81;171;41;42;83
89;17.09.2018;2018;09;19;Maanantai;119;50;169;42;27;69
89;17.09.2018;2018;09;20;Maanantai;55;30;85;20;24;44
89;17.09.2018;2018;09;21;Maanantai;26;24;50;8;7;15
89;17.09.2018;2018;09;22;Maanantai;20;12;32;3;5;8
89;17.09.2018;2018;09;23;Maanantai;1;3;4;1;1;2
89;18.09.2018;2018;09;00;Tiistai;0;3;3;0;0;0
89;18.09.2018;2018;09;01;Tiistai;2;5;7;0;1;1
89;18.09.2018;2018;09;02;Tiistai;0;1;1;1;0;1
89;18.09.2018;2018;09;03;Tiistai;0;6;6;0;1;1
89;18.09.2018;2018;09;04;Tiistai;1;3;4;1;1;2
89;18.09.2018;2018;09;05;Tiistai;3;10;13;1;1;2
89;18.09.2018;2018;09;06;Tiistai;14;61;75;8;3;11
89;18.09.2018;2018;09;07;Tiistai;44;157;201;3;21;24
89;18.09.2018;2018;09;08;Tiistai;56;271;327;6;26;32
89;18.09.2018;2018;09;09;Tiistai;33;142;175;8;24;32
89;18.09.2018;2018;09;10;Tiistai;39;91;130;19;38;57
89;18.09.2018;2018;09;11;Tiistai;70;103;173;14;22;36
89;18.09.2018;2018;09;12;Tiistai;74;90;164;10;21;31
89;18.09.2018;2018;09;13;Tiistai;94;72;166;25;21;46
89;18.09.2018;2018;09;14;Tiistai;155;72;227;44;22;66
89;18.09.2018;2018;09;15;Tiistai;177;73;250;36;19;55
89;18.09.2018;2018;09;16;Tiistai;246;125;371;34;25;59
89;18.09.2018;2018;09;17;Tiistai;128;95;223;26;33;59
89;18.09.2018;2018;09;18;Tiistai;126;72;198;50;42;92
89;18.09.2018;2018;09;19;Tiistai;90;69;159;46;36;82
89;18.09.2018;2018;09;20;Tiistai;59;47;106;39;28;67
89;18.09.2018;2018;09;21;Tiistai;48;23;71;7;7;14
89;18.09.2018;2018;09;22;Tiistai;30;17;47;5;5;10
89;18.09.2018;2018;09;23;Tiistai;10;4;14;4;1;5
89;19.09.2018;2018;09;00;Keskiviikko;5;2;7;3;5;8
89;19.09.2018;2018;09;01;Keskiviikko;2;3;5;0;1;1
89;19.09.2018;2018;09;02;Keskiviikko;0;0;0;1;0;1
89;19.09.2018;2018;09;03;Keskiviikko;2;1;3;0;1;1
89;19.09.2018;2018;09;04;Keskiviikko;1;1;2;0;0;0
89;19.09.2018;2018;09;05;Keskiviikko;4;17;21;0;1;1
89;19.09.2018;2018;09;06;Keskiviikko;7;54;61;3;2;5
89;19.09.2018;2018;09;07;Keskiviikko;34;168;202;6;19;25
89;19.09.2018;2018;09;08;Keskiviikko;61;241;302;12;37;49
89;19.09.2018;2018;09;09;Keskiviikko;49;129;178;11;23;34
89;19.09.2018;2018;09;10;Keskiviikko;40;76;116;6;26;32
89;19.09.2018;2018;09;11;Keskiviikko;50;60;110;13;19;32
89;19.09.2018;2018;09;12;Keskiviikko;39;49;88;12;15;27
89;19.09.2018;2018;09;13;Keskiviikko;88;48;136;25;5;30
89;19.09.2018;2018;09;14;Keskiviikko;137;67;204;17;13;30
89;19.09.2018;2018;09;15;Keskiviikko;159;62;221;16;11;27
89;19.09.2018;2018;09;16;Keskiviikko;164;97;261;22;22;44
89;19.09.2018;2018;09;17;Keskiviikko;102;61;163;31;13;44
89;19.09.2018;2018;09;18;Keskiviikko;79;49;128;18;27;45
89;19.09.2018;2018;09;19;Keskiviikko;79;42;121;30;18;48
89;19.09.2018;2018;09;20;Keskiviikko;59;28;87;22;20;42
89;19.09.2018;2018;09;21;Keskiviikko;31;12;43;10;19;29
89;19.09.2018;2018;09;22;Keskiviikko;27;11;38;7;7;14
89;19.09.2018;2018;09;23;Keskiviikko;17;12;29;4;1;5
89;20.09.2018;2018;09;00;Torstai;6;7;13;2;2;4
89;20.09.2018;2018;09;01;Torstai;5;4;9;3;0;3
89;20.09.2018;2018;09;02;Torstai;2;1;3;0;0;0
89;20.09.2018;2018;09;03;Torstai;6;1;7;0;0;0
89;20.09.2018;2018;09;04;Torstai;6;1;7;1;0;1
89;20.09.2018;2018;09;05;Torstai;7;11;18;0;1;1
89;20.09.2018;2018;09;06;Torstai;14;50;64;6;3;9
89;20.09.2018;2018;09;07;Torstai;28;170;198;9;17;26
89;20.09.2018;2018;09;08;Torstai;35;224;259;8;35;43
89;20.09.2018;2018;09;09;Torstai;48;115;163;8;31;39
89;20.09.2018;2018;09;10;Torstai;41;86;127;14;27;41
89;20.09.2018;2018;09;11;Torstai;63;80;143;23;18;41
89;20.09.2018;2018;09;12;Torstai;64;72;136;23;24;47
89;20.09.2018;2018;09;13;Torstai;102;55;157;25;10;35
89;20.09.2018;2018;09;14;Torstai;108;62;170;11;22;33
89;20.09.2018;2018;09;15;Torstai;153;66;219;14;15;29
89;20.09.2018;2018;09;16;Torstai;212;95;307;17;31;48
89;20.09.2018;2018;09;17;Torstai;107;71;178;25;35;60
89;20.09.2018;2018;09;18;Torstai;83;107;190;26;42;68
89;20.09.2018;2018;09;19;Torstai;93;58;151;29;46;75
89;20.09.2018;2018;09;20;Torstai;55;66;121;16;21;37
89;20.09.2018;2018;09;21;Torstai;36;20;56;9;6;15
89;20.09.2018;2018;09;22;Torstai;22;10;32;3;5;8
89;20.09.2018;2018;09;23;Torstai;18;14;32;4;1;5
89;21.09.2018;2018;09;00;Perjantai;7;2;9;2;1;3
89;21.09.2018;2018;09;01;Perjantai;3;4;7;2;0;2
89;21.09.2018;2018;09;02;Perjantai;4;0;4;2;1;3
89;21.09.2018;2018;09;03;Perjantai;4;4;8;4;0;4
89;21.09.2018;2018;09;04;Perjantai;4;0;4;1;0;1
89;21.09.2018;2018;09;05;Perjantai;3;11;14;0;0;0
89;21.09.2018;2018;09;06;Perjantai;11;51;62;7;7;14
89;21.09.2018;2018;09;07;Perjantai;25;138;163;4;18;22
89;21.09.2018;2018;09;08;Perjantai;31;206;237;7;78;85
89;21.09.2018;2018;09;09;Perjantai;40;120;160;14;34;48
89;21.09.2018;2018;09;10;Perjantai;35;85;120;15;19;34
89;21.09.2018;2018;09;11;Perjantai;67;94;161;19;22;41
89;21.09.2018;2018;09;12;Perjantai;97;76;173;29;30;59
89;21.09.2018;2018;09;13;Perjantai;122;94;216;27;26;53
89;21.09.2018;2018;09;14;Perjantai;147;95;242;27;18;45
89;21.09.2018;2018;09;15;Perjantai;176;72;248;21;8;29
89;21.09.2018;2018;09;16;Perjantai;156;96;252;20;22;42
89;21.09.2018;2018;09;17;Perjantai;100;85;185;24;28;52
89;21.09.2018;2018;09;18;Perjantai;70;67;137;20;21;41
89;21.09.2018;2018;09;19;Perjantai;54;33;87;13;12;25
89;21.09.2018;2018;09;20;Perjantai;39;29;68;16;6;22
89;21.09.2018;2018;09;21;Perjantai;26;21;47;12;9;21
89;21.09.2018;2018;09;22;Perjantai;20;19;39;7;3;10
89;21.09.2018;2018;09;23;Perjantai;20;23;43;2;5;7
89;22.09.2018;2018;09;00;Lauantai;15;13;28;10;2;12
89;22.09.2018;2018;09;01;Lauantai;19;14;33;4;2;6
89;22.09.2018;2018;09;02;Lauantai;15;5;20;1;2;3
89;22.09.2018;2018;09;03;Lauantai;14;3;17;4;2;6
89;22.09.2018;2018;09;04;Lauantai;11;1;12;8;0;8
89;22.09.2018;2018;09;05;Lauantai;11;3;14;3;1;4
89;22.09.2018;2018;09;06;Lauantai;4;11;15;3;1;4
89;22.09.2018;2018;09;07;Lauantai;3;8;11;8;12;20
89;22.09.2018;2018;09;08;Lauantai;7;26;33;8;17;25
89;22.09.2018;2018;09;09;Lauantai;12;20;32;3;17;20
89;22.09.2018;2018;09;10;Lauantai;5;9;14;5;7;12
89;22.09.2018;2018;09;11;Lauantai;8;35;43;9;138;147
89;22.09.2018;2018;09;12;Lauantai;29;46;75;24;41;65
89;22.09.2018;2018;09;13;Lauantai;34;66;100;27;35;62
89;22.09.2018;2018;09;14;Lauantai;58;53;111;31;28;59
89;22.09.2018;2018;09;15;Lauantai;61;40;101;29;29;58
89;22.09.2018;2018;09;16;Lauantai;42;47;89;26;32;58
89;22.09.2018;2018;09;17;Lauantai;40;40;80;29;36;65
89;22.09.2018;2018;09;18;Lauantai;36;41;77;21;29;50
89;22.09.2018;2018;09;19;Lauantai;38;36;74;19;22;41
89;22.09.2018;2018;09;20;Lauantai;21;20;41;21;12;33
89;22.09.2018;2018;09;21;Lauantai;24;28;52;7;15;22
89;22.09.2018;2018;09;22;Lauantai;24;16;40;11;5;16
89;22.09.2018;2018;09;23;Lauantai;24;10;34;6;11;17
89;23.09.2018;2018;09;00;Sunnuntai;12;10;22;3;10;13
89;23.09.2018;2018;09;01;Sunnuntai;8;9;17;3;5;8
89;23.09.2018;2018;09;02;Sunnuntai;10;7;17;9;4;13
89;23.09.2018;2018;09;03;Sunnuntai;12;1;13;7;0;7
89;23.09.2018;2018;09;04;Sunnuntai;8;3;11;3;0;3
89;23.09.2018;2018;09;05;Sunnuntai;17;6;23;7;4;11
89;23.09.2018;2018;09;06;Sunnuntai;4;7;11;4;1;5
89;23.09.2018;2018;09;07;Sunnuntai;2;7;9;6;7;13
89;23.09.2018;2018;09;08;Sunnuntai;3;13;16;18;14;32
89;23.09.2018;2018;09;09;Sunnuntai;17;16;33;10;24;34
89;23.09.2018;2018;09;10;Sunnuntai;22;37;59;28;39;67
89;23.09.2018;2018;09;11;Sunnuntai;23;62;85;31;38;69
89;23.09.2018;2018;09;12;Sunnuntai;46;77;123;28;36;64
89;23.09.2018;2018;09;13;Sunnuntai;73;68;141;33;40;73
89;23.09.2018;2018;09;14;Sunnuntai;67;80;147;32;46;78
89;23.09.2018;2018;09;15;Sunnuntai;71;54;125;36;33;69
89;23.09.2018;2018;09;16;Sunnuntai;68;77;145;55;37;92
89;23.09.2018;2018;09;17;Sunnuntai;72;57;129;35;41;76
89;23.09.2018;2018;09;18;Sunnuntai;58;46;104;33;27;60
89;23.09.2018;2018;09;19;Sunnuntai;46;27;73;29;19;48
89;23.09.2018;2018;09;20;Sunnuntai;29;20;49;11;23;34
89;23.09.2018;2018;09;21;Sunnuntai;21;17;38;9;4;13
89;23.09.2018;2018;09;22;Sunnuntai;8;9;17;6;10;16
89;23.09.2018;2018;09;23;Sunnuntai;5;5;10;0;4;4
89;24.09.2018;2018;09;00;Maanantai;1;2;3;0;2;2
89;24.09.2018;2018;09;01;Maanantai;2;11;13;1;1;2
89;24.09.2018;2018;09;02;Maanantai;4;1;5;1;0;1
89;24.09.2018;2018;09;03;Maanantai;3;3;6;0;0;0
89;24.09.2018;2018;09;04;Maanantai;4;1;5;0;0;0
89;24.09.2018;2018;09;05;Maanantai;3;24;27;0;0;0
89;24.09.2018;2018;09;06;Maanantai;9;50;59;1;5;6
89;24.09.2018;2018;09;07;Maanantai;34;159;193;8;12;20
89;24.09.2018;2018;09;08;Maanantai;43;207;250;6;38;44
89;24.09.2018;2018;09;09;Maanantai;32;115;147;27;16;43
89;24.09.2018;2018;09;10;Maanantai;47;102;149;23;31;54
89;24.09.2018;2018;09;11;Maanantai;75;65;140;20;16;36
89;24.09.2018;2018;09;12;Maanantai;75;91;166;18;16;34
89;24.09.2018;2018;09;13;Maanantai;74;76;150;13;21;34
89;24.09.2018;2018;09;14;Maanantai;138;64;202;30;21;51
89;24.09.2018;2018;09;15;Maanantai;168;73;241;18;20;38
89;24.09.2018;2018;09;16;Maanantai;192;67;259;20;28;48
89;24.09.2018;2018;09;17;Maanantai;106;66;172;24;42;66
89;24.09.2018;2018;09;18;Maanantai;96;50;146;18;26;44
89;24.09.2018;2018;09;19;Maanantai;77;27;104;30;19;49
89;24.09.2018;2018;09;20;Maanantai;40;16;56;12;14;26
89;24.09.2018;2018;09;21;Maanantai;33;18;51;10;8;18
89;24.09.2018;2018;09;22;Maanantai;12;13;25;4;4;8
89;24.09.2018;2018;09;23;Maanantai;5;3;8;1;0;1
89;25.09.2018;2018;09;00;Tiistai;2;0;2;0;0;0
89;25.09.2018;2018;09;01;Tiistai;6;0;6;1;0;1
89;25.09.2018;2018;09;02;Tiistai;1;0;1;1;0;1
89;25.09.2018;2018;09;03;Tiistai;5;0;5;1;0;1
89;25.09.2018;2018;09;04;Tiistai;3;0;3;2;0;2
89;25.09.2018;2018;09;05;Tiistai;10;0;10;2;0;2
89;25.09.2018;2018;09;06;Tiistai;60;0;60;11;0;11
89;25.09.2018;2018;09;07;Tiistai;161;0;161;24;0;24
89;25.09.2018;2018;09;08;Tiistai;262;0;262;32;0;32
89;25.09.2018;2018;09;09;Tiistai;140;0;140;32;0;32
89;25.09.2018;2018;09;10;Tiistai;104;0;104;57;0;57
89;25.09.2018;2018;09;11;Tiistai;138;0;138;36;0;36
89;25.09.2018;2018;09;12;Tiistai;131;0;131;31;0;31
89;25.09.2018;2018;09;13;Tiistai;133;0;133;46;0;46
89;25.09.2018;2018;09;14;Tiistai;182;0;182;66;0;66
89;25.09.2018;2018;09;15;Tiistai;200;0;200;55;0;55
89;25.09.2018;2018;09;16;Tiistai;297;0;297;59;0;59
89;25.09.2018;2018;09;17;Tiistai;178;0;178;59;0;59
89;25.09.2018;2018;09;18;Tiistai;158;0;158;92;0;92
89;25.09.2018;2018;09;19;Tiistai;127;0;127;82;0;82
89;25.09.2018;2018;09;20;Tiistai;85;0;85;67;0;67
89;25.09.2018;2018;09;21;Tiistai;57;0;57;14;0;14
89;25.09.2018;2018;09;22;Tiistai;38;0;38;10;0;10
89;25.09.2018;2018;09;23;Tiistai;11;0;11;5;0;5
89;26.09.2018;2018;09;00;Keskiviikko;10;2;12;2;1;3
89;26.09.2018;2018;09;01;Keskiviikko;5;5;10;0;0;0
89;26.09.2018;2018;09;02;Keskiviikko;7;0;7;0;1;1
89;26.09.2018;2018;09;03;Keskiviikko;6;1;7;1;1;2
89;26.09.2018;2018;09;04;Keskiviikko;1;2;3;0;0;0
89;26.09.2018;2018;09;05;Keskiviikko;3;15;18;0;3;3
89;26.09.2018;2018;09;06;Keskiviikko;9;38;47;0;3;3
89;26.09.2018;2018;09;07;Keskiviikko;33;126;159;5;22;27
89;26.09.2018;2018;09;08;Keskiviikko;37;194;231;18;31;49
89;26.09.2018;2018;09;09;Keskiviikko;28;75;103;17;23;40
89;26.09.2018;2018;09;10;Keskiviikko;19;49;68;9;18;27
89;26.09.2018;2018;09;11;Keskiviikko;39;40;79;13;16;29
89;26.09.2018;2018;09;12;Keskiviikko;43;38;81;10;17;27
89;26.09.2018;2018;09;13;Keskiviikko;68;26;94;20;15;35
89;26.09.2018;2018;09;14;Keskiviikko;75;43;118;22;17;39
89;26.09.2018;2018;09;15;Keskiviikko;114;20;134;9;14;23
89;26.09.2018;2018;09;16;Keskiviikko;105;55;160;15;18;33
89;26.09.2018;2018;09;17;Keskiviikko;63;49;112;11;27;38
89;26.09.2018;2018;09;18;Keskiviikko;53;50;103;29;24;53
89;26.09.2018;2018;09;19;Keskiviikko;57;27;84;41;28;69
89;26.09.2018;2018;09;20;Keskiviikko;48;15;63;27;17;44
89;26.09.2018;2018;09;21;Keskiviikko;27;13;40;10;6;16
89;26.09.2018;2018;09;22;Keskiviikko;17;6;23;5;5;10
89;26.09.2018;2018;09;23;Keskiviikko;4;3;7;3;1;4
89;27.09.2018;2018;09;00;Torstai;4;4;8;3;0;3
89;27.09.2018;2018;09;01;Torstai;2;1;3;0;0;0
89;27.09.2018;2018;09;02;Torstai;1;3;4;2;1;3
89;27.09.2018;2018;09;03;Torstai;2;2;4;0;0;0
89;27.09.2018;2018;09;04;Torstai;2;5;7;0;1;1
89;27.09.2018;2018;09;05;Torstai;3;11;14;1;2;3
89;27.09.2018;2018;09;06;Torstai;7;31;38;0;5;5
89;27.09.2018;2018;09;07;Torstai;24;126;150;4;17;21
89;27.09.2018;2018;09;08;Torstai;22;190;212;5;33;38
89;27.09.2018;2018;09;09;Torstai;28;83;111;14;21;35
89;27.09.2018;2018;09;10;Torstai;44;55;99;10;12;22
89;27.09.2018;2018;09;11;Torstai;37;61;98;12;16;28
89;27.09.2018;2018;09;12;Torstai;49;51;100;13;28;41
89;27.09.2018;2018;09;13;Torstai;59;43;102;16;26;42
89;27.09.2018;2018;09;14;Torstai;121;47;168;32;15;47
89;27.09.2018;2018;09;15;Torstai;136;64;200;24;18;42
89;27.09.2018;2018;09;16;Torstai;140;70;210;23;20;43
89;27.09.2018;2018;09;17;Torstai;73;74;147;20;36;56
89;27.09.2018;2018;09;18;Torstai;74;53;127;32;25;57
89;27.09.2018;2018;09;19;Torstai;87;38;125;30;29;59
89;27.09.2018;2018;09;20;Torstai;38;20;58;12;13;25
89;27.09.2018;2018;09;21;Torstai;38;16;54;6;13;19
89;27.09.2018;2018;09;22;Torstai;19;9;28;7;11;18
89;27.09.2018;2018;09;23;Torstai;12;8;20;6;0;6
89;28.09.2018;2018;09;00;Perjantai;4;6;10;5;0;5
89;28.09.2018;2018;09;01;Perjantai;8;1;9;1;3;4
89;28.09.2018;2018;09;02;Perjantai;7;2;9;5;2;7
89;28.09.2018;2018;09;03;Perjantai;6;3;9;0;0;0
89;28.09.2018;2018;09;04;Perjantai;4;3;7;1;0;1
89;28.09.2018;2018;09;05;Perjantai;5;11;16;0;1;1
89;28.09.2018;2018;09;06;Perjantai;14;37;51;0;3;3
89;28.09.2018;2018;09;07;Perjantai;33;146;179;2;16;18
89;28.09.2018;2018;09;08;Perjantai;34;185;219;5;24;29
89;28.09.2018;2018;09;09;Perjantai;38;98;136;5;38;43
89;28.09.2018;2018;09;10;Perjantai;33;83;116;10;20;30
89;28.09.2018;2018;09;11;Perjantai;61;66;127;24;26;50
89;28.09.2018;2018;09;12;Perjantai;75;104;179;11;29;40
89;28.09.2018;2018;09;13;Perjantai;92;82;174;28;17;45
89;28.09.2018;2018;09;14;Perjantai;131;73;204;19;23;42
89;28.09.2018;2018;09;15;Perjantai;151;81;232;31;37;68
89;28.09.2018;2018;09;16;Perjantai;151;83;234;27;26;53
89;28.09.2018;2018;09;17;Perjantai;116;67;183;26;38;64
89;28.09.2018;2018;09;18;Perjantai;82;52;134;23;29;52
89;28.09.2018;2018;09;19;Perjantai;64;46;110;23;14;37
89;28.09.2018;2018;09;20;Perjantai;45;29;74;16;10;26
89;28.09.2018;2018;09;21;Perjantai;37;24;61;7;7;14
89;28.09.2018;2018;09;22;Perjantai;34;17;51;7;7;14
89;28.09.2018;2018;09;23;Perjantai;16;19;35;3;4;7
89;29.09.2018;2018;09;00;Lauantai;10;18;28;3;2;5
89;29.09.2018;2018;09;01;Lauantai;18;2;20;8;2;10
89;29.09.2018;2018;09;02;Lauantai;10;3;13;0;0;0
89;29.09.2018;2018;09;03;Lauantai;11;3;14;4;2;6
89;29.09.2018;2018;09;04;Lauantai;13;0;13;5;1;6
89;29.09.2018;2018;09;05;Lauantai;4;2;6;1;2;3
89;29.09.2018;2018;09;06;Lauantai;4;5;9;0;0;0
89;29.09.2018;2018;09;07;Lauantai;3;12;15;2;1;3
89;29.09.2018;2018;09;08;Lauantai;6;32;38;4;15;19
89;29.09.2018;2018;09;09;Lauantai;12;64;76;14;12;26
89;29.09.2018;2018;09;10;Lauantai;14;52;66;15;28;43
89;29.09.2018;2018;09;11;Lauantai;34;58;92;25;63;88
89;29.09.2018;2018;09;12;Lauantai;53;75;128;30;47;77
89;29.09.2018;2018;09;13;Lauantai;70;82;152;23;41;64
89;29.09.2018;2018;09;14;Lauantai;77;64;141;30;34;64
89;29.09.2018;2018;09;15;Lauantai;84;61;145;35;34;69
89;29.09.2018;2018;09;16;Lauantai;84;68;152;29;36;65
89;29.09.2018;2018;09;17;Lauantai;40;49;89;37;32;69
89;29.09.2018;2018;09;18;Lauantai;53;34;87;22;21;43
89;29.09.2018;2018;09;19;Lauantai;59;42;101;21;34;55
89;29.09.2018;2018;09;20;Lauantai;30;24;54;21;11;32
89;29.09.2018;2018;09;21;Lauantai;18;15;33;11;7;18
89;29.09.2018;2018;09;22;Lauantai;18;25;43;5;9;14
89;29.09.2018;2018;09;23;Lauantai;21;24;45;7;2;9
89;30.09.2018;2018;09;00;Sunnuntai;10;18;28;6;0;6
89;30.09.2018;2018;09;01;Sunnuntai;14;11;25;4;1;5
89;30.09.2018;2018;09;02;Sunnuntai;19;2;21;5;2;7
89;30.09.2018;2018;09;03;Sunnuntai;20;3;23;7;2;9
89;30.09.2018;2018;09;04;Sunnuntai;11;1;12;4;2;6
89;30.09.2018;2018;09;05;Sunnuntai;10;2;12;0;1;1
89;30.09.2018;2018;09;06;Sunnuntai;1;5;6;0;2;2
89;30.09.2018;2018;09;07;Sunnuntai;2;3;5;2;5;7
89;30.09.2018;2018;09;08;Sunnuntai;1;4;5;9;3;12
89;30.09.2018;2018;09;09;Sunnuntai;6;31;37;10;21;31
89;30.09.2018;2018;09;10;Sunnuntai;10;33;43;16;18;34
89;30.09.2018;2018;09;11;Sunnuntai;29;72;101;27;47;74
89;30.09.2018;2018;09;12;Sunnuntai;62;66;128;28;38;66
89;30.09.2018;2018;09;13;Sunnuntai;43;67;110;38;36;74
89;30.09.2018;2018;09;14;Sunnuntai;52;92;144;41;40;81
89;30.09.2018;2018;09;15;Sunnuntai;55;86;141;52;47;99
89;30.09.2018;2018;09;16;Sunnuntai;59;67;126;46;32;78
89;30.09.2018;2018;09;17;Sunnuntai;67;51;118;40;44;84
89;30.09.2018;2018;09;18;Sunnuntai;67;53;120;31;36;67
89;30.09.2018;2018;09;19;Sunnuntai;50;40;90;29;28;57
89;30.09.2018;2018;09;20;Sunnuntai;45;27;72;9;9;18
89;30.09.2018;2018;09;21;Sunnuntai;23;10;33;6;12;18
89;30.09.2018;2018;09;22;Sunnuntai;16;8;24;6;5;11
89;30.09.2018;2018;09;23;Sunnuntai;7;2;9;3;0;3